year,esize,firms,estabs,emp,denom,estabs_entry,estabs_entry_rate,estabs_exit,estabs_exit_rate,job_creation,job_creation_births,job_creation_continuers,job_creation_rate_births,job_creation_rate,job_destruction,job_destruction_deaths,job_destruction_continuers,job_destruction_rate_deaths,job_destruction_rate,net_job_creation,net_job_creation_rate,reallocation_rate,firmdeath_firms,firmdeath_estabs,firmdeath_emp
1978,a) 1 to 4,2231730,2431777,6147785,5763805,552907,23.396,415823,17.595,2404261,1534798,869463,26.628,41.713,1629991,1111410,518581,19.283,28.28,774270,13.433,56.56,295039,298123,764954
1979,a) 1 to 4,2239587,2439982,6076369,5806808,531699,22.504,377187,15.964,2232957,1467769,765188,25.277,38.454,1696591,1056629,639962,18.196,29.217,536366,9.237,58.435,265224,268258,723326
1980,a) 1 to 4,2233844,2437867,5924538,5868870,495110,20.594,427768,17.793,2006358,1368833,637525,23.324,34.186,1898972,1154994,743978,19.68,32.357,107386,1.83,64.71300000000001,307604,311218,812306
1981,a) 1 to 4,2275573,2490701,6088047,5932689,486604,19.917,391605,16.028,2059132,1375090,684042,23.178,34.708,1749714,1024345,725369,17.266,29.493,309418,5.215,58.986,266377,270778,688424
1982,a) 1 to 4,2261722,2485814,6183911,6058377,506444,20.564,460305,18.691,2188316,1448065,740251,23.902,36.121,1938462,1212332,726130,20.011,31.996,249854,4.124,63.993,326561,331503,856349
1983,a) 1 to 4,2358182,2578736,6325560,6105206,539114,21.623,368236,14.769,2158571,1460085,698486,23.915,35.356,1719283,1024517,694766,16.781,28.161,439288,7.195,56.322,257735,262189,716972
1984,a) 1 to 4,2462747,2688318,6711857,6313546,602390,23.355,384251,14.898,2462824,1656296,806528,26.234,39.009,1663732,1034604,629128,16.387,26.352,799092,12.657,52.70399999999999,283520,287746,764678
1985,a) 1 to 4,2472440,2695858,6746586,6476897,590249,22.498,445624,16.986,2433664,1642537,791127,25.36,37.575,1893386,1229422,663964,18.982,29.233,540278,8.342,58.466,329890,335296,908612
1986,a) 1 to 4,2479816,2708724,6800690,6537140,584113,22.156,439424,16.668,2445692,1665349,780343,25.475,37.412,1918188,1220326,697862,18.668,29.343000000000004,527504,8.068999999999999,58.68600000000001,321453,326452,894713
1987,a) 1 to 4,2510437,2744362,6927507,6657309,616352,23.094,465455,17.44,2569616,1751628,817988,26.311,38.598,2028493,1314911,713582,19.751,30.47,541123,8.128,60.94,332911,337949,930158
1988,a) 1 to 4,2575812,2828326,7090805,6806924,626454,22.831,457597,16.677,2586480,1766932,819548,25.958,37.99800000000001,2018415,1259338,759077,18.501,29.652,568065,8.345,59.305,333260,339132,919773
1989,a) 1 to 4,2604794,2867526,7176800,6905510,613575,21.997,457354,16.396,2555627,1737471,818156,25.161,37.009,2018548,1263197,755351,18.293,29.231,537079,7.778,58.462,337852,345290,942745
1990,a) 1 to 4,2628621,2893769,7217923,6985087,595413,21.062,461750,16.334,2505468,1676804,828664,24.005,35.869,2041093,1272839,768254,18.222,29.221,464375,6.648,58.441,346411,353846,963813
1991,a) 1 to 4,2624139,2915044,7199494,7106625,577003,20.085,492479,17.143,2413306,1660397,752909,23.364,33.959,2231510,1362594,868916,19.174,31.4,181796,2.5580000000000003,62.801,359399,366995,1003358
1992,a) 1 to 4,2644337,2926244,7228440,7113065,554984,19.206,481831,16.674,2368234,1551992,816242,21.819000000000006,33.294000000000004,2139928,1321830,818098,18.583,30.084,228306,3.21,60.169,330253,337648,898783
1993,a) 1 to 4,2696546,2964764,7296721,7174025,562876,19.231,487054,16.641,2368408,1530667,837741,21.336,33.014,2122915,1335564,787351,18.617,29.592,245493,3.422,59.183,333006,341097,901414
1994,a) 1 to 4,2747443,3026913,7399367,7256653,583302,19.592,483818,16.250999999999998,2423181,1592356,830825,21.943,33.393,2138866,1305938,832928,17.996,29.475,284315,3.918,58.949,344019,351314,930183
1995,a) 1 to 4,2810278,3098212,7554589,7345769,601068,19.794,477882,15.737,2482686,1634521,848165,22.251,33.797,2063948,1283870,780078,17.477999999999998,28.097,418738,5.7,56.194,343724,351744,925288
1996,a) 1 to 4,2837470,3133437,7598136,7442075,594687,19.271,499785,16.195,2454053,1616982,837071,21.728,32.975,2139671,1333541,806130,17.919,28.751,314382,4.224,57.502,357811,365692,961234
1997,a) 1 to 4,2861051,3162194,7726499,7573263,617885,19.777,541944,17.347,2585765,1702776,882989,22.484,34.143,2274448,1480060,794388,19.543,30.033,311317,4.1110000000000015,60.065,370742,380382,1007579
1998,a) 1 to 4,2880614,3187347,7697919,7563924,595466,18.943,507633,16.149,2453647,1592598,861049,21.055,32.439,2184709,1370411,814298,18.118,28.883000000000006,268938,3.556,57.767,344177,352229,917633
1999,a) 1 to 4,2888446,3211216,7699365,7593299,584311,18.408,510175,16.073,2406922,1559843,847079,20.542,31.698,2194547,1377220,817327,18.137,28.901,212375,2.797,57.802,348792,357301,932065
2000,a) 1 to 4,2878432,3212928,7739258,7610804,572871,17.979,519750,16.312,2426230,1564212,862018,20.553,31.879,2167101,1379535,787566,18.126,28.474,259129,3.405,56.948,346511,355797,920653
2001,a) 1 to 4,2879264,3224219,7700525,7624442,583900,18.262,530084,16.579,2388525,1587894,800631,20.826,31.327,2235534,1404615,830919,18.423,29.321,152991,2.007,58.64100000000001,348506,358024,930169
2002,a) 1 to 4,2906215,3255943,7886176,7787943,617930,19.108,573851,17.745,2594603,1728848,865755,22.199,33.316,2399896,1535521,864375,19.717,30.816,194707,2.5,61.631,362563,372356,973764
2003,a) 1 to 4,2950703,3300641,7895309,7797155,622602,19.085,545789,16.730999999999998,2481788,1631875,849913,20.929,31.829,2285274,1427507,857767,18.308,29.309,196514,2.52,58.618,353960,360944,918634
2004,a) 1 to 4,2998836,3357570,8041805,7866650,635365,19.216,533227,16.127,2531600,1651264,880336,20.991,32.181,2181776,1374938,806838,17.477999999999998,27.734,349824,4.447,55.469,353908,361221,923702
2005,a) 1 to 4,3068595,3439653,8115165,8012684,662400,19.569000000000006,552968,16.336,2536842,1712708,824134,21.375,31.66,2333784,1413637,920147,17.642,29.126,203058,2.5340000000000003,58.252,371264,378246,960597
2006,a) 1 to 4,3142587,3542641,8414399,8194504,734787,21.153,596927,17.184,2768356,1926330,842026,23.508000000000006,33.783,2325859,1509481,816378,18.421,28.383000000000006,442497,5.4,56.76600000000001,426581,433029,1093602
2007,a) 1 to 4,3154100,3568435,8316235,8242889,682297,19.352,596872,16.929000000000002,2587482,1737986,849496,21.085,31.39,2441762,1502136,939626,18.223,29.623,145720,1.768,59.245,396210,402390,984801
2008,a) 1 to 4,3115242,3525401,8128213,8199129,599752,16.932000000000002,633392,17.881,2356297,1519521,836776,18.533,28.738000000000003,2494986,1540061,954925,18.783,30.43,-138689,-1.692,57.477,429647,435671,1037902
2009,a) 1 to 4,3033299,3444084,7811369,8099720,534004,15.189,677524,19.271,2061708,1343361,718347,16.585,25.454,2640101,1634644,1005457,20.181,32.595,-578393,-7.141,50.908,444798,452162,1085110
2010,a) 1 to 4,3021665,3440462,7831060,7959853,537293,15.475,600551,17.297,2054217,1338467,715750,16.815,25.807,2310530,1439521,871009,18.085,29.027,-256313,-3.22,51.614,382314,389923,929697
2011,a) 1 to 4,3027104,3456760,7925118,7909504,567081,16.410999999999998,564517,16.337,2162516,1396866,765650,17.660999999999994,27.341,2131867,1335788,796079,16.887999999999998,26.953000000000007,30649,0.387,53.90600000000001,365204,374061,886632
2012,a) 1 to 4,3064630,3491469,8031717,7942942,576421,16.636,523113,15.098,2243530,1424963,818567,17.94,28.246,2066863,1288478,778385,16.222,26.021,176667,2.224,52.043,325243,333110,805989
2013,a) 1 to 4,3070940,3498625,8006768,7941954,565355,16.258,522723,15.032,2171047,1389667,781380,17.498,27.336,2044341,1277366,766975,16.084,25.741,126706,1.595,51.482,332224,336623,815984
2014,a) 1 to 4,3085181,3529630,8064065,7945151,574945,16.453,504413,14.435,2197949,1415760,782189,17.819000000000006,27.664,1956644,1215506,741138,15.299,24.627,241305,3.037,49.254,335118,340055,814597
2015,a) 1 to 4,3105322,3563885,8127260,8006202,582421,16.517,506871,14.375,2226210,1436345,789865,17.94,27.806,1980051,1228569,751482,15.345,24.731,246159,3.075,49.463,336567,342219,824895
2016,a) 1 to 4,3142761,3633340,8264149,8086491,604831,16.916,489124,13.68,2291524,1488165,803359,18.403,28.338,1936010,1179771,756239,14.589,23.941,355514,4.396,47.883,344567,350613,842516
2017,a) 1 to 4,3154986,3637649,8174778,8141919,575855,15.924,533014,14.74,2180442,1404870,775572,17.255,26.78,2117667,1305015,812652,16.028,26.009,62775,0.7709999999999999,52.019,362181,368408,877204
2018,a) 1 to 4,3162819,3639717,8129818,8083140,558328,15.431,515141,14.238,2098252,1320220,778032,16.333,25.958,2001033,1240880,760153,15.351,24.756,97219,1.203,49.511,386554,395136,930103
1978,b) 5 to 9,708960,842821,6305437,5962530,54374,6.519,36791,4.4110000000000005,1753824,722286,1031538,12.114,29.414,1072315,490565,581750,8.227,17.984,681509,11.43,35.968,20294,20846,275654
1979,b) 5 to 9,747135,888742,6490022,6282062,50677,5.746,37191,4.217,1632098,670207,961891,10.669,25.98,1217703,494926,722777,7.877999999999999,19.384,414395,6.596,38.768,21988,22340,294945
1980,b) 5 to 9,749600,900637,6359380,6380125,46391,5.17,39675,4.422,1386935,613371,773564,9.614,21.738000000000003,1426120,527825,898295,8.273,22.353,-39185,-0.614,43.477,24796,25370,336080
1981,b) 5 to 9,757777,918329,6539844,6450638,48397,5.315,32800,3.602,1461843,642234,819609,9.956,22.662,1283058,436359,846699,6.765,19.89,178785,2.772,39.781,19092,19631,259834
1982,b) 5 to 9,765559,937086,6645795,6605510,50297,5.405,37290,4.007,1507896,663828,844068,10.05,22.828000000000007,1425919,497172,928747,7.527,21.587,81977,1.241,43.174,24096,24556,325957
1983,b) 5 to 9,782200,958809,6789170,6727902,46298,4.856,35375,3.711,1452754,612306,840448,9.101,21.593000000000004,1331320,471159,860161,7.002999999999999,19.788,121434,1.805,39.576,22203,22824,302863
1984,b) 5 to 9,811999,998654,7255080,6981052,52395,5.2970000000000015,33300,3.367,1724527,688861,1035666,9.868,24.703000000000007,1172100,444065,728035,6.3610000000000015,16.79,552427,7.9129999999999985,33.579,22346,22830,303254
1985,b) 5 to 9,836861,1024618,7413511,7226769,55061,5.4060000000000015,42781,4.2,1725869,729174,996695,10.09,23.882,1352080,567301,784779,7.85,18.709,373789,5.1720000000000015,37.419,28856,29430,391005
1986,b) 5 to 9,858954,1049793,7575700,7404444,58317,5.596,42923,4.119,1772742,773758,998984,10.45,23.942,1430273,569871,860402,7.6960000000000015,19.316,342469,4.625,38.633,27801,28367,376956
1987,b) 5 to 9,878667,1077606,7816580,7627685,62417,5.835,46732,4.368,1900837,828087,1072750,10.856,24.92,1523729,621373,902356,8.146,19.976,377108,4.944,39.953,29754,30413,403175
1988,b) 5 to 9,906326,1120013,8087473,7898149,63004,5.672999999999999,44108,3.972,1910899,835733,1075166,10.581,24.194000000000006,1531725,586933,944792,7.431,19.393,379174,4.801,38.787,28416,29327,388545
1989,b) 5 to 9,924827,1151222,8315218,8122952,61692,5.396,45889,4.0139999999999985,1916498,818388,1098110,10.075,23.594,1533497,609417,924080,7.502000000000002,18.879,383001,4.715,37.757,30246,31404,416698
1990,b) 5 to 9,940226,1175336,8437704,8289291,58613,5.015,45267,3.873,1873139,776319,1096820,9.365,22.597,1574925,602225,972700,7.265,19.0,298214,3.5980000000000003,37.999,30756,31677,420288
1991,b) 5 to 9,946850,1190260,8436959,8423776,64936,5.49,49902,4.2189999999999985,1825157,863095,962062,10.246,21.667,1797896,664189,1133707,7.885,21.343000000000004,27261,0.324,42.68600000000001,32965,34036,453597
1992,b) 5 to 9,948675,1198208,8492427,8449165,54411,4.557,45863,3.841,1780999,719946,1061053,8.521,21.079,1693965,609852,1084113,7.218,20.049,87034,1.03,40.098,27980,28766,381281
1993,b) 5 to 9,960650,1206763,8605564,8519125,50636,4.202,47351,3.929,1791401,671829,1119572,7.886,21.028,1619078,627122,991956,7.3610000000000015,19.005,172323,2.023,38.01,27113,28303,374752
1994,b) 5 to 9,971109,1220120,8715213,8609436,55712,4.584,46265,3.807,1824520,742042,1082478,8.619,21.192,1613280,616003,997277,7.155,18.739,211240,2.454,37.477,28397,29715,395122
1995,b) 5 to 9,978396,1231582,8852025,8697154,56993,4.647,46513,3.793,1859851,759758,1100093,8.736,21.385,1548127,622541,925586,7.158,17.8,311724,3.584,35.601,28192,29817,395303
1996,b) 5 to 9,985468,1243404,8884882,8785038,56726,4.58,46887,3.786,1809701,752914,1056787,8.57,20.6,1609549,624733,984816,7.1110000000000015,18.321,200152,2.278,36.643,29416,30742,410195
1997,b) 5 to 9,994783,1263392,9102669,8983826,64723,5.141,55756,4.4289999999999985,2005346,858111,1147235,9.552,22.322,1763854,747022,1016832,8.315,19.634,241492,2.688,39.267,31402,32897,439111
1998,b) 5 to 9,1008305,1278140,9175346,9053733,56136,4.402,50265,3.942,1915487,749763,1165724,8.281,21.157,1670728,672679,998049,7.43,18.453,244759,2.7030000000000003,36.907,27301,28566,380905
1999,b) 5 to 9,1009400,1284150,9181960,9103287,54991,4.288,51527,4.018,1850762,738800,1111962,8.116,20.331,1695548,688613,1006935,7.564,18.626,155214,1.705,37.251,29101,30996,413578
2000,b) 5 to 9,1011537,1288764,9262772,9131307,56543,4.398,50607,3.936,1904447,756232,1148215,8.282,20.856,1641112,677888,963224,7.423999999999999,17.972,263335,2.884,35.945,28056,30090,402171
2001,b) 5 to 9,1009007,1293624,9222269,9182537,58210,4.51,52448,4.063,1831475,780558,1050917,8.5,19.945,1753610,702780,1050830,7.653,19.097,77865,0.848,38.194,28673,30499,407117
2002,b) 5 to 9,1017020,1311967,9396686,9363953,70768,5.415,60376,4.62,2061399,951436,1109963,10.161,22.014,1999927,811526,1188401,8.666,21.358,61472,0.6559999999999999,42.715,32585,34944,468648
2003,b) 5 to 9,1022709,1315253,9388392,9323672,54556,4.1530000000000005,51379,3.911,1869750,729133,1140617,7.82,20.054,1739771,684428,1055343,7.341,18.66,129979,1.394,37.319,27411,28662,380481
2004,b) 5 to 9,1036753,1331613,9518328,9417158,54107,4.072,48286,3.634,1861171,725487,1135684,7.704,19.764,1663429,646181,1017248,6.862,17.664,197742,2.1,35.328,27557,29061,388142
2005,b) 5 to 9,1048276,1346952,9577588,9530899,59144,4.408,48523,3.617,1862958,790816,1072142,8.297,19.547,1766695,652633,1114062,6.848,18.536,96263,1.01,37.073,28781,29908,399494
2006,b) 5 to 9,1061938,1372533,9937289,9714906,73006,5.362,50959,3.743,2126035,972725,1153310,10.013,21.884,1684636,678255,1006381,6.982,17.340999999999998,441399,4.544,34.681,32459,33623,446084
2007,b) 5 to 9,1073230,1391891,9914112,9880469,62032,4.47,54031,3.893,2002813,829151,1173662,8.392000000000001,20.27,1938280,718643,1219637,7.273,19.617,64533,0.653,39.235,29492,30482,403523
2008,b) 5 to 9,1063139,1391704,9848619,9860134,55443,3.988,52225,3.757,1874742,738299,1136443,7.487999999999999,19.013,1895338,696037,1199301,7.059,19.222,-20596,-0.209,38.027,30222,31661,421393
2009,b) 5 to 9,1038134,1372373,9499700,9716747,50052,3.645,51441,3.746,1584512,669329,915183,6.888,16.307000000000002,2014902,682798,1332104,7.027,20.736,-430390,-4.4289999999999985,32.614000000000004,30000,31280,414416
2010,b) 5 to 9,1016273,1353055,9486040,9515621,54201,4.021,44247,3.282,1655140,706397,948743,7.423999999999999,17.394000000000002,1713081,587699,1125382,6.176,18.003,-57941,-0.609,34.788000000000004,25878,26907,356250
2011,b) 5 to 9,1004402,1342910,9448459,9462691,48291,3.6010000000000004,44582,3.324,1620089,639180,980909,6.755,17.121,1648747,585232,1063515,6.185,17.424,-28658,-0.303,34.242,26173,27722,363375
2012,b) 5 to 9,1003831,1338000,9484788,9434565,46911,3.51,43925,3.287,1676542,623460,1053082,6.608,17.77,1575985,585293,990692,6.204,16.704,100557,1.0659999999999998,33.409,23825,25189,334311
2013,b) 5 to 9,1006726,1340402,9518134,9434376,48778,3.648,41878,3.132,1653205,649820,1003385,6.888,17.523,1485627,558712,926915,5.9220000000000015,15.747,167578,1.776,31.494,23579,24692,328020
2014,b) 5 to 9,1009532,1349713,9591743,9471079,49437,3.677,39082,2.907,1644858,658684,986174,6.955,17.367,1401827,519122,882705,5.481,14.800999999999998,243031,2.5660000000000003,29.602,23604,24629,326226
2015,b) 5 to 9,1014257,1359076,9646607,9547105,49594,3.661,40955,3.023,1657412,664929,992483,6.965,17.36,1455901,548525,907376,5.745,15.25,201511,2.111,30.499,23746,25178,335388
2016,b) 5 to 9,1022978,1375563,9817379,9659846,51342,3.749,39377,2.875,1731959,694390,1037569,7.188,17.929000000000006,1421298,526916,894382,5.455,14.713,310661,3.216,29.427,24735,25967,346462
2017,b) 5 to 9,1023526,1377487,9778475,9724223,50043,3.639,45351,3.298,1711834,670905,1040929,6.899,17.604,1607924,606399,1001525,6.2360000000000015,16.535,103910,1.069,33.07,25914,27452,366877
2018,b) 5 to 9,1025326,1375096,9763614,9698303,46130,3.358,43613,3.175,1647684,613685,1033999,6.3279999999999985,16.989,1517823,580845,936978,5.989,15.65,129861,1.339,31.301,27807,30209,403417
1978,c) 10 to 19,410089,509111,7586141,7218524,25582,5.058,18831,3.723,1897873,693461,1204412,9.607,26.292,1164466,509193,655273,7.0539999999999985,16.132,733407,10.16,32.263000000000005,8132,8394,224568
1979,c) 10 to 19,441106,548675,8006955,7752540,23939,4.387,17996,3.298,1794949,649170,1145779,8.374,23.153,1284971,487585,797386,6.289,16.575,509978,6.5779999999999985,33.15,8607,8814,235043
1980,c) 10 to 19,445470,557234,7875178,7872130,21365,3.846,17982,3.237,1509304,580802,928502,7.377999999999999,19.173,1498715,487606,1011109,6.194,19.038,10589,0.135,38.076,9876,10153,273201
1981,c) 10 to 19,446888,562105,7981179,7900659,22773,4.078,15319,2.7430000000000003,1558365,617040,941325,7.81,19.724,1396808,416389,980419,5.27,17.68,161557,2.045,35.359,7677,7993,215201
1982,c) 10 to 19,447911,565103,7990377,7971266,23101,4.1080000000000005,17488,3.11,1586992,627167,959825,7.8679999999999986,19.909,1547344,474518,1072826,5.9529999999999985,19.412,39648,0.4970000000000001,38.823,9796,10016,269049
1983,c) 10 to 19,450301,571589,8062951,8052405,21246,3.729,17512,3.074,1539536,579459,960077,7.1960000000000015,19.119,1519103,475369,1043734,5.903,18.865,20433,0.254,37.73,9475,9734,261211
1984,c) 10 to 19,465914,592552,8620847,8311740,23643,4.015,16334,2.774,1862482,639879,1222603,7.697999999999999,22.408,1240991,444839,796152,5.352,14.931,621491,7.477,29.861,9412,9666,259802
1985,c) 10 to 19,483269,615083,8903165,8684769,25300,4.129,20646,3.369,1874711,686487,1188224,7.904,21.586,1438324,562565,875759,6.478,16.561,436387,5.025,33.123000000000005,12930,13303,359607
1986,c) 10 to 19,498528,636704,9191884,8987735,28258,4.466,20330,3.213,1966270,771174,1195096,8.58,21.877,1559695,550987,1008708,6.13,17.354,406575,4.524,34.707,11733,12078,324786
1987,c) 10 to 19,511584,654908,9468861,9270741,30438,4.672,23602,3.623,2108230,824858,1283372,8.897,22.741,1710445,641148,1069297,6.916,18.45,397785,4.291,36.9,13288,13688,368261
1988,c) 10 to 19,533453,686273,9876861,9677410,30895,4.53,22383,3.282,2134288,838993,1295295,8.67,22.054,1737407,606965,1130442,6.272,17.953,396881,4.101,35.906,12544,13031,351046
1989,c) 10 to 19,546434,705811,10182932,9951134,29683,4.228,22326,3.18,2138706,806398,1332308,8.104,21.492,1674787,608309,1066478,6.113,16.83,463919,4.662,33.66,13015,13570,366301
1990,c) 10 to 19,558767,726567,10408705,10227366,28239,3.904,21818,3.016,2090484,765380,1325104,7.484,20.44,1726723,591124,1135599,5.78,16.883,363761,3.557,33.767,13550,14011,376580
1991,c) 10 to 19,556552,731416,10268028,10335997,29907,4.103,24908,3.417,1937906,808958,1128948,7.827000000000001,18.749,2074106,679692,1394414,6.5760000000000005,20.067,-136200,-1.318,37.49800000000001,15693,16384,444973
1992,c) 10 to 19,553381,733186,10364338,10319604,25463,3.4810000000000003,22180,3.032,1971884,689940,1281944,6.686,19.108,1882580,603577,1279003,5.849,18.243,89304,0.865,36.486,12379,12895,348760
1993,c) 10 to 19,560839,740349,10540256,10431097,24237,3.276,23362,3.157,2000978,658298,1342680,6.311,19.183,1783501,632018,1151483,6.059,17.098,217477,2.085,34.196,11970,12583,338866
1994,c) 10 to 19,570096,754560,10773592,10621433,27460,3.651,22740,3.023,2050320,744126,1306194,7.006,19.304,1742621,616991,1125630,5.809,16.407,307699,2.897,32.813,12712,13364,360640
1995,c) 10 to 19,581101,771860,11083532,10862640,28917,3.761,22854,2.9730000000000003,2128878,782521,1346357,7.204,19.598,1684657,621099,1063558,5.718,15.509,444221,4.089,31.017,12532,13125,354447
1996,c) 10 to 19,586609,783644,11141531,11037700,28458,3.643,23500,3.008,2032165,775492,1256673,7.026,18.411,1826849,637501,1189348,5.776,16.551,205316,1.86,33.102,13294,13968,377614
1997,c) 10 to 19,594809,792454,11371626,11203944,31878,4.034,27393,3.467,2285055,863000,1422055,7.7029999999999985,20.395,1943916,747710,1196206,6.674,17.35,341139,3.045,34.701,14317,15064,407132
1998,c) 10 to 19,609406,817832,11715242,11530501,29067,3.5610000000000004,25710,3.15,2270887,790779,1480108,6.858,19.695,1897237,700796,1196441,6.0779999999999985,16.454,373650,3.241,32.908,12513,13147,355784
1999,c) 10 to 19,614367,828642,11845931,11715622,29441,3.5580000000000003,27129,3.278,2189218,798081,1391137,6.812,18.686,1928416,733690,1194726,6.2620000000000005,16.46,260802,2.226,32.92,13662,14832,399407
2000,c) 10 to 19,623603,843388,12115813,11917517,29971,3.5610000000000004,26350,3.131,2272179,815389,1456790,6.8420000000000005,19.066,1878039,716926,1161113,6.016,15.759,394140,3.307,31.517,12966,14075,379775
2001,c) 10 to 19,625797,853373,12146216,12070970,30575,3.59,27271,3.202,2180084,829990,1350094,6.876,18.061,2029101,738968,1290133,6.122000000000001,16.81,150983,1.251,33.62,13159,14067,379310
2002,c) 10 to 19,628931,860584,12239325,12254493,38251,4.459,32846,3.829,2412723,1043412,1369311,8.515,19.688,2443873,896834,1547039,7.318,19.943,-31150,-0.254,39.377,16464,17751,482409
2003,c) 10 to 19,635624,872371,12434251,12324536,28040,3.219,25580,2.9360000000000004,2232280,764281,1467999,6.2010000000000005,18.112,2016427,696557,1319870,5.652,16.361,215853,1.751,32.722,12278,12756,344119
2004,c) 10 to 19,644853,884744,12591673,12483506,26769,3.029,24589,2.783,2154110,726482,1427628,5.82,17.256,1940683,665087,1275596,5.3279999999999985,15.546,213427,1.71,31.092,12521,13171,354706
2005,c) 10 to 19,648870,896863,12666575,12629949,29828,3.3360000000000003,24381,2.727,2142589,809272,1333317,6.408,16.964000000000002,2066259,662581,1403678,5.246,16.36,76330,0.604,32.72,12828,13433,361316
2006,c) 10 to 19,653755,910940,13088571,12818544,36410,4.024,24395,2.696,2429064,985223,1443841,7.686,18.95,1888333,659064,1229269,5.141,14.731,540731,4.218,29.463,13865,14413,387531
2007,c) 10 to 19,662016,928037,13124145,13085658,31859,3.442,26755,2.891,2323016,860321,1462695,6.575,17.752,2249697,723749,1525948,5.5310000000000015,17.192,73319,0.56,34.384,13078,13611,365136
2008,c) 10 to 19,655199,925674,13047165,13035838,27784,3.005,25376,2.745,2139218,750664,1388554,5.757999999999999,16.41,2119366,684650,1434716,5.252000000000002,16.258,19852,0.152,32.516,13338,14026,376681
2009,c) 10 to 19,640469,913657,12587820,12871846,24679,2.701,24599,2.692,1748773,664319,1084454,5.1610000000000005,13.586,2317221,667522,1649699,5.186,18.002,-568448,-4.416,27.172,13089,14203,384111
2010,c) 10 to 19,628997,906729,12567083,12729517,22000,2.427,21765,2.401,1710148,594288,1115860,4.669,13.435,2031185,590184,1441001,4.636,15.956,-321037,-2.522,26.869,11186,12091,325232
2011,c) 10 to 19,620666,904066,12719318,12650375,22580,2.503,18798,2.084,1847439,609275,1238164,4.816,14.604,1709487,507323,1202164,4.01,13.513,137952,1.09,27.027,10026,10492,281468
2012,c) 10 to 19,615130,900235,12791544,12664530,23478,2.612,20871,2.322,1998871,635522,1363349,5.018,15.783,1741833,569431,1172402,4.496,13.754,257038,2.03,27.507,10167,11030,298724
2013,c) 10 to 19,621138,906615,12892471,12744537,24838,2.747,20307,2.245,1983268,667772,1315496,5.24,15.562,1683087,551877,1131210,4.33,13.206,300181,2.355,26.413,10354,10871,291826
2014,c) 10 to 19,629462,919545,13073508,12904405,25077,2.736,18889,2.061,1930054,678042,1252012,5.254,14.957,1595939,510402,1085537,3.955,12.367,334115,2.589,24.735,10643,11136,297454
2015,c) 10 to 19,638019,931971,13301995,13091894,28036,3.0210000000000004,20336,2.191,2041089,766052,1275037,5.851,15.59,1620656,551020,1069636,4.209,12.379,420433,3.2110000000000003,24.758000000000006,11085,11707,314528
2016,c) 10 to 19,646748,944019,13443195,13256344,27441,2.918,20270,2.155,2028340,745992,1282348,5.627000000000002,15.300999999999998,1660580,550635,1109945,4.154,12.527,367760,2.774,25.053,11619,12307,332297
2017,c) 10 to 19,654369,955501,13582466,13476800,27065,2.837,24365,2.5540000000000003,2120724,730440,1390284,5.42,15.736,1917064,662036,1255028,4.912,14.225,203660,1.511,28.45,12894,13768,372763
2018,c) 10 to 19,659315,963923,13710337,13578146,23456,2.434,22743,2.36,2085960,634783,1451177,4.675,15.363,1814516,616524,1197992,4.541,13.364,271444,1.999,26.727,13430,14563,392295
1978,d) 20 to 99,301691,439006,18895785,18063570,18397,4.213,13700,3.137,4251750,1387427,2864323,7.681,23.538,2584327,1054895,1529432,5.84,14.307,1667423,9.231,28.614,4438,4679,335276
1979,d) 20 to 99,331741,477389,20233790,19610761,16892,3.554,12662,2.664,3985995,1278365,2707630,6.519,20.326,2741761,956357,1785404,4.877,13.981,1244234,6.345,27.962,4333,4448,314899
1980,d) 20 to 99,340187,495989,20623170,20382027,16675,3.38,11450,2.321,3634100,1271107,2362993,6.2360000000000015,17.83,3146488,857734,2288754,4.208,15.438,487612,2.392,30.875,4944,5150,365693
1981,d) 20 to 99,339669,500614,20738566,20570994,16695,3.3560000000000003,10542,2.119,3475519,1257644,2217875,6.114,16.895,3134822,798149,2336673,3.88,15.239,340697,1.656,30.478,3828,4013,282749
1982,d) 20 to 99,339146,506431,20806354,20775694,16708,3.315,11727,2.327,3541855,1270008,2271847,6.113,17.048,3478492,880675,2597817,4.239,16.743,63363,0.305,33.486,4985,5156,362133
1983,d) 20 to 99,337207,504066,20602653,20694290,14964,2.977,12146,2.416,3454515,1121595,2332920,5.42,16.692999999999998,3635376,935589,2699787,4.521,17.567,-180861,-0.8740000000000001,33.386,4924,5129,358550
1984,d) 20 to 99,349794,519204,22194953,21306349,17402,3.374,10592,2.0540000000000003,4399381,1310110,3089271,6.149,20.648000000000003,2618823,779836,1838987,3.66,12.291,1780558,8.357000000000001,24.583,4650,4765,331600
1985,d) 20 to 99,368440,542635,22987420,22488401,18108,3.345,15473,2.858,4300845,1351700,2949145,6.011,19.125,3306173,1163673,2142500,5.175,14.702,994672,4.423,29.403,7626,7882,570137
1986,d) 20 to 99,382368,562023,23744425,23234142,20909,3.744,13744,2.461,4542579,1580699,2961880,6.803,19.551,3521735,1033208,2488527,4.447,15.158,1020844,4.394,30.315,6412,6633,474122
1987,d) 20 to 99,388875,580910,24603725,24124499,22912,3.963,17290,2.991,4885184,1740730,3144454,7.216,20.25,3926909,1321663,2605246,5.479,16.278,958275,3.972,32.555,7560,7954,569939
1988,d) 20 to 99,405404,607478,25685259,25203654,22667,3.751,16250,2.689,4995323,1744472,3250851,6.9220000000000015,19.82,4040612,1234733,2805879,4.899,16.032,954711,3.788,32.064,7027,7380,534524
1989,d) 20 to 99,417507,628017,26548379,26003442,21717,3.4730000000000003,16418,2.625,4953094,1659003,3294091,6.38,19.048,3866530,1247869,2618661,4.799,14.869000000000002,1086564,4.1789999999999985,29.739,7551,7971,573721
1990,d) 20 to 99,431176,649340,27149559,26760055,19813,3.064,14616,2.26,4656793,1518961,3137832,5.676,17.402,3883915,1090939,2792976,4.077,14.514,772878,2.888,29.028,7420,7809,555560
1991,d) 20 to 99,419915,644177,26189105,26585468,19554,3.037,18742,2.911,4096851,1485916,2610935,5.589,15.41,4892020,1419368,3472652,5.339,18.401,-795169,-2.991,30.82,10248,10682,787339
1992,d) 20 to 99,410183,639876,26407460,26227548,18134,2.841,15085,2.363,4426253,1392014,3034239,5.307,16.875999999999998,4069398,1124178,2945220,4.2860000000000005,15.515999999999998,356855,1.361,31.031,6787,7137,509873
1993,d) 20 to 99,416696,646768,26852876,26583581,17167,2.657,15939,2.467,4475723,1339090,3136633,5.037,16.836,3943600,1201267,2742333,4.519,14.835,532123,2.002,29.669,6325,6784,486518
1994,d) 20 to 99,427894,665217,27769244,27323823,19993,3.014,16082,2.425,4660170,1539830,3120340,5.635,17.055,3771458,1224845,2546613,4.4830000000000005,13.803,888712,3.253,27.606,7210,7718,566055
1995,d) 20 to 99,442624,688536,28873591,28250061,21151,3.085,15384,2.244,4900037,1619055,3280982,5.731,17.345,3647602,1167171,2480431,4.132,12.912,1252435,4.433,25.824,6971,7426,541697
1996,d) 20 to 99,448644,699681,29040741,28787665,20898,2.995,17249,2.472,4656224,1607206,3049018,5.582999999999998,16.174,4151129,1314834,2836295,4.567,14.42,505095,1.755,28.84,7546,8035,584503
1997,d) 20 to 99,457661,714602,30045466,29528725,23180,3.2510000000000003,19949,2.798,5477305,1822089,3655216,6.171,18.549,4438413,1519222,2919191,5.145,15.031,1038892,3.518,30.062,8292,8828,646640
1998,d) 20 to 99,476222,744541,31199039,30726357,22801,3.071,18875,2.542,5431759,1777017,3654742,5.783,17.678,4481292,1456411,3024881,4.74,14.585,950467,3.093,29.169,6990,7582,548254
1999,d) 20 to 99,485040,762182,31926587,31523024,22921,3.012,20380,2.678,5335710,1792801,3542909,5.687,16.926,4529115,1577258,2951857,5.004,14.368,806595,2.559,28.735,8149,8914,656409
2000,d) 20 to 99,497837,783613,32951276,32497706,23009,2.939,21515,2.748,5538241,1815472,3722769,5.586,17.042,4631708,1689948,2941760,5.2,14.252,906533,2.79,28.505,7367,8195,596435
2001,d) 20 to 99,505471,799519,33292210,33134397,23540,2.949,20787,2.604,5288358,1849655,3438703,5.582000000000002,15.96,4974125,1623990,3350135,4.901,15.012,314233,0.948,30.024,7870,8645,636136
2002,d) 20 to 99,501108,801095,32818320,33326370,27987,3.495,27363,3.417,5470231,2166241,3303990,6.5,16.414,6480138,2167880,4312258,6.505,19.444000000000006,-1009907,-3.03,32.828,11252,12363,949059
2003,d) 20 to 99,503654,808812,33476451,33262581,20277,2.507,20107,2.486,5325807,1580492,3745315,4.752,16.011,4910058,1544393,3365665,4.643,14.762,415749,1.25,29.523000000000003,6804,7635,549416
2004,d) 20 to 99,512789,820441,33975818,33710604,19840,2.421,18268,2.229,5082732,1551314,3531418,4.602,15.078,4555239,1412134,3143105,4.189,13.513,527493,1.565,27.026,6996,7507,546490
2005,d) 20 to 99,515871,826175,34133643,33951669,21644,2.627,17363,2.107,4973339,1664898,3308441,4.904,14.648,4615202,1323722,3291480,3.899,13.593,358137,1.055,27.187,7076,7488,539789
2006,d) 20 to 99,521412,841278,35221221,34620483,25447,3.04,17163,2.05,5589245,1972669,3616576,5.698,16.144000000000002,4391651,1317993,3073658,3.807,12.685,1197594,3.459,25.37,7551,7897,574087
2007,d) 20 to 99,525107,856247,35305057,35273508,22528,2.636,19573,2.29,5384470,1748680,3635790,4.957,15.265,5310000,1504550,3805450,4.265,15.054,74470,0.211,30.108,7505,7864,575818
2008,d) 20 to 99,522628,857851,35262629,35243009,19688,2.297,18541,2.1630000000000003,5078855,1509281,3569574,4.282,14.411,5043218,1417374,3625844,4.022,14.31,35637,0.101,28.62,7391,7884,574652
2009,d) 20 to 99,505466,839188,33435190,34439547,17534,2.088,18579,2.213,3877963,1346324,2531639,3.909,11.26,5886400,1451834,4434566,4.216,17.092,-2008437,-5.832000000000002,22.52,7674,8537,654561
2010,d) 20 to 99,481567,809362,32525335,32962183,16608,2.0540000000000003,14986,1.853,3755062,1272993,2482069,3.862,11.392,4621004,1124594,3496410,3.412,14.019,-865942,-2.627,22.784,5776,6758,477251
2011,d) 20 to 99,474761,802674,32892720,32642450,15668,1.955,13053,1.629,4170722,1170186,3000536,3.585,12.777,3667573,992232,2675341,3.04,11.236,503149,1.541,22.471,5356,5663,408929
2012,d) 20 to 99,483079,816147,33687844,33258461,16138,1.98,14093,1.729,4617797,1214251,3403546,3.651,13.885,3758100,1042471,2715629,3.134,11.3,859697,2.585,22.599,5510,5928,424500
2013,d) 20 to 99,494414,833797,34366100,34019570,16401,1.969,14393,1.7280000000000002,4486116,1241927,3244189,3.651,13.187,3795437,1090926,2704511,3.207,11.157,690679,2.03,22.313,5853,6109,440172
2014,d) 20 to 99,504843,853566,35166207,34764079,16931,1.988,12999,1.526,4373741,1288250,3085491,3.706,12.581,3567770,988702,2579068,2.844,10.263,805971,2.318,20.526,5613,5922,424248
2015,d) 20 to 99,517370,876232,36201913,35667052,19638,2.248,14297,1.6369999999999998,4732354,1481246,3251108,4.1530000000000005,13.268,3666669,1061002,2605667,2.975,10.28,1065685,2.988,20.561,6363,6777,479606
2016,d) 20 to 99,529842,901809,37050859,36677196,18658,2.074,14003,1.557,4599879,1394610,3205269,3.802,12.542,3851638,1065388,2786250,2.905,10.501,748241,2.04,21.003,6506,6955,497886
2017,d) 20 to 99,536120,916809,37609629,37391820,18178,1.982,18687,2.0380000000000003,4983851,1358324,3625527,3.633,13.329,4550745,1429995,3120750,3.824,12.17,433106,1.158,24.341,7684,8289,593036
2018,d) 20 to 99,545801,929492,38096839,37838539,16728,1.8,15994,1.721,4686328,1278729,3407599,3.379,12.385,4173502,1179889,2993613,3.1180000000000003,11.03,512826,1.355,22.06,7126,8079,570339
1978,e) 100 to 499,38609,74588,15263282,14826249,1890,2.536,1786,2.396,2700882,654470,2046412,4.414,18.217,1827568,621766,1205802,4.194,12.327,873314,5.89,24.653,334,348,117114
1979,e) 100 to 499,42956,81608,16509640,16099135,1884,2.313,1564,1.92,2625023,648209,1976814,4.026,16.305,1799722,544787,1254935,3.384,11.179,825301,5.126,22.358,274,278,90764
1980,e) 100 to 499,44629,86165,16982010,16897689,1804,2.1,1249,1.454,2300938,633054,1667884,3.746,13.617,2134219,456329,1677890,2.701,12.63,166719,0.987,25.26,313,324,109234
1981,e) 100 to 499,44638,88680,17282557,17266636,1749,1.978,1229,1.39,2242921,609907,1633014,3.532,12.99,2203031,433109,1769922,2.508,12.759,39890,0.231,25.518,217,224,72967
1982,e) 100 to 499,44824,89293,17329396,17340007,2098,2.359,1380,1.5519999999999998,2368127,773615,1594512,4.461,13.657,2387473,488855,1898618,2.819,13.769,-19346,-0.112,27.314,275,287,94825
1983,e) 100 to 499,43829,86343,16556360,16801548,1500,1.739,1335,1.548,2229185,535802,1693383,3.189,13.268,2713680,476802,2236878,2.838,16.151,-484495,-2.884,26.535,278,280,89560
1984,e) 100 to 499,46047,89543,17850650,17273020,2001,2.247,1026,1.152,2893176,700792,2192384,4.057,16.75,1733231,353003,1380228,2.044,10.034,1159945,6.715,20.069000000000006,225,231,75476
1985,e) 100 to 499,48941,94923,18818644,18423685,2034,2.148,1590,1.679,2962227,714990,2247237,3.881,16.078,2170895,555897,1614998,3.017,11.783,791332,4.295,23.566,506,516,166148
1986,e) 100 to 499,50823,98888,19278371,19089541,2177,2.209,1503,1.525,2868538,758724,2109814,3.975,15.027,2484235,522892,1961343,2.739,13.014,384303,2.013,26.027,419,423,138147
1987,e) 100 to 499,52319,101802,19828790,19631262,2697,2.657,2116,2.084,3128288,969821,2158467,4.94,15.935,2731248,746144,1985104,3.801,13.913,397040,2.022,27.825,554,572,186594
1988,e) 100 to 499,54442,106034,20555385,20329703,2606,2.463,2128,2.011,3200919,916454,2284465,4.508,15.745,2748912,756794,1992118,3.723,13.522,452007,2.2230000000000003,27.043000000000006,587,624,220082
1989,e) 100 to 499,56390,110718,21439457,21109976,2202,1.993,1759,1.592,3142541,746006,2396535,3.534,14.887,2486617,610321,1876296,2.891,11.779000000000002,655924,3.107,23.559,486,492,161930
1990,e) 100 to 499,58484,115356,22192983,21945923,2110,1.834,1446,1.257,2938714,722298,2216416,3.2910000000000004,13.390999999999998,2443238,494349,1948889,2.253,11.133,495476,2.258,22.266,537,549,179830
1991,e) 100 to 499,55751,113734,21472573,21780860,2038,1.7919999999999998,1998,1.757,2518221,702921,1815300,3.227,11.562,3135762,695958,2439804,3.195,14.397,-617541,-2.835,23.123,899,912,306889
1992,e) 100 to 499,54146,112279,21518458,21420800,1958,1.7480000000000002,1479,1.32,2782241,684642,2097599,3.196,12.989,2579589,525993,2053596,2.456,12.042,202652,0.946,24.085,491,497,162890
1993,e) 100 to 499,55588,114703,22160619,21954254,1977,1.725,1748,1.525,2996711,677602,2319109,3.0860000000000003,13.65,2592740,634366,1958374,2.889,11.81,403971,1.84,23.619,490,508,176552
1994,e) 100 to 499,57811,119572,23131683,22883410,2076,1.737,1902,1.592,3067556,724738,2342818,3.167,13.405,2569546,697887,1871659,3.05,11.229,498010,2.176,22.458,742,758,277313
1995,e) 100 to 499,60178,125103,24307314,23871585,2296,1.84,1657,1.328,3271178,798731,2472447,3.346,13.703,2399999,585147,1814852,2.451,10.054,871179,3.649,20.108,615,629,221973
1996,e) 100 to 499,60106,127979,24638900,24479225,2233,1.747,1899,1.486,3182141,774218,2407923,3.1630000000000003,12.999,2867806,671090,2196716,2.741,11.715,314335,1.284,23.431,615,648,220911
1997,e) 100 to 499,61696,131947,25693821,25349389,2787,2.115,2404,1.825,3879820,965307,2914513,3.808,15.305,3191791,862932,2328859,3.404,12.591,688029,2.714,25.182,742,769,265881
1998,e) 100 to 499,65685,139064,27147451,26730522,3034,2.188,2252,1.624,3918784,1039118,2879666,3.887,14.66,3076590,797467,2279123,2.983,11.51,842194,3.151,23.019,576,597,204538
1999,e) 100 to 499,66986,143620,27870187,27639473,2868,1.999,2574,1.794,3902662,1006988,2895674,3.643,14.12,3444867,911722,2533145,3.299,12.464,457795,1.656,24.927,660,702,235502
2000,e) 100 to 499,69858,147733,28941900,28518771,3084,2.09,2728,1.849,4217734,1096947,3120787,3.846,14.789,3373750,980700,2393050,3.439,11.83,843984,2.959,23.66,541,583,205758
2001,e) 100 to 499,71092,150096,28907531,28909198,2880,1.922,2429,1.621,3743393,1029266,2714127,3.56,12.949000000000002,3762382,869197,2893185,3.007,13.014,-18989,-0.066,25.898000000000003,663,695,242827
2002,e) 100 to 499,68587,145379,27454599,28182170,3143,2.156,3917,2.687,3595024,1087028,2507996,3.857,12.755999999999998,5051051,1387416,3663635,4.923,17.923,-1456027,-5.166,25.513,1187,1328,471250
2003,e) 100 to 499,68773,144383,27776106,27726330,2485,1.721,2499,1.731,3601905,887933,2713972,3.202,12.991,3510484,889819,2620665,3.209,12.661,91421,0.33,25.322,620,646,221969
2004,e) 100 to 499,70758,146697,28288650,28140665,2164,1.474,2298,1.5659999999999998,3440834,774482,2666352,2.752,12.227,3155605,825776,2329829,2.934,11.214,285229,1.014,22.427,602,630,221086
2005,e) 100 to 499,71955,149467,28808795,28616926,2249,1.506,1925,1.289,3423480,804441,2619039,2.8110000000000004,11.963,3042473,671026,2371447,2.345,10.632,381007,1.331,21.263,538,565,197107
2006,e) 100 to 499,73407,153796,29740776,29446728,2634,1.716,1958,1.276,3757155,921013,2836142,3.128,12.759,3170606,701574,2469032,2.383,10.767,586549,1.992,21.535,550,565,199104
2007,e) 100 to 499,73408,155578,29778238,29805124,2267,1.457,2341,1.504,3534518,793447,2741071,2.662,11.859000000000002,3590299,826982,2763317,2.775,12.046,-55781,-0.187,23.718000000000004,599,629,219110
2008,e) 100 to 499,73437,156331,29924996,29932701,2154,1.378,2197,1.405,3437119,758621,2678498,2.5340000000000003,11.483,3466621,780787,2685834,2.608,11.581,-29502,-0.099,22.966,619,636,213610
2009,e) 100 to 499,70414,150816,27897757,28766342,1819,1.205,2193,1.452,2497767,638594,1859173,2.22,8.683,4247924,768315,3479609,2.6710000000000003,14.767,-1750157,-6.084,17.366,747,814,285578
2010,e) 100 to 499,66686,143842,27050180,27317314,1700,1.183,1526,1.062,2560799,580598,1980201,2.125,9.374,3089336,542128,2547208,1.985,11.309,-528537,-1.935,18.749,388,406,143229
2011,e) 100 to 499,66207,144126,27676753,27422817,1505,1.045,1358,0.943,2960465,537144,2423321,1.959,10.796,2446705,490965,1955740,1.79,8.922,513760,1.873,17.844,368,379,126023
2012,e) 100 to 499,67092,146717,28303306,27995673,1593,1.086,1459,0.995,3101003,557293,2543710,1.991,11.077,2483857,528071,1955786,1.886,8.872,617146,2.204,17.745,404,426,147348
2013,e) 100 to 499,69516,150282,28965136,28712257,1724,1.148,1627,1.083,3073037,611879,2461158,2.131,10.703,2562920,570148,1992772,1.986,8.926,510117,1.777,17.852,513,540,186470
2014,e) 100 to 499,71697,154522,29836189,29517831,1817,1.177,1465,0.949,3161538,656213,2505325,2.2230000000000003,10.711,2525059,524319,2000740,1.776,8.554,636479,2.156,17.109,418,427,146922
2015,e) 100 to 499,73494,159208,30745090,30373595,2069,1.3030000000000002,1318,0.83,3306835,723699,2583136,2.383,10.887,2550312,462143,2088169,1.5219999999999998,8.396,756523,2.491,16.793,412,420,143579
2016,e) 100 to 499,74849,162952,31423492,31177232,1816,1.116,1428,0.877,3190406,646151,2544255,2.073,10.233,2693514,505801,2187713,1.622,8.639,496892,1.594,17.279,454,480,163708
2017,e) 100 to 499,75564,164708,31765914,31480292,1819,1.104,1838,1.116,3437935,647406,2790529,2.057,10.921,2863717,632760,2230957,2.01,9.097,574218,1.824,18.194000000000006,528,540,185577
2018,e) 100 to 499,78363,168169,32549046,32182616,2016,1.2009999999999998,1412,0.841,3445731,754063,2691668,2.343,10.707,2717257,492822,2224435,1.531,8.443,728474,2.264,16.886,474,497,169568
1978,f) 500 to 999,3903,7516,5282901,5195918,76,1.01,88,1.17,681252,98181,583071,1.89,13.111,506427,122816,383611,2.364,9.747,174825,3.365,19.493,25,25,37350
1979,f) 500 to 999,4107,7925,5587353,5474388,62,0.7829999999999999,47,0.594,637920,84980,552940,1.5519999999999998,11.653,410680,65134,345546,1.19,7.502000000000002,227240,4.151,15.004,10,10,13575
1980,f) 500 to 999,4180,8095,5559726,5570600,63,0.778,61,0.754,522560,85497,437063,1.535,9.381,546238,84676,461562,1.52,9.806,-23678,-0.425,18.761,13,13,17633
1981,f) 500 to 999,4116,7965,5417210,5479502,63,0.7909999999999999,68,0.853,467288,82474,384814,1.505,8.527999999999999,593693,91057,502636,1.662,10.835,-126405,-2.307,17.055999999999994,12,12,17904
1982,f) 500 to 999,4153,7931,5463809,5441396,139,1.761,67,0.8490000000000001,610965,190065,420900,3.4930000000000003,11.228,565444,92121,473323,1.693,10.392,45521,0.8370000000000001,20.783,6,7,10285
1983,f) 500 to 999,4109,7643,5191915,5240923,72,0.943,49,0.642,545694,97522,448172,1.861,10.412,644121,65095,579026,1.242,12.29,-98427,-1.878,20.824,3,3,4301
1984,f) 500 to 999,4197,7759,5443176,5327846,97,1.256,28,0.362,641810,131533,510277,2.469,12.046,412715,36420,376295,0.684,7.746,229095,4.3,15.493,0,0,0
1985,f) 500 to 999,4387,8104,5706290,5588894,113,1.399,60,0.743,749543,158050,591493,2.8280000000000003,13.411,515054,82274,432780,1.472,9.216,234489,4.1960000000000015,18.431,11,11,14159
1986,f) 500 to 999,4569,8267,5694837,5700823,102,1.235,83,1.005,646938,134727,512211,2.363,11.348,657438,114410,543028,2.007,11.532,-10500,-0.184,22.696,11,11,14525
1987,f) 500 to 999,4780,8421,5839153,5813568,175,2.087,103,1.228,754642,237798,516844,4.09,12.981,700131,139623,560508,2.402,12.043,54511,0.938,24.086,12,12,15796
1988,f) 500 to 999,5020,8680,6004469,5974127,108,1.243,125,1.439,696560,147939,548621,2.476,11.66,636362,164004,472358,2.745,10.652,60198,1.008,21.304,31,35,49104
1989,f) 500 to 999,5124,8970,6242160,6151928,104,1.162,68,0.76,716469,144830,571639,2.354,11.646,537650,94043,443607,1.529,8.74,178819,2.907,17.479,16,16,22695
1990,f) 500 to 999,5228,9198,6344952,6294489,83,0.904,46,0.501,631789,108413,523376,1.722,10.037,527706,65289,462417,1.037,8.384,104083,1.654,16.767,11,11,14189
1991,f) 500 to 999,5146,9019,6126942,6205069,78,0.8640000000000001,102,1.129,540981,108741,432240,1.7519999999999998,8.718,696987,138723,558264,2.236,11.233,-156006,-2.514,17.437,41,42,57254
1992,f) 500 to 999,5047,8911,6127161,6109313,108,1.215,65,0.731,644352,148364,495988,2.428,10.547,606389,87975,518414,1.44,9.926,37963,0.621,19.851,15,15,21950
1993,f) 500 to 999,5106,8870,6123299,6091591,91,1.026,86,0.97,645895,120540,525355,1.979,10.603,583826,117990,465836,1.937,9.584,62069,1.019,19.168,16,16,22609
1994,f) 500 to 999,5255,9096,6297516,6257917,91,1.0,99,1.088,645073,117204,527869,1.873,10.308,561983,131213,430770,2.097,8.98,83090,1.328,17.961,27,27,34923
1995,f) 500 to 999,5362,9447,6537218,6453059,111,1.178,61,0.647,710736,148079,562657,2.295,11.014,541138,80293,460845,1.244,8.386000000000001,169598,2.628,16.772000000000002,21,21,29714
1996,f) 500 to 999,5491,9791,6734025,6723123,114,1.165,104,1.063,709105,148966,560139,2.216,10.547,685786,141665,544121,2.107,10.2,23319,0.34700000000000003,20.401,26,26,35926
1997,f) 500 to 999,5626,9961,6952639,6891604,167,1.6769999999999998,156,1.567,896937,228377,668560,3.314,13.015,775659,221451,554208,3.213,11.255,121278,1.76,22.51,45,45,66222
1998,f) 500 to 999,5949,10576,7403458,7285938,175,1.6569999999999998,142,1.345,967293,246249,721044,3.38,13.276,723916,187882,536034,2.579,9.936,243377,3.34,19.872,30,30,39705
1999,f) 500 to 999,6067,10837,7504025,7455849,140,1.2919999999999998,130,1.2,887699,183722,703977,2.464,11.906,786816,171264,615552,2.297,10.553,100883,1.3530000000000002,21.106,26,26,32498
2000,f) 500 to 999,6197,11215,7810873,7709048,151,1.347,135,1.205,987550,194521,793029,2.523,12.81,783571,186155,597416,2.415,10.164,203979,2.6460000000000004,20.329,20,20,26188
2001,f) 500 to 999,6352,11655,8045222,8021767,145,1.244,139,1.193,933052,193389,739663,2.411,11.632,888314,184725,703589,2.303,11.074000000000002,44738,0.5579999999999999,22.148000000000003,33,33,44945
2002,f) 500 to 999,6156,11255,7619740,7786250,171,1.518,195,1.731,934632,224997,709635,2.89,12.004,1268322,263708,1004614,3.387,16.289,-333690,-4.2860000000000005,24.007,64,78,106288
2003,f) 500 to 999,5877,10737,7381753,7397366,110,1.024,114,1.062,794688,149691,644997,2.024,10.743,824337,156008,668329,2.109,11.144,-29649,-0.401,21.486,33,33,44997
2004,f) 500 to 999,5934,10875,7536814,7474045,115,1.057,118,1.085,853781,155360,698421,2.079,11.423,735664,154148,581516,2.062,9.843,118117,1.58,19.686,24,29,36388
2005,f) 500 to 999,6136,11219,7708445,7693172,118,1.053,100,0.892,803288,158171,645117,2.056,10.442,771913,133956,637957,1.741,10.034,31375,0.408,20.067,33,33,43920
2006,f) 500 to 999,6260,11327,7871668,7790585,103,0.91,86,0.76,852926,137055,715871,1.759,10.948,692692,114666,578026,1.472,8.891,160234,2.057,17.783,23,23,31637
2007,f) 500 to 999,6504,11642,8049755,8024316,109,0.936,114,0.979,905217,149558,755659,1.864,11.281,852302,151458,700844,1.887,10.621,52915,0.659,21.243,24,24,31687
2008,f) 500 to 999,6509,11475,7899529,7934771,101,0.879,133,1.157,778702,130893,647809,1.65,9.814,857247,176029,681218,2.218,10.804,-78545,-0.99,19.628,26,30,37973
2009,f) 500 to 999,6281,11237,7584037,7752308,87,0.774,105,0.934,613424,117420,496004,1.515,7.9129999999999985,952050,139933,812117,1.805,12.281,-338626,-4.368,15.826,39,39,52378
2010,f) 500 to 999,5930,10715,7292878,7363347,85,0.7929999999999999,88,0.821,639502,113522,525980,1.5419999999999998,8.685,779375,116594,662781,1.5830000000000002,10.585,-139873,-1.9,17.37,26,26,35859
2011,f) 500 to 999,5901,10476,7281041,7205161,66,0.63,70,0.6679999999999999,740057,86164,653893,1.196,10.271,583950,93461,490489,1.297,8.105,156107,2.167,16.209,19,21,27323
2012,f) 500 to 999,6128,10964,7633352,7549263,82,0.748,91,0.83,792344,109428,682916,1.45,10.496,625774,120102,505672,1.591,8.289,166570,2.206,16.578,22,25,34692
2013,f) 500 to 999,6371,11304,7853675,7795270,75,0.6629999999999999,102,0.901,779433,102318,677115,1.3130000000000002,9.999,663946,140338,523608,1.8,8.517000000000001,115487,1.482,17.035,24,24,36323
2014,f) 500 to 999,6501,11608,8055430,7984345,90,0.7759999999999999,83,0.715,810111,121360,688751,1.52,10.146,666373,110347,556026,1.382,8.346,143738,1.8,16.692,16,18,25553
2015,f) 500 to 999,6628,11980,8304879,8236325,96,0.802,79,0.66,822707,124494,698213,1.5119999999999998,9.989,686318,104174,582144,1.265,8.333,136389,1.656,16.666,26,26,34745
2016,f) 500 to 999,6785,12228,8436043,8398393,76,0.622,74,0.605,764383,97282,667101,1.158,9.102,686259,103132,583127,1.228,8.171,78124,0.93,16.343,24,24,32951
2017,f) 500 to 999,6871,12459,8656987,8564746,129,1.037,91,0.732,899196,168092,731104,1.963,10.499,709538,127103,582435,1.484,8.283999999999999,189658,2.214,16.569000000000006,18,18,26153
2018,f) 500 to 999,7163,12891,8944235,8810345,145,1.128,66,0.514,912384,192146,720238,2.181,10.356,643518,85693,557825,0.973,7.3039999999999985,268866,3.052,14.608,17,18,23486
1978,g) 1000+,2192,4268,9862037,9721055,22,0.515,32,0.7490000000000001,982249,95706,886543,0.985,10.104,702516,153719,548797,1.581,7.227,279733,2.878,14.453,(S),(S),(S)
1979,g) 1000+,2282,4512,10429896,10195378,18,0.399,10,0.222,977768,47885,929883,0.47,9.59,503711,23504,480207,0.231,4.941,474057,4.65,9.881,(D),(D),(D)
1980,g) 1000+,2391,4729,10429301,10587871,23,0.486,36,0.76,737452,83931,653521,0.7929999999999999,6.965,1048517,176930,871587,1.671,9.903,-311065,-2.938,13.93,(D),(D),(D)
1981,g) 1000+,2400,4682,10333763,10382149,21,0.449,21,0.449,697326,79350,617976,0.764,6.7170000000000005,795031,97527,697504,0.939,7.657999999999999,-97705,-0.941,13.433,(D),(D),(D)
1982,g) 1000+,2521,4684,10272688,10271212,79,1.6969999999999998,20,0.43,871411,254314,617097,2.476,8.484,871153,83932,787221,0.8170000000000001,8.482000000000001,258,0.003,16.963,(D),(D),(D)
1983,g) 1000+,2529,4604,10269597,10187064,70,1.529,17,0.371,1133146,468519,664627,4.599,11.123,967484,71752,895732,0.7040000000000001,9.497,165662,1.626,18.994,(D),(D),(D)
1984,g) 1000+,2586,4645,10607539,10487874,69,1.494,17,0.368,1057273,283105,774168,2.699,10.081,822740,76070,746670,0.725,7.845,234533,2.236,15.689,3,3,15880
1985,g) 1000+,2666,4803,11053425,10849318,93,1.948,35,0.733,1341574,464793,876781,4.284,12.366,939954,183517,756437,1.692,8.664,401620,3.702,17.327,4,4,13398
1986,g) 1000+,2736,4903,11138636,11108533,45,0.92,20,0.409,927957,170203,757754,1.5319999999999998,8.354,872427,90478,781949,0.8140000000000001,7.854,55530,0.5,15.707,3,3,6668
1987,g) 1000+,2857,4990,10858678,11352395,89,1.794,32,0.645,999419,291214,708205,2.565,8.804,1986549,114737,(S),1.011,17.499000000000002,-987130,-8.695,17.607,6,6,16724
1988,g) 1000+,2897,5048,11061683,11020633,53,1.051,39,0.774,985735,195695,790040,1.776,8.943999999999997,902657,158880,743777,1.442,8.191,83078,0.754,16.381,11,11,42856
1989,g) 1000+,3014,5248,11520151,11390549,55,1.051,27,0.516,1043090,244777,798313,2.149,9.158,790798,93775,697023,0.823,6.943,252292,2.215,13.885,6,6,15572
1990,g) 1000+,3144,5457,12023860,11945299,41,0.753,24,0.44,946409,144671,801738,1.211,7.922999999999999,786286,100361,685925,0.84,6.582000000000002,160123,1.34,13.165,5,5,12215
1991,g) 1000+,3130,5479,11853853,11957171,37,0.6759999999999999,32,0.584,812634,134449,678185,1.124,6.796,1026453,136738,889715,1.144,8.584,-213819,-1.788,13.592,16,16,79256
1992,g) 1000+,3145,5403,11696971,11798791,41,0.758,49,0.906,987247,170915,816332,1.449,8.367,1189914,268955,920959,2.28,10.085,-202667,-1.7180000000000002,16.735,13,17,115865
1993,g) 1000+,3191,5449,11766678,11819806,33,0.605,45,0.825,865955,109691,756264,0.928,7.326,972112,155335,816777,1.314,8.224,-106157,-0.898,14.653,9,9,25668
1994,g) 1000+,3220,5489,11776436,11786494,38,0.6920000000000001,39,0.71,843531,134577,708954,1.142,7.157,861493,142565,718928,1.21,7.309,-17962,-0.152,14.314,14,14,49118
1995,g) 1000+,3244,5638,12035637,11997271,46,0.8170000000000001,24,0.4270000000000001,891960,157905,734055,1.3159999999999998,7.435,814286,77916,736370,0.649,6.787000000000001,77674,0.647,13.575,7,7,23468
1996,g) 1000+,3184,5560,11972314,11952008,36,0.647,44,0.7909999999999999,924082,121048,803034,1.013,7.732,888712,150111,738601,1.256,7.436,35370,0.29600000000000004,14.871,5,5,16127
1997,g) 1000+,3237,5690,12297608,12216502,56,0.985,48,0.8440000000000001,1216261,201889,1014372,1.653,9.956,1051281,167193,884088,1.369,8.605,164980,1.35,17.211,13,13,48706
1998,g) 1000+,3400,6018,13202761,13038676,50,0.8320000000000001,30,0.499,1199836,148655,1051181,1.14,9.202,870460,86129,784331,0.6609999999999999,6.676,329376,2.526,13.352,6,6,14733
1999,g) 1000+,3485,6277,13787354,13687239,53,0.845,42,0.67,1278379,193227,1085152,1.412,9.34,1071757,152468,919289,1.114,7.83,206622,1.51,15.661,13,13,42408
2000,g) 1000+,3576,6512,14422153,14225685,48,0.737,53,0.8140000000000001,1539467,187984,1351483,1.321,10.822,1147189,190721,956468,1.341,8.064,392278,2.758,16.128,8,8,26222
2001,g) 1000+,3625,6619,14691208,14618609,56,0.8440000000000001,91,1.371,1562991,216873,1346118,1.484,10.692,1417101,296550,1120551,2.029,9.694,145890,0.998,19.388,13,13,53206
2002,g) 1000+,3567,6516,14223426,14456858,64,0.981,82,1.257,1400917,205906,1195011,1.4240000000000002,9.69,1878830,324007,1554823,2.241,12.996,-477913,-3.306,19.381,28,31,136568
2003,g) 1000+,3524,6396,13971927,14106890,49,0.7659999999999999,58,0.906,1303304,201631,1101673,1.429,9.239,1556303,244250,1312053,1.731,11.032,-252999,-1.793,18.478,19,19,61968
2004,g) 1000+,3623,6443,14014370,14082140,51,0.79,75,1.162,1224345,155816,1068529,1.106,8.693999999999999,1366167,325033,1041134,2.3080000000000003,9.701,-141822,-1.007,17.389,16,16,57234
2005,g) 1000+,3677,6585,14315726,14288596,61,0.928,42,0.639,1246784,209879,1036905,1.469,8.726,1183352,173086,1010266,1.211,8.282,63432,0.444,16.564,13,13,70113
2006,g) 1000+,3764,6684,14830951,14658100,38,0.569,37,0.5539999999999999,1304993,125429,1179564,0.856,8.902999999999997,973138,140581,832557,0.959,6.6389999999999985,331855,2.264,13.278,12,12,56644
2007,g) 1000+,3847,6756,15208539,15088247,42,0.621,64,0.946,1463646,143906,1319740,0.954,9.701,1230926,246456,984470,1.633,8.158,232720,1.5419999999999998,16.316,18,19,86482
2008,g) 1000+,3821,6772,15324248,15278179,30,0.442,47,0.693,1208154,117822,1090332,0.7709999999999999,7.907999999999999,1129551,160581,968970,1.051,7.393,78603,0.514,14.786,18,18,71351
2009,g) 1000+,3750,6597,14742443,14979147,43,0.652,37,0.561,946915,130502,816413,0.871,6.322,1422657,136983,1285674,0.914,9.498,-475742,-3.176,12.643,17,17,68327
2010,g) 1000+,3630,6404,14436512,14506708,26,0.405,43,0.6709999999999999,959468,76643,882825,0.528,6.614,1099044,158192,940852,1.09,7.576,-139576,-0.962,13.228,12,12,44559
2011,g) 1000+,3669,6481,14839077,14668282,23,0.355,29,0.447,1194658,79965,1114693,0.545,8.144,852046,103165,748881,0.703,5.809,342612,2.336,11.618,7,7,20693
2012,g) 1000+,3706,6587,15248069,15103458,21,0.318,45,0.682,1229520,59033,1170487,0.391,8.141,936502,162897,773605,1.079,6.2010000000000005,293018,1.94,12.401,15,18,65663
2013,g) 1000+,3778,6765,15763080,15611133,37,0.547,43,0.635,1312226,149754,1162472,0.959,8.406,1011291,188216,823075,1.206,6.478,300935,1.928,12.956,10,10,37666
2014,g) 1000+,3864,6967,16213807,16047744,44,0.632,35,0.503,1414976,179314,1235662,1.117,8.817,1083114,149381,933733,0.931,6.749,331862,2.068,13.499,5,5,27560
2015,g) 1000+,3977,7161,16809680,16619332,34,0.475,37,0.517,1436744,119956,1316788,0.722,8.645,1061246,154556,906690,0.93,6.386,375498,2.259,12.771,8,8,34898
2016,g) 1000+,4020,7333,17221571,17109560,36,0.491,39,0.532,1376991,127783,1249208,0.747,8.048,1157331,241950,915381,1.414,6.7639999999999985,219660,1.284,13.528,8,10,61388
2017,g) 1000+,4045,7495,17740409,17522967,45,0.601,42,0.56,1577679,131024,1446655,0.748,9.003,1139562,161820,977742,0.923,6.502999999999999,438117,2.5,13.005999999999998,15,15,61920
2018,g) 1000+,4218,7842,18646750,18376759,56,0.715,30,0.383,1464192,224488,1239704,1.222,7.968,920362,112616,807746,0.613,5.008,543830,2.959,10.017,5,5,19851
