year,vcnaics4,firms,estabs,emp,denom,estabs_entry,estabs_entry_rate,estabs_exit,estabs_exit_rate,job_creation,job_creation_births,job_creation_continuers,job_creation_rate_births,job_creation_rate,job_destruction,job_destruction_deaths,job_destruction_continuers,job_destruction_rate_deaths,job_destruction_rate,net_job_creation,net_job_creation_rate,reallocation_rate,firmdeath_firms,firmdeath_estabs,firmdeath_emp
1978,2111,5249,7001,119104,116723,957,13.777,848,12.208,29591,10797,18794,9.250,25.352,24781,12612,12169,10.805,21.231,4810,4.121,42.461,387,398,1624
1978,2121,3314,4058,186199,202119,926,23.571,667,16.978,37806,16655,21151,8.240,18.705,69248,16136,53112,7.983,34.261,-31442,-15.556,37.410,432,434,5615
1978,2122,466,644,77067,81366,136,21.300,125,19.577,12026,3778,8248,4.643,14.780,20461,9498,10963,11.673,25.147,-8435,-10.367,29.560,60,61,2686
1978,2123,3661,5139,106459,104347,531,10.306,558,10.830,20874,7666,13208,7.347,20.004,16633,6748,9885,6.467,15.940,4241,4.064,31.880,246,250,1615
1978,2131,6872,7972,218503,202151,1692,22.030,1109,14.439,73704,28440,45264,14.069,36.460,41675,18025,23650,8.917,20.616,32029,15.844,41.232,637,646,5055
1978,2211,1473,5450,491432,477316,335,6.206,231,4.279,63052,17427,45625,3.651,13.210,35080,7032,28048,1.473,7.349,27972,5.860,14.699,15,15,224
1978,2212,476,2226,132791,131631,149,6.733,123,5.558,13642,3194,10448,2.426,10.364,11485,4434,7051,3.369,8.725,2157,1.639,17.450,20,20,76
1978,2213,3820,4123,32971,32569,444,10.998,272,6.738,5533,1493,4040,4.584,16.989,4758,2520,2238,7.738,14.609,775,2.380,29.218,181,184,1495
1978,2361,101896,102242,585192,527032,28279,29.347,16518,17.142,247918,112921,134997,21.426,47.040,131878,63854,68024,12.116,25.023,116040,22.018,50.046,12869,12875,48618
1978,2362,32653,33199,583395,549798,6399,20.107,3650,11.469,176039,41960,134079,7.632,32.019,109460,24909,84551,4.531,19.909,66579,12.110,39.818,2701,2702,15775
1978,2371,13196,13515,371580,359805,1850,13.932,1378,10.377,96338,22992,73346,6.390,26.775,71970,17920,54050,4.980,20.003,24368,6.773,40.005,1033,1036,9874
1978,2372,7438,7602,69839,64970,2028,27.848,1389,19.073,28320,12264,16056,18.876,43.589,18382,8393,9989,12.918,28.293,9938,15.296,56.586,1008,1013,4507
1978,2373,10598,10932,239891,231208,1280,11.814,1085,10.014,63012,11343,51669,4.906,27.253,45693,10330,35363,4.468,19.763,17319,7.491,39.526,796,798,5568
1978,2379,4155,4184,61112,53262,934,22.859,738,18.062,26944,13383,13561,25.127,50.588,11093,3814,7279,7.161,20.827,15851,29.761,41.655,557,557,2441
1978,2381,64978,65391,521974,479335,13617,21.739,8113,12.952,186288,60382,125906,12.597,38.864,101085,37052,64033,7.730,21.089,85203,17.775,42.177,6281,6281,28248
1978,2382,91078,92772,880169,833537,15049,16.711,9615,10.677,236134,63683,172451,7.640,28.329,142691,50401,92290,6.047,17.119,93443,11.210,34.237,7580,7583,32098
1978,2383,69490,69879,500934,461047,15696,23.384,10182,15.169,182860,64583,118277,14.008,39.662,102866,39896,62970,8.653,22.311,79994,17.351,44.623,7850,7852,29938
1978,2389,31095,31226,264263,240218,6528,21.712,4208,13.996,100010,31835,68175,13.253,41.633,50902,19990,30912,8.322,21.190,49108,20.443,42.380,3186,3187,13148
1978,3111,2121,2798,66521,65895,257,9.096,312,11.042,11099,3947,7152,5.990,16.844,9867,4275,5592,6.488,14.974,1232,1.870,29.948,184,190,1449
1978,3112,554,892,79172,78829,53,5.879,72,7.987,7056,2481,4575,3.147,8.951,6288,3623,2665,4.596,7.977,768,0.974,15.954,31,31,530
1978,3113,1199,1596,93833,94617,188,11.750,196,12.250,11327,3172,8155,3.352,11.971,13156,4263,8893,4.506,13.905,-1829,-1.933,23.943,107,108,755
1978,3114,1357,1881,190938,184269,160,8.511,158,8.404,33090,13954,19136,7.573,17.957,20029,8276,11753,4.491,10.869,13061,7.088,21.739,82,82,1415
1978,3115,2470,3276,152024,151878,185,5.566,281,8.454,19017,6688,12329,4.404,12.521,18717,8935,9782,5.883,12.324,300,0.198,24.647,175,180,3068
1978,3116,4868,5507,326958,324203,422,7.520,632,11.262,42234,12068,30166,3.722,13.027,36770,16949,19821,5.228,11.342,5464,1.685,22.683,421,427,6545
1978,3117,657,788,44926,42013,64,8.117,65,8.244,11816,2577,9239,6.134,28.125,6161,2664,3497,6.341,14.665,5655,13.460,29.329,40,40,885
1978,3118,8283,9808,311545,304805,1234,12.679,1084,11.137,47359,16760,30599,5.499,15.538,33856,15886,17970,5.212,11.107,13503,4.430,22.215,737,756,8347
1978,3119,2084,2460,113036,107836,245,10.008,221,9.028,22173,10533,11640,9.768,20.562,11752,5320,6432,4.933,10.898,10421,9.664,21.796,147,147,1539
1978,3121,2348,2964,181881,178540,208,6.975,244,8.182,26588,8159,18429,4.570,14.892,19440,9474,9966,5.306,10.888,7148,4.004,21.777,135,136,2373
1978,3122,148,217,47770,48301,14,6.208,31,13.747,3102,448,2654,0.928,6.422,4010,1200,2810,2.484,8.302,-908,-1.880,12.844,12,12,119
1978,3131,488,739,127541,127315,60,8.186,48,6.548,11404,3306,8098,2.597,8.957,10965,5016,5949,3.940,8.612,439,0.345,17.225,28,29,656
1978,3132,1850,2302,366933,370203,187,8.069,218,9.407,29091,10204,18887,2.756,7.858,35185,15345,19840,4.145,9.504,-6094,-1.646,15.716,137,137,4455
1978,3133,1534,1781,133035,132974,161,9.012,172,9.628,15599,4153,11446,3.123,11.731,15434,7152,8282,5.378,11.607,165,0.124,23.214,109,109,2142
1978,3141,4547,4836,139616,132887,705,14.830,541,11.380,28198,9683,18515,7.287,21.220,14874,6733,8141,5.067,11.193,13324,10.027,22.386,411,412,2662
1978,3149,3331,3476,143152,139501,427,12.489,313,9.155,26069,8050,18019,5.771,18.687,18816,8284,10532,5.938,13.488,7253,5.199,26.976,214,214,2876
1978,3151,1452,1598,148695,146352,142,8.842,158,9.838,21566,5750,15816,3.929,14.736,16951,7222,9729,4.935,11.582,4615,3.153,23.165,120,122,3829
1978,3152,13483,15331,985497,978170,2177,14.245,2081,13.616,166586,64316,102270,6.575,17.030,152093,75415,76678,7.710,15.549,14493,1.482,31.097,1547,1560,38093
1978,3159,1748,1864,80339,78542,176,9.475,163,8.775,11539,2975,8564,3.788,14.692,7839,2265,5574,2.884,9.981,3700,4.711,19.961,129,129,1569
1978,3161,442,486,23265,23141,44,9.082,41,8.462,3018,641,2377,2.770,13.042,2790,1214,1576,5.246,12.057,228,0.985,24.113,22,22,125
1978,3162,549,824,156265,158556,61,7.389,64,7.753,16666,4515,12151,2.848,10.511,21599,10243,11356,6.460,13.622,-4933,-3.111,21.022,29,32,1055
1978,3169,1414,1481,68640,67941,150,10.017,183,12.220,11912,2943,8969,4.332,17.533,10573,4873,5700,7.172,15.562,1339,1.971,31.124,145,145,2383
1978,3211,5679,6268,167050,162730,757,12.097,736,11.762,29822,12185,17637,7.488,18.326,21183,9228,11955,5.671,13.017,8639,5.309,26.035,527,527,4333
1978,3212,1032,1301,97920,94064,217,17.388,111,8.894,15155,5762,9393,6.126,16.111,7441,4125,3316,4.385,7.911,7714,8.201,15.821,58,60,1360
1978,3219,8226,9001,304995,289105,1152,12.955,934,10.504,66351,17903,48448,6.193,22.951,34853,17420,17433,6.026,12.056,31498,10.895,24.111,661,665,6384
1978,3221,368,744,214357,213987,80,11.065,38,5.256,11940,5146,6794,2.405,5.580,11171,4991,6180,2.332,5.220,769,0.359,10.441,7,7,457
1978,3222,3458,4987,397677,389731,469,9.608,258,5.285,46926,15705,31221,4.030,12.041,30773,13760,17013,3.531,7.896,16153,4.145,15.792,131,131,2349
1978,3231,29585,30903,602528,584287,3643,11.985,2632,8.659,94468,26958,67510,4.614,16.168,58219,28387,29832,4.858,9.964,36249,6.204,19.928,1939,1946,11456
1978,3241,1446,2279,452321,453049,226,9.978,198,8.742,30562,7235,23327,1.597,6.746,32562,3521,29041,0.777,7.187,-2000,-0.441,13.492,66,66,802
1978,3251,996,2073,268943,265102,170,8.238,151,7.318,25893,7452,18441,2.811,9.767,17800,8424,9376,3.178,6.714,8093,3.053,13.429,47,48,1407
1978,3252,420,656,164835,163419,67,10.404,43,6.677,12116,2716,9400,1.662,7.414,9264,4569,4695,2.796,5.669,2852,1.745,11.338,13,13,278
1978,3253,767,1168,55224,55925,108,9.231,112,9.573,6720,2405,4315,4.300,12.016,8084,3657,4427,6.539,14.455,-1364,-2.439,24.032,46,46,454
1978,3254,909,1116,150078,148980,102,9.079,117,10.414,13439,3702,9737,2.485,9.021,11139,5489,5650,3.684,7.477,2300,1.544,14.954,62,62,1168
1978,3255,1608,2050,76857,76882,147,7.148,160,7.780,9005,2183,6822,2.839,11.713,9109,4659,4450,6.060,11.848,-104,-0.135,23.426,83,84,678
1978,3256,2055,2300,114412,112074,199,8.663,193,8.402,14698,2441,12257,2.178,13.115,9987,3651,6336,3.258,8.911,4711,4.203,17.822,123,124,824
1978,3259,1699,2137,90676,89818,236,11.101,214,10.066,10900,3678,7222,4.095,12.136,9254,4153,5101,4.624,10.303,1646,1.833,20.606,120,120,921
1978,3261,8122,9455,481042,457439,1198,12.916,838,9.035,93377,25017,68360,5.469,20.413,46062,21077,24985,4.608,10.070,47315,10.343,20.139,559,561,7705
1978,3262,1772,2133,233932,231894,215,10.197,166,7.873,20332,4909,15423,2.117,8.768,16623,4253,12370,1.834,7.168,3709,1.599,14.337,102,102,1332
1978,3271,1333,1638,98132,96267,199,12.227,178,10.937,14041,3445,10596,3.579,14.585,10211,4761,5450,4.946,10.607,3830,3.979,21.214,115,115,1173
1978,3272,1295,1578,184983,179635,200,12.887,148,9.536,18673,2761,15912,1.537,10.395,8144,1896,6248,1.055,4.534,10529,5.861,9.067,100,101,823
1978,3273,7623,9424,186499,181517,804,8.546,771,8.196,36181,9006,27175,4.962,19.933,26125,10282,15843,5.664,14.393,10056,5.540,28.785,481,493,3375
1978,3274,279,375,17452,16776,49,13.297,36,9.769,2165,548,1617,3.267,12.905,794,502,292,2.992,4.733,1371,8.172,9.466,23,23,66
1978,3279,2206,2528,92523,90580,296,11.845,238,9.524,13173,2977,10196,3.287,14.543,9389,3764,5625,4.155,10.365,3784,4.178,20.731,152,152,996
1978,3311,248,275,124631,123772,49,17.754,51,18.478,7106,2608,4498,2.107,5.741,5480,2155,3325,1.741,4.428,1626,1.314,8.855,33,33,229
1978,3312,476,631,79788,78620,48,7.662,39,6.225,8710,1517,7193,1.930,11.079,6207,3515,2692,4.471,7.895,2503,3.184,15.790,13,13,363
1978,3313,405,662,146621,144327,38,5.766,32,4.856,15924,2267,13657,1.571,11.033,11602,7179,4423,4.974,8.039,4322,2.995,16.077,12,12,714
1978,3314,801,993,111913,111820,90,9.109,80,8.097,9916,2549,7367,2.280,8.868,10062,2909,7153,2.602,8.998,-146,-0.131,17.736,51,51,405
1978,3315,2800,3125,313830,304746,194,6.193,209,6.672,37838,7248,30590,2.378,12.416,19794,7768,12026,2.549,6.495,18044,5.921,12.991,135,136,2472
1978,3321,2848,3052,156816,150865,250,8.255,203,6.703,23310,6486,16824,4.299,15.451,11545,4891,6654,3.242,7.653,11765,7.798,15.305,131,131,1775
1978,3322,1134,1236,92459,88646,101,8.228,84,6.843,13346,2481,10865,2.799,15.055,5606,2816,2790,3.177,6.324,7740,8.731,12.648,64,64,1231
1978,3323,9295,10069,351662,337301,1029,10.369,739,7.447,68344,17257,51087,5.116,20.262,39796,14553,25243,4.315,11.798,28548,8.464,23.597,515,520,6093
1978,3324,1378,1777,162482,161656,130,7.393,93,5.289,16960,4414,12546,2.730,10.491,15771,5049,10722,3.123,9.756,1189,0.736,19.512,46,47,954
1978,3325,878,954,93383,90581,83,8.825,56,5.954,11560,2234,9326,2.466,12.762,6113,1450,4663,1.601,6.749,5447,6.013,13.497,35,35,295
1978,3326,1476,1658,69148,67144,151,9.244,102,6.244,11607,3236,8371,4.820,17.287,7475,3567,3908,5.313,11.133,4132,6.154,22.266,60,60,585
1978,3327,18455,18737,312011,293307,2278,12.791,424,2.381,61349,13633,47716,4.648,20.916,23982,7978,16004,2.720,8.176,37367,12.740,16.353,199,199,2678
1978,3328,5318,5586,122799,115772,486,8.827,326,5.921,24019,4869,19150,4.206,20.747,10107,3264,6843,2.819,8.730,13912,12.017,17.460,257,258,2032
1978,3329,4600,5101,377175,365770,610,12.177,427,8.524,53476,12824,40652,3.506,14.620,30307,11247,19060,3.075,8.286,23169,6.334,16.572,281,282,3947
1978,3331,2833,3240,379583,371865,368,11.496,290,9.060,49636,9153,40483,2.461,13.348,34380,8138,26242,2.188,9.245,15256,4.103,18.491,184,184,2605
1978,3332,3501,3746,188718,181566,297,7.936,290,7.749,29574,9811,19763,5.404,16.288,15346,7187,8159,3.958,8.452,14228,7.836,16.904,174,174,1448
1978,3333,2006,2113,158522,155994,188,8.982,148,7.071,20839,4333,16506,2.778,13.359,15660,6667,8993,4.274,10.039,5179,3.320,20.078,76,77,455
1978,3334,1652,1874,186524,178257,314,17.382,179,9.909,33085,12994,20091,7.289,18.560,16539,9049,7490,5.076,9.278,16546,9.282,18.556,112,112,1157
1978,3335,9403,9778,282222,271241,858,8.911,559,5.806,44139,9585,34554,3.534,16.273,22208,10398,11810,3.833,8.188,21931,8.085,16.375,415,415,2640
1978,3336,669,800,186038,186563,39,4.848,48,5.966,15632,1141,14491,0.612,8.379,16215,8915,7300,4.779,8.691,-583,-0.312,16.758,27,27,203
1978,3339,5376,5841,354563,342544,548,9.502,401,6.953,56042,16650,39392,4.861,16.361,32174,14181,17993,4.140,9.393,23868,6.968,18.785,243,245,2803
1978,3341,789,914,210412,198136,197,22.894,90,10.459,42276,11979,30297,6.046,21.337,17878,4048,13830,2.043,9.023,24398,12.314,18.046,47,48,1625
1978,3342,1537,1677,249858,242902,209,12.485,203,12.127,35479,5900,29579,2.429,14.606,21447,7433,14014,3.060,8.830,14032,5.777,17.659,135,135,1760
1978,3343,525,555,68769,67693,87,15.890,72,13.151,10497,2204,8293,3.256,15.507,8647,2541,6106,3.754,12.774,1850,2.733,25.548,50,50,465
1978,3344,3175,3541,374758,362718,515,14.818,384,11.049,64102,14010,50092,3.863,17.673,40074,17954,22120,4.950,11.048,24028,6.624,22.097,261,263,5353
1978,3345,3279,3706,503714,488921,397,10.797,339,9.219,66562,12612,53950,2.580,13.614,36602,18341,18261,3.751,7.486,29960,6.128,14.973,203,203,3875
1978,3346,599,625,26936,24856,115,18.654,98,15.896,6876,1289,5587,5.186,27.663,2687,759,1928,3.054,10.810,4189,16.853,21.621,67,67,449
1978,3351,1199,1312,88750,86423,125,9.542,121,9.237,12459,1910,10549,2.210,14.416,7691,3739,3952,4.326,8.899,4768,5.517,17.799,83,83,741
1978,3352,370,480,146378,144838,46,9.694,35,7.376,19809,3561,16248,2.459,13.677,17463,8590,8873,5.931,12.057,2346,1.620,24.114,14,15,162
1978,3353,1814,2223,280609,275066,268,12.299,180,8.261,38403,11323,27080,4.116,13.961,27028,16439,10589,5.976,9.826,11375,4.135,19.652,77,77,788
1978,3359,1529,1816,176710,172920,217,12.012,198,10.960,32202,13502,18700,7.808,18.622,24457,14537,9920,8.407,14.144,7745,4.479,28.287,97,97,1912
1978,3361,150,206,304036,295580,28,13.365,35,16.706,41602,13866,27736,4.691,14.075,23599,16116,7483,5.452,7.984,18003,6.091,15.968,24,24,142
1978,3362,1965,2193,159976,155762,259,11.816,257,11.724,24146,5845,18301,3.753,15.502,16118,5194,10924,3.335,10.348,8028,5.154,20.696,184,184,1769
1978,3363,3717,4419,757941,744406,512,10.486,1439,29.473,71065,13473,57592,1.810,9.547,44283,15387,28896,2.067,5.949,26782,3.598,11.898,1140,1140,7626
1978,3364,991,1175,562981,551937,97,8.203,112,9.471,52329,3479,48850,0.630,9.481,29671,6942,22729,1.258,5.376,22658,4.105,10.752,67,67,1422
1978,3365,160,224,62605,57536,14,6.264,13,5.817,16650,9758,6892,16.960,28.939,6638,380,6258,0.660,11.537,10012,17.401,23.074,9,9,237
1978,3366,1058,1153,201009,201972,164,14.526,116,10.275,22883,4237,18646,2.098,11.330,25218,4060,21158,2.010,12.486,-2335,-1.156,22.660,81,81,1308
1978,3369,454,468,34925,33577,79,17.137,65,14.100,6647,661,5986,1.969,19.797,3916,1588,2328,4.729,11.663,2731,8.134,23.326,52,52,593
1978,3371,11578,12122,391978,372768,1848,15.554,1367,11.505,75620,21640,53980,5.805,20.286,36871,20508,16363,5.502,9.891,38749,10.395,19.782,1013,1018,8752
1978,3372,2161,2256,112153,108129,256,11.493,199,8.934,18335,4753,13582,4.396,16.957,10088,3945,6143,3.648,9.330,8247,7.627,18.659,148,149,1464
1978,3379,1104,1241,38092,37177,101,8.132,103,8.293,7736,2909,4827,7.825,20.809,5661,3533,2128,9.503,15.227,2075,5.581,30.455,67,67,876
1978,3391,8395,8920,202611,196811,1370,15.805,866,9.991,35491,12006,23485,6.100,18.033,23822,9962,13860,5.062,12.104,11669,5.929,24.208,617,620,3900
1978,3399,14968,15647,478631,463418,1944,12.535,1667,10.749,87018,23842,63176,5.145,18.777,56926,23953,32973,5.169,12.284,30092,6.493,24.568,1263,1265,10105
1978,4231,22345,28226,317343,307377,3240,11.601,2645,9.471,63095,21580,41515,7.021,20.527,42845,20410,22435,6.640,13.939,20250,6.588,27.878,1661,1708,8790
1978,4232,6592,7766,89078,83381,1202,15.890,799,10.562,22361,7218,15143,8.657,26.818,10939,5191,5748,6.226,13.119,11422,13.699,26.239,520,524,2103
1978,4233,6643,8372,107564,102560,1236,15.137,823,10.079,25826,8178,17648,7.974,25.181,15646,7841,7805,7.645,15.255,10180,9.926,30.511,505,510,2783
1978,4234,15086,20935,363994,346188,3394,16.781,1975,9.765,82199,34144,48055,9.863,23.744,47446,24741,22705,7.147,13.705,34753,10.039,27.411,1026,1055,6384
1978,4235,5457,7890,125352,121420,994,12.813,729,9.397,25872,9413,16459,7.752,21.308,18215,9120,9095,7.511,15.002,7657,6.306,30.003,382,392,3525
1978,4236,11747,16668,205110,197153,2419,14.745,1895,11.551,47549,18329,29220,9.297,24.118,31618,16746,14872,8.494,16.037,15931,8.081,32.075,941,955,4296
1978,4237,9627,12527,138016,132972,1716,14.021,1139,9.307,29362,11172,18190,8.402,22.081,19294,9457,9837,7.112,14.510,10068,7.572,29.020,624,644,3407
1978,4238,41402,53632,600776,579580,6528,12.408,4488,8.530,123448,45152,78296,7.790,21.300,81239,36171,45068,6.241,14.017,42209,7.283,28.034,2564,2615,13808
1978,4239,17867,19513,203200,197838,3118,16.310,2327,12.172,47551,16647,30904,8.414,24.035,36839,15605,21234,7.888,18.621,10712,5.415,37.242,1618,1638,6453
1978,4241,6037,8477,119280,115224,1024,12.342,664,8.003,22460,7399,15061,6.421,19.492,14428,5723,8705,4.967,12.522,8032,6.971,25.043,390,397,2382
1978,4242,2355,3065,83784,82485,438,14.279,443,14.442,17089,6103,10986,7.399,20.718,14548,9807,4741,11.890,17.637,2541,3.081,35.275,233,249,2833
1978,4243,9391,10310,106506,106202,1621,15.985,1283,12.652,27074,9471,17603,8.918,25.493,26391,12692,13699,11.951,24.850,683,0.643,49.700,895,902,4997
1978,4244,25614,31409,529786,513944,3946,12.670,3418,10.974,109802,38620,71182,7.514,21.365,77295,38172,39123,7.427,15.040,32507,6.325,30.079,2254,2284,15542
1978,4245,8843,11934,108558,106633,872,7.282,952,7.951,22314,5858,16456,5.494,20.926,18537,7338,11199,6.882,17.384,3777,3.542,34.768,562,578,3208
1978,4246,5133,7704,93683,91927,1125,14.951,766,10.180,19787,7680,12107,8.355,21.525,16396,7229,9167,7.864,17.836,3391,3.689,35.672,361,368,1928
1978,4247,11971,16182,151010,148673,1600,9.868,1664,10.263,32539,9787,22752,6.583,21.886,27712,12390,15322,8.334,18.640,4827,3.247,37.279,912,928,4731
1978,4248,4845,5947,118629,114853,444,7.420,517,8.640,20775,6122,14653,5.330,18.088,13142,6122,7020,5.330,11.443,7633,6.646,22.885,341,346,2616
1978,4249,17515,21546,224886,220501,2879,13.491,2467,11.560,48176,19045,29131,8.637,21.848,39331,18575,20756,8.424,17.837,8845,4.011,35.674,1549,1573,8081
1978,4251,24156,26718,262560,253835,3649,13.978,2424,9.285,58195,20484,37711,8.070,22.926,40913,18818,22095,7.413,16.118,17282,6.808,32.236,1473,1477,6991
1978,4411,41082,42196,866056,834981,4126,9.821,3760,8.950,132469,39332,93137,4.711,15.865,70141,27517,42624,3.296,8.400,62328,7.465,16.801,3051,3069,20772
1978,4412,12584,13025,82059,78361,1975,15.422,1537,12.002,21393,8500,12893,10.847,27.301,13969,6083,7886,7.763,17.827,7424,9.474,35.653,1213,1218,4492
1978,4413,38696,54811,356177,339625,7056,13.211,4252,7.961,80781,32828,47953,9.666,23.785,47798,19097,28701,5.623,14.074,32983,9.712,28.148,2603,2720,10614
1978,4421,23320,26817,212483,203372,3588,13.578,2804,10.611,49235,21078,28157,10.364,24.209,30861,14445,16416,7.103,15.175,18374,9.035,30.349,1964,2007,7921
1978,4422,17591,19832,109280,101741,4162,21.922,2469,13.005,33280,15787,17493,15.517,32.711,18219,8812,9407,8.661,17.907,15061,14.803,35.814,1780,1829,5554
1978,4431,25563,32161,180214,170092,5657,17.964,4318,13.712,50991,25020,25971,14.710,29.978,31074,16544,14530,9.727,18.269,19917,11.710,36.538,2773,2842,9868
1978,4441,53731,66912,608732,579279,7689,11.693,5380,8.182,134046,51226,82820,8.843,23.140,74572,33582,40990,5.797,12.873,59474,10.267,25.746,3482,3518,14456
1978,4442,13455,16305,111118,107491,2074,12.937,1526,9.519,24908,8668,16240,8.064,23.172,17629,6603,11026,6.143,16.401,7279,6.772,32.801,1016,1034,3660
1978,4451,64554,102269,1560914,1513471,13727,13.485,12780,12.555,328956,153273,175683,10.127,21.735,235021,115527,119494,7.633,15.529,93935,6.207,31.057,7683,7841,40670
1978,4452,24148,29587,173516,165782,5005,17.000,4713,16.008,51497,24264,27233,14.636,31.063,36051,19636,16415,11.845,21.746,15446,9.317,43.492,3237,3282,12426
1978,4453,28739,33917,174303,158698,4000,11.828,3801,11.240,55290,22487,32803,14.170,34.840,24514,11346,13168,7.149,15.447,30776,19.393,30.894,2694,2732,7722
1978,4461,37806,51999,484933,478488,5986,11.701,4305,8.415,96048,42853,53195,8.956,20.073,83856,43682,40174,9.129,17.525,12192,2.548,35.050,2180,2251,12628
1978,4471,122704,153806,865287,832859,21880,14.017,26469,16.956,250920,103303,147617,12.403,30.128,185750,95951,89799,11.521,22.303,65170,7.825,44.605,18354,18649,61833
1978,4481,59478,89900,748456,728210,14117,15.940,11441,12.919,190117,84889,105228,11.657,26.107,149395,74133,75262,10.180,20.515,40722,5.592,41.031,6557,6849,29519
1978,4482,11352,29025,155840,148993,3744,12.927,3618,12.492,40065,17912,22153,12.022,26.891,27195,14327,12868,9.616,18.253,12870,8.638,36.505,1151,1243,4463
1978,4483,16170,22029,126624,121043,3500,16.368,2209,10.330,32361,15250,17111,12.599,26.735,21450,9420,12030,7.782,17.721,10911,9.014,35.442,1234,1314,4777
1978,4511,30085,37323,216955,208535,7022,19.222,5439,14.889,60661,28739,31922,13.781,29.089,43711,22321,21390,10.704,20.961,16950,8.128,41.922,3679,3739,13391
1978,4512,7211,9621,59805,55144,1811,19.406,1233,13.213,19539,8211,11328,14.890,35.433,10238,4586,5652,8.316,18.566,9301,16.867,37.132,854,868,3037
1978,4521,666,8758,1536485,1486918,957,11.238,473,5.554,245170,102204,142966,6.874,16.488,147783,46077,101706,3.099,9.939,97387,6.550,19.878,50,59,2974
1978,4529,15183,28321,384799,384279,2862,10.012,3392,11.866,65131,28539,36592,7.427,16.949,63672,24506,39166,6.377,16.569,1459,0.380,33.138,1933,1991,7667
1978,4531,18444,19535,97321,91820,2945,15.397,2129,11.131,27557,8927,18630,9.722,30.012,16588,8745,7843,9.524,18.066,10969,11.946,36.132,1612,1653,4919
1978,4532,20011,23460,133478,124688,4766,21.080,3064,13.552,39742,17622,22120,14.133,31.873,22182,11149,11033,8.942,17.790,17560,14.083,35.580,2233,2267,6344
1978,4533,7471,8806,41895,39324,1535,17.741,1228,14.192,13165,5120,8045,13.020,33.479,8011,3306,4705,8.407,20.372,5154,13.107,40.744,862,867,1956
1978,4539,24508,28983,126493,120116,5441,19.124,4378,15.388,39598,18530,21068,15.427,32.966,26708,13684,13024,11.392,22.235,12890,10.731,44.470,2957,3017,8541
1978,4541,4693,6440,89241,89149,1057,16.827,740,11.781,20730,8264,12466,9.270,23.253,20164,10803,9361,12.118,22.618,566,0.635,45.237,430,435,3249
1978,4542,4342,5453,74833,67727,878,16.535,592,11.149,22604,14560,8044,21.498,33.375,9262,4702,4560,6.943,13.675,13342,19.700,27.351,374,377,2072
1978,4543,17239,22665,188535,186653,2651,11.687,2687,11.846,42434,19424,23010,10.406,22.734,38863,15476,23387,8.291,20.821,3571,1.913,41.642,1605,1623,6610
1978,4811,958,2183,227748,219717,280,12.627,349,15.738,37601,3381,34220,1.539,17.113,21625,5270,16355,2.399,9.842,15976,7.271,19.684,107,108,831
1978,4812,319,447,5686,5462,109,24.943,89,20.366,2072,456,1616,8.349,37.938,1653,493,1160,9.027,30.266,419,7.672,60.533,43,43,175
1978,4831,447,707,36765,35146,136,19.682,104,15.051,10738,6040,4698,17.185,30.553,7369,4465,2904,12.704,20.967,3369,9.586,41.934,53,60,1557
1978,4832,427,495,14918,14476,61,12.286,64,12.890,3595,2005,1590,13.851,24.835,2657,1132,1525,7.820,18.355,938,6.480,36.710,38,43,815
1978,4841,19578,24051,492077,477923,4775,20.149,4069,17.170,120621,47428,73193,9.924,25.239,93060,39605,53455,8.287,19.472,27561,5.767,38.944,2813,2815,11383
1978,4842,39948,43443,548347,524679,7823,18.334,6274,14.704,141370,47779,93591,9.106,26.944,94621,41962,52659,7.998,18.034,46749,8.910,36.068,4619,4626,18086
1978,4851,416,455,22332,22097,43,9.378,50,10.905,3062,447,2615,2.023,13.857,2625,1876,749,8.490,11.880,437,1.978,23.759,32,33,1371
1978,4852,302,714,36139,36145,135,20.408,30,4.535,5602,2874,2728,7.951,15.499,5597,838,4759,2.318,15.485,5,0.014,30.970,20,20,311
1978,4853,6275,6340,78338,80370,1061,16.744,1054,16.634,17501,6189,11312,7.701,21.776,21371,9602,11769,11.947,26.591,-3870,-4.815,43.551,885,889,7221
1978,4854,3781,3930,86354,83115,372,9.450,385,9.780,16360,3574,12786,4.300,19.684,9914,4493,5421,5.406,11.928,6446,7.756,23.856,308,308,2172
1978,4855,350,372,6457,6418,93,26.160,60,16.878,1653,510,1143,7.946,25.756,1569,1057,512,16.469,24.447,84,1.309,48.894,44,44,748
1978,4859,800,831,15171,14879,155,18.788,143,17.333,3920,1353,2567,9.094,26.347,3266,2217,1049,14.901,21.951,654,4.396,43.902,106,106,1287
1978,4861,70,278,11564,10464,50,18.797,26,9.774,4144,2386,1758,22.802,39.602,1836,775,1061,7.406,17.546,2308,22.057,35.092,3,3,71
1978,4862,202,918,50751,48467,110,12.394,49,5.521,9444,4317,5127,8.907,19.486,5117,2171,2946,4.479,10.558,4327,8.928,21.116,9,9,40
1978,4869,62,258,6785,6719,29,11.240,29,11.240,1231,391,840,5.819,18.321,1152,806,346,11.996,17.145,79,1.176,34.291,3,3,17
1978,4871,152,153,2263,2036,39,26.351,29,19.595,983,145,838,7.124,48.293,475,256,219,12.577,23.336,508,24.957,46.672,21,21,100
1978,4872,663,673,10531,9166,128,19.292,109,16.428,3881,1342,2539,14.642,42.344,1206,564,642,6.154,13.158,2675,29.186,26.316,91,91,467
1978,4879,32,39,733,618,10,24.691,13,32.099,304,91,213,14.737,49.231,74,31,43,5.020,11.984,230,37.247,23.968,6,6,19
1978,4881,1918,2307,47771,45708,386,17.080,292,12.920,13073,5455,7618,11.934,28.601,8477,5964,2513,13.048,18.546,4596,10.055,37.092,186,186,713
1978,4882,269,325,17760,17999,57,18.095,37,11.746,2065,706,1359,3.923,11.473,2558,642,1916,3.567,14.212,-493,-2.739,22.946,27,27,268
1978,4883,1841,2270,118295,105555,346,15.433,290,12.935,50281,23953,26328,22.693,47.635,25484,7353,18131,6.966,24.143,24797,23.492,48.286,189,189,1982
1978,4884,1666,2267,40880,40359,405,18.231,314,14.135,7947,2097,5850,5.196,19.691,6784,3723,3061,9.225,16.809,1163,2.882,33.619,197,202,2339
1978,4885,3399,5026,69354,66754,891,18.482,481,9.977,16191,5927,10264,8.879,24.255,11067,4975,6092,7.453,16.579,5124,7.676,33.158,240,248,994
1978,4889,311,319,5428,5122,55,17.544,44,14.035,1617,485,1132,9.469,31.570,1036,272,764,5.310,20.226,581,11.343,40.453,35,35,175
1978,4921,1061,1444,90052,89202,312,21.712,298,20.738,11724,1502,10222,1.684,13.143,10235,4693,5542,5.261,11.474,1489,1.669,22.948,179,179,906
1978,4922,1018,1018,6069,5583,264,25.143,328,31.238,2525,1153,1372,20.652,45.227,1530,1013,517,18.144,27.405,995,17.822,54.809,297,297,931
1978,4931,5511,8568,379870,369458,958,11.333,729,8.624,73185,22695,50490,6.143,19.809,52116,14048,38068,3.802,14.106,21069,5.703,28.212,247,248,1569
1978,5111,12820,14208,554587,541427,1707,12.173,1337,9.534,70644,20539,50105,3.793,13.048,44574,21680,22894,4.004,8.233,26070,4.815,16.465,996,1001,7772
1978,5112,2580,3190,54486,50242,1055,36.335,482,16.601,20845,9800,11045,19.506,41.490,12503,7510,4993,14.948,24.886,8342,16.604,49.772,233,235,1384
1978,5121,7908,13307,177767,175355,2382,17.985,2257,17.041,55075,23917,31158,13.639,31.408,49957,27241,22716,15.535,28.489,5118,2.919,56.978,1105,1195,10012
1978,5122,906,912,7934,7180,239,28.452,95,11.310,2529,1327,1202,18.483,35.225,985,315,670,4.387,13.720,1544,21.506,27.439,69,69,216
1978,5151,5166,6040,169168,161927,596,10.027,404,6.797,30720,11084,19636,6.845,18.972,16335,7245,9090,4.474,10.088,14385,8.884,20.176,275,281,3574
1978,5152,6,6,179,164,3,66.667,0,0.000,31,10,21,6.098,18.902,3,0,3,0.000,1.829,28,17.073,3.659,0,0,0
1978,5171,1425,13136,847345,823816,504,3.829,560,4.254,138080,11079,127001,1.345,16.761,90357,4467,85890,0.542,10.968,47723,5.793,21.936,60,61,750
1978,5172,430,1190,60717,58975,112,9.618,61,5.238,9117,921,8196,1.562,15.459,5502,1521,3981,2.579,9.329,3615,6.130,18.659,37,37,331
1978,5174,455,732,16956,15493,127,18.169,61,8.727,5186,2055,3131,13.264,33.473,2186,1206,980,7.784,14.110,3000,19.364,28.219,23,23,120
1978,5179,863,1843,57088,56815,225,12.531,130,7.240,9341,1905,7436,3.353,16.441,8873,1438,7435,2.531,15.617,468,0.824,31.235,79,81,489
1978,5182,4499,5924,162913,156343,1221,21.333,820,14.327,43597,18239,25358,11.666,27.885,30594,15266,15328,9.764,19.569,13003,8.317,39.137,407,414,3687
1978,5191,1941,2315,27178,27416,271,12.061,135,6.008,5058,1148,3910,4.187,18.449,5665,3801,1864,13.864,20.663,-607,-2.214,36.898,92,93,2920
1978,5211,21,53,23522,23823,(D),(D),0,0.000,1112,(D),1083,(D),4.668,1697,0,1697,0.000,7.123,-585,-2.456,9.336,0,0,0
1978,5221,20718,57018,1537380,1493829,3810,6.808,1701,3.039,221774,52208,169566,3.495,14.846,134562,30364,104198,2.033,9.008,87212,5.838,18.016,324,331,5782
1978,5222,23582,41592,304917,298371,4232,10.159,4366,10.480,68702,29035,39667,9.731,23.026,54620,30130,24490,10.098,18.306,14082,4.720,36.612,1189,1207,4857
1978,5223,2316,2568,27952,26227,606,25.124,294,12.189,7271,3004,4267,11.454,27.723,3782,2610,1172,9.952,14.420,3489,13.303,28.841,190,191,972
1978,5231,3818,7229,155443,157562,1163,16.338,942,13.233,32006,10051,21955,6.379,20.313,36248,14634,21614,9.288,23.006,-4242,-2.692,40.627,406,477,5368
1978,5232,88,98,3923,3888,22,23.158,16,16.842,415,84,331,2.161,10.675,344,58,286,1.492,8.849,71,1.826,17.698,12,12,49
1978,5239,8216,8516,68185,65585,1698,20.433,1286,15.475,18360,6880,11480,10.490,27.994,12882,5320,7562,8.112,19.642,5478,8.353,39.284,1023,1025,3242
1978,5241,5871,26472,1095641,1076720,2491,9.358,2785,10.462,185122,52481,132641,4.874,17.193,146164,74415,71749,6.911,13.575,38958,3.618,27.150,276,283,3341
1978,5242,82135,85905,792256,755712,11806,14.142,6954,8.330,154479,41974,112505,5.554,20.442,81029,26108,54921,3.455,10.722,73450,9.719,21.444,5169,5177,14364
1978,5250,1271,1485,21000,21257,324,23.589,101,7.353,3772,2206,1566,10.378,17.745,4671,747,3924,3.514,21.974,-899,-4.229,35.490,60,60,278
1978,5311,104146,105970,489321,474637,14903,14.061,14943,14.098,127663,54577,73086,11.499,26.897,97674,51980,45694,10.952,20.579,29989,6.318,41.157,12244,12256,35467
1978,5312,29402,30312,157168,146116,6644,23.148,3424,11.929,50941,22028,28913,15.076,34.864,28687,13231,15456,9.055,19.633,22254,15.230,39.266,2577,2579,8642
1978,5313,17808,18375,158820,147063,3931,22.458,2188,12.500,50176,19238,30938,13.082,34.119,26411,11303,15108,7.686,17.959,23765,16.160,35.918,1613,1616,6305
1978,5321,5211,7777,75825,71781,1845,24.936,1089,14.718,27945,16950,10995,23.613,38.931,20115,8569,11546,11.938,28.023,7830,10.908,56.045,619,629,2544
1978,5322,7337,8557,69836,66239,1836,22.268,1212,14.700,22117,9162,12955,13.832,33.390,14710,7254,7456,10.951,22.208,7407,11.182,44.415,816,824,3644
1978,5323,1731,1877,16098,15119,421,23.493,251,14.007,4785,2069,2716,13.685,31.649,2815,1537,1278,10.166,18.619,1970,13.030,37.238,162,164,876
1978,5324,3268,3569,34925,33505,731,21.589,365,10.780,9487,3559,5928,10.622,28.315,6725,3223,3502,9.619,20.072,2762,8.244,40.143,223,225,1641
1978,5331,843,957,12204,12557,196,21.087,141,15.169,3822,1461,2361,11.635,30.437,4665,2008,2657,15.991,37.151,-843,-6.713,60.874,91,91,269
1978,5411,95566,98239,471719,460148,13281,13.858,8478,8.846,107806,40694,67112,8.844,23.429,85772,54892,30880,11.929,18.640,22034,4.788,37.280,6132,6192,47743
1978,5412,37763,40432,277899,260252,7613,19.740,3882,10.066,70720,29518,41202,11.342,27.174,35336,17760,17576,6.824,13.578,35384,13.596,27.155,2696,2719,11027
1978,5413,35706,39054,485353,454968,7470,20.025,3969,10.640,128932,47870,81062,10.522,28.339,68158,26646,41512,5.857,14.981,60774,13.358,29.962,2615,2635,11504
1978,5414,8877,9070,64309,59761,2064,24.007,1119,13.015,19026,8742,10284,14.628,31.837,10048,4765,5283,7.973,16.814,8978,15.023,33.627,877,880,3496
1978,5415,1600,1988,21623,18313,1157,73.089,347,21.920,10608,6986,3622,38.149,57.928,4208,2466,1742,13.466,22.979,6400,34.949,45.958,209,212,943
1978,5416,15153,15791,148970,142748,3743,24.508,2706,17.718,53807,20820,32987,14.585,37.694,40784,18456,22328,12.929,28.571,13023,9.123,57.141,1991,2005,10917
1978,5417,4365,5403,350335,340278,762,14.291,620,11.628,56729,21119,35610,6.206,16.671,36736,10358,26378,3.044,10.796,19993,5.875,21.592,356,360,2740
1978,5418,16628,18197,212645,206445,3133,17.653,2234,12.588,54801,21379,33422,10.356,26.545,42471,19514,22957,9.452,20.573,12330,5.973,41.145,1614,1618,8780
1978,5419,20525,21763,169427,159274,3402,16.021,2344,11.039,43058,13210,29848,8.294,27.034,22695,11318,11377,7.106,14.249,20363,12.785,28.498,1397,1542,6828
1978,5511,18835,35415,2364453,2300369,4520,12.917,3675,10.502,539165,169761,369404,7.380,23.438,409795,122483,287312,5.324,17.814,129370,5.624,35.629,421,457,5431
1978,5611,5225,5439,59381,57411,958,17.570,985,18.065,18098,5586,12512,9.730,31.524,14236,6960,7276,12.123,24.797,3862,6.727,49.594,694,695,3124
1978,5612,287,352,18886,18806,56,15.427,78,21.488,5167,884,4283,4.701,27.475,5084,3108,1976,16.527,27.034,83,0.441,54.068,31,36,563
1978,5613,7997,10348,451605,412565,2231,22.605,1274,12.908,175200,54976,120224,13.325,42.466,98283,28562,69721,6.923,23.822,76917,18.644,47.645,815,825,11676
1978,5614,14085,15943,167772,158227,3073,20.071,1808,11.809,45361,19969,25392,12.621,28.668,26048,10287,15761,6.501,16.462,19313,12.206,32.925,1306,1321,5973
1978,5615,12669,15007,109919,103281,2799,19.752,1126,7.946,28041,11186,16855,10.831,27.150,14674,5224,9450,5.058,14.208,13367,12.942,28.416,698,720,3033
1978,5616,8060,9785,299043,281614,2555,27.922,1286,14.054,92068,41271,50797,14.655,32.693,56603,23541,33062,8.359,20.100,35465,12.594,40.199,941,948,11593
1978,5617,40201,42564,568920,527876,10194,24.948,6788,16.612,197385,71312,126073,13.509,37.392,114902,49046,65856,9.291,21.767,82483,15.625,43.534,5253,5262,29044
1978,5619,8353,8966,108579,102639,2295,27.480,1066,12.764,36678,15240,21438,14.848,35.735,24405,8981,15424,8.750,23.778,12273,11.958,47.555,777,778,5126
1978,5621,4764,4892,88857,85178,740,15.208,688,14.139,18200,4581,13619,5.378,21.367,10788,5070,5718,5.952,12.665,7412,8.702,25.330,549,549,3530
1978,5622,1607,1939,31817,29945,264,13.902,184,9.689,7275,2073,5202,6.923,24.295,3569,1562,2007,5.216,11.919,3706,12.376,23.837,107,107,510
1978,5629,3862,4079,38381,36006,736,18.626,481,12.173,11886,4993,6893,13.867,33.011,7215,2563,4652,7.118,20.038,4671,12.973,40.077,364,364,1725
1978,6111,12973,13364,334919,322806,840,6.312,729,5.478,48096,8018,40078,2.484,14.899,23749,6291,17458,1.949,7.357,24347,7.542,14.714,567,568,3914
1978,6112,320,366,25640,24627,35,9.915,9,2.550,5249,337,4912,1.368,21.314,3144,956,2188,3.882,12.767,2105,8.548,25.533,4,4,773
1978,6113,1921,2153,726698,663857,114,5.307,104,4.842,167686,5250,162436,0.791,25.259,44398,13837,30561,2.084,6.688,123288,18.571,13.376,31,33,9814
1978,6114,1510,1704,25600,31868,309,18.497,242,14.487,7146,2000,5146,6.276,22.424,19517,16945,2572,53.172,61.243,-12371,-38.820,44.847,168,176,16003
1978,6115,3424,3775,38689,40699,614,16.624,451,12.211,10353,4114,6239,10.108,25.438,14400,10141,4259,24.917,35.382,-4047,-9.944,50.876,327,327,8345
1978,6116,8743,9202,79553,73620,2218,25.243,1387,15.786,28361,12593,15768,17.106,38.524,16512,8835,7677,12.001,22.429,11849,16.095,44.858,1052,1068,7074
1978,6117,829,838,11061,10468,175,21.328,140,17.063,2739,760,1979,7.260,26.165,1619,891,728,8.512,15.466,1120,10.699,30.932,109,109,652
1978,6211,139108,142940,749140,716683,15694,11.265,8455,6.069,156438,58569,97869,8.172,21.828,91791,29455,62336,4.110,12.808,64647,9.020,25.616,6553,6581,19836
1978,6212,80884,82011,319107,298236,6725,8.374,3321,4.135,72066,20553,51513,6.892,24.164,29897,10235,19662,3.432,10.025,42169,14.139,20.049,2465,2483,7463
1978,6213,26516,27376,80171,74454,4495,17.243,1879,7.208,24791,11006,13785,14.782,33.297,12710,6691,6019,8.987,17.071,12081,16.226,34.142,1342,1349,5344
1978,6214,3832,4787,74393,69782,906,19.818,475,10.390,20220,7373,12847,10.566,28.976,11019,3905,7114,5.596,15.791,9201,13.185,31.581,250,270,1931
1978,6215,3536,4465,57110,54400,756,17.532,450,10.436,12977,5657,7320,10.399,23.855,7640,3512,4128,6.456,14.044,5337,9.811,28.088,308,312,2290
1978,6216,2010,2590,73822,68561,533,21.813,240,9.822,20859,7331,13528,10.693,30.424,10135,3504,6631,5.111,14.782,10724,15.642,29.565,134,135,1428
1978,6219,2002,2262,41191,38571,453,20.929,258,11.920,13367,5312,8055,13.772,34.656,8390,5898,2492,15.291,21.752,4977,12.904,43.505,161,162,4619
1978,6221,3925,4740,2317834,2242468,176,3.724,149,3.152,226225,28708,197517,1.280,10.088,74854,31325,43529,1.397,3.338,151371,6.750,6.676,75,78,12241
1978,6222,278,340,36000,34587,47,14.551,13,4.025,5619,1508,4111,4.360,16.246,2846,854,1992,2.469,8.229,2773,8.018,16.457,5,5,437
1978,6223,145,181,38704,36680,17,9.659,7,3.977,5173,951,4222,2.593,14.103,1201,493,708,1.344,3.274,3972,10.829,6.549,6,6,98
1978,6231,6360,8169,612248,581154,856,10.669,565,7.042,125223,49614,75609,8.537,21.547,62051,34784,27267,5.985,10.677,63172,10.870,21.354,329,343,15981
1978,6232,2765,3268,73592,68437,730,24.431,170,5.689,18264,8767,9497,12.810,26.687,7812,4006,3806,5.854,11.415,10452,15.272,22.830,90,92,3140
1978,6233,8000,9153,349080,335846,1375,15.319,1020,11.364,76622,29338,47284,8.736,22.815,49996,29645,20351,8.827,14.887,26626,7.928,29.773,639,655,15551
1978,6239,2174,2548,64561,61556,403,16.530,183,7.506,13269,4119,9150,6.691,21.556,7134,1873,5261,3.043,11.589,6135,9.967,23.179,99,101,1100
1978,6241,9351,12872,202332,183756,2287,18.653,1064,8.678,65672,19288,46384,10.497,35.739,28608,8290,20318,4.511,15.569,37064,20.170,31.137,432,439,3130
1978,6242,2694,3153,34479,32195,506,16.774,233,7.724,9609,3175,6434,9.862,29.847,5047,1647,3400,5.116,15.677,4562,14.170,31.353,90,90,876
1978,6243,2881,4155,198791,174631,876,22.228,448,11.368,78924,21542,57382,12.336,45.195,30282,11284,18998,6.462,17.341,48642,27.854,34.681,142,149,1874
1978,6244,21624,24933,207342,194659,4401,18.317,2588,10.771,64146,26044,38102,13.379,32.953,39682,14748,24934,7.576,20.385,24464,12.568,40.771,1654,1695,7209
1978,7111,4807,4858,58564,55549,1040,21.842,847,17.789,19966,8291,11675,14.926,35.943,13964,4650,9314,8.371,25.138,6002,10.805,50.276,624,626,3095
1978,7112,2100,2197,55681,54920,474,21.763,436,20.018,14457,4233,10224,7.708,26.324,12877,6088,6789,11.085,23.447,1580,2.877,46.894,308,309,2980
1978,7113,1944,1989,22564,21777,438,22.795,303,15.769,7507,3382,4125,15.530,34.472,5830,2758,3072,12.665,26.771,1677,7.701,53.543,227,228,1413
1978,7114,822,838,9290,8538,241,30.838,128,16.379,3702,1682,2020,19.701,43.362,2274,1246,1028,14.594,26.635,1428,16.726,53.271,90,90,765
1978,7115,2569,2595,17101,15634,945,40.680,401,17.262,7321,3782,3539,24.191,46.827,4374,2186,2188,13.982,27.977,2947,18.850,55.955,254,254,1257
1978,7121,1650,1763,27708,26553,157,8.969,132,7.541,5115,910,4205,3.427,19.263,2751,558,2193,2.101,10.360,2364,8.903,20.721,78,79,291
1978,7131,1408,1486,50117,45209,260,17.669,231,15.698,13022,5375,7647,11.889,28.804,3368,1296,2072,2.867,7.450,9654,21.354,14.900,179,179,867
1978,7132,626,640,14763,13796,126,20.355,84,13.570,3733,1458,2275,10.569,27.060,1808,1013,795,7.343,13.106,1925,13.954,26.211,62,62,688
1978,7139,27463,28933,403352,381195,4115,14.551,2807,9.926,97101,34222,62879,8.978,25.473,52722,18184,34538,4.770,13.831,44379,11.642,27.661,2108,2116,11960
1978,7211,28903,32563,933310,891329,4892,15.068,4700,14.476,247472,111932,135540,12.558,27.764,163658,93605,70053,10.502,18.361,83814,9.403,36.722,3381,3419,50280
1978,7212,3247,3460,17332,15907,741,22.242,484,14.528,6162,2843,3319,17.873,38.738,3364,1410,1954,8.864,21.148,2798,17.590,42.296,323,324,933
1978,7213,5816,5877,29787,29441,402,6.713,625,10.437,5887,1160,4727,3.940,19.996,5072,2643,2429,8.977,17.228,815,2.768,34.456,458,458,1712
1978,7223,15827,24204,438309,414969,5138,21.781,3908,16.567,137064,80565,56499,19.415,33.030,91271,45918,45353,11.065,21.995,45793,11.035,43.989,2189,2202,16698
1978,7224,65009,65745,348205,337634,10286,15.470,11777,17.712,107774,51738,56036,15.324,31.920,86820,43977,42843,13.025,25.714,20954,6.206,51.429,9234,9242,34579
1978,7225,169171,208006,3388082,3189523,41099,20.118,33664,16.479,1045772,573083,472689,17.968,32.788,647206,351366,295840,11.016,20.292,398566,12.496,40.583,22791,23277,197657
1978,8111,81483,84627,404957,380619,15742,19.118,11171,13.567,118645,54410,64235,14.295,31.172,69651,34352,35299,9.025,18.299,48994,12.872,36.599,8514,8553,25943
1978,8112,10724,11737,62806,60619,1716,14.603,1744,14.841,14137,5456,8681,9.001,23.321,9776,5113,4663,8.435,16.127,4361,7.194,32.254,1382,1388,3304
1978,8113,15419,16336,121884,116105,2526,15.781,1867,11.664,30889,9863,21026,8.495,26.604,19239,9252,9987,7.969,16.570,11650,10.034,33.141,1420,1421,4260
1978,8114,21904,23481,139601,132971,4161,17.989,3461,14.963,33634,13063,20571,9.824,25.294,20246,10103,10143,7.598,15.226,13388,10.068,30.452,2589,2598,6835
1978,8121,82307,89241,400417,389628,13642,15.392,12416,14.009,102585,46241,56344,11.868,26.329,80550,41921,38629,10.759,20.674,22035,5.655,41.347,9609,9702,30540
1978,8122,17114,19355,107131,105719,1681,8.804,1157,6.060,17808,5943,11865,5.622,16.845,15049,4110,10939,3.888,14.235,2759,2.610,28.470,731,749,2186
1978,8123,33769,39176,331330,328475,4285,10.835,5028,12.714,62355,20869,41486,6.353,18.983,56650,25729,30921,7.833,17.246,5705,1.737,34.493,3644,3749,17500
1978,8129,10054,15547,155241,151637,3491,23.259,2416,16.096,48305,22424,25881,14.788,31.856,40038,17236,22802,11.367,26.404,8267,5.452,52.808,1071,1110,5495
1978,8131,67328,67485,586207,545807,4988,7.552,2117,3.205,122133,14559,107574,2.667,22.377,41468,8219,33249,1.506,7.598,80665,14.779,15.195,1142,1142,3198
1978,8132,6453,7120,106841,99173,1054,15.355,542,7.896,34328,9760,24568,9.841,34.614,18646,4687,13959,4.726,18.801,15682,15.813,37.603,310,314,2193
1978,8133,6028,6971,97295,89563,1259,18.852,674,10.092,32437,10197,22240,11.385,36.217,17204,5572,11632,6.221,19.209,15233,17.008,38.418,325,337,2368
1978,8134,26642,27732,232687,219067,2127,7.760,1480,5.400,52458,9291,43167,4.241,23.946,25015,4854,20161,2.216,11.419,27443,12.527,22.838,935,935,2837
1978,8139,52406,54341,415413,395575,5400,10.123,3405,6.383,97178,21749,75429,5.498,24.566,57893,14660,43233,3.706,14.635,39285,9.931,29.270,2145,2156,8089
1979,2111,5577,7347,127400,123146,1026,14.276,706,9.823,24902,7397,17505,6.007,20.222,16449,6948,9501,5.642,13.357,8453,6.864,26.715,343,347,2111
1979,2121,3105,3824,238253,211438,826,21.527,852,22.205,87626,16243,71383,7.682,41.443,34294,19247,15047,9.103,16.219,53332,25.223,32.439,556,558,6054
1979,2122,447,629,79781,78444,94,14.780,108,16.981,11784,2622,9162,3.343,15.022,9047,2916,6131,3.717,11.533,2737,3.489,23.066,64,64,331
1979,2123,3644,5111,116408,111666,530,10.355,545,10.648,23147,7005,16142,6.273,20.729,13686,5895,7791,5.279,12.256,9461,8.473,24.512,233,238,1727
1979,2131,7374,8548,248781,235326,1699,20.554,1135,13.731,72496,23794,48702,10.111,30.807,45003,20735,24268,8.811,19.124,27493,11.683,38.247,659,664,8873
1979,2211,1439,5408,514566,504667,254,4.719,202,3.753,47793,17330,30463,3.434,9.470,28435,4873,23562,0.966,5.634,19358,3.836,11.269,12,12,122
1979,2212,500,2261,130415,129814,115,5.151,58,2.598,8409,2847,5562,2.193,6.478,7333,1868,5465,1.439,5.649,1076,0.829,11.298,7,7,152
1979,2213,3616,3919,30096,29175,419,11.196,66,1.764,4487,1580,2907,5.416,15.380,2699,955,1744,3.273,9.251,1788,6.129,18.502,21,21,50
1979,2361,107512,107863,633297,605655,26542,25.392,19878,19.016,238603,106484,132119,17.582,39.396,183527,79730,103797,13.164,30.302,55076,9.094,60.604,15528,15528,61143
1979,2362,36054,36618,690422,648468,6313,17.721,4326,12.143,208925,40921,168004,6.310,32.218,125335,30617,94718,4.721,19.328,83590,12.890,38.656,3255,3255,21935
1979,2371,13845,14221,422520,416189,1660,11.776,1411,10.010,96687,14886,81801,3.577,23.232,83271,19835,63436,4.766,20.008,13416,3.224,40.016,1072,1073,11282
1979,2372,6987,7142,66408,62361,2095,30.941,1353,19.982,25698,12871,12827,20.640,41.208,17722,8445,9277,13.542,28.418,7976,12.790,56.837,985,987,4230
1979,2373,10934,11252,241232,231750,1139,10.187,996,8.908,60934,9981,50953,4.307,26.293,42074,9754,32320,4.209,18.155,18860,8.138,36.310,719,721,6706
1979,2379,4432,4463,72489,65252,855,19.583,661,15.140,28822,5189,23633,7.952,44.171,14351,3654,10697,5.600,21.993,14471,22.177,43.987,487,488,2025
1979,2381,68251,68648,586023,554692,12281,18.295,9240,13.765,190365,56376,133989,10.163,34.319,127704,46229,81475,8.334,23.023,62661,11.297,46.045,7172,7173,34801
1979,2382,95610,97290,989843,939151,13774,14.446,9884,10.367,250631,59470,191161,6.332,26.687,149133,48821,100312,5.198,15.880,101498,10.807,31.759,7733,7745,33935
1979,2383,72192,72586,556678,530469,13640,19.087,11392,15.941,179182,54521,124661,10.278,33.778,126489,46377,80112,8.743,23.845,52693,9.933,47.690,8976,8980,36421
1979,2389,32561,32694,293208,276503,6124,19.282,4258,13.406,95008,29177,65831,10.552,34.361,61782,20117,41665,7.276,22.344,33226,12.017,44.688,3227,3228,13720
1979,3111,2010,2693,68548,67792,197,7.177,301,10.965,11458,3694,7764,5.449,16.902,9944,3470,6474,5.119,14.669,1514,2.233,29.337,174,176,1363
1979,3112,505,851,79788,79388,51,5.920,72,8.358,7478,2369,5109,2.984,9.420,6658,2876,3782,3.623,8.387,820,1.033,16.773,28,28,399
1979,3113,1159,1483,90573,92676,180,11.869,247,16.288,10221,3688,6533,3.979,11.029,14428,5877,8551,6.341,15.568,-4207,-4.539,22.057,80,84,741
1979,3114,1263,1775,189403,190019,93,5.101,189,10.368,23651,3630,20021,1.910,12.447,24708,8995,15713,4.734,13.003,-1057,-0.556,24.893,84,84,1278
1979,3115,2090,2824,141633,146371,153,5.199,391,13.286,16790,5843,10947,3.992,11.471,26536,15595,10941,10.654,18.129,-9746,-6.658,22.942,174,176,1934
1979,3116,4469,5089,327739,326158,372,7.126,635,12.164,43323,13216,30107,4.052,13.283,40451,18259,22192,5.598,12.402,2872,0.881,24.805,369,371,4697
1979,3117,746,874,49624,49011,55,6.232,72,8.159,9445,2811,6634,5.736,19.271,8215,2329,5886,4.752,16.762,1230,2.510,33.523,35,35,826
1979,3118,7948,9444,309282,308837,1129,11.924,1177,12.431,45117,17170,27947,5.560,14.609,43983,24108,19875,7.806,14.242,1134,0.367,28.483,746,762,7374
1979,3119,1912,2278,114332,114023,159,6.793,284,12.134,17191,5727,11464,5.023,15.077,16876,7907,8969,6.935,14.801,315,0.276,29.601,156,156,2169
1979,3121,2220,2820,187758,185634,199,6.943,291,10.154,23934,6530,17404,3.518,12.893,19607,8607,11000,4.637,10.562,4327,2.331,21.124,154,155,2309
1979,3122,128,194,47875,47871,10,5.000,22,11.000,2977,341,2636,0.712,6.219,2945,560,2385,1.170,6.152,32,0.067,12.304,10,10,92
1979,3131,454,711,126995,129124,49,6.796,69,9.570,10837,4329,6508,3.353,8.393,14883,6614,8269,5.122,11.526,-4046,-3.133,16.785,30,30,1482
1979,3132,1778,2221,367414,368909,154,6.802,240,10.601,28523,7170,21353,1.944,7.732,30960,11225,19735,3.043,8.392,-2437,-0.661,15.463,132,135,2937
1979,3133,1563,1808,130576,131371,164,9.121,144,8.009,12237,3389,8848,2.580,9.315,13780,4479,9301,3.409,10.489,-1543,-1.175,18.630,77,78,1671
1979,3141,4432,4741,136156,136945,591,12.436,614,12.920,17437,5468,11969,3.993,12.733,19146,5807,13339,4.240,13.981,-1709,-1.248,25.466,434,434,2828
1979,3149,3340,3490,144520,144368,453,13.075,402,11.603,24119,8505,15614,5.891,16.707,23739,8848,14891,6.129,16.443,380,0.263,32.887,260,260,4434
1979,3151,1386,1526,140061,139282,144,9.366,167,10.862,19671,6149,13522,4.415,14.123,18123,5950,12173,4.272,13.012,1548,1.111,26.023,116,116,2551
1979,3152,13135,14982,980069,987330,1865,12.326,2162,14.289,143423,56171,87252,5.689,14.526,158276,65767,92509,6.661,16.031,-14853,-1.504,29.053,1484,1498,32074
1979,3159,1676,1797,84426,83407,179,9.898,202,11.169,12158,2423,9735,2.905,14.577,10217,3644,6573,4.369,12.250,1941,2.327,24.499,130,130,1168
1979,3161,378,423,22897,23549,24,5.393,68,15.281,2252,544,1708,2.310,9.563,3577,680,2897,2.888,15.190,-1325,-5.627,19.126,45,45,375
1979,3162,519,783,154447,154979,57,7.192,76,9.590,17281,4955,12326,3.197,11.151,18530,6999,11531,4.516,11.956,-1249,-0.806,22.301,38,39,2335
1979,3169,1348,1411,69067,69334,134,9.338,182,12.683,9609,2039,7570,2.941,13.859,10144,2431,7713,3.506,14.631,-535,-0.772,27.718,109,109,1408
1979,3211,5645,6225,171350,168862,770,12.347,793,12.715,27889,8484,19405,5.024,16.516,22500,9066,13434,5.369,13.325,5389,3.191,26.649,492,502,4041
1979,3212,1021,1307,99518,97812,163,12.577,141,10.880,12669,4613,8056,4.716,12.952,9314,3843,5471,3.929,9.522,3355,3.430,19.045,82,82,1084
1979,3219,8086,8884,312809,311024,1127,12.701,1105,12.454,52703,18468,34235,5.938,16.945,48860,18352,30508,5.901,15.709,3843,1.236,31.419,674,674,8194
1979,3221,371,747,215813,215671,46,6.097,61,8.085,13273,6039,7234,2.800,6.154,13230,3860,9370,1.790,6.134,43,0.020,12.269,34,34,337
1979,3222,3383,4945,407721,404925,309,6.196,393,7.880,44929,13643,31286,3.369,11.096,38955,15415,23540,3.807,9.620,5974,1.475,19.241,177,179,3877
1979,3231,29092,30429,628628,615756,3047,9.938,3508,11.442,94352,26694,67658,4.335,15.323,68313,33114,35199,5.378,11.094,26039,4.229,22.188,2167,2183,13377
1979,3241,1441,2349,580081,578158,234,10.036,199,8.535,36009,4440,31569,0.768,6.228,32259,4154,28105,0.718,5.580,3750,0.649,11.159,73,73,850
1979,3251,997,2051,269219,267633,173,8.427,177,8.622,19405,4260,15145,1.592,7.251,16168,5161,11007,1.928,6.041,3237,1.209,12.082,47,48,369
1979,3252,378,601,162945,161723,53,8.746,63,10.396,11094,4829,6265,2.986,6.860,8548,2452,6096,1.516,5.286,2546,1.574,10.571,26,26,138
1979,3253,737,1108,53195,55141,84,7.407,136,11.993,5691,1422,4269,2.579,10.321,9671,4105,5566,7.445,17.539,-3980,-7.218,20.642,37,37,215
1979,3254,852,1071,157411,154112,118,10.967,128,11.896,18217,6562,11655,4.258,11.821,11348,4450,6898,2.888,7.363,6869,4.457,14.727,59,59,1133
1979,3255,1637,2091,81170,78969,168,8.079,145,6.973,11787,3924,7863,4.969,14.926,7233,2498,4735,3.163,9.159,4554,5.767,18.319,70,70,363
1979,3256,1966,2225,119330,116871,195,8.672,242,10.763,16250,3855,12395,3.299,13.904,11352,3866,7486,3.308,9.713,4898,4.191,19.427,129,129,803
1979,3259,1488,1949,123707,121234,190,9.630,238,12.063,13402,4411,8991,3.638,11.055,8301,3866,4435,3.189,6.847,5101,4.208,13.694,114,115,1239
1979,3261,9003,10403,543426,528761,1198,11.663,936,9.112,97242,26273,70969,4.969,18.391,67564,28120,39444,5.318,12.778,29678,5.613,25.556,514,521,8006
1979,3262,1731,2108,240338,236324,199,9.547,152,7.292,23974,5056,18918,2.139,10.145,16278,4979,11299,2.107,6.888,7696,3.257,13.776,83,83,1218
1979,3271,1237,1540,99140,98284,193,12.400,226,14.520,12590,4177,8413,4.250,12.810,11140,3774,7366,3.840,11.335,1450,1.475,22.669,153,153,1393
1979,3272,1306,1580,180812,182729,190,12.090,173,11.009,14113,2857,11256,1.564,7.723,17680,5495,12185,3.007,9.676,-3567,-1.952,15.447,109,110,1292
1979,3273,7404,9259,200276,192933,770,8.263,890,9.550,42848,12350,30498,6.401,22.209,28230,12103,16127,6.273,14.632,14618,7.577,29.264,472,518,4282
1979,3274,258,357,17823,17335,44,12.325,44,12.325,2040,769,1271,4.436,11.768,1079,413,666,2.383,6.225,961,5.544,12.449,32,32,112
1979,3279,1972,2287,95598,93144,213,9.159,290,12.470,14512,4137,10375,4.442,15.580,9607,4046,5561,4.344,10.314,4905,5.266,20.628,166,167,1029
1979,3311,172,183,13142,13501,37,19.629,48,25.464,2890,1129,1761,8.363,21.407,3673,3182,491,23.569,27.206,-783,-5.800,42.813,24,24,343
1979,3312,498,663,81844,79860,50,7.582,43,6.520,8966,2409,6557,3.017,11.227,5087,1777,3310,2.225,6.370,3879,4.857,12.740,17,17,404
1979,3313,437,735,165349,161865,39,5.303,40,5.438,18149,3297,14852,2.037,11.212,11526,6107,5419,3.773,7.121,6623,4.092,14.242,8,9,294
1979,3314,665,833,107717,103850,75,8.731,127,14.785,15960,4040,11920,3.890,15.368,8166,4360,3806,4.198,7.863,7794,7.505,15.727,59,59,524
1979,3315,2785,3134,339263,326625,187,5.950,205,6.522,46671,13914,32757,4.260,14.289,21299,9224,12075,2.824,6.521,25372,7.768,13.042,109,109,1944
1979,3321,2752,2959,163751,159309,202,6.780,243,8.156,22475,5184,17291,3.254,14.108,13493,6203,7290,3.894,8.470,8982,5.638,16.939,115,115,1982
1979,3322,1105,1211,96639,95753,99,8.138,110,9.042,11772,2635,9137,2.752,12.294,9853,4407,5446,4.602,10.290,1919,2.004,20.580,53,55,953
1979,3323,9165,9959,374187,364358,851,8.519,912,9.130,63167,14499,48668,3.979,17.337,43542,14776,28766,4.055,11.950,19625,5.386,23.901,526,527,5433
1979,3324,1323,1720,160076,159466,112,6.470,134,7.741,17787,4539,13248,2.846,11.154,16545,6750,9795,4.233,10.375,1242,0.779,20.751,53,53,1208
1979,3325,826,901,95955,94159,71,7.751,101,11.026,9079,1630,7449,1.731,9.642,5598,1879,3719,1.996,5.945,3481,3.697,11.891,47,47,429
1979,3326,1503,1695,75752,72458,143,8.514,112,6.669,11930,2669,9261,3.684,16.465,5342,1682,3660,2.321,7.373,6588,9.092,14.745,53,53,412
1979,3327,18372,18672,346328,326628,2309,12.554,1749,9.510,71288,16853,54435,5.160,21.825,31763,15347,16416,4.699,9.725,39525,12.101,19.449,1058,1061,6535
1979,3328,5160,5434,128545,124546,427,7.809,495,9.053,22020,3847,18173,3.089,17.680,14175,5819,8356,4.672,11.381,7845,6.299,22.763,305,306,3103
1979,3329,4246,4758,401512,390114,488,10.182,558,11.642,53985,11060,42925,2.835,13.838,30954,14460,16494,3.707,7.935,23031,5.904,15.869,270,271,3070
1979,3331,2735,3145,408905,393488,338,10.671,383,12.092,66459,17851,48608,4.537,16.890,35844,21783,14061,5.536,9.109,30615,7.780,18.219,177,177,2170
1979,3332,3333,3580,189483,186307,253,6.975,348,9.593,22375,4531,17844,2.432,12.010,15949,6784,9165,3.641,8.561,6426,3.449,17.121,181,181,1711
1979,3333,1982,2092,162468,155728,181,8.638,188,8.972,26529,8454,18075,5.429,17.036,12867,4938,7929,3.171,8.263,13662,8.773,16.525,96,96,879
1979,3334,1599,1834,198154,192395,227,12.387,224,12.224,27787,5600,22187,2.911,14.443,16612,5356,11256,2.784,8.634,11175,5.808,17.269,130,130,1138
1979,3335,9406,9817,309777,296571,826,8.451,739,7.561,49344,12439,36905,4.194,16.638,22985,11632,11353,3.922,7.750,26359,8.888,15.501,398,399,3341
1979,3336,632,766,198417,191726,57,7.407,64,8.317,26452,7975,18477,4.160,13.797,12651,6499,6152,3.390,6.598,13801,7.198,13.197,22,22,207
1979,3339,5590,6097,395406,380133,506,8.292,517,8.472,61806,17702,44104,4.657,16.259,31772,13551,18221,3.565,8.358,30034,7.901,16.716,254,254,3501
1979,3341,857,1006,269901,251077,183,18.769,121,12.410,56442,13143,43299,5.235,22.480,18504,9015,9489,3.591,7.370,37938,15.110,14.740,67,67,2390
1979,3342,1468,1624,278631,268905,160,9.741,197,11.994,38588,8398,30190,3.123,14.350,19530,6873,12657,2.556,7.263,19058,7.087,14.526,95,95,2188
1979,3343,452,478,62915,64171,64,13.008,92,18.699,6896,1693,5203,2.638,10.746,9298,3276,6022,5.105,14.489,-2402,-3.743,21.493,61,61,332
1979,3344,3127,3532,417507,390789,518,14.883,415,11.924,80843,25469,55374,6.517,20.687,27591,13545,14046,3.466,7.060,53252,13.627,14.121,208,210,3347
1979,3345,3282,3749,547827,531370,395,10.556,381,10.182,72953,18994,53959,3.575,13.729,39960,16588,23372,3.122,7.520,32993,6.209,15.040,183,183,2792
1979,3346,574,601,25083,26016,84,13.748,104,17.021,4066,1170,2896,4.497,15.629,5932,2345,3587,9.014,22.801,-1866,-7.173,31.258,73,73,1227
1979,3351,1142,1258,92614,91148,108,8.444,150,11.728,13075,3089,9986,3.389,14.345,10247,4834,5413,5.303,11.242,2828,3.103,22.484,86,86,1433
1979,3352,346,451,143329,144390,46,10.166,49,10.829,13292,5474,7818,3.791,9.206,15165,3356,11809,2.324,10.503,-1873,-1.297,18.411,19,19,117
1979,3353,1788,2234,300751,289465,231,10.391,209,9.402,45544,19960,25584,6.895,15.734,22211,6605,15606,2.282,7.673,23333,8.061,15.346,99,101,1367
1979,3359,1474,1774,188188,178593,198,11.190,189,10.681,37304,16248,21056,9.098,20.888,18126,10155,7971,5.686,10.149,19178,10.738,20.299,93,93,2315
1979,3361,159,215,325962,315171,38,18.182,26,12.440,32978,337,32641,0.107,10.464,10748,232,10516,0.074,3.410,22230,7.053,6.820,19,19,156
1979,3362,1842,2081,164540,163534,237,11.270,281,13.362,25291,5815,19476,3.556,15.465,23178,8397,14781,5.135,14.173,2113,1.292,28.346,173,173,2010
1979,3363,3333,4069,808599,780734,435,10.543,549,13.306,92649,21708,70941,2.780,11.867,37024,12916,24108,1.654,4.742,55625,7.125,9.484,326,327,3138
1979,3364,982,1172,607298,570039,98,8.333,106,9.014,85683,6430,79253,1.128,15.031,10495,5408,5087,0.949,1.841,75188,13.190,3.682,44,44,894
1979,3365,144,191,65800,63287,9,4.569,21,10.660,8810,542,8268,0.856,13.921,3436,1896,1540,2.996,5.429,5374,8.492,10.859,5,5,74
1979,3366,1083,1184,204116,202426,167,14.440,112,9.684,28754,5304,23450,2.620,14.205,25763,5059,20704,2.499,12.727,2991,1.478,25.454,74,74,2286
1979,3369,419,433,33741,34371,58,13.122,76,17.195,3424,660,2764,1.920,9.962,4644,1405,3239,4.088,13.512,-1220,-3.550,19.924,50,50,528
1979,3371,11494,12067,395195,392833,1525,12.607,1583,13.087,57883,19245,38638,4.899,14.735,53348,22445,30903,5.714,13.580,4535,1.154,27.161,1079,1082,9585
1979,3372,2131,2241,121685,116548,243,10.824,251,11.180,20643,4185,16458,3.591,17.712,10619,4150,6469,3.561,9.111,10024,8.601,18.223,148,148,1872
1979,3379,1066,1206,40787,39582,98,8.116,101,8.364,6406,2012,4394,5.083,16.184,3866,1393,2473,3.519,9.767,2540,6.417,19.534,51,51,439
1979,3391,8477,9003,201493,197289,1181,13.252,999,11.210,34902,11134,23768,5.643,17.691,26557,11164,15393,5.659,13.461,8345,4.230,26.922,694,697,4613
1979,3399,13859,14498,469840,469720,1665,11.310,2111,14.340,73530,20666,52864,4.400,15.654,72710,29989,42721,6.384,15.479,820,0.175,30.959,1357,1360,11257
1979,4231,23169,29135,345765,333842,2857,9.862,2524,8.713,63673,22390,41283,6.707,19.073,39974,17800,22174,5.332,11.974,23699,7.099,23.948,1617,1651,8391
1979,4232,6957,8191,96937,93854,1027,12.743,764,9.479,20037,8057,11980,8.585,21.349,14112,4505,9607,4.800,15.036,5925,6.313,30.072,519,522,2407
1979,4233,7068,8858,115999,112501,1149,13.219,817,9.399,22810,7624,15186,6.777,20.275,15644,6088,9556,5.412,13.906,7166,6.370,27.811,530,536,3127
1979,4234,16312,22201,392805,380386,3272,15.044,2368,10.888,79385,33616,45769,8.837,20.870,54246,26478,27768,6.961,14.261,25139,6.609,28.522,1186,1223,5821
1979,4235,5709,8169,136067,131371,898,11.109,727,8.994,24472,6834,17638,5.202,18.628,15021,7025,7996,5.347,11.434,9451,7.194,22.868,316,319,1996
1979,4236,12323,17673,224538,215095,2477,14.335,1690,9.780,48102,18697,29405,8.692,22.363,29467,13386,16081,6.223,13.700,18635,8.664,27.399,909,939,4277
1979,4237,10040,13091,151254,146406,1321,10.256,900,6.987,25627,7610,18017,5.198,17.504,16083,5883,10200,4.018,10.985,9544,6.519,21.970,517,530,2472
1979,4238,43261,56259,667039,638329,5939,10.723,4195,7.574,130865,43237,87628,6.773,20.501,73102,30611,42491,4.795,11.452,57763,9.049,22.904,2474,2525,13589
1979,4239,18994,20670,219036,213174,2947,14.487,2292,11.267,48189,14963,33226,7.019,22.606,36751,12852,23899,6.029,17.240,11438,5.366,34.480,1645,1650,8038
1979,4241,6335,8790,125905,123294,905,10.416,702,8.080,20330,5792,14538,4.698,16.489,14909,6579,8330,5.336,12.092,5421,4.397,24.184,349,357,1856
1979,4242,2462,3178,88585,86449,421,13.374,361,11.468,15151,5836,9315,6.751,17.526,10621,5009,5612,5.794,12.286,4530,5.240,24.572,220,222,1710
1979,4243,9866,10837,115622,113132,1551,14.548,1199,11.247,27604,10197,17407,9.013,24.400,22377,7165,15212,6.333,19.780,5227,4.620,39.559,835,844,3836
1979,4244,26012,31727,537141,536073,3268,10.263,3502,10.997,94462,31760,62702,5.925,17.621,92794,43027,49767,8.026,17.310,1668,0.311,34.620,2255,2285,15009
1979,4245,8938,12067,111112,110823,809,6.684,882,7.287,19196,5865,13331,5.292,17.321,18541,5907,12634,5.330,16.730,655,0.591,33.461,526,541,3531
1979,4246,5430,8118,102143,98092,1070,13.481,708,8.920,21886,7427,14459,7.571,22.312,13936,5672,8264,5.782,14.207,7950,8.105,28.414,346,357,1766
1979,4247,12142,16095,153712,153592,1221,7.507,1560,9.591,29845,8784,21061,5.719,19.431,29525,12017,17508,7.824,19.223,320,0.208,38.446,784,809,3562
1979,4248,4788,5839,123425,121860,336,5.670,509,8.590,17505,3946,13559,3.238,14.365,14341,6138,8203,5.037,11.768,3164,2.596,23.537,332,340,2949
1979,4249,18058,22006,236499,232543,2586,11.775,2498,11.374,45285,14693,30592,6.318,19.474,37205,16960,20245,7.293,15.999,8080,3.475,31.998,1600,1621,7163
1979,4251,25527,28193,280467,273448,3319,11.988,2303,8.319,54110,18726,35384,6.848,19.788,39886,15332,24554,5.607,14.586,14224,5.202,29.173,1388,1392,6974
1979,4411,41243,42331,919306,899219,3862,9.134,3759,8.891,126169,34542,91627,3.841,14.031,86009,31902,54107,3.548,9.565,40160,4.466,19.130,3046,3065,24716
1979,4412,12555,12983,87152,84900,1500,11.513,1592,12.219,20115,6016,14099,7.086,23.693,15646,6890,8756,8.115,18.429,4469,5.264,36.857,1297,1310,5321
1979,4413,40058,56441,388752,374360,5716,10.271,4138,7.435,77161,26770,50391,7.151,20.611,48420,18666,29754,4.986,12.934,28741,7.677,25.868,2546,2613,10632
1979,4421,24223,27969,226346,220828,3218,11.654,2508,9.082,42586,16020,26566,7.255,19.285,31709,12014,19695,5.440,14.359,10877,4.926,28.718,1857,1894,8175
1979,4422,18585,21038,118586,114579,3503,17.099,2400,11.715,29384,12876,16508,11.238,25.645,21376,8884,12492,7.754,18.656,8008,6.989,37.312,1791,1817,6285
1979,4431,24975,31763,186443,181823,4341,13.740,4002,12.667,41927,18780,23147,10.329,23.059,32752,14686,18066,8.077,18.013,9175,5.046,36.026,2670,2750,9269
1979,4441,54781,68441,655146,632998,6819,10.099,4984,7.381,122864,46262,76602,7.308,19.410,78762,27903,50859,4.408,12.443,44102,6.967,24.885,3341,3378,14948
1979,4442,13685,16559,119103,115429,1770,10.782,1485,9.046,24702,7786,16916,6.745,21.400,17238,6223,11015,5.391,14.934,7464,6.466,29.868,994,1011,3910
1979,4451,65608,103298,1653163,1610153,12676,12.292,12335,11.961,304820,136535,168285,8.480,18.931,217707,107326,110381,6.666,13.521,87113,5.410,27.042,7054,7175,37124
1979,4452,23426,28505,176697,174006,4392,15.292,4822,16.790,46537,20481,26056,11.770,26.744,41129,20631,20498,11.856,23.637,5408,3.108,47.273,3045,3154,12340
1979,4453,28891,34171,182136,178154,3658,10.747,3389,9.957,40589,12360,28229,6.938,22.783,32920,11072,21848,6.215,18.478,7669,4.305,36.957,2558,2584,8032
1979,4461,39781,55039,514943,501200,6474,12.067,3694,6.885,96220,40634,55586,8.107,19.198,68573,29378,39195,5.862,13.682,27647,5.516,27.364,2193,2227,10867
1979,4471,118373,148063,851948,859839,18064,11.955,24138,15.975,199317,83296,116021,9.687,23.181,214545,98116,116429,11.411,24.952,-15228,-1.771,46.361,16060,16289,60083
1979,4481,60954,93643,772837,762972,12861,14.000,9301,10.125,162251,74969,87282,9.826,21.266,143293,51597,91696,6.763,18.781,18958,2.485,37.562,5873,6068,23142
1979,4482,11949,30891,174058,165308,4363,14.547,2564,8.549,44035,19275,24760,11.660,26.638,26825,10955,15870,6.627,16.227,17210,10.411,32.455,989,1036,3855
1979,4483,16829,23455,136652,132274,3084,13.473,1954,8.536,29576,12395,17181,9.371,22.360,20533,8138,12395,6.152,15.523,9043,6.837,31.046,1295,1337,5304
1979,4511,31732,39000,231368,225555,6227,16.201,5100,13.269,56792,24674,32118,10.939,25.179,45161,20463,24698,9.072,20.022,11631,5.157,40.044,3442,3645,11083
1979,4512,7295,9988,64347,61804,1736,17.962,1090,11.278,15688,6763,8925,10.943,25.383,10639,4075,6564,6.593,17.214,5049,8.169,34.428,804,819,2659
1979,4521,682,9085,1552084,1545785,846,9.468,546,6.111,174128,82323,91805,5.326,11.265,158775,40186,118589,2.600,10.271,15353,0.993,20.543,27,40,1322
1979,4529,15441,27983,388842,387894,2714,9.585,3379,11.933,58696,26881,31815,6.930,15.132,57435,23893,33542,6.160,14.807,1261,0.325,29.614,1662,1722,6796
1979,4531,19485,20623,101172,99387,3028,15.085,1928,9.605,21957,8862,13095,8.917,22.093,18484,6012,12472,6.049,18.598,3473,3.494,37.196,1459,1475,4452
1979,4532,21391,25136,147822,141206,4697,19.290,3123,12.826,40535,19413,21122,13.748,28.706,27098,12690,14408,8.987,19.190,13437,9.516,38.381,2199,2230,7110
1979,4533,8274,9648,44975,44085,1633,17.383,1125,11.976,10808,5112,5696,11.596,24.517,9083,3760,5323,8.529,20.604,1725,3.913,41.207,872,873,2428
1979,4539,25092,29687,135480,130958,5019,17.213,3963,13.591,37512,16032,21480,12.242,28.644,28404,12777,15627,9.757,21.689,9108,6.955,43.379,2831,2891,8864
1979,4541,5184,6934,97475,93048,1028,15.214,674,9.975,20910,8535,12375,9.173,22.472,11618,3987,7631,4.285,12.486,9292,9.986,24.972,475,477,1958
1979,4542,4456,5620,82135,78710,635,11.370,565,10.116,15698,4626,11072,5.877,19.944,8954,3613,5341,4.590,11.376,6744,8.568,22.752,390,395,1434
1979,4543,17393,22914,198941,194465,2266,9.896,2234,9.756,38063,11968,26095,6.154,19.573,29280,11858,17422,6.098,15.057,8783,4.517,30.113,1579,1605,6727
1979,4811,1003,2346,255163,240994,366,16.542,99,4.475,34533,7686,26847,3.189,14.329,6336,1615,4721,0.670,2.629,28197,11.700,5.258,9,9,33
1979,4812,388,545,7975,6892,155,32.292,25,5.208,2601,846,1755,12.276,37.742,423,98,325,1.422,6.138,2178,31.604,12.276,8,8,21
1979,4831,438,685,36690,36225,98,14.715,60,9.009,9467,3848,5619,10.623,26.134,8455,2266,6189,6.255,23.341,1012,2.794,46.681,5,5,23
1979,4832,422,491,15741,14881,59,12.567,16,3.408,3385,1186,2199,7.970,22.747,1606,599,1007,4.025,10.792,1779,11.955,21.585,(D),(D),(D)
1979,4841,20084,24723,531664,510536,4954,20.554,3713,15.405,113841,41422,72419,8.113,22.298,71112,39309,31803,7.700,13.929,42729,8.369,27.858,2586,2588,11016
1979,4842,41001,44515,590336,566447,7911,18.207,5781,13.305,134685,44841,89844,7.916,23.777,86937,31672,55265,5.591,15.348,47748,8.429,30.696,4323,4334,16415
1979,4851,421,470,24119,23308,35,7.431,37,7.856,2975,685,2290,2.939,12.764,1323,385,938,1.652,5.676,1652,7.088,11.352,26,26,212
1979,4852,296,560,32111,34108,20,3.155,168,26.498,3174,315,2859,0.924,9.306,7624,5631,1993,16.510,22.353,-4450,-13.047,18.612,13,13,55
1979,4853,6353,6412,75170,74085,1074,18.022,169,2.836,15491,5213,10278,7.037,20.910,13202,1218,11984,1.644,17.820,2289,3.090,35.640,105,111,710
1979,4854,3759,3913,91323,87612,356,9.462,55,1.462,16799,4394,12405,5.015,19.174,9625,1806,7819,2.061,10.986,7174,8.188,21.972,27,27,180
1979,4855,430,452,7819,7294,67,15.438,31,7.143,1774,465,1309,6.376,24.323,735,184,551,2.523,10.077,1039,14.246,20.155,19,19,63
1979,4859,839,880,16526,15639,163,19.393,84,9.994,3549,1355,2194,8.665,22.694,1842,688,1154,4.399,11.779,1707,10.915,23.557,66,66,566
1979,4861,84,294,11103,11516,19,6.563,10,3.454,1190,200,990,1.737,10.333,2053,412,1641,3.578,17.827,-863,-7.494,20.667,0,0,0
1979,4862,224,1010,55165,53213,105,10.903,11,1.142,5838,3094,2744,5.814,10.971,2055,65,1990,0.122,3.862,3783,7.109,7.724,(D),(D),(D)
1979,4869,59,260,7183,6973,19,7.393,13,5.058,1021,120,901,1.721,14.643,599,290,309,4.159,8.591,422,6.052,17.182,0,0,0
1979,4871,163,168,1961,1980,39,25.325,11,7.143,715,354,361,17.883,36.120,796,163,633,8.234,40.212,-81,-4.092,72.240,9,9,145
1979,4872,666,676,8571,8602,129,20.000,67,10.388,2169,1137,1032,13.218,25.215,2202,491,1711,5.708,25.599,-33,-0.384,50.430,53,53,299
1979,4879,44,52,954,859,18,40.449,3,6.742,241,78,163,9.080,28.056,44,3,41,0.349,5.122,197,22.934,10.244,(D),(D),(D)
1979,4881,2062,2495,49560,47135,434,18.837,52,2.257,11332,4106,7226,8.711,24.042,6465,1843,4622,3.910,13.716,4867,10.326,27.432,21,21,113
1979,4882,259,339,12814,11965,57,18.124,8,2.544,3137,1161,1976,9.704,26.219,1521,264,1257,2.207,12.713,1616,13.507,25.425,(D),(D),(D)
1979,4883,2054,2471,126328,122855,360,15.427,85,3.643,34306,8828,25478,7.186,27.924,26395,3862,22533,3.144,21.485,7911,6.439,42.970,12,12,42
1979,4884,1818,2386,40851,40482,432,18.754,267,11.591,6908,2465,4443,6.089,17.065,6274,2161,4113,5.338,15.498,634,1.566,30.997,175,175,752
1979,4885,3763,5434,75123,72028,871,17.008,245,4.784,15165,4763,10402,6.613,21.054,9050,2934,6116,4.073,12.565,6115,8.490,25.129,63,81,1060
1979,4889,354,364,5971,6017,59,17.378,10,2.946,1511,677,834,11.252,25.114,1516,33,1483,0.548,25.197,-5,-0.083,50.229,6,6,16
1979,4921,1056,1503,99281,94519,381,27.137,183,13.034,14331,4510,9821,4.772,15.162,4987,1988,2999,2.103,5.276,9344,9.886,10.552,136,136,545
1979,4922,809,809,4679,4800,320,39.925,305,38.054,1461,869,592,18.104,30.438,1690,1044,646,21.750,35.208,-229,-4.771,60.875,268,268,965
1979,4931,6123,9290,397937,390306,1018,11.177,654,7.181,72670,27042,45628,6.928,18.619,57324,14404,42920,3.690,14.687,15346,3.932,29.374,229,229,1847
1979,5111,12645,14143,581851,570282,1752,12.412,1696,12.016,72953,23930,49023,4.196,12.792,49900,19738,30162,3.461,8.750,23053,4.042,17.500,1109,1111,8945
1979,5112,3326,4080,67304,62457,1322,36.115,483,13.195,24547,11829,12718,18.940,39.303,14628,8466,6162,13.555,23.421,9919,15.881,46.842,254,258,1695
1979,5121,8354,13711,189765,184899,2018,14.832,1808,13.288,54842,18051,36791,9.763,29.661,44561,15798,28763,8.544,24.100,10281,5.560,48.200,865,884,6120
1979,5122,1069,1075,9251,8612,309,31.386,128,13.002,2848,1575,1273,18.289,33.072,1577,494,1083,5.737,18.313,1271,14.759,36.625,88,88,283
1979,5151,5316,6242,177591,171416,640,10.695,124,2.072,28816,12182,16634,7.107,16.811,16346,3501,12845,2.042,9.536,12470,7.275,19.072,25,27,251
1979,5152,5,5,160,169,(D),(D),(D),(D),28,(D),23,(D),16.568,45,(D),1,(D),26.627,-17,-10.059,33.136,(D),(D),(D)
1979,5171,1523,12563,870306,859215,287,2.236,837,6.520,156189,3420,152769,0.398,18.178,134059,22054,112005,2.567,15.603,22130,2.576,31.205,64,64,487
1979,5172,502,1232,65798,63132,137,11.379,81,6.728,15432,882,14550,1.397,24.444,10165,1559,8606,2.469,16.101,5267,8.343,32.202,25,25,130
1979,5174,509,838,20994,19570,141,18.042,28,3.583,5882,2186,3696,11.170,30.056,2915,820,2095,4.190,14.895,2967,15.161,29.790,3,3,44
1979,5179,977,1936,59527,58096,255,13.669,114,6.111,12367,1406,10961,2.420,21.287,9540,2549,6991,4.388,16.421,2827,4.866,32.842,31,31,131
1979,5182,4830,6245,175322,168907,1108,18.165,817,13.395,42321,17885,24436,10.589,25.056,29425,17177,12248,10.170,17.421,12896,7.635,34.842,381,383,2846
1979,5191,2008,2390,28478,27947,243,10.321,172,7.305,3956,1120,2836,4.008,14.155,2893,878,2015,3.142,10.352,1063,3.804,20.703,112,112,439
1979,5211,20,52,23700,23586,(D),(D),0,0.000,803,(D),640,(D),3.405,630,0,630,0.000,2.671,173,0.733,5.342,0,0,0
1979,5221,21044,59725,1638777,1590729,3933,6.750,1017,1.745,188067,56627,131440,3.560,11.823,91741,16561,75180,1.041,5.767,96326,6.055,11.534,210,211,2350
1979,5222,23861,43821,331971,316397,5121,12.105,2086,4.931,67143,32046,35097,10.128,21.221,36207,14869,21338,4.699,11.444,30936,9.778,22.887,285,297,1532
1979,5223,2547,2826,33692,30508,662,25.516,199,7.670,9853,3362,6491,11.020,32.296,3539,1340,2199,4.392,11.600,6314,20.696,23.200,138,140,639
1979,5231,4211,7930,172555,163762,1347,18.132,345,4.644,35426,11190,24236,6.833,21.633,17884,7675,10209,4.687,10.921,17542,10.712,21.841,125,125,826
1979,5232,92,103,4489,4187,13,13.402,(D),(D),625,59,566,1.409,14.929,27,(D),26,(D),0.645,598,14.284,1.290,0,0,0
1979,5239,8849,9157,71997,67661,1762,20.842,356,4.211,20490,8184,12306,12.096,30.284,11910,3461,8449,5.115,17.603,8580,12.681,35.205,194,194,657
1979,5241,6275,29486,1169028,1134849,4948,17.782,1629,5.854,178168,73488,104680,6.476,15.700,111104,30139,80965,2.656,9.790,67064,5.910,19.580,100,120,2026
1979,5242,84603,88729,589322,555817,11053,13.186,1246,1.486,147825,43568,104257,7.839,26.596,79470,12163,67307,2.188,14.298,68355,12.298,28.596,645,652,2722
1979,5250,1376,1584,14061,13935,148,9.642,50,3.257,2507,822,1685,5.899,17.991,2242,566,1676,4.062,16.089,265,1.902,32.178,12,12,21
1979,5311,107365,109144,512072,482342,16058,15.753,1642,1.611,126141,56882,69259,11.793,26.152,66849,12970,53879,2.689,13.859,59292,12.293,27.719,869,890,3714
1979,5312,32735,33746,177518,164239,6823,22.209,774,2.519,52910,21487,31423,13.083,32.215,26499,3797,22702,2.312,16.134,26411,16.081,32.269,516,517,1599
1979,5313,19714,20291,173740,161988,4092,22.096,549,2.964,47288,17490,29798,10.797,29.192,23727,5179,18548,3.197,14.647,23561,14.545,29.295,339,340,2174
1979,5321,5567,9086,99387,88144,2174,25.589,994,11.700,34754,13284,21470,15.071,39.429,12816,6286,6530,7.132,14.540,21938,24.889,29.080,562,570,2774
1979,5322,7563,8850,76188,72304,1769,20.645,1206,14.075,21974,8343,13631,11.539,30.391,14305,6777,7528,9.373,19.785,7669,10.607,39.569,855,858,4267
1979,5323,1939,2118,18895,17694,406,20.169,196,9.737,5453,1922,3531,10.862,30.818,3030,1448,1582,8.184,17.124,2423,13.694,34.249,126,126,611
1979,5324,3536,3909,40010,36140,695,18.578,359,9.596,12985,4575,8410,12.659,35.930,5241,2199,3042,6.085,14.502,7744,21.428,29.004,246,246,989
1979,5331,902,962,10860,11226,181,19.814,84,9.195,3159,1382,1777,12.311,28.141,4003,2764,1239,24.623,35.660,-844,-7.519,56.283,7,9,84
1979,5411,100143,102896,516318,495109,13618,13.545,8897,8.850,106203,39472,66731,7.972,21.450,63569,25501,38068,5.151,12.839,42634,8.611,25.679,6423,6463,17596
1979,5412,41947,44734,320007,299044,8076,18.857,4262,9.952,78892,37153,41739,12.424,26.381,37253,19088,18165,6.383,12.457,41639,13.924,24.915,3015,3096,13213
1979,5413,39268,42748,556407,522125,7579,18.475,4129,10.065,137688,48486,89202,9.286,26.371,69219,26149,43070,5.008,13.257,68469,13.114,26.514,2916,2938,13977
1979,5414,9867,10065,72934,68485,2270,23.823,1197,12.562,21056,9792,11264,14.298,30.745,12221,5424,6797,7.920,17.845,8835,12.901,35.690,914,915,3246
1979,5415,2428,2943,28970,25680,1509,60.724,593,23.863,12819,7228,5591,28.146,49.918,6034,3971,2063,15.463,23.497,6785,26.421,46.994,503,503,2419
1979,5416,16544,17150,158257,154074,4315,26.236,2909,17.687,47641,18761,28880,12.177,30.921,39222,16012,23210,10.392,25.457,8419,5.464,50.913,2238,2246,9951
1979,5417,4364,5402,359969,355822,719,13.348,688,12.773,45435,11471,33964,3.224,12.769,36488,12972,23516,3.646,10.255,8947,2.514,20.509,410,416,2724
1979,5418,17481,19120,229698,220624,3216,17.264,2233,11.987,54486,20772,33714,9.415,24.696,36085,16109,19976,7.302,16.356,18401,8.340,32.712,1640,1653,9097
1979,5419,21868,23470,185254,178364,3670,16.221,1980,8.751,38521,14315,24206,8.026,21.597,24397,9056,15341,5.077,13.678,14124,7.919,27.356,1463,1482,6096
1979,5511,19894,36998,2510793,2442427,4730,13.064,3146,8.689,476592,169274,307318,6.931,19.513,338453,97085,241368,3.975,13.857,138139,5.656,27.714,302,308,3637
1979,5611,5018,5234,64254,60884,845,16.008,934,17.694,18210,5651,12559,9.282,29.909,11395,5189,6206,8.523,18.716,6815,11.193,37.432,691,695,2999
1979,5612,221,270,14543,14819,36,12.414,76,26.207,3362,870,2492,5.871,22.687,3939,2513,1426,16.958,26.581,-577,-3.894,45.374,38,40,475
1979,5613,8852,11632,543405,500983,2545,23.176,1243,11.320,186683,59161,127522,11.809,37.263,100555,23378,77177,4.666,20.072,86128,17.192,40.143,828,841,9718
1979,5614,15252,17192,186845,178166,3082,18.600,1838,11.092,46300,16533,29767,9.280,25.987,28628,12602,16026,7.073,16.068,17672,9.919,32.136,1355,1365,6847
1979,5615,14312,16589,126435,118251,2870,18.115,1378,8.698,32706,13585,19121,11.488,27.658,16209,7379,8830,6.240,13.707,16497,13.951,27.415,809,830,3442
1979,5616,9175,11061,332856,316633,2509,24.072,1233,11.830,86304,31095,55209,9.821,27.257,54831,18309,36522,5.782,17.317,31473,9.940,34.634,905,908,10319
1979,5617,43577,45873,613446,590747,10849,24.639,7165,16.273,177271,65535,111736,11.094,30.008,132566,54930,77636,9.298,22.440,44705,7.568,44.881,5490,5509,31319
1979,5619,9632,10301,134121,121646,2591,27.135,1086,11.374,46666,20803,25863,17.101,38.362,22234,9763,12471,8.026,18.278,24432,20.085,36.555,778,784,5544
1979,5621,4885,5004,97955,93067,776,15.793,595,12.109,18972,3649,15323,3.921,20.385,9466,3840,5626,4.126,10.171,9506,10.214,20.342,482,482,2563
1979,5622,1818,2185,34582,33036,314,15.325,42,2.050,7123,2639,4484,7.988,21.562,4044,1155,2889,3.496,12.241,3079,9.320,24.483,5,7,54
1979,5629,4109,4324,42818,40517,692,16.527,418,9.983,11525,2706,8819,6.679,28.445,6861,2339,4522,5.773,16.934,4664,11.511,33.867,318,318,1438
1979,6111,12215,12562,318844,312144,623,4.953,658,5.231,38056,5559,32497,1.781,12.192,24836,6100,18736,1.954,7.957,13220,4.235,15.913,467,478,3646
1979,6112,458,531,30692,30357,45,8.712,16,3.098,3891,700,3191,2.306,12.818,3217,175,3042,0.576,10.597,674,2.220,21.195,11,11,131
1979,6113,1924,2165,774539,738715,116,5.388,92,4.273,111266,4850,106416,0.657,15.062,38689,1911,36778,0.259,5.237,72577,9.825,10.475,59,59,1199
1979,6114,1596,1768,27035,26101,319,18.590,215,12.529,5992,2110,3882,8.084,22.957,4123,1688,2435,6.467,15.796,1869,7.161,31.593,158,159,1028
1979,6115,3483,3905,49951,47551,591,15.498,408,10.699,11503,4176,7327,8.782,24.191,6590,2870,3720,6.036,13.859,4913,10.332,27.718,296,303,1630
1979,6116,9430,9877,82380,79544,2162,22.691,1464,15.365,23795,9144,14651,11.496,29.914,17960,7199,10761,9.050,22.579,5835,7.336,45.157,1130,1142,5284
1979,6117,849,860,14794,14521,163,19.154,145,17.039,2828,681,2147,4.690,19.476,2245,1567,678,10.792,15.461,583,4.015,30.922,107,107,1238
1979,6211,145871,149923,822500,792521,15195,10.365,8551,5.833,150645,55821,94824,7.043,19.008,91194,30075,61119,3.795,11.507,59451,7.502,23.014,6438,6463,22106
1979,6212,83694,84931,346448,332545,6486,7.771,3556,4.260,65643,20136,45507,6.055,19.740,37990,11861,26129,3.567,11.424,27653,8.316,22.848,2693,2703,8827
1979,6213,29042,29988,90977,85591,4630,16.077,2251,7.816,24549,11038,13511,12.896,28.682,13533,6531,7002,7.630,15.811,11016,12.871,31.622,1618,1629,4573
1979,6214,4048,5000,74570,71191,800,16.548,469,9.701,16599,5598,11001,7.863,23.316,9852,3405,6447,4.783,13.839,6747,9.477,27.678,275,278,1560
1979,6215,3626,4594,58519,56921,657,14.531,512,11.324,13712,6148,7564,10.801,24.090,10525,4286,6239,7.530,18.491,3187,5.599,36.981,313,321,1978
1979,6216,2168,2765,77443,74226,552,21.145,243,9.309,19494,6903,12591,9.300,26.263,13073,3197,9876,4.307,17.613,6421,8.651,35.225,151,152,1462
1979,6219,2169,2423,45290,42653,433,18.855,180,7.838,12181,3966,8215,9.298,28.558,6925,2153,4772,5.048,16.236,5256,12.323,32.471,114,114,1027
1979,6221,3945,4796,2403344,2353474,177,3.674,220,4.567,191182,30516,160666,1.297,8.123,91148,41939,49209,1.782,3.873,100034,4.250,7.746,113,116,18459
1979,6222,304,362,41435,39885,35,9.763,28,7.810,6140,2042,4098,5.120,15.394,2935,1722,1213,4.317,7.359,3205,8.036,14.717,13,13,567
1979,6223,165,195,41305,40180,17,8.971,6,3.166,3229,310,2919,0.772,8.036,995,103,892,0.256,2.476,2234,5.560,4.953,5,5,102
1979,6231,6387,8287,649727,633084,621,7.527,547,6.630,101793,38636,63157,6.103,16.079,68604,31512,37092,4.978,10.836,33189,5.242,21.673,323,346,18169
1979,6232,3040,3665,81082,77137,606,17.461,217,6.253,16418,6941,9477,8.998,21.284,8609,3450,5159,4.473,11.161,7809,10.124,22.321,148,148,2407
1979,6233,8163,9416,364054,358401,1112,11.945,899,9.657,60516,24239,36277,6.763,16.885,49229,26161,23068,7.299,13.736,11287,3.149,27.471,605,637,16139
1979,6239,2331,2750,70688,68777,313,11.787,124,4.670,10233,2711,7522,3.942,14.879,6275,1770,4505,2.574,9.124,3958,5.755,18.247,88,89,1204
1979,6241,10123,14013,222784,214385,1859,13.779,816,6.048,49676,13943,35733,6.504,23.171,32952,6408,26544,2.989,15.370,16724,7.801,30.741,506,514,3106
1979,6242,2965,3513,37813,36168,530,15.880,179,5.363,7787,2824,4963,7.808,21.530,4403,986,3417,2.726,12.174,3384,9.356,24.348,113,114,560
1979,6243,3078,4524,202151,194769,719,16.538,366,8.419,48227,19964,28263,10.250,24.761,33658,6892,26766,3.539,17.281,14569,7.480,34.562,186,187,2240
1979,6244,23197,26847,232008,220502,4201,16.231,2271,8.774,57255,22280,34975,10.104,25.966,34239,12587,21652,5.708,15.528,23016,10.438,31.056,1655,1678,7794
1979,7111,4801,4850,58540,58777,889,18.417,843,17.464,17244,5542,11702,9.429,29.338,17971,6739,11232,11.465,30.575,-727,-1.237,58.677,631,632,4132
1979,7112,2062,2159,55023,54835,400,18.600,383,17.810,13607,3687,9920,6.724,24.815,13080,2609,10471,4.758,23.854,527,0.961,47.707,283,283,2128
1979,7113,2017,2063,23880,23235,424,21.037,329,16.323,8140,3211,4929,13.820,35.033,6918,2482,4436,10.682,29.774,1222,5.259,59.548,234,234,1974
1979,7114,887,901,26595,17905,238,27.658,157,18.245,20801,1449,19352,8.093,116.177,2895,1399,1496,7.814,16.169,17906,100.008,32.338,118,118,920
1979,7115,3756,3773,25381,21851,1545,47.656,483,14.898,12323,5543,6780,25.368,56.397,5289,1884,3405,8.622,24.205,7034,32.191,48.411,324,326,1105
1979,7121,1728,1817,29935,29036,137,7.573,121,6.689,4653,800,3853,2.755,16.025,2971,557,2414,1.918,10.232,1682,5.793,20.464,70,70,364
1979,7131,1413,1501,48701,49302,220,14.550,242,16.005,7728,4078,3650,8.272,15.675,9244,3491,5753,7.081,18.750,-1516,-3.075,31.350,198,199,1056
1979,7132,604,619,16376,15917,90,14.504,93,14.988,3161,897,2264,5.635,19.859,2208,1339,869,8.412,13.872,953,5.987,27.744,77,77,1247
1979,7139,28367,29877,428688,416913,3891,13.275,2758,9.410,88301,29635,58666,7.108,21.180,65023,20891,44132,5.011,15.596,23278,5.583,31.193,2049,2065,13988
1979,7211,29611,33277,987028,964778,4783,14.458,4393,13.279,217628,92988,124640,9.638,22.557,173187,80346,92841,8.328,17.951,44441,4.606,35.902,3145,3187,43582
1979,7212,3369,3579,18410,18092,535,15.022,500,14.039,5155,1813,3342,10.021,28.493,4521,1911,2610,10.563,24.989,634,3.504,49.978,327,328,1090
1979,7213,5741,5817,34772,34930,412,6.995,558,9.474,5162,1250,3912,3.579,14.778,5480,2266,3214,6.487,15.689,-318,-0.910,29.557,432,432,1892
1979,7223,16158,24676,465249,452562,4140,16.938,3673,15.027,120521,56402,64119,12.463,26.631,96224,46554,49670,10.287,21.262,24297,5.369,42.524,2040,2062,15985
1979,7224,66374,67051,357970,356008,10132,15.020,10941,16.220,101551,48683,52868,13.675,28.525,97712,45315,52397,12.729,27.447,3839,1.078,54.893,8382,8404,34023
1979,7225,173228,216271,3638254,3517408,40866,19.323,31304,14.802,994247,579007,415240,16.461,28.266,754550,326813,427737,9.291,21.452,239697,6.815,42.904,21708,22117,195160
1979,8111,86806,90085,443994,425647,16411,18.738,11402,13.019,120383,53566,66817,12.585,28.282,83489,38840,44649,9.125,19.615,36894,8.668,39.229,8690,8745,29062
1979,8112,10293,11325,63147,62333,1525,13.442,1565,13.795,12555,4962,7593,7.960,20.142,10953,4587,6366,7.359,17.572,1602,2.570,35.144,1224,1224,3202
1979,8113,16093,17075,134278,128269,2626,15.705,1917,11.465,32672,11629,21043,9.066,25.471,20565,8384,12181,6.536,16.033,12107,9.439,32.065,1412,1412,5176
1979,8114,22174,23764,148059,143477,3854,16.397,3335,14.189,33404,13926,19478,9.706,23.282,24064,10769,13295,7.506,16.772,9340,6.510,33.544,2523,2535,7708
1979,8121,83500,91086,412970,406839,13474,14.954,11502,12.766,96826,46794,50032,11.502,23.800,85376,36814,48562,9.049,20.985,11450,2.814,41.970,8935,9020,27421
1979,8122,17378,19692,109254,107834,1511,7.794,902,4.652,16990,5291,11699,4.907,15.756,14123,3139,10984,2.911,13.097,2867,2.659,26.194,571,589,1763
1979,8123,33877,39337,343711,340789,4085,10.335,4462,11.289,55674,19889,35785,5.836,16.337,49905,21111,28794,6.195,14.644,5769,1.693,29.288,3401,3490,15148
1979,8129,11191,16908,174342,165732,3527,21.776,2104,12.990,43330,20782,22548,12.540,26.145,26532,9901,16631,5.974,16.009,16798,10.136,32.018,1080,1121,4063
1979,8131,60158,60237,586781,569927,3304,5.631,171,0.291,82079,15357,66722,2.695,14.402,48562,2300,46262,0.404,8.521,33517,5.881,17.041,5,5,484
1979,8132,6486,7213,106944,105783,776,11.037,412,5.860,20837,5495,15342,5.195,19.698,18284,3473,14811,3.283,17.284,2553,2.413,34.569,263,263,2264
1979,8133,6325,7319,100179,97962,952,13.263,670,9.334,23995,8064,15931,8.232,24.494,19655,5697,13958,5.816,20.064,4340,4.430,40.128,404,409,3251
1979,8134,27912,29096,235044,231750,2782,9.790,1423,5.008,37778,7767,30011,3.351,16.301,31425,5179,26246,2.235,13.560,6353,2.741,27.120,972,973,3556
1979,8139,53876,55857,421068,417388,4843,8.837,2742,5.003,82308,18630,63678,4.463,19.720,74754,13647,61107,3.270,17.910,7554,1.810,35.820,1814,1821,7525
1980,2111,5890,7684,136522,131990,1079,14.368,731,9.734,28086,9579,18507,7.257,21.279,18963,5423,13540,4.109,14.367,9123,6.912,28.734,403,421,1877
1980,2121,2884,3648,231367,235702,646,17.312,813,21.787,40699,20388,20311,8.650,17.267,49203,14798,34405,6.278,20.875,-8504,-3.608,34.534,626,632,8290
1980,2122,515,695,84972,82406,166,25.038,102,15.385,11561,3410,8151,4.138,14.029,6319,2356,3963,2.859,7.668,5242,6.361,15.336,51,52,265
1980,2123,3643,5086,115092,116249,479,9.386,514,10.072,17036,5587,11449,4.806,14.655,19724,5607,14117,4.823,16.967,-2688,-2.312,29.310,275,294,2449
1980,2131,8181,9458,286918,267853,2008,22.223,1163,12.871,84545,28116,56429,10.497,31.564,46337,18059,28278,6.742,17.299,38208,14.265,34.599,760,778,10840
1980,2211,1463,5565,529137,522093,243,4.431,80,1.459,31127,8514,22613,1.631,5.962,16982,4346,12636,0.832,3.253,14145,2.709,6.505,12,12,81
1980,2212,502,2296,131962,130537,127,5.615,59,2.608,8921,2863,6058,2.193,6.834,6195,1576,4619,1.207,4.746,2726,2.088,9.492,4,8,95
1980,2213,3606,3910,31645,30951,282,7.416,67,1.762,4782,2177,2605,7.034,15.450,3362,620,2742,2.003,10.862,1420,4.588,21.725,32,32,110
1980,2361,103097,103435,584337,610851,21339,20.174,26017,24.597,185913,84849,101064,13.890,30.435,239021,97576,141445,15.974,39.129,-53108,-8.694,60.870,20154,20157,75336
1980,2362,33936,34448,635949,640814,4883,13.982,5835,16.708,153284,31028,122256,4.842,23.920,162678,37415,125263,5.839,25.386,-9394,-1.466,47.840,4475,4476,25916
1980,2371,13803,14185,410874,417526,1571,11.030,1688,11.851,78780,17425,61355,4.173,18.868,92481,17580,74901,4.211,22.150,-13701,-3.281,37.737,1211,1214,10282
1980,2372,7625,7777,69329,68294,2132,28.681,1445,19.439,23743,11691,12052,17.119,34.766,21811,8025,13786,11.751,31.937,1932,2.829,63.874,1077,1077,5175
1980,2373,10838,11107,237998,241017,989,8.798,1257,11.182,48608,8622,39986,3.577,20.168,54690,11647,43043,4.832,22.691,-6082,-2.523,40.336,833,840,6493
1980,2379,4426,4452,70928,70833,752,16.823,788,17.629,20315,3675,16640,5.188,28.680,20233,4128,16105,5.828,28.565,82,0.116,57.129,593,593,2379
1980,2381,65825,66226,558923,572922,9649,14.307,12081,17.913,148562,44249,104313,7.723,25.931,176844,52002,124842,9.077,30.867,-28282,-4.936,51.861,9199,9200,39869
1980,2382,96328,97997,1003470,999251,12339,12.630,11733,12.010,215986,56668,159318,5.671,21.615,207186,54871,152315,5.491,20.734,8800,0.881,41.468,9158,9167,39670
1980,2383,69369,69763,535631,551655,11321,15.930,13926,19.596,142426,45971,96455,8.333,25.818,175572,53413,122159,9.682,31.826,-33146,-6.008,51.636,10806,10806,41168
1980,2389,33137,33274,293175,294278,5506,16.638,5144,15.544,77037,24446,52591,8.307,26.178,79188,21487,57701,7.302,26.909,-2151,-0.731,52.357,3860,3860,15978
1980,3111,1955,2641,67823,68250,210,7.874,262,9.824,9471,3548,5923,5.199,13.877,10417,3406,7011,4.990,15.263,-946,-1.386,27.754,164,167,1704
1980,3112,505,864,81115,80536,63,7.326,55,6.395,8265,4434,3831,5.506,10.263,6962,1778,5184,2.208,8.645,1303,1.618,17.289,28,28,373
1980,3113,1155,1537,92293,91618,190,12.583,136,9.007,10664,4221,6443,4.607,11.640,9112,1724,7388,1.882,9.945,1553,1.695,19.890,80,81,627
1980,3114,1228,1760,193535,191288,138,7.814,150,8.494,29233,14848,14385,7.762,15.282,24775,5681,19094,2.970,12.952,4458,2.331,25.903,77,77,1170
1980,3115,1952,2751,147092,144363,210,7.557,266,9.572,22090,12959,9131,8.977,15.302,16246,5114,11132,3.542,11.254,5844,4.048,22.507,180,182,2458
1980,3116,4323,4935,346575,336297,382,7.631,524,10.467,57927,27935,29992,8.307,17.225,35994,16006,19988,4.759,10.703,21933,6.522,21.406,348,350,4896
1980,3117,725,848,47906,48379,66,7.683,88,10.244,7494,3092,4402,6.391,15.490,8455,1935,6520,4.000,17.477,-961,-1.986,30.980,58,59,715
1980,3118,7968,9510,307695,308534,1230,12.988,1150,12.144,39928,18136,21792,5.878,12.941,41630,16691,24939,5.410,13.493,-1702,-0.552,25.882,798,820,9048
1980,3119,1878,2261,118005,115751,190,8.377,204,8.995,17809,5811,11998,5.020,15.386,13177,4022,9155,3.475,11.384,4632,4.002,22.768,120,123,1765
1980,3121,2153,2759,188821,188356,176,6.303,243,8.702,19232,7727,11505,4.102,10.210,18240,5845,12395,3.103,9.684,992,0.527,19.368,144,145,2401
1980,3122,128,189,44889,46434,13,6.824,16,8.399,2111,174,1937,0.375,4.546,5132,519,4613,1.118,11.052,-3021,-6.506,9.093,7,7,24
1980,3131,458,719,125838,126833,67,9.364,60,8.386,10343,3797,6546,2.994,8.155,12218,4085,8133,3.221,9.633,-1875,-1.478,16.310,33,33,1648
1980,3132,1751,2189,366130,366519,157,7.099,202,9.134,26818,7783,19035,2.123,7.317,27727,7575,20152,2.067,7.565,-909,-0.248,14.634,133,133,1413
1980,3133,1522,1755,127544,129196,122,6.862,168,9.449,12444,3544,8900,2.743,9.632,15583,5957,9626,4.611,12.062,-3139,-2.430,19.264,102,103,1817
1980,3141,4253,4553,129553,132671,495,10.667,670,14.438,14143,3536,10607,2.665,10.660,20374,6426,13948,4.844,15.357,-6231,-4.697,21.320,522,530,3787
1980,3149,3238,3384,136152,140151,369,10.747,468,13.630,18936,6858,12078,4.893,13.511,27105,10681,16424,7.621,19.340,-8169,-5.829,27.022,347,347,6347
1980,3151,1384,1520,140080,139552,136,8.939,139,9.136,16895,4695,12200,3.364,12.107,15922,6072,9850,4.351,11.409,973,0.697,22.819,103,104,3022
1980,3152,12617,14417,948938,963803,1622,11.044,2161,14.714,128993,46510,82483,4.826,13.384,158437,59570,98867,6.181,16.439,-29444,-3.055,26.768,1673,1685,35755
1980,3159,1638,1769,84160,84350,198,11.117,222,12.465,11947,4229,7718,5.014,14.164,12436,3395,9041,4.025,14.743,-489,-0.580,28.327,178,178,2079
1980,3161,369,414,20842,21867,25,5.945,38,9.037,1892,508,1384,2.323,8.652,3924,979,2945,4.477,17.945,-2032,-9.293,17.305,31,31,627
1980,3162,492,741,144233,148150,46,6.061,82,10.804,14024,3409,10615,2.301,9.466,21830,9193,12637,6.205,14.735,-7806,-5.269,18.932,45,46,3061
1980,3169,1317,1374,67710,68186,139,10.029,163,11.760,9564,3509,6055,5.146,14.026,10438,2930,7508,4.297,15.308,-874,-1.282,28.053,117,118,1859
1980,3211,5524,6102,165808,168457,683,11.088,799,12.971,22547,7745,14802,4.598,13.384,27712,8429,19283,5.004,16.451,-5165,-3.066,26.769,569,569,4687
1980,3212,1038,1327,90681,95111,147,11.153,129,9.788,7940,3188,4752,3.352,8.348,16817,4474,12343,4.704,17.682,-8877,-9.333,16.696,83,83,1512
1980,3219,7964,8757,288037,299615,1004,11.417,1078,12.258,35370,13389,21981,4.469,11.805,58681,18339,40342,6.121,19.586,-23311,-7.780,23.610,761,762,9208
1980,3221,355,744,219407,217610,39,5.228,43,5.764,14703,2813,11890,1.293,6.757,11295,3143,8152,1.444,5.190,3408,1.566,10.381,26,26,1252
1980,3222,3346,4942,413805,410805,343,6.931,357,7.214,42710,15848,26862,3.858,10.397,36554,9526,27028,2.319,8.898,6156,1.499,17.796,208,209,3540
1980,3231,29180,30584,638087,633412,3313,10.866,3124,10.246,83182,27511,55671,4.343,13.132,74089,25703,48386,4.058,11.697,9093,1.436,23.394,2160,2167,15274
1980,3241,1455,2362,550847,563481,259,11.012,239,10.162,26009,6017,19992,1.068,4.616,50608,14770,35838,2.621,8.981,-24599,-4.366,9.232,71,90,1851
1980,3251,999,2081,281234,274973,175,8.503,129,6.268,28514,12396,16118,4.508,10.370,15583,3526,12057,1.282,5.667,12931,4.703,11.334,54,54,746
1980,3252,372,609,160820,161682,56,9.256,48,7.934,9144,2991,6153,1.850,5.656,10628,2482,8146,1.535,6.573,-1484,-0.918,11.311,32,34,466
1980,3253,741,1125,55901,54524,106,9.502,87,7.799,8137,2953,5184,5.416,14.924,5309,2043,3266,3.747,9.737,2828,5.187,19.474,44,44,581
1980,3254,866,1098,160046,158977,117,10.759,96,8.828,14073,3828,10245,2.408,8.852,11985,2125,9860,1.337,7.539,2088,1.313,15.078,53,54,762
1980,3255,1627,2094,81350,81351,144,6.867,150,7.153,8194,3540,4654,4.352,10.072,8135,1840,6295,2.262,10.000,59,0.073,20.000,75,77,670
1980,3256,1924,2183,119084,118626,174,7.913,206,9.368,12404,3306,9098,2.787,10.456,11363,2667,8696,2.248,9.579,1041,0.878,19.158,131,131,873
1980,3259,1496,1974,95207,94076,190,9.714,154,7.873,9971,3781,6190,4.019,10.599,7837,1895,5942,2.014,8.330,2134,2.268,16.661,84,85,870
1980,3261,9088,10569,535858,539951,1167,11.122,1015,9.673,77848,29658,48190,5.493,14.418,86192,24340,61852,4.508,15.963,-8344,-1.545,28.835,650,661,10622
1980,3262,1764,2147,216186,227842,198,9.287,168,7.880,15868,6170,9698,2.708,6.964,40163,11853,28310,5.202,17.628,-24295,-10.663,13.929,103,103,730
1980,3271,1283,1584,97435,98401,208,13.270,175,11.164,10538,3589,6949,3.647,10.709,12448,2381,10067,2.420,12.650,-1910,-1.941,21.418,128,129,1121
1980,3272,1342,1632,177475,179343,210,13.060,162,10.075,13507,4063,9444,2.265,7.531,17186,2190,14996,1.221,9.583,-3679,-2.051,15.063,107,107,695
1980,3273,7249,9094,192238,196635,623,6.791,784,8.545,26962,10371,16591,5.274,13.712,35837,9910,25927,5.040,18.225,-8875,-4.513,27.423,489,500,4560
1980,3274,251,337,16888,17268,49,14.244,63,18.314,1451,614,837,3.556,8.403,2263,1442,821,8.351,13.106,-812,-4.702,16.806,40,40,375
1980,3279,1920,2237,92228,93878,208,9.226,243,10.778,9343,4149,5194,4.420,9.952,12774,3979,8795,4.238,13.607,-3431,-3.655,19.905,155,157,1287
1980,3311,215,233,23462,18395,60,28.235,19,8.941,11398,10094,1304,54.875,61.964,1407,670,737,3.642,7.649,9991,54.315,15.298,9,9,115
1980,3312,506,679,79005,80345,59,8.793,43,6.408,9646,6143,3503,7.646,12.006,12316,6091,6225,7.581,15.329,-2670,-3.323,24.012,22,22,795
1980,3313,447,754,174843,169972,66,8.901,41,5.529,21629,10106,11523,5.946,12.725,12341,4792,7549,2.819,7.261,9288,5.464,14.521,10,10,407
1980,3314,686,861,111294,109282,91,10.744,63,7.438,12956,4383,8573,4.011,11.856,9169,1719,7450,1.573,8.390,3787,3.465,16.780,37,37,350
1980,3315,2779,3150,317174,328580,192,6.110,177,5.632,24629,7039,17590,2.142,7.496,47981,6625,41356,2.016,14.603,-23352,-7.107,14.991,109,109,2131
1980,3321,2766,2994,165678,164479,240,8.059,208,6.985,18814,5123,13691,3.115,11.439,16445,3236,13209,1.967,9.998,2369,1.440,19.996,130,130,1425
1980,3322,1092,1216,98522,97446,105,8.663,97,8.003,10460,4741,5719,4.865,10.734,8372,2227,6145,2.285,8.591,2088,2.143,17.183,61,61,909
1980,3323,9233,10041,374353,375102,925,9.242,860,8.593,52794,16060,36734,4.282,14.075,54247,13944,40303,3.717,14.462,-1453,-0.387,28.149,595,604,8047
1980,3324,1339,1734,158958,159619,132,7.639,120,6.944,14821,4706,10115,2.948,9.285,15989,4053,11936,2.539,10.017,-1168,-0.732,18.571,67,67,1247
1980,3325,814,901,92305,94072,88,9.767,88,9.767,8173,3351,4822,3.562,8.688,11745,2292,9453,2.436,12.485,-3572,-3.797,17.376,59,59,462
1980,3326,1493,1687,73563,74698,117,6.907,131,7.733,8772,2611,6161,3.495,11.743,11213,2364,8849,3.165,15.011,-2441,-3.268,23.487,79,81,1077
1980,3327,19174,19482,353676,350286,2569,13.468,1755,9.201,54612,15846,38766,4.524,15.591,48049,14510,33539,4.142,13.717,6563,1.874,27.434,1265,1268,9706
1980,3328,5137,5425,125540,127278,436,8.024,453,8.337,17493,5645,11848,4.435,13.744,20889,4893,15996,3.844,16.412,-3396,-2.668,27.488,305,306,3075
1980,3329,4414,4945,409302,406562,560,11.530,384,7.906,44006,13396,30610,3.295,10.824,38990,9405,29585,2.313,9.590,5016,1.234,19.180,237,237,3094
1980,3331,2832,3274,406538,407022,385,11.973,268,8.335,47120,16829,30291,4.135,11.577,48903,11834,37069,2.907,12.015,-1783,-0.438,23.154,169,170,2160
1980,3332,3347,3607,199412,194387,302,8.435,249,6.954,26311,7363,18948,3.788,13.535,16614,5664,10950,2.914,8.547,9697,4.989,17.094,148,148,2224
1980,3333,1975,2094,162573,161296,179,8.560,173,8.274,18543,4994,13549,3.096,11.496,15803,4313,11490,2.674,9.798,2740,1.699,19.595,113,113,1694
1980,3334,1701,1944,192164,195268,272,14.388,165,8.728,22957,7774,15183,3.981,11.757,29334,8778,20556,4.495,15.022,-6377,-3.266,23.513,102,102,1404
1980,3335,9414,9848,314972,312233,790,8.041,744,7.573,38281,8760,29521,2.806,12.260,32634,13620,19014,4.362,10.452,5647,1.809,20.904,471,472,4372
1980,3336,632,781,199930,198997,65,8.425,46,5.962,18714,10913,7801,5.484,9.404,16877,1709,15168,0.859,8.481,1837,0.923,16.962,22,22,420
1980,3339,5611,6148,406408,401090,527,8.610,473,7.727,52314,18570,33744,4.630,13.043,41512,14821,26691,3.695,10.350,10802,2.693,20.700,293,293,4391
1980,3341,923,1099,315420,293494,198,18.750,112,10.606,68778,18126,50652,6.176,23.434,25435,11556,13879,3.937,8.666,43343,14.768,17.333,70,70,3481
1980,3342,1486,1664,301244,290151,193,11.729,156,9.480,40440,9374,31066,3.231,13.938,17807,6012,11795,2.072,6.137,22633,7.800,12.274,99,100,1965
1980,3343,437,467,64225,63978,62,13.080,76,16.034,8371,3255,5116,5.088,13.084,7927,2041,5886,3.190,12.390,444,0.694,24.781,54,54,930
1980,3344,3260,3709,461736,439758,552,15.265,366,10.122,79973,25634,54339,5.829,18.186,35362,13127,22235,2.985,8.041,44611,10.144,16.083,241,241,6570
1980,3345,3311,3826,589859,568939,406,10.715,332,8.762,79070,22532,56538,3.960,13.898,36451,13879,22572,2.439,6.407,42619,7.491,12.814,189,190,3226
1980,3346,556,579,21530,23243,91,15.424,113,19.153,2630,1443,1187,6.208,11.315,6182,1422,4760,6.118,26.598,-3552,-15.282,22.631,79,79,886
1980,3351,1130,1249,89419,90775,111,8.855,120,9.573,8697,3032,5665,3.340,9.581,11320,2174,9146,2.395,12.470,-2623,-2.890,19.162,76,76,948
1980,3352,347,457,152090,147729,53,11.713,44,9.724,15085,3323,11762,2.249,10.211,6336,722,5614,0.489,4.289,8749,5.922,8.578,28,28,95
1980,3353,1790,2262,302438,301327,219,9.781,173,7.727,34056,9973,24083,3.310,11.302,31889,9633,22256,3.197,10.583,2167,0.719,21.166,98,99,1982
1980,3359,1468,1774,189399,189030,154,8.698,147,8.303,23821,9477,14344,5.014,12.602,22951,7374,15577,3.901,12.141,870,0.460,24.283,86,87,1852
1980,3361,165,225,263104,294542,38,17.195,30,13.575,15815,8696,7119,2.952,5.369,78829,6387,72442,2.168,26.763,-63014,-21.394,10.739,22,22,309
1980,3362,1683,1905,121236,141755,192,9.692,344,17.365,12623,6640,5983,4.684,8.905,54457,8209,46248,5.791,38.416,-41834,-29.511,17.810,252,253,4347
1980,3363,3304,4065,670932,739151,412,10.157,395,9.737,35923,16398,19525,2.218,4.860,173114,12540,160574,1.697,23.421,-137191,-18.561,9.720,265,266,4328
1980,3364,1012,1215,665682,636252,133,11.144,90,7.541,77886,6589,71297,1.036,12.241,19568,9550,10018,1.501,3.076,58318,9.166,6.151,47,47,412
1980,3365,149,198,77013,71198,24,12.403,15,7.752,15923,11201,4722,15.732,22.365,4803,614,4189,0.862,6.746,11120,15.619,13.492,5,5,291
1980,3366,1102,1215,202344,202595,148,12.349,115,9.595,24224,4854,19370,2.396,11.957,24002,3513,20489,1.734,11.847,222,0.110,23.695,88,88,1291
1980,3369,412,425,33987,33865,66,15.439,71,16.608,4457,662,3795,1.955,13.161,4140,936,3204,2.764,12.225,317,0.936,24.450,51,51,602
1980,3371,11402,12026,383608,390089,1494,12.372,1594,13.200,46121,18507,27614,4.744,11.823,58983,18053,40930,4.628,15.120,-12862,-3.297,23.646,1218,1223,11296
1980,3372,2137,2251,120566,120359,255,11.376,236,10.529,12728,2335,10393,1.940,10.575,12415,3101,9314,2.576,10.315,313,0.260,20.630,167,167,1730
1980,3379,1033,1175,39346,39942,92,7.767,111,9.371,4483,1069,3414,2.676,11.224,5684,1289,4395,3.227,14.231,-1201,-3.007,22.448,76,76,687
1980,3391,8730,9258,208151,205373,1201,13.151,950,10.402,29818,10516,19302,5.120,14.519,24201,8825,15376,4.297,11.784,5617,2.735,23.568,692,695,3464
1980,3399,13612,14294,456634,462061,1655,11.510,1824,12.686,68576,27991,40585,6.058,14.841,79278,24003,55275,5.195,17.157,-10702,-2.316,29.683,1336,1339,9988
1980,4231,22870,28881,330412,338991,2563,8.830,2852,9.826,42975,18406,24569,5.430,12.677,60177,19733,40444,5.821,17.752,-17202,-5.074,25.355,1880,1937,10334
1980,4232,7015,8224,97054,97118,939,11.433,917,11.165,15352,5345,10007,5.504,15.808,15387,5293,10094,5.450,15.844,-35,-0.036,31.615,597,603,2726
1980,4233,7203,9068,115016,115924,1116,12.414,959,10.668,18913,7415,11498,6.396,16.315,20813,6844,13969,5.904,17.954,-1900,-1.639,32.630,611,617,3581
1980,4234,16939,23443,411550,402721,3529,15.446,2337,10.229,72978,33185,39793,8.240,18.121,55827,25860,29967,6.421,13.862,17151,4.259,27.725,1332,1357,6667
1980,4235,5835,8337,140518,138155,875,10.591,724,8.764,22397,9698,12699,7.020,16.212,17696,6507,11189,4.710,12.809,4701,3.403,25.618,394,404,2752
1980,4236,12577,18129,234792,230041,2187,12.211,1750,9.771,43623,15534,28089,6.753,18.963,34342,14465,19877,6.288,14.929,9281,4.034,29.857,991,1027,5823
1980,4237,10229,13363,151871,152254,1217,9.185,990,7.472,20565,6626,13939,4.352,13.507,21299,7716,13583,5.068,13.989,-734,-0.482,27.014,604,621,3188
1980,4238,44090,57610,688777,679540,5535,9.705,4384,7.687,109007,35312,73695,5.196,16.041,90440,32988,57452,4.854,13.309,18567,2.732,26.618,2662,2739,15022
1980,4239,19801,21485,221358,220822,3125,14.774,2460,11.630,41202,14064,27138,6.369,18.658,40206,14223,25983,6.441,18.207,996,0.451,36.415,1770,1779,9383
1980,4241,6538,9023,133168,129626,870,9.758,655,7.347,19677,6737,12940,5.197,15.180,12571,4642,7929,3.581,9.698,7106,5.482,19.396,391,397,2125
1980,4242,2447,3156,91394,90336,346,10.927,367,11.590,12492,4640,7852,5.136,13.828,10426,5088,5338,5.632,11.541,2066,2.287,23.083,237,241,1192
1980,4243,9882,10849,112394,114730,1425,13.129,1435,13.221,21571,7816,13755,6.813,18.802,26366,10404,15962,9.068,22.981,-4795,-4.179,37.603,1041,1046,5416
1980,4244,25524,31391,544268,542628,3233,10.227,3675,11.625,86961,34523,52438,6.362,16.026,83081,32738,50343,6.033,15.311,3880,0.715,30.622,2492,2540,16097
1980,4245,8791,11888,108566,110207,747,6.219,994,8.275,15700,4231,11469,3.839,14.246,18964,5254,13710,4.767,17.208,-3264,-2.962,28.492,615,639,3464
1980,4246,5571,8440,106109,104828,1063,12.832,751,9.066,18297,7206,11091,6.874,17.454,15619,5033,10586,4.801,14.900,2678,2.555,29.799,415,423,2253
1980,4247,12014,15934,151434,152366,1179,7.352,1382,8.618,23807,7579,16228,4.974,15.625,25650,7931,17719,5.205,16.835,-1843,-1.210,31.250,831,849,4124
1980,4248,4711,5713,125577,124778,376,6.505,511,8.840,15593,3917,11676,3.139,12.497,13943,6158,7785,4.935,11.174,1650,1.322,22.348,287,295,2528
1980,4249,18074,22064,235558,236389,2499,11.323,2511,11.377,39358,13624,25734,5.763,16.650,40961,15317,25644,6.480,17.328,-1603,-0.678,33.299,1710,1750,9216
1980,4251,26177,28969,283570,282547,3267,11.416,2563,8.956,48283,17522,30761,6.201,17.088,46370,15821,30549,5.599,16.411,1913,0.677,32.823,1646,1657,7917
1980,4411,39828,40866,824200,872184,3266,7.850,4745,11.405,70908,29123,41785,3.339,8.130,166967,41735,125232,4.785,19.144,-96059,-11.014,16.260,3853,3888,34074
1980,4412,12100,12524,78744,83307,1332,10.440,1801,14.116,14643,5332,9311,6.400,17.577,23823,8012,15811,9.617,28.597,-9180,-11.020,35.155,1446,1456,6372
1980,4413,40633,57265,377242,384241,5397,9.488,4629,8.138,56748,23423,33325,6.096,14.769,69946,22187,47759,5.774,18.204,-13198,-3.435,29.538,2966,3047,13332
1980,4421,24018,28093,224017,227418,2987,10.647,2910,10.373,35818,14319,21499,6.296,15.750,42546,12390,30156,5.448,18.708,-6728,-2.958,31.500,2216,2250,8980
1980,4422,19025,21790,121854,120410,3393,15.829,2685,12.526,26768,11818,14950,9.815,22.231,23881,9402,14479,7.808,19.833,2887,2.398,39.666,2072,2105,7101
1980,4431,24428,31110,181569,184562,3934,12.506,4628,14.712,35914,15435,20479,8.363,19.459,42171,17222,24949,9.331,22.849,-6257,-3.390,38.918,3066,3155,10454
1980,4441,55529,69697,653419,658111,6413,9.264,5472,7.904,97002,40520,56482,6.157,14.739,106644,29770,76874,4.524,16.205,-9642,-1.465,29.479,3855,3972,19778
1980,4442,13795,16702,118584,119317,1616,9.696,1546,9.276,19480,6963,12517,5.836,16.326,20934,6206,14728,5.201,17.545,-1454,-1.219,32.653,1096,1110,4037
1980,4451,65016,104886,1732048,1693399,12821,12.318,11209,10.770,294610,148581,146029,8.774,17.398,216832,82777,134055,4.888,12.805,77778,4.593,25.609,7484,7632,38894
1980,4452,23212,28812,177097,177813,4383,15.292,4084,14.249,43848,20217,23631,11.370,24.660,44769,16815,27954,9.457,25.178,-921,-0.518,49.319,2986,3042,12247
1980,4453,28266,30688,147885,165102,3437,10.606,6874,21.212,30424,12103,18321,7.331,18.427,63937,45961,17976,27.838,38.726,-33513,-20.298,36.855,2787,2822,8779
1980,4461,40752,57337,533995,524268,6185,11.002,3944,7.016,94743,52682,42061,10.049,18.071,73446,23431,50015,4.469,14.009,21297,4.062,28.018,2639,2719,13429
1980,4471,113057,143264,781780,817180,15949,10.954,20629,14.168,155424,75484,79940,9.237,19.020,226143,83080,143063,10.167,27.674,-70719,-8.654,38.039,14600,15018,58029
1980,4481,60440,95507,766642,770399,12396,13.107,10526,11.130,142898,73960,68938,9.600,18.549,149225,48894,100331,6.347,19.370,-6327,-0.821,37.097,7088,7468,27164
1980,4482,12287,33355,180177,177560,4693,14.600,2269,7.059,39493,21544,17949,12.133,22.242,33504,8669,24835,4.882,18.869,5989,3.373,37.738,1195,1248,4120
1980,4483,17008,23647,151166,144361,2713,11.522,2511,10.664,40478,10542,29936,7.303,28.040,25724,9977,15747,6.911,17.819,14754,10.220,35.639,1515,1573,5403
1980,4511,31755,39602,239881,236213,6067,15.439,5457,13.887,57902,28365,29537,12.008,24.513,49790,18812,30978,7.964,21.078,8112,3.434,42.157,4008,4133,12982
1980,4512,7359,10289,67358,66220,1557,15.352,1263,12.453,15677,6564,9113,9.912,23.674,13115,5279,7836,7.972,19.805,2562,3.869,39.611,900,934,3161
1980,4521,634,9514,1551956,1552049,876,9.429,429,4.618,142556,90277,52279,5.817,9.185,145271,20985,124286,1.352,9.360,-2715,-0.175,18.370,39,44,1228
1980,4529,14968,27559,392847,390961,2522,9.072,3002,10.799,59149,29027,30122,7.425,15.129,54542,19745,34797,5.050,13.951,4607,1.178,27.902,1748,1836,7230
1980,4531,19990,21205,102952,102478,2894,13.813,2388,11.397,21384,8381,13003,8.178,20.867,20302,7250,13052,7.075,19.811,1082,1.056,39.622,1847,1872,5546
1980,4532,22089,26347,155179,151625,4458,17.312,3267,12.687,36051,17161,18890,11.318,23.777,28956,11586,17370,7.641,19.097,7095,4.679,38.194,2554,2586,8340
1980,4533,8261,9677,45840,45480,1439,14.917,1379,14.295,9782,4516,5266,9.930,21.509,9063,3533,5530,7.768,19.928,719,1.581,39.855,1074,1082,2505
1980,4539,25950,30769,138804,153859,5058,16.696,4109,13.564,34976,16511,18465,10.731,22.733,63248,13120,50128,8.527,41.108,-28272,-18.375,45.465,2981,3075,9462
1980,4541,5186,6956,93084,95243,872,12.559,846,12.185,15868,6354,9514,6.671,16.661,20278,6565,13713,6.893,21.291,-4410,-4.630,33.321,607,609,3122
1980,4542,4399,5577,84729,83901,564,10.079,602,10.758,13862,4160,9702,4.958,16.522,12065,3546,8519,4.226,14.380,1797,2.142,28.760,421,425,1721
1980,4543,16873,22310,195778,197307,1857,8.218,2428,10.746,29457,10100,19357,5.119,14.930,32616,12795,19821,6.485,16.531,-3159,-1.601,29.859,1699,1742,7269
1980,4811,1030,2440,266296,260231,330,14.142,117,5.014,28955,4834,24121,1.858,11.127,16713,2349,14364,0.903,6.422,12242,4.704,12.845,9,11,57
1980,4812,409,573,8980,8325,140,26.846,37,7.095,2064,1062,1002,12.758,24.794,735,121,614,1.454,8.829,1329,15.965,17.659,10,10,35
1980,4831,419,679,38440,37049,88,13.435,40,6.107,10082,4680,5402,12.632,27.213,7602,1631,5971,4.402,20.519,2480,6.694,41.038,6,6,25
1980,4832,420,477,16319,15649,60,12.987,30,6.494,3685,1376,2309,8.793,23.549,2477,1412,1065,9.023,15.829,1208,7.720,31.658,4,5,65
1980,4841,20005,25022,504281,517101,4408,17.757,4011,16.158,77654,38100,39554,7.368,15.017,104432,36356,68076,7.031,20.196,-26778,-5.178,30.034,3146,3174,13334
1980,4842,41065,44756,568853,577522,7127,16.035,6509,14.644,98555,37911,60644,6.564,17.065,116282,29959,86323,5.188,20.135,-17727,-3.069,34.130,5070,5099,19821
1980,4851,407,456,21451,22767,49,10.817,43,9.492,2277,686,1591,3.013,10.001,4636,3666,970,16.102,20.363,-2359,-10.361,20.003,28,28,496
1980,4852,320,761,38266,35246,200,29.918,15,2.244,8595,5459,3136,15.489,24.386,2103,296,1807,0.840,5.967,6492,18.419,11.933,8,8,16
1980,4853,5983,6045,66894,68867,876,15.317,224,3.917,11148,4075,7073,5.917,16.188,15234,1382,13852,2.007,22.121,-4086,-5.933,32.375,181,181,803
1980,4854,3729,3903,92501,90110,427,11.489,54,1.453,16413,5766,10647,6.399,18.215,11484,1506,9978,1.671,12.744,4929,5.470,25.489,34,34,167
1980,4855,463,486,8845,8589,50,10.341,45,9.307,1954,612,1342,7.125,22.750,1433,567,866,6.601,16.684,521,6.066,33.368,39,39,275
1980,4859,827,870,16104,16061,143,16.784,107,12.559,3092,1264,1828,7.870,19.252,2945,899,2046,5.598,18.337,147,0.915,36.674,80,80,386
1980,4861,87,301,11081,11007,23,7.757,14,4.722,1326,364,962,3.307,12.047,1185,263,922,2.389,10.766,141,1.281,21.532,(D),(D),(D)
1980,4862,228,1035,56801,55936,63,6.213,21,2.071,5328,1240,4088,2.217,9.525,3616,753,2863,1.346,6.465,1712,3.061,12.929,5,10,139
1980,4869,65,264,6864,7095,27,10.305,23,8.779,922,381,541,5.370,12.996,1380,913,467,12.869,19.452,-458,-6.456,25.992,(D),(D),(D)
1980,4871,161,166,2031,2035,25,15.198,22,13.374,574,330,244,16.220,28.213,586,214,372,10.519,28.803,-12,-0.590,56.427,13,13,102
1980,4872,657,663,9636,8961,113,17.385,87,13.385,2744,1192,1552,13.302,30.622,1375,377,998,4.207,15.344,1369,15.277,30.689,64,64,204
1980,4879,47,57,1099,1020,15,29.126,4,7.767,203,67,136,6.572,19.912,41,4,37,0.392,4.022,162,15.890,8.043,3,3,3
1980,4881,2083,2518,53487,51326,376,15.862,81,3.417,10029,3428,6601,6.679,19.540,5712,892,4820,1.738,11.129,4317,8.411,22.258,29,30,85
1980,4882,255,323,9342,10931,58,18.384,43,13.629,2263,991,1272,9.066,20.703,5511,4365,1146,39.932,50.416,-3248,-29.714,41.405,4,5,91
1980,4883,2146,2564,125382,125914,394,16.386,75,3.119,33338,15570,17768,12.366,26.477,34857,1643,33214,1.305,27.683,-1519,-1.206,52.954,20,21,437
1980,4884,1791,2366,38153,39438,388,16.578,337,14.399,4916,2300,2616,5.832,12.465,7549,2061,5488,5.226,19.141,-2633,-6.676,24.930,249,251,1302
1980,4885,3975,5696,80993,77456,854,15.856,234,4.345,17210,6391,10819,8.251,22.219,10053,2009,8044,2.594,12.979,7157,9.240,25.958,80,81,557
1980,4889,370,380,6625,6025,63,17.622,18,5.035,2135,822,1313,13.644,35.439,1019,153,866,2.540,16.914,1116,18.524,33.829,11,11,81
1980,4921,1059,1545,108301,103210,338,23.087,176,12.022,14651,2697,11954,2.613,14.195,4120,705,3415,0.683,3.992,10531,10.204,7.984,118,118,360
1980,4922,758,758,3749,3680,339,46.823,271,37.431,1513,1088,425,29.565,41.114,1369,783,586,21.277,37.201,144,3.913,74.402,244,244,712
1980,4931,6314,9686,401637,400021,990,10.392,672,7.054,58223,20831,37392,5.207,14.555,54619,13120,41499,3.280,13.654,3604,0.901,27.308,340,341,2011
1980,5111,12417,14038,585979,581819,1531,10.872,1618,11.490,61790,23247,38543,3.996,10.620,53539,19320,34219,3.321,9.202,8251,1.418,18.404,1140,1155,10961
1980,5112,4237,5150,79368,72526,1653,35.822,582,12.612,27962,14567,13395,20.085,38.554,14412,8427,5985,11.619,19.871,13550,18.683,39.743,340,346,2840
1980,5121,8482,13820,185429,188236,1978,14.353,1901,13.794,43643,16433,27210,8.730,23.185,50085,16532,33553,8.783,26.608,-6442,-3.422,46.371,1034,1120,8981
1980,5122,1238,1246,9969,9521,328,28.070,173,14.805,3004,1499,1505,15.744,31.551,2040,1003,1037,10.535,21.426,964,10.125,42.853,115,115,416
1980,5151,5446,6406,191538,182984,637,10.375,105,1.710,31539,11238,20301,6.142,17.236,14040,2262,11778,1.236,7.673,17499,9.563,15.346,28,30,263
1980,5152,3,3,23,92,(D),(D),3,75.000,13,(D),(D),(D),14.208,145,145,(D),158.470,158.470,-132,-144.262,28.415,(D),(D),(D)
1980,5171,1518,12639,891968,881062,307,2.442,169,1.344,230977,2057,228920,0.233,26.216,209347,1503,207844,0.171,23.761,21630,2.455,47.522,88,88,830
1980,5172,497,1252,68051,66924,120,9.800,65,5.308,16954,912,16042,1.363,25.333,14775,404,14371,0.604,22.077,2179,3.256,44.155,37,37,147
1980,5174,551,947,25025,22884,169,19.325,24,2.744,6598,1750,4848,7.647,28.833,2304,623,1681,2.722,10.068,4294,18.765,20.137,6,6,10
1980,5179,1034,2058,71439,65337,289,14.813,75,3.844,22494,2399,20095,3.672,34.428,10212,311,9901,0.476,15.630,12282,18.798,31.259,51,51,150
1980,5182,5081,6658,193319,183340,1270,19.698,849,13.168,49775,24377,25398,13.296,27.149,29681,14242,15439,7.768,16.189,20094,10.960,32.378,502,505,5312
1980,5191,1870,2228,26222,27384,195,8.438,361,15.621,2830,945,1885,3.451,10.335,5212,3263,1949,11.916,19.033,-2382,-8.699,20.669,131,132,1077
1980,5211,19,44,20155,21928,(D),(D),10,20.833,809,(D),392,(D),3.689,4377,4073,304,18.575,19.961,-3568,-16.272,7.379,0,0,0
1980,5221,21200,62376,1732186,1686529,3888,6.384,945,1.552,179090,52672,126418,3.123,10.619,87410,16470,70940,0.977,5.183,91680,5.436,10.366,250,346,4157
1980,5222,23531,43907,343523,335513,3680,8.507,2378,5.498,57381,23969,33412,7.144,17.102,42332,14155,28177,4.219,12.617,15049,4.485,25.234,372,398,1840
1980,5223,2694,3019,36326,33597,669,23.944,219,7.838,9817,5974,3843,17.782,29.220,4411,1520,2891,4.524,13.129,5406,16.091,26.259,159,159,589
1980,5231,4491,8623,190808,180930,1461,18.085,372,4.605,43480,14916,28564,8.244,24.031,23694,5944,17750,3.285,13.096,19786,10.936,26.191,163,173,1384
1980,5232,97,108,5844,5200,17,16.832,3,2.970,1325,73,1252,1.404,25.483,57,13,44,0.250,1.096,1268,24.387,2.193,(D),(D),(D)
1980,5239,9187,9531,69545,68025,1776,20.062,419,4.733,17296,8204,9092,12.060,25.426,14279,4832,9447,7.103,20.991,3017,4.435,41.982,275,275,835
1980,5241,6250,29917,1216564,1195373,2444,8.277,1662,5.629,143801,56949,86852,4.764,12.030,100757,30232,70525,2.529,8.429,43044,3.601,16.858,116,150,1497
1980,5242,85564,90047,540310,530135,10174,11.867,1551,1.809,92794,37623,55171,7.097,17.504,72148,13599,58549,2.565,13.609,20646,3.894,27.219,915,927,4468
1980,5250,1411,1614,14474,13392,163,10.486,44,2.830,3560,984,2576,7.348,26.584,1442,502,940,3.749,10.768,2118,15.816,21.536,13,13,72
1980,5311,104869,106540,501439,485166,13809,13.722,1999,1.986,110510,51452,59058,10.605,22.778,78788,10601,68187,2.185,16.239,31722,6.538,32.479,1213,1237,4173
1980,5312,33350,34418,171204,168120,6079,19.088,938,2.945,42113,17805,24308,10.591,25.049,36203,5917,30286,3.520,21.534,5910,3.515,43.068,680,695,2062
1980,5313,20059,20706,177232,169957,3811,19.919,664,3.471,44241,16181,28060,9.521,26.031,29679,5469,24210,3.218,17.463,14562,8.568,34.925,455,458,1933
1980,5321,5520,8931,100165,99941,1336,14.806,1521,16.856,28126,7895,20231,7.900,28.143,27405,12344,15061,12.351,27.421,721,0.721,54.842,739,757,4220
1980,5322,7906,9438,81486,78997,1928,21.094,1332,14.573,22144,10256,11888,12.983,28.032,17338,7746,9592,9.805,21.948,4806,6.084,43.896,989,995,5371
1980,5323,2077,2322,19032,18991,427,19.187,234,10.514,4296,1806,2490,9.510,22.621,4234,1624,2610,8.551,22.295,62,0.326,44.590,147,147,698
1980,5324,3759,4257,43159,41730,733,17.950,386,9.453,10809,3519,7290,8.433,25.902,7947,2843,5104,6.813,19.044,2862,6.858,38.088,277,277,1055
1980,5331,878,935,10307,10314,160,18.265,42,4.795,3181,1095,2086,10.617,30.842,3217,1560,1657,15.125,31.191,-36,-0.349,61.683,20,20,62
1980,5411,103714,106608,544079,531244,14207,13.573,10329,9.868,103007,41556,61451,7.822,19.390,77412,28261,49151,5.320,14.572,25595,4.818,29.144,7855,7891,21046
1980,5412,44061,46977,338962,329559,7627,16.634,5379,11.731,68464,29749,38715,9.027,20.774,49133,21608,27525,6.557,14.909,19331,5.866,29.817,4020,4061,15165
1980,5413,41677,45334,604407,584373,7575,17.184,5069,11.499,126991,46454,80537,7.949,21.731,86848,28667,58181,4.906,14.862,40143,6.869,29.724,3637,3654,16529
1980,5414,10927,11135,78312,76053,2469,23.256,1432,13.488,20022,9000,11022,11.834,26.326,15577,6119,9458,8.046,20.482,4445,5.845,40.964,1078,1080,4168
1980,5415,2676,3156,28803,29187,1322,43.580,1077,35.504,9772,5158,4614,17.672,33.481,10511,7277,3234,24.932,36.013,-739,-2.532,66.961,817,820,3360
1980,5416,17141,17737,163227,165508,4089,23.378,3597,20.565,46225,18619,27606,11.250,27.929,50367,20455,29912,12.359,30.432,-4142,-2.503,55.858,2817,2824,14062
1980,5417,4089,5150,378177,369665,559,10.566,840,15.878,45929,13046,32883,3.529,12.425,29309,10235,19074,2.769,7.929,16620,4.496,15.857,406,408,2877
1980,5418,18204,19873,240924,235434,3215,16.474,2501,12.815,49868,18428,31440,7.827,21.181,38948,15663,23285,6.653,16.543,10920,4.638,33.086,1860,1868,9535
1980,5419,22694,24408,156498,170695,3545,14.824,2558,10.696,31045,12079,18966,7.076,18.187,58127,39745,18382,23.284,34.053,-27082,-15.866,36.375,1770,1788,6710
1980,5511,20456,38585,2605442,2557845,4520,12.008,2633,6.995,435392,149790,285602,5.856,17.022,338448,97239,241209,3.802,13.232,96944,3.790,26.464,363,392,4681
1980,5611,4630,4833,62857,63859,666,13.245,1057,21.020,15904,5403,10501,8.461,24.905,18010,6332,11678,9.916,28.203,-2106,-3.298,49.810,804,805,4239
1980,5612,193,242,14169,14675,44,17.121,74,28.794,3917,2045,1872,13.936,26.693,4955,3646,1309,24.846,33.766,-1038,-7.073,53.385,33,34,844
1980,5613,9596,12705,577522,560639,2554,20.984,1486,12.209,151867,45041,106826,8.034,27.088,118521,25860,92661,4.613,21.140,33346,5.948,42.281,1063,1072,12523
1980,5614,16386,18429,191072,189998,3228,18.090,2059,11.539,38586,15696,22890,8.261,20.309,36755,10050,26705,5.290,19.345,1831,0.964,38.690,1538,1559,6789
1980,5615,15436,18072,137392,131469,2876,16.593,1398,8.066,31716,12372,19344,9.411,24.124,20134,6552,13582,4.984,15.315,11582,8.810,30.629,1005,1023,4344
1980,5616,10393,12439,370509,351830,2741,23.349,1342,11.431,97188,35838,61350,10.186,27.624,59111,18266,40845,5.192,16.801,38077,10.823,33.602,970,972,10035
1980,5617,45295,47746,627634,621842,10396,22.227,8449,18.064,156244,64894,91350,10.436,25.126,145447,44235,101212,7.114,23.390,10797,1.736,46.779,6742,6755,30036
1980,5619,11181,11940,143220,139552,2772,24.868,1186,10.640,37741,17793,19948,12.750,27.044,30404,7479,22925,5.359,21.787,7337,5.258,43.574,834,835,4515
1980,5621,4841,4966,94131,96100,673,13.541,681,13.702,10600,2899,7701,3.017,11.030,14412,4185,10227,4.355,14.997,-3812,-3.967,22.060,566,566,3229
1980,5622,1863,2249,35845,34800,284,13.324,49,2.299,5974,2110,3864,6.063,17.167,3904,718,3186,2.063,11.219,2070,5.948,22.437,14,15,187
1980,5629,4231,4455,42580,42518,669,15.447,421,9.721,9052,2910,6142,6.844,21.290,9017,2235,6782,5.257,21.208,35,0.082,42.415,301,302,1585
1980,6111,11172,11506,294876,305560,496,4.171,1269,10.671,26988,4242,22746,1.388,8.832,47829,26808,21021,8.773,15.653,-20841,-6.821,17.665,411,413,3068
1980,6112,409,477,27146,30137,15,2.964,73,14.427,4371,523,3848,1.735,14.504,10615,5970,4645,19.810,35.222,-6244,-20.719,29.008,28,29,594
1980,6113,1797,2038,786238,789787,77,3.654,215,10.204,76413,1087,75326,0.138,9.675,84369,40599,43770,5.140,10.683,-7956,-1.007,19.350,53,55,1820
1980,6114,1559,1733,26448,26805,258,14.739,293,16.738,4993,1121,3872,4.182,18.627,5788,2551,3237,9.517,21.593,-795,-2.966,37.254,199,200,1458
1980,6115,3409,3853,49039,49360,526,13.595,558,14.422,8968,2845,6123,5.764,18.169,9676,4076,5600,8.258,19.603,-708,-1.434,36.337,390,396,2250
1980,6116,9216,9690,77833,80592,1852,18.935,2034,20.795,18543,7555,10988,9.374,23.009,24120,11531,12589,14.308,29.929,-5577,-6.920,46.017,1433,1438,5648
1980,6117,811,821,11296,13080,158,18.821,195,23.228,2094,672,1422,5.138,16.009,5355,4496,859,34.373,40.940,-3261,-24.931,32.018,140,140,560
1980,6211,152742,156989,847241,841901,16534,10.776,9435,6.149,140923,57244,83679,6.799,16.739,130246,35378,94868,4.202,15.470,10677,1.268,30.941,7455,7485,24241
1980,6212,85929,87287,355597,350964,6399,7.434,3991,4.636,57197,19060,38137,5.431,16.297,47831,12055,35776,3.435,13.628,9366,2.669,27.257,3111,3124,9350
1980,6213,30837,31985,96993,95439,4876,15.742,2854,9.214,24002,12104,11898,12.682,25.149,20737,7429,13308,7.784,21.728,3265,3.421,43.456,2184,2187,5793
1980,6214,4182,5218,75063,75873,779,15.201,592,11.552,15734,6326,9408,8.338,20.737,17467,8086,9381,10.657,23.021,-1733,-2.284,41.475,310,313,4694
1980,6215,3730,4734,59915,59157,639,13.699,500,10.719,11471,4654,6817,7.867,19.391,9976,3397,6579,5.742,16.864,1495,2.527,33.727,334,350,1770
1980,6216,2330,3027,89914,85096,542,18.578,323,11.071,25275,9519,15756,11.186,29.702,15726,4234,11492,4.976,18.480,9549,11.221,36.961,167,168,1627
1980,6219,2360,2667,51456,48195,490,19.345,222,8.764,13326,4587,8739,9.518,27.650,6817,2192,4625,4.548,14.145,6509,13.506,28.289,128,128,930
1980,6221,3790,4715,2490986,2449889,229,4.836,269,5.681,186975,50870,136105,2.076,7.632,101946,59312,42634,2.421,4.161,85029,3.471,8.323,103,104,23443
1980,6222,309,385,43024,41902,55,14.765,30,8.054,6974,3815,3159,9.105,16.644,4603,2495,2108,5.954,10.985,2371,5.659,21.971,12,12,362
1980,6223,172,200,40631,40868,18,9.091,14,7.071,2677,748,1929,1.830,6.550,2974,2098,876,5.134,7.277,-297,-0.727,13.101,6,6,1567
1980,6231,6353,8461,667539,658015,635,7.588,451,5.389,85227,35255,49972,5.358,12.952,65772,25954,39818,3.944,9.996,19455,2.957,19.991,285,294,15655
1980,6232,3082,3799,85854,83790,546,14.628,413,11.065,15737,6507,9230,7.766,18.782,11488,4735,6753,5.651,13.711,4249,5.071,27.421,207,208,2170
1980,6233,8020,9345,363997,364443,985,10.497,1063,11.328,48797,18145,30652,4.979,13.389,49565,23388,26177,6.417,13.600,-768,-0.211,26.779,679,699,16276
1980,6239,2264,2707,71686,71264,234,8.578,276,10.117,9304,2883,6421,4.046,13.056,8436,3789,4647,5.317,11.838,868,1.218,23.676,109,109,1501
1980,6241,9589,13584,216910,219897,1370,9.939,1771,12.848,39452,9382,30070,4.267,17.941,45247,20511,24736,9.328,20.576,-5795,-2.635,35.882,697,703,5254
1980,6242,2808,3368,36614,37501,323,9.388,468,13.603,6275,1597,4678,4.259,16.733,8039,3979,4060,10.610,21.437,-1764,-4.704,33.466,180,186,918
1980,6243,2965,4451,205021,209448,575,12.829,637,14.212,34354,10124,24230,4.834,16.402,42952,15312,27640,7.311,20.507,-8598,-4.105,32.804,225,246,3786
1980,6244,21735,25612,217936,225708,3800,14.504,4976,18.992,44405,19519,24886,8.648,19.674,59594,33084,26510,14.658,26.403,-15189,-6.729,39.347,2305,2374,12312
1980,7111,4436,4475,54638,56409,795,17.113,1136,24.454,15165,5180,9985,9.183,26.884,18567,9481,9086,16.808,32.915,-3402,-6.031,53.768,746,751,4671
1980,7112,2062,2149,56709,56435,400,18.566,411,19.076,12719,2723,9996,4.825,22.538,12465,2580,9885,4.572,22.088,254,0.450,44.175,302,304,1616
1980,7113,2001,2046,24641,24465,377,18.390,385,18.780,7304,3257,4047,13.313,29.856,7044,3027,4017,12.373,28.793,260,1.063,57.585,253,254,1846
1980,7114,930,943,27893,27208,222,24.144,175,19.032,4532,1452,3080,5.337,16.657,3048,1527,1521,5.612,11.203,1484,5.454,22.406,131,131,1023
1980,7115,4434,4454,24406,25000,1465,35.284,861,20.737,8365,4555,3810,18.220,33.460,9589,3243,6346,12.972,38.356,-1224,-4.896,66.920,613,613,2220
1980,7121,1510,1596,28133,29012,77,4.521,291,17.087,3062,298,2764,1.027,10.554,4777,2200,2577,7.583,16.466,-1715,-5.911,21.109,96,96,445
1980,7131,1395,1641,51494,50106,355,22.583,217,13.804,9090,4501,4589,8.983,18.142,6164,1306,4858,2.606,12.302,2926,5.840,24.604,166,167,810
1980,7132,629,645,15700,15955,113,17.837,90,14.207,2141,826,1315,5.177,13.419,2665,911,1754,5.710,16.703,-524,-3.284,26.838,73,73,790
1980,7139,28743,30360,436528,432686,3752,12.511,3012,10.043,83699,30860,52839,7.132,19.344,76059,22651,53408,5.235,17.578,7640,1.766,35.157,2137,2153,14815
1980,7211,29141,32968,1015522,1003030,4152,12.528,4499,13.575,199821,86093,113728,8.583,19.922,174793,71790,103003,7.157,17.427,25028,2.495,34.853,3339,3357,43810
1980,7212,3226,3422,17473,17959,450,12.835,618,17.627,4506,1522,2984,8.475,25.090,5465,2019,3446,11.242,30.430,-959,-5.340,50.181,347,348,1003
1980,7213,5523,5599,31538,33215,322,5.645,532,9.327,4146,1022,3124,3.077,12.482,7345,4262,3083,12.832,22.114,-3199,-9.631,24.965,367,371,1374
1980,7223,16079,25003,468608,467006,4075,16.396,3777,15.197,113244,59708,53536,12.785,24.249,109844,42604,67240,9.123,23.521,3400,0.728,47.042,2308,2327,18377
1980,7224,64227,64992,347710,353203,9459,14.324,11547,17.486,92236,46468,45768,13.156,26.114,103628,45741,57887,12.950,29.340,-11392,-3.225,52.228,9203,9233,35898
1980,7225,174391,221320,3749490,3721699,38659,17.667,33665,15.385,926833,541661,385172,14.554,24.903,870309,335920,534389,9.026,23.385,56524,1.519,46.769,25444,25999,232899
1980,8111,87685,91147,423500,435455,14552,16.047,13627,15.027,90135,46475,43660,10.673,20.699,113996,44674,69322,10.259,26.179,-23861,-5.480,41.398,10648,10684,34841
1980,8112,9903,10958,62865,62925,1379,12.392,1720,15.456,11214,4618,6596,7.339,17.821,11345,4641,6704,7.375,18.029,-131,-0.208,35.642,1364,1364,3291
1980,8113,16451,17490,141198,137756,2580,14.943,2132,12.348,30160,10922,19238,7.929,21.894,23421,8463,14958,6.143,17.002,6739,4.892,34.004,1573,1581,6096
1980,8114,22084,23711,141233,144756,3642,15.361,3639,15.348,24986,11466,13520,7.921,17.261,32230,11843,20387,8.181,22.265,-7244,-5.004,34.522,2781,2784,8210
1980,8121,82561,90621,406446,409932,12516,13.778,12959,14.265,85896,43717,42179,10.664,20.954,92826,38034,54792,9.278,22.644,-6930,-1.691,41.907,10522,10599,29583
1980,8122,17389,19790,107772,108061,1394,7.125,945,4.830,15514,4968,10546,4.597,14.357,16104,2902,13202,2.686,14.903,-590,-0.546,28.713,621,634,1910
1980,8123,33197,38833,335190,340892,4064,10.382,4684,11.966,44782,17545,27237,5.147,13.137,55852,20102,35750,5.897,16.384,-11070,-3.247,26.273,3540,3633,14375
1980,8129,12252,18497,186955,180535,4003,22.648,2359,13.347,44831,22205,22626,12.300,24.832,31859,11855,20004,6.567,17.647,12972,7.185,35.294,1381,1428,6941
1980,8131,58696,58776,576382,576927,1878,3.217,1091,1.869,60676,7565,53111,1.311,10.517,61973,8069,53904,1.399,10.742,-1297,-0.225,21.034,7,9,469
1980,8132,6141,6893,109947,109853,636,9.118,800,11.470,27715,4430,23285,4.033,25.229,27318,11854,15464,10.791,24.868,397,0.361,49.736,279,283,2422
1980,8133,5776,6862,91273,107815,787,11.066,1287,18.096,16985,4298,12687,3.986,15.754,51074,14191,36883,13.162,47.372,-34089,-31.618,31.508,499,502,3927
1980,8134,27369,28584,235135,236640,1640,5.688,2137,7.412,33630,6119,27511,2.586,14.211,36868,8872,27996,3.749,15.580,-3238,-1.368,28.423,1190,1190,3732
1980,8139,53161,55206,406315,419099,4239,7.710,3789,6.891,72396,17137,55259,4.089,17.274,97913,30319,67594,7.234,23.363,-25517,-6.089,34.548,1933,1937,7287
1981,2111,6801,8730,163902,150938,1603,19.403,666,8.061,41302,12739,28563,8.440,27.364,15630,7514,8116,4.978,10.355,25672,17.008,20.710,340,347,2461
1981,2121,2956,3730,234448,232780,744,20.143,671,18.167,40121,14293,25828,6.140,17.236,36291,13942,22349,5.989,15.590,3830,1.645,31.181,444,446,6907
1981,2122,634,813,85189,85348,214,27.919,121,15.786,10744,3704,7040,4.340,12.589,11120,3031,8089,3.551,13.029,-376,-0.441,25.177,64,66,334
1981,2123,3665,5132,116373,115974,478,9.358,430,8.418,19783,7171,12612,6.183,17.058,19060,3567,15493,3.076,16.435,723,0.623,32.870,240,242,1577
1981,2131,10167,11620,363818,325142,3146,29.660,1120,10.559,127891,46831,81060,14.403,39.334,49874,20701,29173,6.367,15.339,78017,23.995,30.678,690,695,10917
1981,2211,1505,5630,546189,538235,180,3.218,108,1.931,29838,5026,24812,0.934,5.544,13939,4318,9621,0.802,2.590,15899,2.954,5.180,13,13,59
1981,2212,516,2314,135861,134651,113,4.937,63,2.752,8717,2834,5883,2.105,6.474,6282,1559,4723,1.158,4.665,2435,1.808,9.331,4,4,6
1981,2213,3564,3867,30520,29876,294,7.815,84,2.233,3759,1074,2685,3.595,12.582,2475,613,1862,2.052,8.284,1284,4.298,16.569,40,41,78
1981,2361,94616,94979,535622,559481,16684,16.909,24066,24.390,165618,63811,101807,11.405,29.602,213505,84531,128974,15.109,38.161,-47887,-8.559,59.204,17615,17619,62239
1981,2362,33551,34070,617490,627022,4752,13.856,5201,15.166,146994,35966,111028,5.736,23.443,164915,28622,136293,4.565,26.301,-17921,-2.858,46.886,3704,3704,16726
1981,2371,13695,14078,401254,404130,1513,10.735,1545,10.962,77563,15798,61765,3.909,19.193,83260,16176,67084,4.003,20.602,-5697,-1.410,38.385,1069,1069,8171
1981,2372,7666,7823,68968,68815,1755,22.852,1469,19.128,20644,9350,11294,13.587,29.999,20238,6804,13434,9.887,29.409,406,0.590,58.819,1055,1057,3798
1981,2373,10608,10900,224068,230422,990,9.023,1135,10.344,47501,12283,35218,5.331,20.615,59897,9271,50626,4.023,25.994,-12396,-5.380,41.230,764,764,5516
1981,2379,4583,4621,77215,75064,894,19.716,721,15.900,24799,9864,14935,13.141,33.037,20099,2869,17230,3.822,26.776,4700,6.261,53.552,537,537,1995
1981,2381,62302,62694,528682,542152,8038,12.507,11182,17.400,136619,39076,97543,7.208,25.199,163580,46722,116858,8.618,30.172,-26961,-4.973,50.399,7776,7777,33449
1981,2382,95313,97026,992681,997504,10882,11.177,11554,11.867,200471,52592,147879,5.272,20.097,209788,49233,160555,4.936,21.031,-9317,-0.934,40.195,8316,8330,35172
1981,2383,65188,65569,504660,518811,9539,14.152,13210,19.598,130636,39462,91174,7.606,25.180,158679,49007,109672,9.446,30.585,-28043,-5.405,50.360,9630,9634,36080
1981,2389,32911,33061,307650,301068,4854,14.628,5099,15.366,89183,22758,66425,7.559,29.622,75349,19729,55620,6.553,25.027,13834,4.595,50.054,3559,3562,13096
1981,3111,1949,2634,65383,66532,218,8.259,229,8.676,7884,3135,4749,4.712,11.850,10128,3386,6742,5.089,15.223,-2244,-3.373,23.700,137,139,1611
1981,3112,534,893,78076,79168,70,7.986,37,4.221,5249,1673,3576,2.113,6.630,7465,2196,5269,2.774,9.429,-2216,-2.799,13.260,19,19,254
1981,3113,1216,1609,90183,90781,186,11.791,123,7.797,7775,1974,5801,2.174,8.565,8905,1402,7503,1.544,9.809,-1130,-1.245,17.129,46,48,236
1981,3114,1268,1780,187615,190581,156,8.809,138,7.792,18638,4048,14590,2.124,9.780,24296,6548,17748,3.436,12.748,-5658,-2.969,19.559,67,68,1039
1981,3115,1926,2717,146498,146425,141,5.154,178,6.507,15256,5195,10061,3.548,10.419,14856,5994,8862,4.094,10.146,400,0.273,20.292,93,93,1433
1981,3116,4473,5082,331041,335895,554,11.066,403,8.050,40667,17428,23239,5.189,12.107,51893,24709,27184,7.356,15.449,-11226,-3.342,24.214,255,261,5045
1981,3117,728,862,45477,46683,87,10.158,76,8.873,8543,3522,5021,7.545,18.300,11137,3926,7211,8.410,23.857,-2594,-5.557,36.600,39,39,1522
1981,3118,8166,9612,295788,301075,1157,12.109,1043,10.916,32393,12591,19802,4.182,10.759,42789,18188,24601,6.041,14.212,-10396,-3.453,21.518,628,650,8590
1981,3119,1969,2336,116204,116976,243,10.547,179,7.769,15532,6242,9290,5.336,13.278,17227,5599,11628,4.786,14.727,-1695,-1.449,26.556,82,82,1264
1981,3121,2164,2758,184522,185851,217,7.894,199,7.239,17622,6826,10796,3.673,9.482,20095,8732,11363,4.698,10.812,-2473,-1.331,18.964,124,126,2844
1981,3122,124,185,47002,45871,10,5.391,11,5.930,3965,600,3365,1.308,8.644,1604,367,1237,0.800,3.497,2361,5.147,6.994,8,8,223
1981,3131,447,702,120132,124120,34,4.749,62,8.659,6845,1338,5507,1.078,5.515,14814,4474,10340,3.605,11.935,-7969,-6.420,11.030,27,28,575
1981,3132,1788,2227,348334,356439,207,9.358,177,8.002,22305,9097,13208,2.552,6.258,38459,11383,27076,3.194,10.790,-16154,-4.532,12.515,110,111,2278
1981,3133,1606,1842,119370,122655,204,11.327,122,6.774,10168,3677,6491,2.998,8.290,16631,3946,12685,3.217,13.559,-6463,-5.269,16.580,69,70,1670
1981,3141,4239,4547,119844,124782,538,11.828,541,11.894,13513,6408,7105,5.135,10.829,23341,7133,16208,5.716,18.705,-9828,-7.876,21.659,396,400,3113
1981,3149,3386,3530,130067,133082,485,14.005,351,10.136,18003,7016,10987,5.272,13.528,23958,7702,16256,5.787,18.003,-5955,-4.475,27.056,209,209,2731
1981,3151,1402,1543,144671,145596,164,10.729,135,8.832,14167,3506,10661,2.408,9.730,15782,4131,11651,2.837,10.840,-1615,-1.109,19.461,110,111,2497
1981,3152,13410,15182,938910,942445,2314,15.619,1580,10.665,137852,57206,80646,6.070,14.627,145025,48197,96828,5.114,15.388,-7173,-0.761,29.254,1090,1102,23276
1981,3159,1763,1887,82139,82891,263,14.332,159,8.665,10806,2988,7818,3.605,13.036,12224,3850,8374,4.645,14.747,-1418,-1.711,26.073,113,113,1800
1981,3161,373,415,21377,20946,42,10.108,43,10.349,3205,841,2364,4.015,15.301,2355,1105,1250,5.275,11.243,850,4.058,22.486,31,34,635
1981,3162,510,754,143943,143773,64,8.550,53,7.081,17736,3302,14434,2.297,12.336,17065,5939,11126,4.131,11.869,671,0.467,23.739,24,24,1137
1981,3169,1387,1437,62840,65434,194,13.754,141,9.996,8671,2740,5931,4.187,13.252,13648,4264,9384,6.516,20.858,-4977,-7.606,26.503,93,93,1787
1981,3211,5488,6051,150934,157557,727,11.978,764,12.588,19084,7939,11145,5.039,12.112,32266,8231,24035,5.224,20.479,-13182,-8.366,24.225,562,566,4758
1981,3212,1082,1353,84936,87443,158,11.773,136,10.134,10241,3904,6337,4.465,11.712,15190,4454,10736,5.094,17.371,-4949,-5.660,23.423,81,85,1220
1981,3219,8498,9300,271839,279962,1368,15.073,920,10.137,37398,16945,20453,6.053,13.358,53664,16579,37085,5.922,19.168,-16266,-5.810,26.717,611,615,7004
1981,3221,353,711,216269,217477,43,5.952,66,9.135,11612,4523,7089,2.080,5.339,14173,3857,10316,1.774,6.517,-2561,-1.178,10.679,17,19,647
1981,3222,3500,5087,406743,410144,436,8.702,283,5.648,39055,19849,19206,4.840,9.522,46622,14676,31946,3.578,11.367,-7567,-1.845,19.045,122,122,2578
1981,3231,32229,33691,664190,653562,5191,16.100,2292,7.109,100227,45909,54318,7.024,15.336,78227,27288,50939,4.175,11.969,22000,3.366,23.939,1492,1498,9307
1981,3241,1536,2419,528870,541123,268,11.197,217,9.066,24488,6211,18277,1.148,4.525,49453,9949,39504,1.839,9.139,-24965,-4.614,9.051,74,74,1152
1981,3251,1132,2219,273804,278184,251,11.620,133,6.157,16456,6107,10349,2.195,5.916,25657,4461,21196,1.604,9.223,-9201,-3.308,11.831,35,35,669
1981,3252,402,641,155374,158071,62,9.896,33,5.267,7971,3058,4913,1.935,5.043,13247,2655,10592,1.680,8.380,-5276,-3.338,10.085,18,18,187
1981,3253,772,1136,59179,57616,99,8.777,83,7.358,8423,3371,5052,5.851,14.619,5271,1686,3585,2.926,9.149,3152,5.471,18.297,35,37,538
1981,3254,954,1194,164353,163064,154,13.276,86,7.414,14254,3538,10716,2.170,8.741,11595,3137,8458,1.924,7.111,2659,1.631,14.221,44,44,307
1981,3255,1658,2116,77737,79409,171,8.149,136,6.481,6351,1964,4387,2.473,7.998,9834,3115,6719,3.923,12.384,-3483,-4.386,15.996,72,77,515
1981,3256,2050,2304,121233,119431,282,12.601,150,6.702,16027,4198,11829,3.515,13.420,12272,2739,9533,2.293,10.275,3755,3.144,20.551,97,97,1069
1981,3259,1632,2152,95179,95036,293,14.127,137,6.606,11540,6009,5531,6.323,12.143,11028,3016,8012,3.174,11.604,512,0.539,23.208,65,65,527
1981,3261,9700,11209,519829,526357,1417,12.989,817,7.489,70748,27767,42981,5.275,13.441,84400,22228,62172,4.223,16.035,-13652,-2.594,26.882,491,493,6676
1981,3262,1862,2235,194490,205417,233,10.608,156,7.102,13001,3235,9766,1.575,6.329,35463,14490,20973,7.054,17.264,-22462,-10.935,12.658,87,87,1642
1981,3271,1334,1637,87633,92183,241,14.997,181,11.263,7176,3257,3919,3.533,7.785,16243,4562,11681,4.949,17.620,-9067,-9.836,15.569,127,128,1722
1981,3272,1493,1779,173973,175644,274,15.939,154,8.959,13021,5185,7836,2.952,7.413,16652,4424,12228,2.519,9.481,-3631,-2.067,14.827,95,95,1196
1981,3273,7326,9243,184955,188640,736,8.026,590,6.434,25843,9339,16504,4.951,13.700,33188,7834,25354,4.153,17.593,-7345,-3.894,27.399,347,353,3030
1981,3274,253,352,17063,16886,58,16.934,39,11.387,1922,1219,703,7.219,11.382,1529,226,1303,1.338,9.055,393,2.327,18.110,32,32,79
1981,3279,2031,2343,88060,90087,294,12.785,207,9.002,10094,4041,6053,4.486,11.205,13943,3891,10052,4.319,15.477,-3849,-4.273,22.410,143,143,949
1981,3311,252,266,26798,26288,52,20.352,31,12.133,6897,3831,3066,14.573,26.237,5530,3929,1601,14.946,21.037,1367,5.200,42.073,17,17,233
1981,3312,529,706,79282,79302,71,10.282,40,5.793,8507,3659,4848,4.614,10.727,8443,1657,6786,2.089,10.647,64,0.081,21.293,21,22,875
1981,3313,448,742,161329,167156,56,7.609,44,5.978,9478,3563,5915,2.132,5.670,20809,6610,14199,3.954,12.449,-11331,-6.779,11.340,8,8,405
1981,3314,792,958,105927,109103,160,17.477,75,8.192,8851,4266,4585,3.910,8.113,15341,6363,8978,5.832,14.061,-6490,-5.949,16.225,38,39,263
1981,3315,2916,3288,291400,303913,276,8.538,165,5.104,26374,11244,15130,3.700,8.678,51498,13091,38407,4.307,16.945,-25124,-8.267,17.356,100,102,3347
1981,3321,2919,3160,156425,160481,336,10.932,163,5.303,14765,5998,8767,3.738,9.200,22895,3536,19359,2.203,14.267,-8130,-5.066,18.401,104,104,1887
1981,3322,1162,1294,92347,95387,141,11.168,78,6.178,6620,2477,4143,2.597,6.940,12611,1890,10721,1.981,13.221,-5991,-6.281,13.880,49,50,582
1981,3323,9796,10636,367318,370634,1279,12.355,711,6.868,54033,19289,34744,5.204,14.579,60616,14866,45750,4.011,16.355,-6583,-1.776,29.157,485,488,5233
1981,3324,1417,1811,151707,155518,177,9.972,105,5.915,13170,4970,8200,3.196,8.469,20853,3803,17050,2.445,13.409,-7683,-4.940,16.937,61,61,994
1981,3325,861,942,85775,89163,99,10.651,74,7.961,6067,2651,3416,2.973,6.804,12847,2817,10030,3.159,14.409,-6780,-7.604,13.609,39,40,369
1981,3326,1578,1767,67340,69733,198,11.488,111,6.440,9424,4810,4614,6.898,13.514,14215,3781,10434,5.422,20.385,-4791,-6.870,27.029,58,58,631
1981,3327,20456,20774,348160,351679,2811,13.940,1594,7.905,47865,19289,28576,5.485,13.610,54999,10831,44168,3.080,15.639,-7134,-2.029,27.221,1126,1129,6634
1981,3328,5350,5641,122054,123309,591,10.687,369,6.673,17621,7187,10434,5.828,14.290,20037,4657,15380,3.777,16.249,-2416,-1.959,28.580,244,250,2676
1981,3329,4780,5326,401031,404693,737,14.340,364,7.082,38800,14383,24417,3.554,9.588,46299,11793,34506,2.914,11.441,-7499,-1.853,19.175,214,214,2313
1981,3331,3157,3642,397481,402843,532,15.228,235,6.727,61798,26083,35715,6.475,15.340,71689,20736,50953,5.147,17.796,-9891,-2.455,30.681,135,135,1734
1981,3332,3598,3863,196822,198302,430,11.484,193,5.154,22125,10114,12011,5.100,11.157,25172,4732,20440,2.386,12.694,-3047,-1.537,22.315,117,118,1119
1981,3333,2038,2155,160121,160581,212,9.986,148,6.971,18447,4598,13849,2.863,11.488,19449,5120,14329,3.188,12.112,-1002,-0.624,22.975,85,85,1053
1981,3334,1890,2138,184672,188425,350,17.061,177,8.628,22977,8559,14418,4.542,12.194,29778,7721,22057,4.098,15.804,-6801,-3.609,24.389,120,120,1584
1981,3335,10042,10502,305448,309357,1167,11.468,516,5.071,30504,11850,18654,3.831,9.860,38344,6643,31701,2.147,12.395,-7840,-2.534,19.721,343,343,3386
1981,3336,669,827,181661,190765,87,10.787,46,5.704,11374,4417,6957,2.315,5.962,29490,8329,21161,4.366,15.459,-18116,-9.497,11.925,21,22,573
1981,3339,5922,6489,384124,394479,748,11.854,390,6.181,43021,15658,27363,3.969,10.906,63646,15938,47708,4.040,16.134,-20625,-5.228,21.812,252,253,3010
1981,3341,1132,1319,329235,321449,310,25.348,118,9.648,48618,16330,32288,5.080,15.125,33024,11258,21766,3.502,10.273,15594,4.851,20.547,59,59,3088
1981,3342,1645,1832,283305,291507,297,16.875,153,8.693,28773,10831,17942,3.716,9.870,45788,10067,35721,3.453,15.707,-17015,-5.837,19.741,80,82,3442
1981,3343,472,499,60817,62534,77,15.827,52,10.689,4653,995,3658,1.591,7.441,7989,2579,5410,4.124,12.776,-3336,-5.335,14.882,33,33,474
1981,3344,3678,4155,462136,462821,709,18.002,276,7.008,59763,24186,35577,5.226,12.913,61104,18104,43000,3.912,13.203,-1341,-0.290,25.826,166,167,3502
1981,3345,3644,4185,601221,595466,593,14.702,290,7.190,65545,21305,44240,3.578,11.007,53649,14474,39175,2.431,9.010,11896,1.998,18.019,133,133,2021
1981,3346,562,588,20141,20669,109,18.957,83,14.435,3028,1341,1687,6.488,14.650,3972,1273,2699,6.159,19.218,-944,-4.567,29.301,62,62,632
1981,3351,1185,1294,82150,85173,154,12.150,101,7.968,6840,2478,4362,2.909,8.031,12781,3113,9668,3.655,15.006,-5941,-6.975,16.061,71,73,1000
1981,3352,379,486,144173,148334,59,12.447,35,7.384,8966,2390,6576,1.611,6.044,17479,3052,14427,2.058,11.784,-8513,-5.739,12.089,20,20,778
1981,3353,1915,2409,295653,300750,267,11.401,133,5.679,30876,14459,16417,4.808,10.266,41041,10824,30217,3.599,13.646,-10165,-3.380,20.533,72,72,988
1981,3359,1649,1976,192624,192368,281,14.828,119,6.280,23401,11595,11806,6.028,12.165,22468,5396,17072,2.805,11.680,933,0.485,23.359,65,65,670
1981,3361,177,231,242851,253018,44,19.256,39,17.068,32564,13867,18697,5.481,12.870,52056,19161,32895,7.573,20.574,-19492,-7.704,25.740,24,24,143
1981,3362,1675,1863,101363,110974,216,11.468,257,13.645,16021,2842,13179,2.561,14.437,35266,9708,25558,8.748,31.779,-19245,-17.342,28.874,164,165,2302
1981,3363,3416,4165,616406,642348,499,12.184,360,8.790,54490,16449,38041,2.561,8.483,105393,24145,81248,3.759,16.407,-50903,-7.925,16.966,205,206,2850
1981,3364,1134,1346,677983,672201,185,14.308,79,6.110,47680,6177,41503,0.919,7.093,38012,3805,34207,0.566,5.655,9668,1.438,11.310,52,52,1114
1981,3365,164,212,57248,67105,24,11.622,13,6.295,2158,531,1627,0.791,3.216,21912,1014,20898,1.511,32.653,-19754,-29.437,6.432,6,6,77
1981,3366,1145,1250,211717,206884,176,14.367,126,10.286,28156,6743,21413,3.259,13.610,18249,5571,12678,2.693,8.821,9907,4.789,17.642,85,85,3338
1981,3369,430,441,33889,34228,66,15.190,53,12.198,4647,2773,1874,8.102,13.577,5563,694,4869,2.028,16.253,-916,-2.676,27.154,38,38,322
1981,3371,11828,12470,371420,378441,1798,14.673,1366,11.147,47196,21877,25319,5.781,12.471,60876,17881,42995,4.725,16.086,-13680,-3.615,24.942,998,1002,7869
1981,3372,2280,2395,116787,118642,308,13.216,179,7.681,13231,5296,7935,4.464,11.152,16977,3421,13556,2.883,14.309,-3746,-3.157,22.304,135,135,1342
1981,3379,1091,1228,39657,39669,126,10.461,79,6.559,4900,1845,3055,4.651,12.352,5045,1416,3629,3.570,12.718,-145,-0.366,24.704,48,48,620
1981,3391,9123,9670,215046,211715,1344,14.185,953,10.059,33794,16229,17565,7.666,15.962,26801,10308,16493,4.869,12.659,6993,3.303,25.318,649,655,2706
1981,3399,14206,14878,438501,445338,1969,13.497,1389,9.522,60192,21902,38290,4.918,13.516,74001,23345,50656,5.242,16.617,-13809,-3.101,27.032,929,934,10652
1981,4231,23039,28879,316071,322198,2615,9.070,2517,8.730,43133,18013,25120,5.591,13.387,55332,18662,36670,5.792,17.173,-12199,-3.786,26.774,1569,1631,8913
1981,4232,7367,8598,98230,97929,1156,13.737,790,9.388,16957,5570,11387,5.688,17.316,16176,6408,9768,6.544,16.518,781,0.798,33.036,502,510,2669
1981,4233,7370,9324,110939,112856,1119,12.162,873,9.488,18476,8041,10435,7.125,16.371,22378,6266,16112,5.552,19.829,-3902,-3.458,32.743,536,548,3207
1981,4234,18113,24932,434359,422868,3765,15.562,2287,9.453,77527,35290,42237,8.345,18.334,54162,21109,33053,4.992,12.808,23365,5.525,25.617,1192,1220,6137
1981,4235,6191,8698,141069,140939,1010,11.848,663,7.778,20474,7917,12557,5.617,14.527,20251,6281,13970,4.457,14.369,223,0.158,28.737,318,325,2338
1981,4236,13270,19183,248189,241434,2555,13.706,1472,7.896,48742,19451,29291,8.056,20.189,35095,10987,24108,4.551,14.536,13647,5.652,29.072,794,835,3754
1981,4237,10554,13784,151238,151204,1378,10.161,933,6.880,21985,8777,13208,5.805,14.540,21766,6528,15238,4.317,14.395,219,0.145,28.790,601,614,3453
1981,4238,45754,59965,697662,692501,6701,11.403,4298,7.314,111117,43742,67375,6.317,16.046,100752,30302,70450,4.376,14.549,10365,1.497,29.098,2495,2572,13317
1981,4239,21347,23042,225014,223122,3598,16.088,2243,10.029,43379,18197,25182,8.156,19.442,39659,12585,27074,5.640,17.775,3720,1.667,35.549,1532,1555,6186
1981,4241,6905,9381,138623,136539,989,10.748,631,6.857,21339,6842,14497,5.011,15.629,17342,5267,12075,3.858,12.701,3997,2.927,25.402,321,336,1546
1981,4242,2561,3325,94687,92802,489,15.121,307,9.493,16248,6789,9459,7.316,17.508,12837,4313,8524,4.648,13.833,3411,3.676,27.666,198,200,1246
1981,4243,10188,11112,115440,114844,1608,14.667,1311,11.958,25399,11168,14231,9.724,22.116,24467,8191,16276,7.132,21.305,932,0.812,42.609,883,897,4364
1981,4244,26106,32026,562748,553412,3692,11.643,3058,9.644,92292,37444,54848,6.766,16.677,73348,27060,46288,4.890,13.254,18944,3.423,26.508,1993,2037,13329
1981,4245,8761,11940,107607,108006,890,7.486,789,6.636,16347,6710,9637,6.213,15.135,17318,4713,12605,4.364,16.034,-971,-0.899,30.271,518,537,3078
1981,4246,5971,8949,111570,108356,1184,13.604,693,7.962,22870,9304,13566,8.587,21.106,16495,5233,11262,4.829,15.223,6375,5.883,30.446,358,366,1857
1981,4247,11998,15859,157465,154311,1341,8.454,1347,8.492,31191,10049,21142,6.512,20.213,24831,8616,16215,5.584,16.092,6360,4.122,32.183,752,769,3848
1981,4248,4757,5775,133315,129187,407,7.097,327,5.702,18839,5903,12936,4.569,14.583,10639,3366,7273,2.606,8.235,8200,6.347,16.471,218,228,1894
1981,4249,18621,22704,241077,238580,2750,12.288,2100,9.384,42420,15936,26484,6.680,17.780,37596,11965,25631,5.015,15.758,4824,2.022,31.516,1468,1502,6298
1981,4251,27533,30472,293550,288574,3868,13.020,2340,7.877,54687,22526,32161,7.806,18.951,44731,13377,31354,4.636,15.501,9956,3.450,31.001,1447,1457,6921
1981,4411,37999,38975,752140,784965,3010,7.566,4626,11.628,76152,30263,45889,3.855,9.701,141500,44503,96997,5.669,18.026,-65348,-8.325,19.403,3614,3657,34619
1981,4412,11599,11997,74796,76349,1140,9.343,1549,12.695,14247,4822,9425,6.316,18.660,17331,6289,11042,8.237,22.700,-3084,-4.039,37.321,1162,1180,4430
1981,4413,41243,58176,381941,379838,5248,9.093,4330,7.502,62325,26920,35405,7.087,16.408,58522,18304,40218,4.819,15.407,3803,1.001,30.814,2463,2557,9624
1981,4421,23401,27770,215164,219568,2533,9.093,2706,9.714,31794,11913,19881,5.426,14.480,40552,12714,27838,5.790,18.469,-8758,-3.989,28.961,1985,2030,8388
1981,4422,19255,22309,119590,120725,3036,13.780,2481,11.261,23569,11043,12526,9.147,19.523,25738,8806,16932,7.294,21.320,-2169,-1.797,39.046,1778,1814,5967
1981,4431,23979,30883,176717,179206,3962,12.817,4022,13.011,35329,17095,18234,9.539,19.714,40386,15064,25322,8.406,22.536,-5057,-2.822,39.428,2564,2756,9122
1981,4441,55875,70566,646913,649639,5879,8.385,4973,7.093,92246,38496,53750,5.926,14.200,97815,25041,72774,3.855,15.057,-5569,-0.857,28.399,3462,3524,14125
1981,4442,14040,16991,121914,120293,1705,10.121,1416,8.405,21425,7310,14115,6.077,17.811,18279,5241,13038,4.357,15.195,3146,2.615,30.391,1000,1033,3677
1981,4451,65283,108571,1806841,1768923,13718,12.851,10075,9.438,300665,150387,150278,8.502,16.997,222183,79273,142910,4.481,12.560,78482,4.437,25.121,6242,6388,32702
1981,4452,23258,28991,176502,176553,3902,13.508,3692,12.781,39594,18716,20878,10.601,22.426,39756,15837,23919,8.970,22.518,-162,-0.092,44.852,2429,2525,9862
1981,4453,28200,30621,147844,147921,3156,10.305,3165,10.335,28617,11009,17608,7.443,19.346,28729,10201,18528,6.896,19.422,-112,-0.076,38.692,2243,2287,6814
1981,4461,41216,59071,532183,532340,5751,9.901,3778,6.504,78604,34818,43786,6.541,14.766,78536,21486,57050,4.036,14.753,68,0.013,29.506,2389,2457,12025
1981,4471,108420,139198,786703,783403,14724,10.452,18076,12.831,171312,68757,102555,8.777,21.868,165171,68135,97036,8.697,21.084,6141,0.784,42.168,11905,12192,43360
1981,4481,59694,96666,763522,764327,11547,12.039,10045,10.473,137785,66125,71660,8.651,18.027,139055,45938,93117,6.010,18.193,-1270,-0.166,36.054,6109,6847,24786
1981,4482,12370,34705,189925,185088,4469,13.139,3085,9.070,44432,22094,22338,11.937,24.006,35607,11716,23891,6.330,19.238,8825,4.768,38.476,1090,1216,4441
1981,4483,17224,24625,144454,148253,3076,12.757,2050,8.502,29199,15073,14126,10.167,19.695,37346,8877,28469,5.988,25.191,-8147,-5.495,39.391,1258,1320,4666
1981,4511,32023,40183,246418,243261,5587,14.014,4953,12.424,52580,21265,31315,8.742,21.615,46242,17660,28582,7.260,19.009,6338,2.605,38.018,3362,3504,10524
1981,4512,7477,10653,66920,67389,1520,14.504,1174,11.202,13049,6186,6863,9.180,19.364,14036,4824,9212,7.158,20.828,-987,-1.465,38.727,737,773,2403
1981,4521,636,10000,1541226,1546835,759,7.774,285,2.919,145357,86427,58930,5.587,9.397,156466,20540,135926,1.328,10.115,-11109,-0.718,18.794,30,38,2031
1981,4529,14378,26798,379533,386147,1979,7.294,2644,9.745,44175,21575,22600,5.587,11.440,56980,19137,37843,4.956,14.756,-12805,-3.316,22.880,1484,1514,5090
1981,4531,20472,21720,102427,103025,2635,12.243,2241,10.412,19086,6878,12208,6.676,18.526,20350,6166,14184,5.985,19.752,-1264,-1.227,37.051,1596,1617,4292
1981,4532,22925,27444,162203,159093,4263,15.842,3195,11.873,36954,17464,19490,10.977,23.228,30759,11936,18823,7.503,19.334,6195,3.894,38.668,2153,2193,6304
1981,4533,8471,9947,46248,46126,1460,14.896,1169,11.927,9840,4715,5125,10.222,21.333,9524,3794,5730,8.225,20.648,316,0.685,41.296,845,848,2287
1981,4539,26457,31256,140139,139587,4489,14.472,4016,12.947,33508,14285,19223,10.234,24.005,32443,13027,19416,9.333,23.242,1065,0.763,46.484,2672,2790,8202
1981,4541,5277,7005,89813,91027,939,13.504,836,12.023,13579,4686,8893,5.148,14.918,15933,5753,10180,6.320,17.504,-2354,-2.586,29.835,531,535,2067
1981,4542,4286,5503,82323,83624,528,9.550,580,10.490,11165,3562,7603,4.260,13.351,13826,3502,10324,4.188,16.534,-2661,-3.182,26.703,353,356,1359
1981,4543,16554,22060,191914,193043,1931,8.727,2062,9.320,29693,10497,19196,5.438,15.382,31799,10587,21212,5.484,16.472,-2106,-1.091,30.763,1419,1437,6351
1981,4811,1069,2573,260402,262415,343,14.034,85,3.478,17017,4631,12386,1.765,6.485,21280,1501,19779,0.572,8.109,-4263,-1.625,12.970,9,11,182
1981,4812,428,621,10002,9228,130,23.009,18,3.186,2100,864,1236,9.363,22.757,566,135,431,1.463,6.134,1534,16.623,12.267,7,7,11
1981,4831,424,682,35744,37003,79,11.907,42,6.330,5596,1508,4088,4.075,15.123,7845,1360,6485,3.675,21.201,-2249,-6.078,30.246,9,9,12
1981,4832,422,489,17414,16899,53,11.325,11,2.350,3801,1718,2083,10.167,22.493,2804,470,2334,2.781,16.593,997,5.900,33.186,(D),(D),(D)
1981,4841,19796,25054,485187,494495,3932,15.748,3759,15.056,67102,26954,40148,5.451,13.570,86081,23619,62462,4.776,17.408,-18979,-3.838,27.140,2777,2784,11036
1981,4842,40824,44634,551208,558441,6331,14.221,6098,13.698,92465,33503,58962,5.999,16.558,106740,32043,74697,5.738,19.114,-14275,-2.556,33.115,4456,4471,16873
1981,4851,393,430,20157,20872,37,8.467,51,11.670,2309,447,1862,2.142,11.063,3829,2745,1084,13.152,18.346,-1520,-7.283,22.126,24,24,263
1981,4852,327,769,38754,38545,30,3.929,19,2.489,2668,622,2046,1.614,6.922,2284,859,1425,2.229,5.926,384,0.996,11.851,9,9,55
1981,4853,5637,5694,61395,62170,777,14.294,261,4.801,10859,3344,7515,5.379,17.467,12370,1623,10747,2.611,19.897,-1511,-2.430,34.934,178,181,937
1981,4854,3695,3885,94484,93376,342,8.786,357,9.171,15283,6180,9103,6.618,16.367,13048,3752,9296,4.018,13.974,2235,2.394,27.947,281,281,1982
1981,4855,482,511,10027,9628,78,15.584,57,11.389,2092,827,1265,8.590,21.729,1308,319,989,3.313,13.586,784,8.143,27.172,45,45,224
1981,4859,822,857,15351,15387,138,16.178,130,15.240,3161,1243,1918,8.079,20.544,3285,1717,1568,11.159,21.350,-124,-0.806,41.088,103,103,634
1981,4861,87,325,11929,11397,43,13.849,14,4.509,1898,680,1218,5.966,16.654,848,380,468,3.334,7.441,1050,9.213,14.881,0,0,0
1981,4862,230,1154,58855,57370,146,13.431,12,1.104,5950,1984,3966,3.458,10.371,2980,132,2848,0.230,5.194,2970,5.177,10.389,0,0,0
1981,4869,71,268,6670,6805,29,10.964,22,8.318,716,213,503,3.130,10.522,1001,116,885,1.705,14.711,-285,-4.188,21.045,(D),(D),(D)
1981,4871,163,168,2377,2228,23,14.154,12,7.385,561,109,452,4.893,25.185,281,54,227,2.424,12.615,280,12.570,25.230,9,9,35
1981,4872,676,682,8517,8858,129,19.635,79,12.024,2030,720,1310,8.128,22.917,2664,1437,1227,16.223,30.075,-634,-7.157,45.834,50,50,222
1981,4879,53,64,1071,1083,16,27.826,3,5.217,105,45,60,4.157,9.700,132,16,116,1.478,12.194,-27,-2.494,19.400,(D),(D),(D)
1981,4881,2129,2607,54520,53054,413,16.878,93,3.801,9730,3500,6230,6.597,18.340,6874,2311,4563,4.356,12.957,2856,5.383,25.913,30,32,86
1981,4882,272,352,8757,8956,63,19.149,17,5.167,1904,799,1105,8.922,21.261,2265,589,1676,6.577,25.292,-361,-4.031,42.521,(D),(D),(D)
1981,4883,2250,2663,121258,122542,372,14.806,71,2.826,22461,4854,17607,3.961,18.329,24815,3082,21733,2.515,20.250,-2354,-1.921,36.658,14,16,602
1981,4884,1765,2309,35321,35751,376,16.355,356,15.485,5028,2530,2498,7.077,14.064,5824,1609,4215,4.501,16.291,-796,-2.227,28.128,232,233,839
1981,4885,4178,5943,80894,79990,839,14.852,251,4.443,15590,6247,9343,7.810,19.490,14145,2002,12143,2.503,17.684,1445,1.806,35.367,70,74,361
1981,4889,387,397,7046,6754,65,17.380,19,5.080,1786,984,802,14.569,26.444,1219,303,916,4.486,18.049,567,8.395,36.097,13,13,38
1981,4921,1147,1694,103227,105511,376,23.813,146,9.246,6711,2741,3970,2.598,6.360,10870,756,10114,0.717,10.302,-4159,-3.942,12.721,96,96,333
1981,4922,787,787,3600,3634,270,35.202,230,29.987,1357,889,468,24.467,37.347,1478,662,816,18.219,40.677,-121,-3.330,74.694,190,190,550
1981,4931,6416,9912,400103,401103,845,8.635,592,6.050,51705,19223,32482,4.793,12.891,53352,9503,43849,2.369,13.301,-1647,-0.411,25.781,268,270,1620
1981,5111,13193,14905,597800,591277,2163,14.938,1313,9.068,60939,22829,38110,3.861,10.306,47926,15781,32145,2.669,8.106,13013,2.201,16.211,982,988,6995
1981,5112,5465,6474,96853,88132,1909,32.711,633,10.846,31967,14729,17238,16.712,36.272,14528,6123,8405,6.948,16.484,17439,19.787,32.969,330,346,1955
1981,5121,8754,14131,186571,186369,1971,14.097,1672,11.959,47101,18190,28911,9.760,25.273,46341,13289,33052,7.130,24.865,760,0.408,49.730,887,927,5194
1981,5122,1479,1486,10369,10199,396,28.664,187,13.536,2666,1424,1242,13.963,26.141,2337,974,1363,9.550,22.915,329,3.226,45.830,120,120,626
1981,5151,5583,6600,199747,193745,623,9.800,137,2.155,29232,11357,17875,5.862,15.088,17380,3000,14380,1.548,8.971,11852,6.117,17.941,31,39,337
1981,5152,8,8,183,107,5,83.333,(D),(D),158,158,0,147.664,147.664,10,(D),7,(D),9.346,148,138.318,18.692,(D),(D),(D)
1981,5171,1554,12465,904571,898595,279,2.227,409,3.264,192433,4459,187974,0.496,21.415,181197,3678,177519,0.409,20.164,11236,1.250,40.329,80,80,350
1981,5172,531,1292,65340,66536,137,10.877,72,5.717,14747,1689,13058,2.538,22.164,17450,339,17111,0.509,26.226,-2703,-4.062,44.328,32,32,135
1981,5174,600,1038,32796,28232,177,18.276,38,3.924,11066,3433,7633,12.160,39.197,1960,386,1574,1.367,6.943,9106,32.255,13.885,5,5,68
1981,5179,1103,2148,72982,71383,298,14.491,115,5.592,19527,3132,16395,4.388,27.355,16936,1161,15775,1.626,23.726,2591,3.630,47.451,53,53,130
1981,5182,5490,7188,196190,195948,1335,19.263,820,11.832,39112,16812,22300,8.580,19.960,38914,14577,24337,7.439,19.859,198,0.101,39.719,423,436,3950
1981,5191,1940,2294,27962,27150,232,10.254,169,7.470,4269,1592,2677,5.864,15.724,2613,899,1714,3.311,9.624,1656,6.100,19.249,103,108,522
1981,5211,20,48,20981,20551,6,13.333,0,0.000,1015,147,868,0.715,4.939,120,0,120,0.000,0.584,895,4.355,1.168,0,0,0
1981,5221,21067,65043,1806178,1764740,3915,6.168,769,1.212,183873,51984,131889,2.946,10.419,101327,14216,87111,0.806,5.742,82546,4.678,11.484,213,247,1901
1981,5222,23062,43223,342326,341068,3594,8.365,3073,7.153,57002,25268,31734,7.408,16.713,54725,19837,34888,5.816,16.045,2277,0.668,32.090,356,376,1413
1981,5223,2794,3151,42965,39493,648,21.837,281,9.469,12484,6570,5914,16.636,31.611,5597,2212,3385,5.601,14.172,6887,17.439,28.344,180,189,793
1981,5231,4975,9474,219849,204302,1623,18.275,437,4.921,47311,14208,33103,6.954,23.157,16146,4514,11632,2.209,7.903,31165,15.254,15.806,173,181,2558
1981,5232,113,127,6398,6107,25,21.645,(D),(D),954,231,723,3.783,15.623,377,(D),145,(D),6.174,577,9.449,12.347,0,0,0
1981,5239,10108,10455,80704,73027,2212,23.075,474,4.945,25207,11100,14107,15.200,34.517,9662,2697,6965,3.693,13.231,15545,21.287,26.461,257,258,735
1981,5241,6214,30296,1232053,1221890,2507,8.377,1771,5.918,156225,71173,85052,5.825,12.786,135238,37867,97371,3.099,11.068,20987,1.718,22.136,132,163,1087
1981,5242,86424,91158,542211,526450,9872,11.324,1913,2.194,92933,37972,54961,7.213,17.653,61571,10982,50589,2.086,11.696,31362,5.957,23.391,907,927,3072
1981,5250,1507,1699,14799,14188,203,12.504,52,3.203,3347,984,2363,6.935,23.590,2089,186,1903,1.311,14.724,1258,8.867,29.447,13,14,53
1981,5311,102184,104001,504082,484492,12187,12.310,2183,2.205,112598,50488,62110,10.421,23.240,74209,11909,62300,2.458,15.317,38389,7.924,30.634,1158,1225,4054
1981,5312,33171,34254,175082,169003,5568,17.366,1186,3.699,44706,19191,25515,11.355,26.453,33108,5029,28079,2.976,19.590,11598,6.863,39.180,685,704,1871
1981,5313,20081,20714,184706,176586,3466,17.867,836,4.310,44442,17140,27302,9.706,25.167,28228,5209,23019,2.950,15.985,16214,9.182,31.971,480,487,1538
1981,5321,5472,8995,101310,100876,1177,13.159,1076,12.030,18883,7634,11249,7.568,18.719,18395,6532,11863,6.475,18.235,488,0.484,36.471,601,613,2745
1981,5322,8200,9900,85786,83598,1867,19.356,1358,14.079,23966,10289,13677,12.308,28.668,19484,8524,10960,10.196,23.307,4482,5.361,46.614,922,932,4684
1981,5323,2254,2534,20702,19951,444,18.257,240,9.868,5042,2329,2713,11.674,25.273,3541,1170,2371,5.865,17.749,1501,7.524,35.498,148,148,682
1981,5324,3948,4542,45893,45695,731,16.657,424,9.662,11998,4888,7110,10.697,26.257,11348,2654,8694,5.808,24.834,650,1.422,49.669,286,286,993
1981,5331,911,963,9698,9910,183,20.390,52,5.794,2047,881,1166,8.890,20.656,2428,696,1732,7.023,24.501,-381,-3.845,41.312,26,27,81
1981,5411,108520,111638,587935,567113,14958,13.720,9732,8.926,118187,47288,70899,8.338,20.840,76331,27993,48338,4.936,13.460,41856,7.381,26.919,6714,6752,17774
1981,5412,46472,49702,367294,353592,8006,16.583,5157,10.682,75138,32901,42237,9.305,21.250,47706,18036,29670,5.101,13.492,27432,7.758,26.984,3566,3608,11444
1981,5413,44152,48062,648451,629452,7978,17.091,5214,11.170,137958,51166,86792,8.129,21.917,99635,28002,71633,4.449,15.829,38323,6.088,31.658,3451,3487,13467
1981,5414,12359,12572,84729,81485,2801,23.580,1414,11.904,21888,10381,11507,12.740,26.862,15369,5709,9660,7.006,18.861,6519,8.000,37.723,961,962,2836
1981,5415,2801,3334,31002,29228,1233,38.185,1023,31.682,11520,6086,5434,20.823,39.415,7968,4231,3737,14.476,27.262,3552,12.153,54.524,816,822,2573
1981,5416,17011,17568,168117,165529,3597,20.396,3732,21.162,46469,16808,29661,10.154,28.073,41495,16162,25333,9.764,25.068,4974,3.005,50.136,2804,2812,10476
1981,5417,4048,5103,390187,384771,573,11.210,590,11.543,46202,11094,35108,2.883,12.008,35630,9497,26133,2.468,9.260,10572,2.748,18.520,338,349,1694
1981,5418,19051,20892,252341,246739,3349,16.423,2349,11.519,49054,17877,31177,7.245,19.881,38126,12988,25138,5.264,15.452,10928,4.429,30.904,1623,1638,7174
1981,5419,23833,26021,173636,164763,3712,14.702,2166,8.579,44091,20081,24010,12.188,26.760,25668,8833,16835,5.361,15.579,18423,11.182,31.158,1462,1471,5300
1981,5511,21333,41058,2706293,2659617,5013,12.584,2570,6.451,442831,158994,283837,5.978,16.650,349624,75055,274569,2.822,13.146,93207,3.505,26.291,351,362,4226
1981,5611,4074,4238,61659,62016,476,10.581,997,22.163,13046,3695,9351,5.958,21.037,13743,5974,7769,9.633,22.160,-697,-1.124,42.073,737,744,3429
1981,5612,167,196,9762,11973,24,11.060,66,30.415,1367,597,770,4.986,11.418,5733,2658,3075,22.201,47.885,-4366,-36.467,22.836,27,27,402
1981,5613,10191,13600,556984,563416,2462,18.717,1569,11.928,142396,52243,90153,9.273,25.274,155512,28133,127379,4.993,27.602,-13116,-2.328,50.547,1042,1056,13252
1981,5614,17895,20001,204625,198250,3526,18.317,2024,10.514,46937,19437,27500,9.804,23.676,34016,10145,23871,5.117,17.158,12921,6.518,34.316,1374,1390,5736
1981,5615,16446,19247,144420,141334,2627,14.086,1432,7.678,28223,11361,16862,8.038,19.969,21997,6630,15367,4.691,15.564,6226,4.405,31.128,922,954,3960
1981,5616,12075,14357,384484,376610,3218,23.969,1355,10.093,94532,40374,54158,10.720,25.101,78865,23912,54953,6.349,20.941,15667,4.160,41.882,873,885,10230
1981,5617,47113,49793,644173,636553,10353,21.247,8220,16.870,149207,54972,94235,8.636,23.440,133453,46432,87021,7.294,20.965,15754,2.475,41.930,6257,6281,27950
1981,5619,13163,14033,158258,150891,3252,24.986,1217,9.350,42954,19478,23476,12.909,28.467,28429,8283,20146,5.489,18.841,14525,9.626,37.682,783,789,4138
1981,5621,4692,4817,90933,91631,578,11.903,656,13.509,11039,3287,7752,3.587,12.047,12398,3913,8485,4.270,13.530,-1359,-1.483,24.094,522,524,2823
1981,5622,1943,2364,38549,37153,307,13.699,61,2.722,6650,2714,3936,7.305,17.899,3896,826,3070,2.223,10.487,2754,7.413,20.973,12,12,25
1981,5629,4336,4573,42811,42368,665,14.912,438,9.822,9878,3484,6394,8.223,23.315,8886,2322,6564,5.481,20.973,992,2.341,41.947,291,291,1445
1981,6111,11268,11597,308645,303178,526,4.557,417,3.613,31412,6363,25049,2.099,10.361,20581,4204,16377,1.387,6.788,10831,3.572,13.577,255,261,2275
1981,6112,415,483,30142,29355,31,6.418,31,6.418,4935,1604,3331,5.464,16.811,3358,818,2540,2.787,11.439,1577,5.372,22.879,15,15,114
1981,6113,1805,2067,829206,808005,98,4.776,68,3.314,80880,3755,77125,0.465,10.010,37946,2079,35867,0.257,4.696,42934,5.314,9.393,35,37,363
1981,6114,1584,1763,28301,27519,278,15.890,251,14.347,6476,1826,4650,6.636,23.533,4894,1881,3013,6.835,17.784,1582,5.749,35.569,168,173,898
1981,6115,3405,3910,50819,49995,498,12.872,416,10.752,8790,2963,5827,5.927,17.582,7046,1809,5237,3.618,14.093,1744,3.488,28.187,296,299,1196
1981,6116,9346,9797,79554,79637,1780,18.312,1627,16.738,19577,8108,11469,10.181,24.583,19857,7798,12059,9.792,24.935,-280,-0.352,49.166,1214,1224,5205
1981,6117,817,826,12645,12443,141,17.060,142,17.181,2040,520,1520,4.179,16.395,1714,871,843,7.000,13.775,326,2.620,27.551,113,113,684
1981,6211,161547,166022,900101,876841,17742,10.983,8768,5.428,156157,63653,92504,7.259,17.809,109731,30241,79490,3.449,12.514,46426,5.295,25.029,6045,6088,18636
1981,6212,88310,89783,375779,366001,6368,7.193,3871,4.372,64590,20763,43827,5.673,17.648,44926,12252,32674,3.348,12.275,19664,5.373,24.550,2666,2686,8203
1981,6213,33099,34402,107832,103396,5124,15.407,2836,8.527,27626,13394,14232,12.954,26.719,18616,7865,10751,7.607,18.005,9010,8.714,36.009,1926,1935,4836
1981,6214,4459,5611,84183,80611,850,15.699,457,8.440,18758,8617,10141,10.690,23.270,11670,4160,7510,5.161,14.477,7088,8.793,28.954,288,291,2469
1981,6215,3796,4866,63195,61553,596,12.421,461,9.607,12091,4247,7844,6.900,19.643,8763,4301,4462,6.988,14.237,3328,5.407,28.473,275,286,1587
1981,6216,2689,3490,110239,100367,664,20.085,296,8.953,34349,14747,19602,14.693,34.224,14235,4536,9699,4.519,14.183,20114,20.041,28.366,135,135,1001
1981,6219,2646,3012,56507,54814,558,19.589,231,8.110,14216,5041,9175,9.197,25.935,10755,3934,6821,7.177,19.621,3461,6.314,39.242,111,111,1035
1981,6221,3768,4743,2638413,2566796,231,4.891,190,4.023,224683,53468,171215,2.083,8.753,80613,37165,43448,1.448,3.141,144070,5.613,6.281,86,90,19681
1981,6222,317,417,44144,43175,61,15.269,26,6.508,6824,2953,3871,6.840,15.806,4651,3151,1500,7.298,10.773,2173,5.033,21.545,11,11,2136
1981,6223,183,213,42686,41520,23,11.192,8,3.893,3772,795,2977,1.915,9.085,1459,344,1115,0.829,3.514,2313,5.571,7.028,3,3,110
1981,6231,6533,8984,728599,698131,873,9.994,375,4.293,117052,60880,56172,8.720,16.766,54929,19927,35002,2.854,7.868,62123,8.898,15.736,247,255,13017
1981,6232,3229,4107,94207,89887,596,15.060,297,7.505,18767,8407,10360,9.353,20.879,10082,4114,5968,4.577,11.216,8685,9.662,22.433,190,190,2479
1981,6233,8222,9692,376828,369357,1186,12.469,825,8.674,58852,25286,33566,6.846,15.934,43551,20641,22910,5.588,11.791,15301,4.143,23.582,531,548,12035
1981,6239,2336,2834,77030,74208,288,10.407,155,5.601,11523,4240,7283,5.714,15.528,5951,1633,4318,2.201,8.019,5572,7.509,16.039,84,86,726
1981,6241,9976,14180,230231,223136,1644,11.853,1024,7.383,45858,14805,31053,6.635,20.552,31719,9209,22510,4.127,14.215,14139,6.336,28.430,504,517,2391
1981,6242,2897,3492,38074,37365,358,10.446,228,6.653,6445,1824,4621,4.882,17.249,5019,1350,3669,3.613,13.433,1426,3.816,26.865,128,128,642
1981,6243,3098,4629,206941,205145,582,12.817,406,8.941,36337,11922,24415,5.811,17.713,32700,8652,24048,4.218,15.940,3637,1.773,31.880,152,155,2547
1981,6244,22306,26523,224003,220980,3724,14.292,2792,10.715,45272,20514,24758,9.283,20.487,39173,14955,24218,6.768,17.727,6099,2.760,35.454,2010,2032,8924
1981,7111,4484,4526,55834,55050,806,17.959,730,16.266,15978,6530,9448,11.862,29.025,14483,3683,10800,6.690,26.309,1495,2.716,52.618,518,518,2180
1981,7112,2024,2118,57445,57493,364,17.146,374,17.617,12868,5701,7167,9.916,22.382,13009,4391,8618,7.638,22.627,-141,-0.245,44.764,277,278,2740
1981,7113,2024,2065,26643,25306,337,16.495,293,14.342,8086,3405,4681,13.455,31.953,5346,1621,3725,6.406,21.125,2740,10.827,42.251,193,197,1066
1981,7114,980,994,28049,27937,195,20.082,149,15.345,3443,1577,1866,5.645,12.324,3305,772,2533,2.763,11.830,138,0.494,23.660,96,96,577
1981,7115,5143,5163,33165,28878,1567,32.329,935,19.290,17164,5533,11631,19.160,59.436,8075,3336,4739,11.552,27.962,9089,31.474,55.925,607,607,1795
1981,7121,1461,1542,28523,28781,82,5.216,142,9.033,3304,608,2696,2.113,11.480,3762,729,3033,2.533,13.071,-458,-1.591,22.960,91,94,484
1981,7131,1511,1784,49369,50542,313,18.214,182,10.591,5387,1555,3832,3.077,10.658,7489,1584,5905,3.134,14.817,-2102,-4.159,21.317,115,120,1194
1981,7132,629,647,16614,15993,108,16.757,103,15.981,4197,1190,3007,7.441,26.243,2970,840,2130,5.252,18.571,1227,7.672,37.141,74,74,618
1981,7139,29596,31284,454192,444921,3774,12.271,2715,8.828,85877,33563,52314,7.544,19.302,67119,18328,48791,4.119,15.086,18758,4.216,30.171,1828,1841,10055
1981,7211,28890,32818,1049423,1029834,3760,11.445,3829,11.655,201941,96661,105280,9.386,19.609,163187,50713,112474,4.924,15.846,38754,3.763,31.692,2668,2701,28223
1981,7212,3221,3425,17448,17483,458,13.400,444,12.990,4020,1560,2460,8.923,22.994,4121,1533,2588,8.769,23.571,-101,-0.578,45.988,290,290,921
1981,7213,5305,5388,30306,30691,314,5.747,466,8.529,4073,912,3161,2.972,13.271,4820,2044,2776,6.660,15.705,-747,-2.434,26.542,327,328,1631
1981,7223,16416,25822,481363,474455,4293,16.897,3464,13.634,115151,59637,55514,12.570,24.270,100976,40376,60600,8.510,21.283,14175,2.988,42.565,1833,1855,13822
1981,7224,63152,63932,346879,346660,8902,13.827,9799,15.220,92399,45750,46649,13.197,26.654,91688,39255,52433,11.324,26.449,711,0.205,52.898,7042,7067,26689
1981,7225,176981,226060,3823110,3780683,35620,15.919,31015,13.861,842972,476458,366514,12.602,22.297,758770,302546,456224,8.002,20.070,84202,2.227,40.139,20909,21519,185326
1981,8111,88193,91985,419000,423521,13433,14.654,12797,13.960,89531,41578,47953,9.817,21.140,98762,39399,59363,9.303,23.319,-9231,-2.180,42.279,9067,9116,26404
1981,8112,9675,10748,65019,63805,1230,11.372,1367,12.638,13422,6797,6625,10.653,21.036,11238,4145,7093,6.496,17.613,2184,3.423,35.226,1025,1028,2493
1981,8113,17206,18227,147226,143786,2729,15.297,1956,10.964,31722,12051,19671,8.381,22.062,24865,7993,16872,5.559,17.293,6857,4.769,34.586,1334,1335,4720
1981,8114,22310,23872,142544,142494,3644,15.344,3398,14.308,28200,12335,15865,8.657,19.790,28013,10531,17482,7.390,19.659,187,0.131,39.318,2420,2424,6306
1981,8121,80828,89111,399568,403354,11041,12.311,12187,13.589,79482,37736,41746,9.356,19.705,86528,35772,50756,8.869,21.452,-7046,-1.747,39.411,9096,9222,25420
1981,8122,17203,19625,109674,108226,1192,6.119,902,4.630,16089,4544,11545,4.199,14.866,13087,2695,10392,2.490,12.092,3002,2.774,24.185,565,597,1730
1981,8123,32664,38361,334327,334486,3645,9.459,3991,10.357,49577,19449,30128,5.815,14.822,49911,17968,31943,5.372,14.922,-334,-0.100,29.644,2816,2961,12327
1981,8129,13587,19603,207753,197025,3757,19.747,2602,13.676,53225,23715,29510,12.037,27.014,31727,14221,17506,7.218,16.103,21498,10.911,32.206,1238,1302,5640
1981,8131,59757,59847,592942,583235,2554,4.353,200,0.341,72217,13207,59010,2.264,12.382,53320,918,52402,0.157,9.142,18897,3.240,18.284,8,9,29
1981,8132,6237,7165,115560,112105,816,11.726,404,5.805,22298,7862,14436,7.013,19.890,15521,3992,11529,3.561,13.845,6777,6.045,27.690,212,215,1518
1981,8133,6019,7169,94088,93242,902,12.831,624,8.876,20554,8453,12101,9.066,22.044,18621,7449,11172,7.989,19.971,1933,2.073,39.941,317,325,1925
1981,8134,27384,28635,237241,236396,1701,5.949,1613,5.642,33559,8200,25359,3.469,14.196,31669,6632,25037,2.805,13.397,1890,0.800,26.793,1099,1101,3216
1981,8139,53200,55341,395674,398833,4138,7.561,2914,5.324,67710,17957,49753,4.502,16.977,74042,13834,60208,3.469,18.565,-6332,-1.588,33.954,1870,1874,7075
1982,2111,7406,9465,183081,173388,1744,19.125,1052,11.536,52456,19174,33282,11.058,30.254,33142,13077,20065,7.542,19.114,19314,11.139,38.229,599,613,3679
1982,2121,3131,3863,239203,237274,808,21.246,688,18.091,42693,16895,25798,7.120,17.993,38215,16190,22025,6.823,16.106,4478,1.887,32.212,474,477,7121
1982,2122,655,834,70206,78156,206,25.000,186,22.573,5566,3027,2539,3.873,7.122,21600,3532,18068,4.519,27.637,-16034,-20.515,14.243,115,115,1186
1982,2123,3559,5019,102953,108480,359,7.091,446,8.810,14522,4639,9883,4.276,13.387,25844,6751,19093,6.223,23.824,-11322,-10.437,26.774,254,254,1744
1982,2131,11955,13653,426792,394752,3626,28.640,1641,12.962,151087,57207,93880,14.492,38.274,87505,36623,50882,9.277,22.167,63582,16.107,44.334,1167,1176,18387
1982,2211,1585,5745,569587,558064,221,3.899,67,1.182,37146,6715,30431,1.203,6.656,14443,2634,11809,0.472,2.588,22703,4.068,5.176,24,24,118
1982,2212,534,2391,142916,139539,128,5.453,41,1.747,12478,5646,6832,4.046,8.942,6147,747,5400,0.535,4.405,6331,4.537,8.810,14,14,38
1982,2213,3844,4141,34249,31916,612,15.684,134,3.434,7525,5519,2006,17.293,23.578,2898,1042,1856,3.265,9.080,4627,14.498,18.160,90,93,358
1982,2361,78285,78690,401706,452079,12337,14.437,25870,30.273,112227,44769,67458,9.903,24.825,212668,92771,119897,20.521,47.042,-100441,-22.218,49.649,17851,17853,67847
1982,2362,32083,32654,573459,593815,4170,12.523,5458,16.391,134544,32669,101875,5.502,22.658,176186,36026,140160,6.067,29.670,-41642,-7.013,45.315,3834,3838,25730
1982,2371,12811,13177,365870,368368,1433,10.708,1843,13.772,76070,15389,60681,4.178,20.651,80140,19980,60160,5.424,21.755,-4070,-1.105,41.301,1315,1319,9865
1982,2372,6878,6968,47529,50554,1650,23.236,1916,26.982,14444,7288,7156,14.416,28.572,20606,9273,11333,18.343,40.761,-6162,-12.189,57.143,1419,1419,6210
1982,2373,9596,9855,189817,201672,908,9.029,1310,13.027,34598,7735,26863,3.835,17.156,58361,9811,48550,4.865,28.939,-23763,-11.783,34.311,905,906,5881
1982,2379,4399,4448,80985,84238,658,14.406,897,19.639,22854,5610,17244,6.660,27.130,29263,4388,24875,5.209,34.739,-6409,-7.608,54.261,627,627,3069
1982,2381,58150,58558,495870,519991,7357,12.063,12216,20.030,129608,36217,93391,6.965,24.925,178157,55639,122518,10.700,34.262,-48549,-9.337,49.850,8044,8049,37131
1982,2382,92661,94584,965854,979608,11041,11.538,13258,13.855,200098,50300,149798,5.135,20.426,228430,55670,172760,5.683,23.319,-28332,-2.892,40.853,9627,9631,41162
1982,2383,60381,60818,462738,487149,8733,13.765,13986,22.044,118991,36759,82232,7.546,24.426,167763,51937,115826,10.661,34.438,-48772,-10.012,48.852,9634,9639,37748
1982,2389,32270,32461,300369,308241,4406,13.276,5861,17.660,77777,24441,53336,7.929,25.233,93437,23467,69970,7.613,30.313,-15660,-5.080,50.465,4009,4011,16790
1982,3111,1861,2527,65479,65743,180,7.106,192,7.580,9349,2901,6448,4.413,14.221,9684,2624,7060,3.991,14.730,-335,-0.510,28.441,114,114,936
1982,3112,529,891,82753,82693,61,6.850,60,6.738,8108,3278,4830,3.964,9.805,7747,2294,5453,2.774,9.368,361,0.437,18.737,33,33,627
1982,3113,1323,1713,95866,93862,217,12.855,167,9.893,15687,4807,10880,5.121,16.713,11532,3634,7898,3.872,12.286,4155,4.427,24.572,73,73,537
1982,3114,1209,1662,172614,176154,105,6.252,140,8.336,17800,4248,13552,2.412,10.105,24821,6948,17873,3.944,14.091,-7021,-3.986,20.210,70,71,1457
1982,3115,1845,2578,139785,142146,104,3.949,215,8.164,13237,3076,10161,2.164,9.312,17822,6789,11033,4.776,12.538,-4585,-3.226,18.625,123,123,1198
1982,3116,4231,4821,304693,305601,372,7.671,429,8.846,40901,18706,22195,6.121,13.384,42919,16028,26891,5.245,14.044,-2018,-0.660,26.768,293,299,3782
1982,3117,789,919,57492,56296,87,9.370,106,11.416,11952,3042,8910,5.404,21.231,9394,3237,6157,5.750,16.687,2558,4.544,33.374,59,59,1014
1982,3118,8261,9715,303890,299681,1219,12.630,1092,11.314,39456,14140,25316,4.718,13.166,30889,11462,19427,3.825,10.307,8567,2.859,20.615,788,811,6101
1982,3119,1985,2380,127349,124647,265,11.310,191,8.152,21211,7961,13250,6.387,17.017,15747,5983,9764,4.800,12.633,5464,4.384,25.267,125,126,1829
1982,3121,2042,2607,178059,180421,165,6.219,257,9.687,16424,4112,12312,2.279,9.103,21118,8367,12751,4.637,11.705,-4694,-2.602,18.206,165,167,2464
1982,3122,107,170,45899,46827,12,6.977,16,9.302,2625,536,2089,1.145,5.606,4428,1123,3305,2.398,9.456,-1803,-3.850,11.212,7,7,54
1982,3131,436,677,108226,112902,36,5.252,53,7.732,7344,3377,3967,2.991,6.505,16576,3878,12698,3.435,14.682,-9232,-8.177,13.010,26,26,695
1982,3132,1707,2113,318160,328870,154,7.237,184,8.647,19074,8215,10859,2.498,5.800,40640,8317,32323,2.529,12.357,-21566,-6.558,11.600,124,124,1787
1982,3133,1524,1750,106320,110757,140,7.973,152,8.656,8667,3056,5611,2.759,7.825,17771,5496,12275,4.962,16.045,-9104,-8.220,15.650,89,94,2689
1982,3141,3924,4199,104551,108213,411,9.548,622,14.450,11657,3845,7812,3.553,10.772,18891,5194,13697,4.800,17.457,-7234,-6.685,21.545,482,485,3267
1982,3149,3355,3495,126428,126886,375,10.691,400,11.404,19108,5462,13646,4.305,15.059,20106,5953,14153,4.692,15.846,-998,-0.787,30.118,319,319,4010
1982,3151,1366,1492,140265,143261,103,6.810,144,9.521,13145,3707,9438,2.588,9.176,19235,3399,15836,2.373,13.427,-6090,-4.251,18.351,105,105,1674
1982,3152,15217,17033,1053076,1062988,1983,11.645,1975,11.598,147785,52563,95222,4.945,13.903,167012,55293,111719,5.202,15.712,-19227,-1.809,27.806,1540,1555,32410
1982,3159,1747,1858,73946,76896,184,9.811,219,11.677,9058,2732,6326,3.553,11.780,15071,3268,11803,4.250,19.599,-6013,-7.820,23.559,160,163,1751
1982,3161,352,396,19440,20162,35,8.805,38,9.560,2209,856,1353,4.246,10.957,3657,927,2730,4.598,18.139,-1448,-7.182,21.913,23,23,437
1982,3162,510,744,136879,140976,66,8.877,65,8.742,13548,3247,10301,2.303,9.610,21950,5063,16887,3.591,15.570,-8402,-5.960,19.220,41,42,2025
1982,3169,1303,1348,55510,56601,133,9.794,153,11.267,6889,1441,5448,2.546,12.171,9043,2165,6878,3.825,15.977,-2154,-3.806,24.342,125,125,1199
1982,3211,4952,5490,126143,138485,390,6.763,944,16.369,13895,6135,7760,4.430,10.034,38834,10045,28789,7.254,28.042,-24939,-18.009,20.067,645,646,4869
1982,3212,994,1296,80498,87165,69,5.149,157,11.716,6097,2243,3854,2.573,6.995,19582,4236,15346,4.860,22.465,-13485,-15.471,13.990,110,110,1312
1982,3219,8364,9081,231002,244457,927,10.128,1071,11.701,30134,11615,18519,4.751,12.327,56959,16296,40663,6.666,23.300,-26825,-10.973,24.654,756,758,7712
1982,3221,273,618,207812,210932,27,4.262,58,9.155,10141,5118,5023,2.426,4.808,15997,5508,10489,2.611,7.584,-5856,-2.776,9.615,23,23,378
1982,3222,3623,5224,404930,410880,274,5.233,298,5.691,38748,13075,25673,3.182,9.430,50221,15536,34685,3.781,12.223,-11473,-2.792,18.861,170,176,2583
1982,3231,33263,34807,685223,682793,3767,10.962,2880,8.381,90138,28892,61246,4.231,13.201,85310,27750,57560,4.064,12.494,4828,0.707,24.989,2163,2170,14018
1982,3241,1489,2384,355865,384835,209,8.791,196,8.244,17073,4703,12370,1.222,4.436,75712,12999,62713,3.378,19.674,-58639,-15.237,8.873,92,100,1469
1982,3251,1142,2222,234978,235113,211,9.462,227,10.179,19537,7925,11612,3.371,8.310,20067,7196,12871,3.061,8.535,-530,-0.225,16.619,97,97,708
1982,3252,360,599,148608,152285,52,8.674,53,8.841,7646,3335,4311,2.190,5.021,14882,5171,9711,3.396,9.772,-7236,-4.752,10.042,23,23,235
1982,3253,733,1096,54757,56054,89,8.102,94,8.557,4883,2502,2381,4.464,8.711,7539,3265,4274,5.825,13.450,-2656,-4.738,17.423,44,44,359
1982,3254,963,1201,158375,159308,101,8.459,87,7.286,15064,3288,11776,2.064,9.456,16792,5951,10841,3.736,10.541,-1728,-1.085,18.912,46,46,775
1982,3255,1642,2090,73553,75944,125,5.928,162,7.683,6184,1753,4431,2.308,8.143,10987,3147,7840,4.144,14.467,-4803,-6.324,16.286,89,89,884
1982,3256,1987,2239,127474,127506,161,7.099,219,9.656,14428,5151,9277,4.040,11.316,14532,3708,10824,2.908,11.397,-104,-0.082,22.631,142,144,1516
1982,3259,1660,2155,91492,90091,228,10.674,190,8.895,12505,5355,7150,5.944,13.880,9638,2336,7302,2.593,10.698,2867,3.182,21.396,99,99,635
1982,3261,9931,11406,496384,506570,1071,9.435,962,8.475,63836,23535,40301,4.646,12.602,84266,25451,58815,5.024,16.635,-20430,-4.033,25.203,635,640,8493
1982,3262,1903,2283,187577,191926,180,7.917,161,7.082,13807,6080,7727,3.168,7.194,22677,4505,18172,2.347,11.815,-8870,-4.622,14.388,108,108,1321
1982,3271,1283,1578,77082,82328,171,10.677,218,13.612,7562,3376,4186,4.101,9.185,17976,3664,14312,4.451,21.835,-10414,-12.649,18.371,145,145,901
1982,3272,1456,1739,160029,166689,185,10.571,207,11.829,15320,9229,6091,5.537,9.191,28747,7927,20820,4.756,17.246,-13427,-8.055,18.382,137,139,1777
1982,3273,7189,9117,166708,174907,583,6.330,769,8.350,23059,8086,14973,4.623,13.184,39644,8676,30968,4.960,22.666,-16585,-9.482,26.367,487,494,4882
1982,3274,250,350,16423,17311,35,9.845,46,12.940,842,487,355,2.813,4.864,2644,533,2111,3.079,15.274,-1802,-10.410,9.728,33,33,142
1982,3279,1860,2140,78891,82338,165,7.586,235,10.805,8323,3859,4464,4.687,10.108,15152,3423,11729,4.157,18.402,-6829,-8.294,20.217,158,162,1126
1982,3311,303,335,131726,134451,61,19.396,20,6.359,13319,10697,2622,7.956,9.906,18237,759,17478,0.565,13.564,-4918,-3.658,19.812,9,9,133
1982,3312,511,687,74120,77822,47,6.856,44,6.419,5537,2322,3215,2.984,7.115,12958,2557,10401,3.286,16.651,-7421,-9.536,14.230,27,28,1165
1982,3313,424,663,131689,138444,27,4.057,32,4.808,6083,847,5236,0.612,4.394,19538,3769,15769,2.722,14.113,-13455,-9.719,8.788,9,9,204
1982,3314,764,930,92735,97046,119,12.928,100,10.864,7275,3611,3664,3.721,7.496,15652,3237,12415,3.336,16.129,-8377,-8.632,14.993,63,63,664
1982,3315,2844,3210,255747,271762,163,5.025,231,7.121,18663,6318,12345,2.325,6.867,50903,13100,37803,4.820,18.731,-32240,-11.863,13.735,149,149,2887
1982,3321,3118,3353,150216,156922,217,6.497,191,5.719,12566,3854,8712,2.456,8.008,26136,5792,20344,3.691,16.655,-13570,-8.648,16.016,126,126,1526
1982,3322,1225,1372,86878,90733,105,7.687,93,6.808,7689,3288,4401,3.624,8.474,15260,3580,11680,3.946,16.819,-7571,-8.344,16.949,63,63,1329
1982,3323,9945,10815,353701,367438,779,7.168,884,8.134,41956,11288,30668,3.072,11.419,69529,16274,53255,4.429,18.923,-27573,-7.504,22.837,636,642,6002
1982,3324,1437,1841,148695,151123,118,6.406,120,6.515,14385,5597,8788,3.704,9.519,19259,3729,15530,2.468,12.744,-4874,-3.225,19.038,66,66,1150
1982,3325,900,973,74002,79488,93,9.642,76,7.880,6505,4256,2249,5.354,8.184,17732,3842,13890,4.833,22.308,-11227,-14.124,16.367,48,48,484
1982,3326,1550,1755,63485,66163,111,6.296,127,7.204,6523,2004,4519,3.029,9.859,11885,3384,8501,5.115,17.963,-5362,-8.104,19.718,85,85,956
1982,3327,20813,21148,332237,338100,2346,11.209,1908,9.117,44778,15616,29162,4.619,13.244,56444,13886,42558,4.107,16.694,-11666,-3.450,26.488,1487,1488,8631
1982,3328,5341,5642,118611,120510,427,7.564,433,7.671,15112,4253,10859,3.529,12.540,18881,4533,14348,3.762,15.668,-3769,-3.128,25.080,330,331,2644
1982,3329,5309,5871,376545,380855,660,11.482,414,7.203,40306,16359,23947,4.295,10.583,48489,11494,36995,3.018,12.732,-8183,-2.149,21.166,272,273,2260
1982,3331,3320,3803,385551,393654,436,11.597,349,9.283,44134,14662,29472,3.725,11.211,60193,12182,48011,3.095,15.291,-16059,-4.079,22.423,239,239,3918
1982,3332,3681,3960,184882,192365,299,7.578,270,6.843,18921,9187,9734,4.776,9.836,33469,7360,26109,3.826,17.399,-14548,-7.563,19.672,189,189,2231
1982,3333,1939,2068,160045,162171,152,7.348,153,7.397,19818,7897,11921,4.870,12.220,23670,5051,18619,3.115,14.596,-3852,-2.375,24.441,97,97,1006
1982,3334,1920,2167,182204,185127,223,10.204,260,11.897,29993,20457,9536,11.050,16.201,36410,12336,24074,6.664,19.668,-6417,-3.466,32.403,187,189,1379
1982,3335,9395,9872,266323,274198,722,7.322,700,7.099,26708,11132,15576,4.060,9.740,42732,9625,33107,3.510,15.584,-16024,-5.844,19.481,525,525,3351
1982,3336,723,887,171301,176141,53,6.036,35,3.986,9438,2347,7091,1.332,5.358,19093,1752,17341,0.995,10.840,-9655,-5.481,10.716,23,23,451
1982,3339,5438,6043,365600,374475,492,8.165,457,7.584,34401,11889,22512,3.175,9.186,52035,9715,42320,2.594,13.895,-17634,-4.709,18.373,309,310,3884
1982,3341,1421,1671,405413,398306,311,19.684,129,8.165,52387,15069,37318,3.783,13.152,38215,6756,31459,1.696,9.594,14172,3.558,19.189,86,86,1009
1982,3342,1734,1887,209590,208956,242,13.156,147,7.991,30633,8402,22231,4.021,14.660,29676,12000,17676,5.743,14.202,957,0.458,28.404,80,80,1208
1982,3343,424,455,52710,55459,45,9.688,64,13.778,4301,725,3576,1.307,7.755,9841,1686,8155,3.040,17.745,-5540,-9.989,15.511,51,51,532
1982,3344,3855,4372,465442,465980,608,14.277,381,8.947,56400,19738,36662,4.236,12.104,57710,13627,44083,2.924,12.385,-1310,-0.281,24.207,263,264,5884
1982,3345,3718,4288,639304,630279,444,10.508,319,7.549,76371,19144,57227,3.037,12.117,57578,19266,38312,3.057,9.135,18793,2.982,18.271,199,199,2098
1982,3346,564,587,17695,18139,94,16.193,81,13.953,4048,1724,2324,9.504,22.317,4835,1825,3010,10.061,26.655,-787,-4.339,44.633,56,56,569
1982,3351,1199,1335,88739,89829,98,7.313,108,8.060,11203,6198,5005,6.900,12.471,13716,3886,9830,4.326,15.269,-2513,-2.798,24.943,79,81,1079
1982,3352,362,473,122960,134238,46,9.850,34,7.281,4471,1248,3223,0.930,3.331,27254,2067,25187,1.540,20.303,-22783,-16.972,6.661,18,18,103
1982,3353,1940,2454,279370,284777,201,8.273,152,6.256,26541,9532,17009,3.347,9.320,37595,6432,31163,2.259,13.202,-11054,-3.882,18.640,92,92,1298
1982,3359,1707,2053,195503,196560,234,11.613,158,7.841,23421,9253,14168,4.707,11.915,25645,6566,19079,3.340,13.047,-2224,-1.131,23.831,101,101,1193
1982,3361,169,224,226552,234678,30,13.158,38,16.667,19656,4859,14797,2.070,8.376,36224,3109,33115,1.325,15.436,-16568,-7.060,16.751,28,28,228
1982,3362,1605,1782,93413,97560,148,8.163,210,11.583,11080,1999,9081,2.049,11.357,19280,3396,15884,3.481,19.762,-8200,-8.405,22.714,152,152,1580
1982,3363,3490,4208,556127,587989,326,7.729,346,8.203,33970,8590,25380,1.461,5.777,99295,13451,85844,2.288,16.887,-65325,-11.110,11.555,222,222,2379
1982,3364,1208,1435,649342,668134,108,7.592,83,5.835,49209,14332,34877,2.145,7.365,85120,32850,52270,4.917,12.740,-35911,-5.375,14.730,65,65,1273
1982,3365,173,202,40728,47700,13,6.373,17,8.333,1110,651,459,1.365,2.327,14913,5826,9087,12.214,31.264,-13803,-28.937,4.654,5,5,65
1982,3366,1138,1236,199563,205285,127,10.234,137,11.039,18229,3586,14643,1.747,8.880,29499,4813,24686,2.345,14.370,-11270,-5.490,17.760,99,101,1898
1982,3369,414,424,27881,29100,64,14.849,78,18.097,3056,1590,1466,5.464,10.502,5470,2966,2504,10.192,18.797,-2414,-8.296,21.003,55,55,559
1982,3371,11369,11998,337143,353454,1315,10.752,1780,14.554,36660,14832,21828,4.196,10.372,69182,20500,48682,5.800,19.573,-32522,-9.201,20.744,1343,1352,11107
1982,3372,2353,2482,120240,122124,198,7.934,225,9.016,13214,3696,9518,3.026,10.820,16768,4337,12431,3.551,13.730,-3554,-2.910,21.640,155,155,1952
1982,3379,1053,1187,36928,37995,92,7.676,115,9.595,4414,1920,2494,5.053,11.617,6599,1380,5219,3.632,17.368,-2185,-5.751,23.235,95,95,861
1982,3391,9442,9989,214343,214455,1297,13.136,1067,10.806,30280,11126,19154,5.188,14.120,30135,12448,17687,5.804,14.052,145,0.068,28.104,775,779,3032
1982,3399,13920,14557,412912,420626,1737,11.934,1734,11.913,59741,22230,37511,5.285,14.203,75268,21442,53826,5.098,17.894,-15527,-3.691,28.406,1286,1290,9798
1982,4231,23193,28652,306954,313500,2528,8.731,3131,10.814,43463,14892,28571,4.750,13.864,56629,20831,35798,6.645,18.063,-13166,-4.200,27.728,1769,1906,9104
1982,4232,7706,8866,97880,98779,1039,11.697,1072,12.069,18253,5753,12500,5.824,18.479,19908,8736,11172,8.844,20.154,-1655,-1.675,36.957,675,683,3320
1982,4233,7348,9354,104162,108317,974,10.288,1200,12.676,16503,5565,10938,5.138,15.236,24781,7183,17598,6.631,22.878,-8278,-7.642,30.472,757,768,3723
1982,4234,18867,26103,441232,438138,4012,15.811,2555,10.069,87823,34889,52934,7.963,20.045,82400,28251,54149,6.448,18.807,5423,1.238,37.614,1482,1502,7848
1982,4235,6474,9001,137282,138329,965,10.818,804,9.013,20964,7379,13585,5.334,15.155,23081,6074,17007,4.391,16.686,-2117,-1.530,30.310,428,430,2551
1982,4236,13738,19970,256361,253452,2438,12.364,1935,9.813,51151,19234,31917,7.589,20.182,45433,16298,29135,6.430,17.926,5718,2.256,35.851,1111,1148,6020
1982,4237,10526,13795,151220,151680,1246,9.058,1167,8.484,22468,7255,15213,4.783,14.813,23468,6634,16834,4.374,15.472,-1000,-0.659,29.626,745,766,3656
1982,4238,46733,61089,677024,683921,6005,9.899,5154,8.496,103324,34876,68448,5.099,15.108,117235,35794,81441,5.234,17.142,-13911,-2.034,30.215,3114,3167,17004
1982,4239,20911,22584,210366,214844,3285,14.517,3375,14.914,42320,16515,25805,7.687,19.698,51199,16138,35061,7.511,23.831,-8879,-4.133,39.396,2552,2581,11385
1982,4241,7401,9923,144804,142390,1062,10.856,782,7.993,26766,6087,20679,4.275,18.798,21675,7379,14296,5.182,15.222,5091,3.575,30.445,431,439,2192
1982,4242,2550,3272,90979,91079,416,12.726,410,12.542,15394,5856,9538,6.430,16.902,15433,6302,9131,6.919,16.945,-39,-0.043,33.804,280,281,1590
1982,4243,10476,11388,120145,118948,1645,14.556,1472,13.025,27011,10011,17000,8.416,22.708,24776,9655,15121,8.117,20.829,2235,1.879,41.659,1061,1074,4778
1982,4244,26077,32170,582071,574552,3556,11.069,3467,10.792,100950,36850,64100,6.414,17.570,86265,31247,55018,5.439,15.014,14685,2.556,30.029,2340,2378,15787
1982,4245,9015,12191,111749,111552,763,6.196,1010,8.202,18817,4893,13924,4.386,16.868,18435,5673,12762,5.086,16.526,382,0.342,33.052,625,648,3494
1982,4246,6542,9710,121357,119368,1194,12.497,882,9.232,23563,7002,16561,5.866,19.740,19318,7889,11429,6.609,16.184,4245,3.556,32.367,436,438,1991
1982,4247,12149,15748,164449,164660,1245,7.789,1719,10.754,34457,9107,25350,5.531,20.926,34885,12218,22667,7.420,21.186,-428,-0.260,41.852,862,889,5725
1982,4248,4664,5802,134951,134122,399,6.878,398,6.860,15884,4908,10976,3.659,11.843,14203,3954,10249,2.948,10.590,1681,1.253,21.179,259,262,1896
1982,4249,18473,22863,236833,239039,2714,11.881,2673,11.702,42502,15920,26582,6.660,17.780,47123,16991,30132,7.108,19.714,-4621,-1.933,35.561,1837,1852,7965
1982,4251,27957,30881,288536,288109,3684,12.098,2823,9.271,52826,18939,33887,6.574,18.335,52141,16378,35763,5.685,18.098,685,0.238,36.195,1791,1794,9450
1982,4411,36547,37506,732864,742316,3118,8.166,4469,11.705,88617,28958,59659,3.901,11.938,107283,39300,67983,5.294,14.452,-18666,-2.515,23.876,3569,3589,32006
1982,4412,10993,11381,69976,71301,1106,9.504,1619,13.912,13874,4559,9315,6.394,19.458,16517,6760,9757,9.481,23.165,-2643,-3.707,38.917,1234,1244,5274
1982,4413,42516,62600,406724,397142,8570,14.077,5125,8.419,88923,46498,42425,11.708,22.391,71022,22861,48161,5.756,17.883,17901,4.507,35.767,3069,3182,12599
1982,4421,22355,26774,203948,208834,2523,9.282,3339,12.284,33558,11968,21590,5.731,16.069,43424,14313,29111,6.854,20.794,-9866,-4.724,32.139,2354,2431,9264
1982,4422,18985,22458,118286,119558,3016,13.380,3181,14.112,25716,11089,14627,9.275,21.509,28134,9891,18243,8.273,23.532,-2418,-2.022,43.019,2287,2363,6700
1982,4431,22927,30168,168949,170963,4643,15.318,4927,16.255,39485,18955,20530,11.087,23.096,43319,20363,22956,11.911,25.338,-3834,-2.243,46.191,3003,3201,11649
1982,4441,54826,69532,618326,630854,5516,7.873,6584,9.397,88065,32902,55163,5.215,13.960,113374,33292,80082,5.277,17.972,-25309,-4.012,27.919,4450,4572,18632
1982,4442,13709,16904,119073,119573,1681,9.945,1678,9.928,20748,7249,13499,6.062,17.352,21850,6336,15514,5.299,18.273,-1102,-0.922,34.704,1196,1202,4162
1982,4451,64418,109458,1833774,1822489,11804,10.777,11942,10.903,292893,134980,157913,7.406,16.071,267857,105473,162384,5.787,14.697,25036,1.374,29.395,7906,8021,43641
1982,4452,22585,27955,171210,169949,4058,14.500,4121,14.725,41231,18931,22300,11.139,24.261,38554,16593,21961,9.764,22.686,2677,1.575,45.371,2988,3039,11711
1982,4453,28589,34168,166871,158033,6973,21.421,3742,11.495,48940,29505,19435,18.670,30.968,31107,12205,18902,7.723,19.684,17833,11.284,39.368,2918,2967,9447
1982,4461,43263,64238,554975,551219,6159,9.680,4936,7.758,91782,36940,54842,6.702,16.651,83449,26657,56792,4.836,15.139,8333,1.512,30.278,3268,3340,16228
1982,4471,99650,130277,757193,767451,15206,11.379,21910,16.396,170355,73530,96825,9.581,22.198,189976,87505,102471,11.402,24.754,-19621,-2.557,44.395,15516,15939,57662
1982,4481,58467,96894,784678,780934,11384,11.713,11971,12.317,156914,70088,86826,8.975,20.093,148284,53846,94438,6.895,18.988,8630,1.105,37.976,7616,8237,28934
1982,4482,12132,35751,189323,190559,4176,11.819,3342,9.458,40899,19033,21866,9.988,21.463,42209,12092,30117,6.346,22.150,-1310,-0.687,42.925,1530,1620,5062
1982,4483,17132,24621,144422,144709,2596,10.525,2682,10.874,26615,10785,15830,7.453,18.392,27161,10020,17141,6.924,18.769,-546,-0.377,36.784,1574,1615,5237
1982,4511,31720,41933,250875,248700,7451,18.121,5819,14.152,59306,30728,28578,12.355,23.846,56012,20572,35440,8.272,22.522,3294,1.324,45.044,4103,4212,13211
1982,4512,7431,10863,66781,66669,1471,13.694,1229,11.441,14311,6484,7827,9.726,21.466,13906,4245,9661,6.367,20.858,405,0.607,41.717,920,932,3045
1982,4521,535,9826,1494476,1513733,608,6.200,568,5.792,138099,66827,71272,4.415,9.123,181144,36023,145121,2.380,11.967,-43045,-2.844,18.246,46,48,1691
1982,4529,12608,24362,355748,360007,2008,8.106,2829,11.420,51339,19860,31479,5.517,14.261,59354,19245,40109,5.346,16.487,-8015,-2.226,28.521,1689,1742,6270
1982,4531,19901,21188,101690,101422,2602,12.178,2960,13.853,22181,8287,13894,8.171,21.870,21408,8135,13273,8.021,21.108,773,0.762,42.216,2244,2262,6095
1982,4532,23249,28554,171728,168968,4401,15.586,3766,13.337,40968,18070,22898,10.694,24.246,35319,13251,22068,7.842,20.903,5649,3.343,41.806,2863,2904,8332
1982,4533,8720,9773,44664,46126,1626,16.307,2022,20.279,11726,5595,6131,12.130,25.422,15127,7603,7524,16.483,32.795,-3401,-7.373,50.844,1129,1392,3873
1982,4539,22717,26531,121171,121738,4447,16.597,4972,18.557,32565,15597,16968,12.812,26.750,33703,15417,18286,12.664,27.685,-1138,-0.935,53.500,3500,3602,10925
1982,4541,5569,7300,91011,92354,888,12.077,994,13.518,14898,6172,8726,6.683,16.131,17873,6303,11570,6.825,19.353,-2975,-3.221,32.263,688,689,2703
1982,4542,3996,5414,80809,83012,558,10.264,603,11.092,11414,3597,7817,4.333,13.750,15775,3964,11811,4.775,19.003,-4361,-5.253,27.500,389,404,2011
1982,4543,15975,21481,190727,191733,1904,8.736,2533,11.622,35954,12650,23304,6.598,18.752,38106,11686,26420,6.095,19.875,-2152,-1.122,37.504,1703,1720,6749
1982,4811,1077,2718,252801,254351,399,15.465,123,4.767,19641,5112,14529,2.010,7.722,22733,1358,21375,0.534,8.938,-3092,-1.216,15.444,59,64,525
1982,4812,436,639,12092,10949,102,16.735,43,7.055,2975,601,2374,5.489,27.173,720,234,486,2.137,6.576,2255,20.596,13.152,28,28,98
1982,4831,416,678,38021,36478,68,10.241,40,6.024,7125,1249,5876,3.424,19.532,4198,850,3348,2.330,11.508,2927,8.024,23.017,14,15,279
1982,4832,400,461,16642,17034,49,10.757,38,8.342,2608,1517,1091,8.906,15.311,3414,812,2602,4.767,20.042,-806,-4.732,30.621,18,18,85
1982,4841,19635,25134,475510,477742,4091,17.015,1910,7.944,70089,29596,40493,6.195,14.671,74318,15759,58559,3.299,15.556,-4229,-0.885,29.342,1342,1373,7840
1982,4842,40206,44197,536668,538868,6381,15.051,2779,6.555,90531,32891,57640,6.104,16.800,95103,18290,76813,3.394,17.649,-4572,-0.848,33.600,2074,2084,10513
1982,4851,395,436,21118,20035,50,11.765,28,6.588,4247,2915,1332,14.550,21.198,2320,489,1831,2.441,11.580,1927,9.618,23.160,17,17,123
1982,4852,342,752,36469,37636,25,3.281,45,5.906,2750,197,2553,0.523,7.307,5200,437,4763,1.161,13.817,-2450,-6.510,14.614,8,8,35
1982,4853,5240,5299,56278,56757,688,13.358,391,7.591,11135,4141,6994,7.296,19.619,11987,2412,9575,4.250,21.120,-852,-1.501,39.237,319,322,1518
1982,4854,3482,3680,93526,92729,284,7.881,131,3.635,13269,4785,8484,5.160,14.309,11559,2849,8710,3.072,12.465,1710,1.844,24.931,93,93,865
1982,4855,499,539,11521,10769,83,16.290,24,4.711,3131,1898,1233,17.625,29.076,1588,612,976,5.683,14.747,1543,14.329,29.493,15,15,80
1982,4859,859,893,16206,15595,173,20.632,64,7.633,3563,1408,2155,9.029,22.848,2363,592,1771,3.796,15.153,1200,7.695,30.306,53,53,466
1982,4861,75,323,12831,12373,24,7.524,16,5.016,2077,877,1200,7.088,16.787,1186,534,652,4.316,9.585,891,7.201,19.171,(D),(D),(D)
1982,4862,226,1193,60598,59704,103,8.868,40,3.444,5496,1103,4393,1.847,9.205,3794,1823,1971,3.053,6.355,1702,2.851,12.709,10,10,28
1982,4869,59,309,6923,6918,56,19.048,26,8.844,856,495,361,7.156,12.374,867,285,582,4.120,12.533,-11,-0.159,24.749,(D),(D),(D)
1982,4871,161,166,2475,2409,31,19.558,16,10.095,569,299,270,12.414,23.625,429,111,318,4.609,17.812,140,5.813,35.624,10,10,57
1982,4872,669,676,8399,8455,119,17.761,107,15.970,1862,840,1022,9.936,22.024,1931,452,1479,5.346,22.840,-69,-0.816,44.048,86,86,374
1982,4879,52,63,1036,1050,13,21.667,7,11.667,201,19,182,1.810,19.143,215,188,27,17.905,20.476,-14,-1.333,38.286,6,6,13
1982,4881,1984,2490,55041,54160,367,15.324,177,7.390,8769,2819,5950,5.205,16.191,6995,1715,5280,3.167,12.916,1774,3.276,25.831,116,118,531
1982,4882,320,439,14141,11436,129,33.205,28,7.207,7563,6832,731,59.744,66.136,2318,535,1783,4.678,20.270,5245,45.866,40.540,14,14,43
1982,4883,2261,2674,119352,119242,374,14.647,133,5.209,23397,7799,15598,6.540,19.621,23026,2761,20265,2.315,19.310,371,0.311,38.621,81,81,1277
1982,4884,1648,2198,33002,33906,362,16.369,389,17.590,5073,1882,3191,5.551,14.962,6901,2142,4759,6.318,20.354,-1828,-5.391,29.924,295,299,1139
1982,4885,4388,6164,84332,81715,868,14.716,337,5.713,15392,4713,10679,5.768,18.836,10014,1938,8076,2.372,12.255,5378,6.581,24.510,199,202,990
1982,4889,380,389,6598,6650,63,16.733,38,10.093,1425,570,855,8.572,21.430,1504,255,1249,3.835,22.618,-79,-1.188,42.860,33,33,196
1982,4921,1145,1728,97456,99781,327,19.848,166,10.076,7664,2604,5060,2.610,7.681,12315,762,11553,0.764,12.342,-4651,-4.661,15.362,119,120,506
1982,4922,723,723,4176,3978,221,32.572,132,19.455,1300,625,675,15.711,32.680,870,441,429,11.086,21.870,430,10.809,43.741,122,122,409
1982,4931,6213,9865,383479,389160,963,9.889,709,7.281,57219,21418,35801,5.504,14.703,68448,11563,56885,2.971,17.589,-11229,-2.885,29.406,299,299,1894
1982,5111,12794,14575,601883,595548,1410,9.587,1675,11.389,63217,21338,41879,3.583,10.615,50092,15582,34510,2.616,8.411,13125,2.204,16.822,1300,1301,8379
1982,5112,6999,8242,123425,112662,2335,31.175,831,11.095,41896,19133,22763,16.983,37.187,20216,6290,13926,5.583,17.944,21680,19.243,35.888,515,525,2760
1982,5121,8651,14154,204848,205985,1987,14.077,1909,13.525,48054,18229,29825,8.850,23.329,50200,14615,35585,7.095,24.371,-2146,-1.042,46.658,1115,1152,7728
1982,5122,1641,1650,11836,11714,378,23.312,321,19.796,2791,1513,1278,12.916,23.826,2555,1134,1421,9.681,21.812,236,2.015,43.623,241,241,865
1982,5151,5777,6858,211141,203021,846,12.916,230,3.511,32436,14447,17989,7.116,15.977,16234,2912,13322,1.434,7.996,16202,7.980,15.992,150,155,1281
1982,5152,6,6,181,180,0,0.000,(D),(D),12,0,12,0.000,6.667,8,(D),4,(D),4.444,4,2.222,8.889,(D),(D),(D)
1982,5171,1519,12408,887615,895723,224,1.806,217,1.749,61228,3091,58137,0.345,6.836,79206,3304,75902,0.369,8.843,-17978,-2.007,13.671,102,103,732
1982,5172,548,1337,67359,66289,150,11.565,70,5.397,7158,1659,5499,2.503,10.798,5194,621,4573,0.937,7.835,1964,2.963,15.671,56,56,321
1982,5174,651,1122,40145,36073,182,17.317,40,3.806,11825,3698,8127,10.252,32.781,3560,739,2821,2.049,9.869,8265,22.912,19.738,15,15,269
1982,5179,1113,2217,81537,76760,307,14.440,125,5.880,16137,3582,12555,4.666,21.023,7010,906,6104,1.180,9.132,9127,11.890,18.265,85,85,291
1982,5182,5666,7455,208909,202804,1252,17.192,907,12.455,47641,18324,29317,9.035,23.491,35937,10759,25178,5.305,17.720,11704,5.771,35.440,544,566,4762
1982,5191,1884,2103,24559,23128,366,18.200,182,9.050,5906,3528,2378,15.255,25.537,3115,1105,2010,4.778,13.469,2791,12.068,26.938,127,127,858
1982,5211,30,66,24624,22842,15,25.424,(D),(D),4009,4009,0,17.551,17.551,671,(D),670,(D),2.938,3338,14.613,5.875,(D),(D),(D)
1982,5221,20515,66313,1842235,1818715,2678,4.094,876,1.339,155591,34580,121011,1.901,8.555,109055,12566,96489,0.691,5.996,46536,2.559,11.993,373,454,4106
1982,5222,22554,40253,326444,332983,2399,5.806,4534,10.973,47068,15931,31137,4.784,14.135,60387,25927,34460,7.786,18.135,-13319,-4.000,28.271,703,828,3607
1982,5223,2883,3289,45971,44576,638,20.228,368,11.668,10786,4648,6138,10.427,24.197,7619,1813,5806,4.067,17.092,3167,7.105,34.184,275,275,1098
1982,5231,5219,9877,227041,222838,1412,14.906,603,6.366,30394,8820,21574,3.958,13.640,22285,6445,15840,2.892,10.001,8109,3.639,20.001,310,353,2554
1982,5232,116,131,6140,6236,19,15.323,5,4.032,328,123,205,1.972,5.260,519,18,501,0.289,8.323,-191,-3.063,10.520,3,3,7
1982,5239,11322,11679,118708,98457,2756,25.708,839,7.826,55308,39615,15693,40.236,56.175,15132,4935,10197,5.012,15.369,40176,40.806,30.738,644,644,2200
1982,5241,5930,29965,1212992,1222636,1740,5.819,1612,5.391,115641,37542,78099,3.071,9.458,134523,29078,105445,2.378,11.003,-18882,-1.544,18.917,214,226,1435
1982,5242,87908,92587,876931,700853,11788,13.300,3880,4.378,415821,311738,104083,44.480,59.331,64127,15204,48923,2.169,9.150,351694,50.181,18.300,2715,2718,7004
1982,5250,1742,1943,42397,28633,290,15.917,48,2.634,29862,26674,3188,93.158,104.292,1854,138,1716,0.482,6.475,28008,97.817,12.950,30,30,84
1982,5311,95836,97754,487494,477214,11430,12.013,6219,6.536,107657,46484,61173,9.741,22.560,86921,21733,65188,4.554,18.214,20736,4.345,36.429,4946,4970,14314
1982,5312,31154,32319,168338,168939,4824,15.382,2908,9.273,37989,15994,21995,9.467,22.487,39475,8305,31170,4.916,23.366,-1486,-0.880,44.974,2229,2232,5605
1982,5313,19173,19834,185863,181956,3195,16.695,1801,9.411,40652,16391,24261,9.008,22.342,33005,7730,25275,4.248,18.139,7647,4.203,36.278,1384,1388,4084
1982,5321,5301,8932,99098,99926,1205,13.532,1150,12.915,18783,7614,11169,7.620,18.797,20386,7942,12444,7.948,20.401,-1603,-1.604,37.594,707,738,3320
1982,5322,8712,10557,89197,87810,2109,20.424,1647,15.950,24316,10231,14085,11.651,27.692,21568,8358,13210,9.518,24.562,2748,3.130,49.125,1189,1194,5305
1982,5323,2561,2907,22073,21329,528,19.000,272,9.788,5846,2462,3384,11.543,27.409,4310,1463,2847,6.859,20.207,1536,7.201,40.414,183,183,817
1982,5324,4476,5180,51631,50317,854,17.128,466,9.346,12488,5175,7313,10.285,24.819,9827,2895,6932,5.754,19.530,2661,5.288,39.060,331,331,1150
1982,5331,912,970,11043,10330,197,21.589,82,8.986,2993,1165,1828,11.278,28.974,1550,581,969,5.624,15.005,1443,13.969,30.010,65,65,283
1982,5411,112664,116121,611296,599685,16910,14.852,12389,10.881,126758,57681,69077,9.619,21.137,103743,37184,66559,6.201,17.300,23015,3.838,34.599,9266,9316,28293
1982,5412,49147,53038,414378,397511,8935,17.255,6423,12.404,92287,40235,52052,10.122,23.216,58440,21301,37139,5.359,14.701,33847,8.515,29.403,4701,4733,15844
1982,5413,45201,49123,653882,655310,8184,16.995,6251,12.981,132249,54905,77344,8.378,20.181,135282,37028,98254,5.650,20.644,-3033,-0.463,40.362,4361,4380,18381
1982,5414,15476,15771,102093,99681,3365,22.514,1716,11.481,26563,11853,14710,11.891,26.648,21830,6929,14901,6.951,21.900,4733,4.748,43.800,1302,1305,4671
1982,5415,2630,3640,42183,39667,1216,33.393,1219,33.475,15440,10120,5320,25.512,38.924,10033,5508,4525,13.886,25.293,5407,13.631,50.586,1033,1034,3773
1982,5416,8836,9123,83528,85525,2643,26.201,4572,45.323,29613,13303,16310,15.555,34.625,33956,21181,12775,24.766,39.703,-4343,-5.078,69.250,3669,3670,15568
1982,5417,2661,3520,300274,299507,744,21.172,732,20.831,53694,14866,38828,4.963,17.927,51660,25602,26058,8.548,17.248,2034,0.679,34.497,440,444,2956
1982,5418,18438,20306,250947,247127,3414,17.062,2821,14.098,51784,20111,31673,8.138,20.954,44456,17104,27352,6.921,17.989,7328,2.965,35.978,2104,2125,10466
1982,5419,24044,26245,158102,155682,3432,13.372,2274,8.860,32699,12983,19716,8.339,21.004,28243,8509,19734,5.466,18.142,4456,2.862,36.283,1662,1672,5817
1982,5511,22083,42667,2766875,2737171,4852,11.604,3145,7.521,538382,200797,337585,7.336,19.669,475376,119371,356005,4.361,17.367,63006,2.302,34.735,468,481,5595
1982,5611,392,415,14127,15776,122,13.951,1041,119.039,5439,3818,1621,24.201,34.476,8574,6448,2126,40.872,54.348,-3135,-19.872,68.953,846,848,4911
1982,5612,51,55,4803,6814,10,12.579,59,74.214,758,372,386,5.460,11.125,4683,2284,2399,33.522,68.731,-3925,-57.606,22.250,26,27,161
1982,5613,10070,13738,567447,561900,2456,18.193,1980,14.667,149063,46362,102701,8.251,26.528,137745,24156,113589,4.299,24.514,11318,2.014,49.028,1433,1451,16040
1982,5614,20875,23129,233512,229239,4088,18.326,2445,10.960,51612,18950,32662,8.266,22.514,43044,12272,30772,5.353,18.777,8568,3.738,37.554,1782,1791,7501
1982,5615,17801,20922,153646,149820,3154,15.617,1703,8.432,33425,13455,19970,8.981,22.310,25884,8982,16902,5.995,17.277,7541,5.033,34.553,1224,1239,6600
1982,5616,17361,20532,538508,529196,3785,19.424,1693,8.688,106683,32983,73700,6.233,20.159,88728,22933,65795,4.334,16.767,17955,3.393,33.533,1156,1157,11724
1982,5617,48191,51001,668514,656006,9995,20.067,7608,15.275,171975,67725,104250,10.324,26.215,147298,53490,93808,8.154,22.454,24677,3.762,44.908,6044,6059,27405
1982,5619,18480,19668,216814,208110,4159,22.644,1557,8.477,56638,21539,35099,10.350,27.215,39432,8029,31403,3.858,18.948,17206,8.268,37.895,1095,1095,4811
1982,5621,4342,4492,86765,86122,559,12.842,281,6.455,12757,3805,8952,4.418,14.813,11495,2419,9076,2.809,13.347,1262,1.465,26.695,222,222,1775
1982,5622,2120,2558,42131,40354,331,13.566,95,3.893,8001,2830,5171,7.013,19.827,4320,1030,3290,2.552,10.705,3681,9.122,21.411,57,57,244
1982,5629,4215,4415,39259,39149,628,14.372,537,12.290,8513,2887,5626,7.374,21.745,8333,3293,5040,8.411,21.285,180,0.460,42.571,390,390,2000
1982,6111,12481,12808,351952,328097,2083,17.548,207,1.744,68283,43131,25152,13.146,20.812,20631,1966,18665,0.599,6.288,47652,14.524,12.576,134,135,1158
1982,6112,431,526,35892,32826,84,17.004,20,4.049,9478,5982,3496,18.223,28.873,3243,738,2505,2.248,9.879,6235,18.994,19.759,14,15,573
1982,6113,1969,2250,876825,853005,225,10.460,27,1.255,95967,32038,63929,3.756,11.250,46960,2128,44832,0.249,5.505,49007,5.745,11.010,11,11,166
1982,6114,1614,1822,28874,27958,338,19.021,248,13.956,6879,2885,3994,10.319,24.605,5060,1475,3585,5.276,18.099,1819,6.506,36.197,178,179,875
1982,6115,3795,4559,57380,56060,631,14.086,472,10.537,11245,4711,6534,8.404,20.059,8554,2406,6148,4.292,15.259,2691,4.800,30.518,356,356,1655
1982,6116,9780,10269,85771,82340,2223,22.071,1829,18.159,25680,13855,11825,16.827,31.188,18853,7769,11084,9.435,22.897,6827,8.291,45.793,1411,1419,5459
1982,6117,529,537,7697,6845,147,26.800,170,30.994,2787,2345,442,34.261,40.719,1128,616,512,9.000,16.480,1659,24.238,32.961,131,131,383
1982,6211,169994,174853,950018,929166,19766,11.585,11284,6.614,169908,69682,100226,7.499,18.286,129431,37781,91650,4.066,13.930,40477,4.356,27.860,8883,8931,28983
1982,6212,90005,91885,400054,387870,7335,8.080,5114,5.634,76275,26250,50025,6.768,19.665,52364,16582,35782,4.275,13.500,23911,6.165,27.001,3986,3999,13233
1982,6213,35315,36930,115892,111562,5797,16.185,3573,9.975,31081,14953,16128,13.403,27.860,22389,9581,12808,8.588,20.069,8692,7.791,40.137,2664,2690,7492
1982,6214,4703,5822,87739,85449,943,16.775,542,9.642,18813,8877,9936,10.389,22.017,14122,4929,9193,5.768,16.527,4691,5.490,33.054,360,364,3300
1982,6215,3775,4755,62870,62662,546,11.382,630,13.133,12047,4285,7762,6.838,19.226,11463,6178,5285,9.859,18.294,584,0.932,36.587,344,362,2738
1982,6216,2873,3820,150145,133240,744,20.370,409,11.198,52490,24818,27672,18.627,39.395,18782,5031,13751,3.776,14.096,33708,25.299,28.193,260,261,1442
1982,6219,2898,3340,64274,59654,601,19.085,219,6.955,17591,6908,10683,11.580,29.489,8446,2884,5562,4.835,14.158,9145,15.330,28.317,151,151,1236
1982,6221,3675,4749,2787159,2702416,344,7.407,135,2.907,252552,92762,159790,3.433,9.345,81775,25378,56397,0.939,3.026,170777,6.319,6.052,71,73,16969
1982,6222,341,456,46711,45105,74,17.090,28,6.467,8088,4399,3689,9.753,17.931,4961,3064,1897,6.793,10.999,3127,6.933,21.998,12,13,1165
1982,6223,195,239,41827,42218,39,17.411,9,4.018,4613,1425,3188,3.375,10.927,5504,411,5093,0.974,13.037,-891,-2.110,21.853,4,4,130
1982,6231,6761,9525,772557,758955,758,8.092,443,4.729,103722,49329,54393,6.500,13.666,76564,26664,49900,3.513,10.088,27158,3.578,20.176,260,265,13533
1982,6232,3479,4547,103266,98636,754,17.359,347,7.989,21960,11728,10232,11.890,22.264,12766,4239,8527,4.298,12.943,9194,9.321,25.885,260,262,3018
1982,6233,8434,10050,384909,383584,1303,13.124,1060,10.676,63249,29760,33489,7.758,16.489,60652,31091,29561,8.105,15.812,2597,0.677,31.624,696,711,18748
1982,6239,2470,3002,70176,68494,458,15.992,182,6.355,11270,5517,5753,8.055,16.454,7942,2672,5270,3.901,11.595,3328,4.859,23.191,108,113,1626
1982,6241,11978,16109,236378,236469,2690,17.319,1537,9.895,54959,27627,27332,11.683,23.242,55384,15285,40099,6.464,23.421,-425,-0.180,46.483,654,918,8919
1982,6242,3332,3884,36130,36125,653,17.448,370,9.886,8562,5170,3392,14.311,23.701,8678,3818,4860,10.569,24.022,-116,-0.321,47.402,181,231,2448
1982,6243,3517,5133,214884,221733,808,16.131,560,11.180,42725,16843,25882,7.596,19.269,56372,10009,46363,4.514,25.423,-13647,-6.155,38.537,247,264,5551
1982,6244,25377,30172,259807,242504,6631,23.325,3144,11.059,79609,47445,32164,19.565,32.828,44329,15861,28468,6.541,18.280,35280,14.548,36.559,2428,2484,12102
1982,7111,5018,5077,70589,65734,1212,24.725,862,17.585,25691,11443,14248,17.408,39.083,15743,4579,11164,6.966,23.950,9948,15.134,47.899,654,657,3530
1982,7112,2068,2179,59274,59102,394,18.132,382,17.579,11910,4138,7772,7.001,20.152,11593,3330,8263,5.634,19.615,317,0.536,39.230,270,271,2506
1982,7113,2101,2143,25904,25497,409,19.366,347,16.430,7554,3011,4543,11.809,29.627,6690,2759,3931,10.821,26.238,864,3.389,52.477,260,260,2178
1982,7114,1190,1206,12992,12599,256,22.088,162,13.978,3968,1846,2122,14.652,31.495,3179,1157,2022,9.183,25.232,789,6.262,50.464,123,123,833
1982,7115,4618,4634,30849,32254,1428,30.190,1620,34.249,9247,4993,4254,15.480,28.669,12099,5718,6381,17.728,37.512,-2852,-8.842,57.339,1192,1192,3330
1982,7121,181,184,3022,2965,37,15.812,137,58.547,955,556,399,18.755,32.215,869,739,130,24.928,29.314,86,2.901,58.627,98,98,392
1982,7131,2107,2584,56463,53343,941,42.330,219,9.852,9628,4714,4914,8.837,18.049,3558,846,2712,1.586,6.670,6070,11.379,13.340,176,179,732
1982,7132,732,755,19402,18685,163,22.498,102,14.079,4512,1151,3361,6.160,24.148,3161,934,2227,4.999,16.917,1351,7.230,33.835,80,80,700
1982,7139,31462,33395,485197,475424,4593,14.075,3069,9.405,94610,35564,59046,7.480,19.900,75131,20006,55125,4.208,15.803,19479,4.097,31.606,2292,2307,14879
1982,7211,28086,32246,1084577,1070620,3850,11.847,4352,13.392,209254,92342,116912,8.625,19.545,182098,71576,110522,6.685,17.009,27156,2.536,34.017,3254,3296,45638
1982,7212,3391,3641,20055,18944,595,16.636,466,13.029,6789,2792,3997,14.739,35.838,4701,1378,3323,7.274,24.816,2088,11.022,49.632,312,312,980
1982,7213,4717,4821,22104,22341,291,5.913,492,9.997,3647,1016,2631,4.548,16.325,4102,1439,2663,6.441,18.361,-455,-2.037,32.649,346,351,1048
1982,7223,16643,26189,484396,482580,4340,16.708,3913,15.064,116978,57705,59273,11.958,24.240,113130,43007,70123,8.912,23.443,3848,0.797,46.886,2267,2309,17608
1982,7224,58760,59576,320601,322262,8574,14.118,10883,17.920,89348,47042,42306,14.597,27.725,92480,41758,50722,12.958,28.697,-3132,-0.972,55.451,8551,8575,32553
1982,7225,177643,229853,3929641,3890275,36610,15.975,35243,15.379,939876,500416,439460,12.863,24.160,855300,351001,504299,9.023,21.986,84576,2.174,43.971,26574,27057,235240
1982,8111,88296,92397,424063,420786,13711,14.847,13611,14.739,99681,43754,55927,10.398,23.689,93035,40389,52646,9.598,22.110,6646,1.579,44.220,10310,10347,31139
1982,8112,9135,10108,59820,59201,1186,11.535,1533,14.910,12461,4632,7829,7.824,21.049,11294,4711,6583,7.958,19.077,1167,1.971,38.155,1188,1193,3066
1982,8113,17198,18094,138913,139286,2552,14.177,2366,13.144,28699,11175,17524,8.023,20.604,29482,9997,19485,7.177,21.167,-783,-0.562,41.209,1746,1747,6587
1982,8114,21730,23309,135708,137637,3472,14.793,3796,16.173,26382,11624,14758,8.445,19.168,30207,12814,17393,9.310,21.947,-3825,-2.779,38.336,2859,2860,7903
1982,8121,76954,85175,383820,386639,10754,12.407,13763,15.878,81487,38655,42832,9.998,21.076,86519,41517,45002,10.738,22.377,-5032,-1.301,42.151,10751,10822,29602
1982,8122,16866,19530,111194,110127,1389,7.120,1348,6.909,18231,5314,12917,4.825,16.555,16088,4231,11857,3.842,14.609,2143,1.946,29.217,924,935,2917
1982,8123,31977,37694,328792,331985,4115,10.803,4913,12.897,51871,20138,31733,6.066,15.625,58109,25582,32527,7.706,17.504,-6238,-1.879,31.249,3569,3674,14701
1982,8129,17519,23954,271907,261358,4834,21.100,2745,11.982,74033,35215,38818,13.474,28.326,52814,14646,38168,5.604,20.208,21219,8.119,40.415,1377,1411,6700
1982,8131,74602,74716,712248,654402,16513,24.759,469,0.703,174273,107210,67063,16.383,26.631,57952,1639,56313,0.250,8.856,116321,17.775,17.711,151,151,478
1982,8132,6599,7601,116316,114898,1262,17.536,453,6.295,22853,12093,10760,10.525,19.890,20094,3238,16856,2.818,17.489,2759,2.401,34.977,254,263,2012
1982,8133,6424,7604,82222,83728,1592,22.182,738,10.283,21046,12932,8114,15.445,25.136,24139,5412,18727,6.464,28.830,-3093,-3.694,50.273,408,430,2862
1982,8134,27044,28331,244564,242107,2034,7.115,2547,8.909,38666,10594,28072,4.376,15.971,33510,5781,27729,2.388,13.841,5156,2.130,27.682,1341,1342,3510
1982,8139,53909,56106,426991,412301,5107,9.306,2654,4.836,92940,31958,60982,7.751,22.542,63147,8519,54628,2.066,15.316,29793,7.226,30.632,1812,1818,5753
1983,2111,7719,9784,170308,176711,1415,14.591,1243,12.817,33849,14471,19378,8.189,19.155,46736,14159,32577,8.013,26.448,-12887,-7.293,38.310,844,849,5174
1983,2121,2751,3454,186172,212778,498,13.577,926,25.245,21582,10712,10870,5.034,10.143,75155,19261,55894,9.052,35.321,-53573,-25.178,20.286,659,660,8508
1983,2122,545,697,46019,57921,120,15.758,249,32.699,3329,2048,1281,3.536,5.748,27105,4105,23000,7.087,46.797,-23776,-41.049,11.495,167,167,936
1983,2123,3542,4983,96083,99858,411,8.173,503,10.002,13764,4372,9392,4.378,13.784,21259,5340,15919,5.348,21.289,-7495,-7.506,27.567,273,277,2048
1983,2131,11367,12893,297972,362450,1989,15.038,2656,20.081,53865,24918,28947,6.875,14.861,182364,48578,133786,13.403,50.314,-128499,-35.453,29.723,1862,1871,23936
1983,2211,1554,5738,580878,573228,193,3.420,3,0.053,40604,12176,28428,2.124,7.083,25359,32,25327,0.006,4.424,15245,2.660,8.848,3,3,32
1983,2212,530,2356,137129,137897,111,4.824,(D),(D),8198,1968,6230,1.427,5.945,9427,(D),9426,(D),6.836,-1229,-0.891,11.890,(D),(D),(D)
1983,2213,3624,3928,30376,29754,311,8.237,6,0.159,3266,1208,2058,4.060,10.977,2049,18,2031,0.060,6.886,1217,4.090,13.773,4,4,14
1983,2361,79123,79490,423948,417595,16526,20.849,16076,20.281,148087,59571,88516,14.265,35.462,135562,58272,77290,13.954,32.463,12525,2.999,64.925,11070,11075,43181
1983,2362,33062,33643,527719,554580,4596,13.751,4158,12.440,121733,29792,91941,5.372,21.951,176366,32555,143811,5.870,31.802,-54633,-9.851,43.901,2853,2855,20792
1983,2371,12658,12991,316248,339617,1414,10.815,1581,12.092,54188,11945,42243,3.517,15.956,100152,18575,81577,5.469,29.490,-45964,-13.534,31.911,1114,1115,9418
1983,2372,7116,7211,53981,51702,1706,23.961,1524,21.404,18727,9427,9300,18.233,36.221,13947,5395,8552,10.435,26.976,4780,9.245,53.951,1147,1147,3976
1983,2373,9559,9820,185525,188658,995,10.116,1026,10.432,40716,8193,32523,4.343,21.582,47030,8475,38555,4.492,24.929,-6314,-3.347,43.164,731,734,5765
1983,2379,4434,4489,68668,74242,737,16.480,703,15.720,17299,5252,12047,7.074,23.301,28332,4276,24056,5.760,38.162,-11033,-14.861,46.602,496,496,2633
1983,2381,59688,60077,509111,505161,9634,16.231,8194,13.805,152349,44627,107722,8.834,30.159,144487,40001,104486,7.918,28.602,7862,1.556,57.204,5723,5724,29901
1983,2382,93606,95544,928886,948227,12095,12.721,11164,11.742,190652,50758,139894,5.353,20.106,229568,51084,178484,5.387,24.210,-38916,-4.104,40.212,8122,8128,37628
1983,2383,60750,61162,465005,464681,10684,17.525,10290,16.879,136808,42729,94079,9.195,29.441,135852,42779,93073,9.206,29.236,956,0.206,58.471,7176,7190,31568
1983,2389,32641,32844,314283,326167,5051,15.454,4730,14.472,77501,28793,48708,8.828,23.761,101156,23108,78048,7.085,31.014,-23655,-7.252,47.522,3380,3380,17216
1983,3111,1860,2504,62821,62553,188,7.584,138,5.567,8933,2755,6178,4.404,14.281,8485,1595,6890,2.550,13.564,448,0.716,27.129,73,74,756
1983,3112,537,896,75009,76542,58,6.495,52,5.823,5834,2082,3752,2.720,7.622,8982,2409,6573,3.147,11.735,-3148,-4.113,15.244,29,29,799
1983,3113,1348,1729,85660,90064,237,14.032,157,9.295,8661,2831,5830,3.143,9.617,17602,8374,9228,9.298,19.544,-8941,-9.927,19.233,83,83,473
1983,3114,1263,1737,174533,177625,114,6.518,138,7.890,19665,3359,16306,1.891,11.071,25489,6377,19112,3.590,14.350,-5824,-3.279,22.142,73,73,2023
1983,3115,1844,2561,135436,137051,141,5.474,171,6.638,12614,3409,9205,2.487,9.204,15989,4757,11232,3.471,11.667,-3375,-2.463,18.408,99,99,1578
1983,3116,4314,4909,322626,328982,327,6.663,325,6.622,34100,11073,23027,3.366,10.365,46713,16551,30162,5.031,14.199,-12613,-3.834,20.731,206,208,3802
1983,3117,770,887,47275,47651,66,7.346,89,9.905,8246,2106,6140,4.420,17.305,9162,3575,5587,7.503,19.228,-916,-1.922,34.610,57,59,1935
1983,3118,8652,10082,302037,302556,1361,13.747,998,10.080,36266,13079,23187,4.323,11.987,37010,13518,23492,4.468,12.232,-744,-0.246,23.973,701,714,6523
1983,3119,2037,2399,118874,122414,193,8.023,206,8.564,12954,3262,9692,2.665,10.582,19878,8128,11750,6.640,16.238,-6924,-5.656,21.164,122,126,2735
1983,3121,2006,2564,173679,176389,153,5.904,208,8.026,14930,4398,10532,2.493,8.464,20523,5949,14574,3.373,11.635,-5593,-3.171,16.928,125,127,1890
1983,3122,107,165,43048,44306,14,8.459,15,9.063,3776,594,3182,1.341,8.523,6484,2739,3745,6.182,14.635,-2708,-6.112,17.045,5,5,50
1983,3131,451,679,105145,107439,48,7.012,59,8.619,7755,2294,5461,2.135,7.218,12303,4787,7516,4.456,11.451,-4548,-4.233,14.436,23,23,475
1983,3132,1750,2143,294015,307052,141,6.486,203,9.338,19778,5355,14423,1.744,6.441,45474,14529,30945,4.732,14.810,-25696,-8.369,12.883,117,118,2417
1983,3133,1599,1834,108303,110213,126,6.850,137,7.448,9549,2558,6991,2.321,8.664,13270,3635,9635,3.298,12.040,-3721,-3.376,17.328,82,82,1370
1983,3141,3919,4212,113028,112588,408,9.572,509,11.941,15968,3630,12338,3.224,14.183,15090,5568,9522,4.945,13.403,878,0.780,26.806,403,410,3593
1983,3149,3455,3601,120562,123538,460,12.947,364,10.245,18874,7817,11057,6.328,15.278,24732,9209,15523,7.454,20.020,-5858,-4.742,30.556,274,274,5302
1983,3151,1370,1497,140118,141164,102,6.748,131,8.667,13661,2873,10788,2.035,9.677,15771,4926,10845,3.490,11.172,-2110,-1.495,19.355,106,106,1645
1983,3152,12129,13678,846008,871877,1662,11.868,2314,16.524,112967,39910,73057,4.577,12.957,165338,66986,98352,7.683,18.963,-52371,-6.007,25.914,1861,1883,40832
1983,3159,1808,1920,78573,79438,215,11.245,199,10.408,11671,3658,8013,4.605,14.692,13353,4435,8918,5.583,16.809,-1682,-2.117,29.384,150,151,1641
1983,3161,360,403,19425,19603,30,7.435,31,7.683,2283,814,1469,4.152,11.646,2680,338,2342,1.724,13.671,-397,-2.025,23.292,25,26,238
1983,3162,522,758,128083,133504,52,6.838,57,7.495,11468,3052,8416,2.286,8.590,22096,5038,17058,3.774,16.551,-10628,-7.961,17.180,35,36,1040
1983,3169,1324,1375,51207,54036,152,11.018,161,11.671,5490,1907,3583,3.529,10.160,11170,2576,8594,4.767,20.672,-5680,-10.512,20.320,132,132,1628
1983,3211,4831,5352,129691,127479,488,8.986,645,11.877,24593,6831,17762,5.359,19.292,20221,8177,12044,6.414,15.862,4372,3.430,31.725,429,430,3279
1983,3212,1012,1266,79830,77034,119,9.407,117,9.249,13546,3969,9577,5.152,17.585,7867,3281,4586,4.259,10.212,5679,7.372,20.425,74,74,691
1983,3219,8408,9159,246161,243020,1015,11.069,1037,11.309,44736,12832,31904,5.280,18.408,38181,14861,23320,6.115,15.711,6555,2.697,31.422,760,762,7785
1983,3221,289,628,202659,205146,36,5.723,38,6.041,10223,5858,4365,2.856,4.983,15126,6471,8655,3.154,7.373,-4903,-2.390,9.967,11,11,149
1983,3222,3579,5117,378751,386329,227,4.401,308,5.972,29529,7666,21863,1.984,7.643,44854,16821,28033,4.354,11.610,-15325,-3.967,15.287,176,185,2974
1983,3231,34472,36039,678273,679012,4182,11.831,2801,7.924,84176,27194,56982,4.005,12.397,85225,27085,58140,3.989,12.551,-1049,-0.154,24.794,2204,2209,14350
1983,3241,1481,2353,273804,315058,186,7.823,235,9.884,15524,4791,10733,1.521,4.927,98286,20099,78187,6.379,31.196,-82762,-26.269,9.855,105,107,1337
1983,3251,1159,2267,264005,265614,187,8.282,169,7.484,27319,19111,8208,7.195,10.285,30975,10127,20848,3.813,11.662,-3656,-1.376,20.570,76,76,837
1983,3252,507,773,150176,156264,44,5.674,49,6.319,7878,3842,4036,2.459,5.041,19784,4901,14883,3.136,12.661,-11906,-7.619,10.083,15,15,134
1983,3253,726,1083,49658,52566,72,6.596,89,8.154,3952,1894,2058,3.603,7.518,9874,2887,6987,5.492,18.784,-5922,-11.266,15.036,42,42,596
1983,3254,1009,1243,159852,159478,126,10.273,93,7.583,13291,3518,9773,2.206,8.334,12340,3507,8833,2.199,7.738,951,0.596,15.475,52,52,584
1983,3255,1630,2076,72357,73513,113,5.418,132,6.329,6829,1632,5197,2.220,9.290,9289,2362,6927,3.213,12.636,-2460,-3.346,18.579,74,80,762
1983,3256,2024,2280,122870,125621,177,7.816,146,6.447,11079,2200,8879,1.751,8.819,16304,3208,13096,2.554,12.979,-5225,-4.159,17.639,102,102,634
1983,3259,1734,2247,94427,96166,244,11.003,185,8.343,8249,2585,5664,2.688,8.578,11725,2214,9511,2.302,12.192,-3476,-3.615,17.156,112,113,873
1983,3261,9838,11331,491160,490256,1030,9.125,944,8.363,72431,24339,48092,4.965,14.774,70416,22260,48156,4.540,14.363,2015,0.411,28.726,636,642,8386
1983,3262,1969,2334,174414,181475,215,9.291,175,7.563,13850,4954,8896,2.730,7.632,28008,9050,18958,4.987,15.434,-14158,-7.802,15.264,101,101,1764
1983,3271,1299,1587,75200,76458,187,11.813,179,11.308,9346,3400,5946,4.447,12.224,12103,2573,9530,3.365,15.830,-2757,-3.606,24.447,129,129,1079
1983,3272,1509,1794,148827,154195,211,11.874,177,9.961,12442,4621,7821,2.997,8.069,23525,10270,13255,6.660,15.257,-11083,-7.188,16.138,113,113,1654
1983,3273,7066,8966,163292,166508,554,6.118,733,8.095,26125,6899,19226,4.143,15.690,32426,9477,22949,5.692,19.474,-6301,-3.784,31.380,461,466,4132
1983,3274,248,346,16029,16061,44,12.735,43,12.446,2112,715,1397,4.452,13.150,2087,627,1460,3.904,12.995,25,0.156,25.989,30,30,85
1983,3279,1859,2143,75619,78064,181,8.436,186,8.669,7288,2122,5166,2.718,9.336,12187,3736,8451,4.786,15.612,-4899,-6.276,18.672,117,117,833
1983,3311,296,330,110526,122820,38,11.429,43,12.932,3945,2115,1830,1.722,3.212,28636,1457,27179,1.186,23.315,-24691,-20.103,6.424,30,30,467
1983,3312,507,691,59367,65960,58,8.461,47,6.856,5697,2342,3355,3.551,8.637,18936,3563,15373,5.402,28.709,-13239,-20.071,17.274,21,22,277
1983,3313,447,668,115843,124035,40,5.935,52,7.715,6417,1672,4745,1.348,5.174,22426,7768,14658,6.263,18.080,-16009,-12.907,10.347,13,13,212
1983,3314,723,895,84699,89530,72,7.856,115,12.548,6083,2922,3161,3.264,6.794,15967,2746,13221,3.067,17.834,-9884,-11.040,13.589,79,80,712
1983,3315,2805,3133,202008,229765,167,5.257,254,7.996,12968,3871,9097,1.685,5.644,68543,14038,54505,6.110,29.832,-55575,-24.188,11.288,152,152,3567
1983,3321,3137,3376,133380,142020,204,6.049,197,5.841,11931,5170,6761,3.640,8.401,29407,5218,24189,3.674,20.706,-17476,-12.305,16.802,147,147,2742
1983,3322,1227,1360,80163,83532,84,6.149,96,7.028,8626,3559,5067,4.261,10.327,15294,3525,11769,4.220,18.309,-6668,-7.983,20.653,56,56,628
1983,3323,9927,10756,312970,334192,764,7.063,887,8.200,38827,10658,28169,3.189,11.618,81293,16858,64435,5.044,24.325,-42466,-12.707,23.236,611,616,7431
1983,3324,1435,1823,125785,137245,110,5.977,145,7.878,8204,2602,5602,1.896,5.978,31231,7843,23388,5.715,22.756,-23027,-16.778,11.955,77,77,1259
1983,3325,909,984,75553,76026,86,8.722,90,9.128,7892,2778,5114,3.654,10.381,8721,3639,5082,4.787,11.471,-829,-1.090,20.761,58,58,1316
1983,3326,1559,1766,61030,61706,143,8.146,122,6.950,8312,2624,5688,4.252,13.470,9666,2470,7196,4.003,15.665,-1354,-2.194,26.941,80,85,1364
1983,3327,20734,21073,293144,319285,1657,7.733,2366,11.042,30476,10311,20165,3.229,9.545,83065,18113,64952,5.673,26.016,-52589,-16.471,19.090,1701,1702,10661
1983,3328,5348,5658,110846,114622,410,7.239,422,7.451,14083,4161,9922,3.630,12.287,21675,5147,16528,4.490,18.910,-7592,-6.624,24.573,302,306,2981
1983,3329,4965,5533,335022,361734,669,12.175,593,10.792,32034,12935,19099,3.576,8.856,85850,16300,69550,4.506,23.733,-53816,-14.877,17.711,420,423,6649
1983,3331,3128,3566,247429,314346,247,6.730,455,12.398,13737,5467,8270,1.739,4.370,147827,19530,128297,6.213,47.027,-134090,-42.657,8.740,297,298,3469
1983,3332,3669,3928,158736,172243,293,7.434,320,8.119,15171,6643,8528,3.857,8.808,42109,11314,30795,6.569,24.447,-26938,-15.640,17.616,208,210,2283
1983,3333,1972,2095,155410,157723,162,7.749,153,7.319,18889,4305,14584,2.729,11.976,23820,7239,16581,4.590,15.102,-4931,-3.126,23.952,95,95,1528
1983,3334,1850,2082,155994,169358,173,8.147,256,12.056,16622,6600,10022,3.897,9.815,44118,18226,25892,10.762,26.050,-27496,-16.235,19.629,163,163,1220
1983,3335,9434,9895,216088,245674,589,5.885,815,8.143,15953,5759,10194,2.344,6.494,74515,16538,57977,6.732,30.331,-58562,-23.837,12.987,555,558,4898
1983,3336,737,906,144828,160239,44,4.859,43,4.749,5797,3043,2754,1.899,3.618,36690,1704,34986,1.063,22.897,-30893,-19.279,7.235,27,27,278
1983,3339,5941,6539,308218,344512,429,6.490,572,8.653,21511,8884,12627,2.579,6.244,93790,18848,74942,5.471,27.224,-72279,-20.980,12.488,356,356,3771
1983,3341,1476,1690,333982,332555,312,19.295,166,10.266,49367,14125,35242,4.247,14.845,45602,15421,30181,4.637,13.713,3765,1.132,27.425,115,115,2206
1983,3342,1776,1978,265842,270909,192,9.726,184,9.321,31173,10191,20982,3.762,11.507,41469,10613,30856,3.918,15.307,-10296,-3.801,23.014,136,136,1949
1983,3343,410,435,46997,49392,43,9.674,62,13.948,3398,1099,2299,2.225,6.880,7975,3455,4520,6.995,16.146,-4577,-9.267,13.759,41,41,714
1983,3344,4125,4670,465686,476124,599,13.077,420,9.169,47229,14491,32738,3.044,9.919,67711,15476,52235,3.250,14.221,-20482,-4.302,19.839,292,294,5317
1983,3345,3876,4445,621542,633139,432,9.809,350,7.947,58086,16452,41634,2.598,9.174,81000,27369,53631,4.323,12.793,-22914,-3.619,18.349,209,210,3641
1983,3346,616,641,17549,17748,122,19.757,75,12.146,4278,1256,3022,7.077,24.104,4627,590,4037,3.324,26.071,-349,-1.966,48.208,55,55,272
1983,3351,1167,1285,76635,80829,96,7.387,125,9.619,6537,1283,5254,1.587,8.087,14716,7146,7570,8.841,18.206,-8179,-10.119,16.175,82,82,1458
1983,3352,346,451,114985,119071,31,6.674,58,12.487,11280,2436,8844,2.046,9.473,18899,3542,15357,2.975,15.872,-7619,-6.399,18.947,40,40,596
1983,3353,1946,2435,237781,259231,157,6.404,190,7.750,13687,3004,10683,1.159,5.280,55827,13310,42517,5.134,21.536,-42140,-16.256,10.560,98,98,1818
1983,3359,1856,2199,191471,197422,256,11.824,188,8.684,19856,8014,11842,4.059,10.058,31452,7735,23717,3.918,15.931,-11596,-5.874,20.115,105,105,1617
1983,3361,184,240,221085,224107,44,18.925,29,12.473,22025,1604,20421,0.716,9.828,28074,4282,23792,1.911,12.527,-6049,-2.699,19.656,22,22,657
1983,3362,1644,1814,86308,90495,174,9.581,178,9.802,13224,3119,10105,3.447,14.613,22278,9035,13243,9.984,24.618,-9054,-10.005,29.226,126,126,1053
1983,3363,3607,4312,549671,553009,412,9.642,334,7.817,52735,9820,42915,1.776,9.536,59008,20415,38593,3.692,10.670,-6273,-1.134,19.072,229,231,7593
1983,3364,1220,1460,639203,642997,120,8.216,121,8.285,50508,4951,45557,0.770,7.855,59432,4510,54922,0.701,9.243,-8924,-1.388,15.710,80,80,999
1983,3365,170,211,25680,33454,20,9.412,23,10.824,816,604,212,1.805,2.439,16383,1502,14881,4.490,48.972,-15567,-46.533,4.878,13,13,211
1983,3366,1128,1228,160907,181446,126,10.174,147,11.869,16791,1362,15429,0.751,9.254,57456,7051,50405,3.886,31.666,-40665,-22.412,18.508,105,105,2894
1983,3369,430,441,35255,33295,67,15.402,55,12.644,8243,4021,4222,12.077,24.757,4224,711,3513,2.135,12.687,4019,12.071,25.373,41,41,376
1983,3371,11313,11943,336815,338899,1375,11.455,1495,12.455,45624,13832,31792,4.081,13.462,49322,20937,28385,6.178,14.554,-3698,-1.091,26.925,1113,1126,10786
1983,3372,2385,2518,118695,119739,239,9.560,203,8.120,16177,6670,9507,5.570,13.510,18408,4580,13828,3.825,15.373,-2231,-1.863,27.020,159,160,1958
1983,3379,1069,1203,36622,36936,109,9.102,98,8.184,4919,1091,3828,2.954,13.318,5488,2016,3472,5.458,14.858,-569,-1.541,26.635,72,72,661
1983,3391,9773,10330,217225,218364,1277,12.574,928,9.138,24789,8288,16501,3.795,11.352,27064,7667,19397,3.511,12.394,-2275,-1.042,22.704,672,673,3079
1983,3399,14338,14968,399188,412335,1837,12.346,1660,11.156,50172,18073,32099,4.383,12.168,76618,20597,56021,4.995,18.582,-26446,-6.414,24.336,1280,1282,9981
1983,4231,23134,28518,297437,301873,2717,9.519,2768,9.697,41955,14143,27812,4.685,13.898,50771,18283,32488,6.057,16.819,-8816,-2.920,27.797,1758,1834,10723
1983,4232,7672,8802,94417,95740,1039,11.805,1037,11.783,15284,4860,10424,5.076,15.964,17906,5609,12297,5.859,18.703,-2622,-2.739,31.928,733,742,3599
1983,4233,7228,8920,101718,101325,1055,11.806,1088,12.175,18226,5933,12293,5.855,17.988,17381,6953,10428,6.862,17.154,845,0.834,34.307,689,700,3798
1983,4234,20733,28175,462367,452495,4450,16.301,2698,9.883,90733,33129,57604,7.321,20.052,70309,24335,45974,5.378,15.538,20424,4.514,31.076,1604,1630,8876
1983,4235,6354,8760,119359,127982,921,10.427,1066,12.069,14476,6272,8204,4.901,11.311,31732,10826,20906,8.459,24.794,-17256,-13.483,22.622,562,586,5048
1983,4236,14201,20337,254950,255632,2385,11.817,2076,10.286,43633,15620,28013,6.110,17.069,44655,16241,28414,6.353,17.469,-1022,-0.400,34.137,1160,1194,6352
1983,4237,10752,14041,147497,150370,1232,8.787,1193,8.508,19041,6465,12576,4.299,12.663,24708,7387,17321,4.913,16.431,-5667,-3.769,25.326,706,734,4091
1983,4238,46498,60665,611062,642948,5579,9.180,5801,9.545,77254,28969,48285,4.506,12.016,141334,37146,104188,5.777,21.982,-64080,-9.967,24.031,3513,3605,19122
1983,4239,21462,23075,200972,205609,3512,15.302,3264,14.222,38952,13392,25560,6.513,18.945,47955,17900,30055,8.706,23.323,-9003,-4.379,37.889,2480,2513,11651
1983,4241,7641,10280,139786,142172,1120,11.084,770,7.620,19681,6428,13253,4.521,13.843,24347,6221,18126,4.376,17.125,-4666,-3.282,27.686,495,504,3055
1983,4242,2677,3398,94179,93397,450,13.447,347,10.369,14810,3486,11324,3.732,15.857,13200,3286,9914,3.518,14.133,1610,1.724,28.266,237,237,1356
1983,4243,10604,11478,118673,119345,1720,15.128,1504,13.228,24181,10118,14063,8.478,20.262,25478,9725,15753,8.149,21.348,-1297,-1.087,40.523,1114,1125,5413
1983,4244,26813,32800,579688,584426,3458,10.564,3325,10.158,84280,25194,59086,4.311,14.421,93207,33444,59763,5.723,15.948,-8927,-1.527,28.842,2268,2307,16285
1983,4245,8399,11524,101816,105023,737,6.310,1049,8.981,14037,3883,10154,3.697,13.366,20379,5693,14686,5.421,19.404,-6342,-6.039,26.731,667,718,3698
1983,4246,6268,9440,114541,116943,1173,12.541,1000,10.691,20625,8851,11774,7.569,17.637,25497,7450,18047,6.371,21.803,-4872,-4.166,35.274,513,531,2547
1983,4247,11906,15398,152529,157905,1085,6.957,1479,9.484,23839,7110,16729,4.503,15.097,34430,11186,23244,7.084,21.804,-10591,-6.707,30.194,931,947,6746
1983,4248,4639,5748,135259,135233,353,6.109,413,7.148,15402,3645,11757,2.695,11.389,15381,5837,9544,4.316,11.374,21,0.016,22.747,263,271,2600
1983,4249,19228,23372,233247,236427,2923,12.552,2752,11.818,37847,15119,22728,6.395,16.008,44163,17645,26518,7.463,18.679,-6316,-2.671,32.016,1736,1758,8027
1983,4251,28169,30985,279577,283739,3416,11.109,2948,9.587,45481,15911,29570,5.608,16.029,53590,17110,36480,6.030,18.887,-8109,-2.858,32.058,1876,1880,8739
1983,4411,36459,37487,747384,741536,3659,9.748,3755,10.004,98373,30790,67583,4.152,13.266,86805,34973,51832,4.716,11.706,11568,1.560,23.412,3094,3110,29006
1983,4412,10942,11377,69867,69989,1259,11.056,1280,11.240,13819,4840,8979,6.915,19.745,14098,5362,8736,7.661,20.143,-279,-0.399,39.489,1005,1015,4197
1983,4413,43865,64658,415060,409549,6459,10.164,4238,6.669,71961,28509,43452,6.961,17.571,60877,19012,41865,4.642,14.864,11084,2.706,29.729,2630,2703,11019
1983,4421,21928,26398,197398,200679,2645,9.955,2989,11.250,33405,12694,20711,6.326,16.646,39741,15315,24426,7.632,19.803,-6336,-3.157,33.292,2110,2199,9597
1983,4422,19383,22989,122496,120523,3285,14.446,2787,12.256,27769,12266,15503,10.177,23.040,23579,8835,14744,7.331,19.564,4190,3.477,39.128,1977,2072,6211
1983,4431,23848,31065,174165,173421,4520,14.598,4317,13.942,40148,17443,22705,10.058,23.151,38504,17313,21191,9.983,22.203,1644,0.948,44.405,2627,2784,9915
1983,4441,55282,69916,629060,628527,5705,8.151,5848,8.356,96336,30617,65719,4.871,15.327,95439,31193,64246,4.963,15.185,897,0.143,30.369,3866,3987,17236
1983,4442,14216,17241,117939,118956,1850,10.807,1606,9.381,19295,6988,12307,5.874,16.220,21364,6464,14900,5.434,17.960,-2069,-1.739,32.441,963,978,3850
1983,4451,65520,109600,1874465,1852726,11793,10.776,11460,10.472,302864,144186,158678,7.782,16.347,261052,106796,154256,5.764,14.090,41812,2.257,28.180,6727,7002,40466
1983,4452,23473,28798,177760,174923,4345,15.297,3557,12.523,42395,19697,22698,11.260,24.236,36694,15698,20996,8.974,20.977,5701,3.259,41.955,2581,2679,11142
1983,4453,29023,34417,168974,167936,3708,10.808,3488,10.167,35932,12513,23419,7.451,21.396,33949,12827,21122,7.638,20.215,1983,1.181,40.431,2494,2528,8455
1983,4461,42678,61534,551694,548914,6259,10.288,4862,7.992,86064,36598,49466,6.667,15.679,80090,28127,51963,5.124,14.591,5974,1.088,29.181,2855,2993,15005
1983,4471,97981,129496,746770,752641,16677,12.842,17402,13.401,165459,79094,86365,10.509,21.984,177376,74163,103213,9.854,23.567,-11917,-1.583,43.968,11450,11718,45048
1983,4481,57761,96095,780497,782496,10294,10.667,11107,11.510,153077,64709,88368,8.270,19.563,159665,56330,103335,7.199,20.405,-6588,-0.842,39.125,6771,7314,29140
1983,4482,12286,35494,184100,186719,3663,10.282,3927,11.023,36838,15946,20892,8.540,19.729,41681,16818,24863,9.007,22.323,-4843,-2.594,39.458,1282,1440,5134
1983,4483,17584,25188,145167,152512,2901,11.644,2352,9.441,28116,12938,15178,8.483,18.435,42100,25112,16988,16.466,27.604,-13984,-9.169,36.871,1390,1466,5494
1983,4511,31508,41843,256423,252717,5692,13.664,5322,12.775,54445,22177,32268,8.775,21.544,47340,19779,27561,7.827,18.732,7105,2.811,37.465,3728,3880,12471
1983,4512,7656,11424,70259,68169,1648,14.780,1100,9.865,16210,7062,9148,10.360,23.779,12170,4273,7897,6.268,17.853,4040,5.926,35.705,793,817,2878
1983,4521,562,9660,1412955,1453468,524,5.376,698,7.161,118937,53229,65708,3.662,8.183,198191,75197,122994,5.174,13.636,-79254,-5.453,16.366,24,32,1210
1983,4529,12643,23836,333825,346664,2255,9.355,2790,11.575,42123,18877,23246,5.445,12.151,68113,20286,47827,5.852,19.648,-25990,-7.497,24.302,1382,1417,5354
1983,4531,20925,22247,104310,103108,3316,15.257,2291,10.541,22427,9421,13006,9.137,21.751,20045,7176,12869,6.960,19.441,2382,2.310,38.882,1699,1723,5263
1983,4532,24391,30001,186366,182212,4712,16.094,3265,11.152,48037,27121,20916,14.884,26.363,40687,12925,27762,7.093,22.329,7350,4.034,44.659,2321,2399,8286
1983,4533,9059,11066,49572,47555,2578,24.727,1298,12.450,14749,8255,6494,17.359,31.015,10179,3320,6859,6.981,21.405,4570,9.610,42.809,945,947,2270
1983,4539,25994,31624,137404,135244,4977,15.991,3978,12.781,35960,16793,19167,12.417,26.589,31646,13574,18072,10.037,23.399,4314,3.190,46.799,2703,2825,9147
1983,4541,5682,7355,93131,92503,944,12.857,919,12.516,19427,7097,12330,7.672,21.001,18064,7245,10819,7.832,19.528,1363,1.473,39.056,580,585,2660
1983,4542,3961,5215,78185,79534,519,9.779,704,13.264,12346,3239,9107,4.072,15.523,15088,5602,9486,7.044,18.971,-2742,-3.448,31.046,363,366,1637
1983,4543,16258,21812,189628,190709,2278,10.520,1963,9.065,31554,11310,20244,5.931,16.546,33986,11470,22516,6.014,17.821,-2432,-1.275,33.091,1324,1352,6002
1983,4811,1093,2782,258366,251651,370,14.225,8,0.308,31018,12085,18933,4.802,12.326,17200,32,17168,0.013,6.835,13818,5.491,13.670,8,8,32
1983,4812,433,632,13650,12551,101,17.295,5,0.856,2840,472,2368,3.761,22.629,684,7,677,0.056,5.450,2156,17.179,10.900,5,5,7
1983,4831,405,673,34025,33981,63,9.813,(D),(D),6481,2878,3603,8.470,19.073,6296,(D),6280,(D),18.528,185,0.544,37.057,0,0,0
1983,4832,381,439,14642,15378,36,8.551,0,0.000,1254,467,787,3.037,8.155,2724,0,2724,0.000,17.714,-1470,-9.559,16.310,0,0,0
1983,4841,19751,25140,453369,446521,4179,18.057,185,0.799,71458,24821,46637,5.559,16.003,58628,831,57797,0.186,13.130,12830,2.873,26.260,148,148,623
1983,4842,40833,44743,517557,511145,6697,16.134,227,0.547,88777,30138,58639,5.896,17.368,76286,990,75296,0.194,14.925,12491,2.444,29.849,159,159,644
1983,4851,391,429,22480,20466,44,10.732,6,1.463,5469,414,5055,2.023,26.722,1214,23,1191,0.112,5.932,4255,20.791,11.864,4,4,8
1983,4852,351,754,34598,35131,37,5.027,(D),(D),3084,1407,1677,4.005,8.779,4071,(D),4069,(D),11.588,-987,-2.810,17.557,0,0,0
1983,4853,5222,5288,52798,52148,832,17.030,27,0.553,9265,3343,5922,6.411,17.767,8022,63,7959,0.121,15.383,1243,2.384,30.767,21,21,49
1983,4854,3442,3660,93998,91273,309,8.807,6,0.171,12450,4557,7893,4.993,13.640,6947,40,6907,0.044,7.611,5503,6.029,15.223,6,6,40
1983,4855,520,554,11909,11205,93,18.307,(D),(D),2605,636,1969,5.676,23.250,1162,(D),1161,(D),10.371,1443,12.879,20.742,(D),(D),(D)
1983,4859,925,963,16577,15903,178,20.273,8,0.911,3168,1297,1871,8.156,19.921,1810,16,1794,0.101,11.382,1358,8.540,22.764,7,7,15
1983,4861,76,321,12037,12099,28,9.121,0,0.000,1539,694,845,5.736,12.721,1725,0,1725,0.000,14.258,-186,-1.537,25.441,0,0,0
1983,4862,236,1273,61414,60507,121,9.979,0,0.000,5425,2942,2483,4.862,8.966,3657,0,3657,0.000,6.044,1768,2.922,12.088,0,0,0
1983,4869,62,331,7496,7079,52,17.021,(D),(D),1410,904,506,12.770,19.918,583,(D),582,(D),8.236,827,11.682,16.471,(D),(D),(D)
1983,4871,174,178,2455,2351,43,26.875,7,4.375,650,301,349,12.803,27.648,446,97,349,4.126,18.971,204,8.677,37.941,7,7,97
1983,4872,664,670,9261,8682,111,17.236,59,9.161,2471,1573,898,18.119,28.463,1362,265,1097,3.052,15.689,1109,12.774,31.377,46,46,199
1983,4879,49,59,1005,1001,7,12.389,(D),(D),173,21,152,2.099,17.291,145,(D),42,(D),14.493,28,2.799,28.986,(D),(D),(D)
1983,4881,2030,2571,56271,54728,375,15.707,8,0.335,10034,3306,6728,6.041,18.334,6966,239,6727,0.437,12.729,3068,5.606,25.457,5,5,29
1983,4882,297,400,7148,7380,69,18.878,0,0.000,1215,488,727,6.613,16.465,1686,0,1686,0.000,22.847,-471,-6.383,32.929,0,0,0
1983,4883,2195,2624,106416,109887,340,13.821,12,0.488,17024,6014,11010,5.473,15.492,24007,100,23907,0.091,21.847,-6983,-6.355,30.985,10,10,35
1983,4884,1638,2113,29730,30325,314,15.162,230,11.106,4429,1663,2766,5.484,14.605,5677,1245,4432,4.106,18.721,-1248,-4.115,29.210,197,199,1151
1983,4885,4715,6548,81970,81057,1031,17.060,22,0.364,14494,6408,8086,7.906,17.881,12864,67,12797,0.083,15.870,1630,2.011,31.741,18,18,58
1983,4889,403,411,5499,5658,79,20.789,17,4.474,1178,342,836,6.045,20.820,1476,59,1417,1.043,26.087,-298,-5.267,41.640,14,14,50
1983,4921,1241,1840,105685,100463,383,23.107,18,1.086,18549,5047,13502,5.024,18.464,8298,97,8201,0.097,8.260,10251,10.204,16.520,18,18,97
1983,4922,939,948,6082,4904,447,60.941,18,2.454,2955,2494,461,50.862,60.263,623,49,574,0.999,12.705,2332,47.558,25.410,17,17,46
1983,4931,6154,9678,366265,374730,870,8.946,963,9.903,51710,14610,37100,3.899,13.799,68407,19577,48830,5.224,18.255,-16697,-4.456,27.599,301,318,2803
1983,5111,13182,15061,603670,607534,1626,10.909,1315,8.822,48930,14479,34451,2.383,8.054,56157,18655,37502,3.071,9.243,-7227,-1.190,16.108,1037,1038,8525
1983,5112,7108,8375,132270,128599,1375,16.566,1225,14.759,31463,7724,23739,6.006,24.466,24339,9533,14806,7.413,18.926,7124,5.540,37.853,828,841,4012
1983,5121,8872,14198,194503,200778,2229,15.715,2200,15.511,43410,16323,27087,8.130,21.621,55385,15730,39655,7.835,27.585,-11975,-5.964,43.242,1085,1167,8011
1983,5122,1476,1483,11226,10957,449,31.991,290,20.663,2902,1592,1310,14.530,26.485,2356,1037,1319,9.464,21.502,546,4.983,43.004,236,236,772
1983,5151,6001,7080,216968,208392,820,12.283,12,0.180,31980,13801,18179,6.623,15.346,14568,50,14518,0.024,6.991,17412,8.355,13.981,9,9,46
1983,5152,7,7,74,123,3,54.545,0,0.000,5,4,1,3.252,4.065,99,0,99,0.000,80.488,-94,-76.423,8.130,0,0,0
1983,5171,1739,10684,872150,786769,1057,10.395,26,0.256,431297,31565,399732,4.012,54.819,256745,170,256575,0.022,32.633,174552,22.186,65.266,20,20,149
1983,5172,628,1322,69092,62099,225,18.549,7,0.577,30723,2539,28184,4.089,49.474,17592,38,17554,0.061,28.329,13131,21.145,56.658,7,7,38
1983,5174,664,1194,49112,43493,187,16.985,(D),(D),14197,4282,9915,9.845,32.642,3052,(D),3051,(D),7.017,11145,25.625,14.034,(D),(D),(D)
1983,5179,1228,2334,71345,70848,495,23.633,16,0.764,24987,6856,18131,9.677,35.269,24355,54,24301,0.076,34.377,632,0.892,68.753,13,13,41
1983,5182,5819,7588,221598,216676,1224,16.323,1045,13.936,49088,17442,31646,8.050,22.655,39310,13856,25454,6.395,18.142,9778,4.513,36.285,634,641,5222
1983,5191,2085,2512,29566,29468,289,11.830,151,6.181,3987,1524,2463,5.172,13.530,3737,1045,2692,3.546,12.682,250,0.848,25.364,101,101,415
1983,5211,37,75,24518,24478,10,14.286,0,0.000,742,384,358,1.569,3.031,680,0,680,0.000,2.778,62,0.253,5.556,0,0,0
1983,5221,20283,67876,1848806,1823875,4005,6.077,65,0.099,193270,57815,135455,3.170,10.597,143869,695,143174,0.038,7.888,49401,2.709,15.776,58,58,657
1983,5222,22278,39330,349556,327404,3069,8.084,335,0.882,72220,21829,50391,6.667,22.058,27978,1209,26769,0.369,8.545,44242,13.513,17.091,239,239,827
1983,5223,2942,3370,44730,41456,787,25.952,112,3.693,11897,4345,7552,10.481,28.698,5309,2010,3299,4.849,12.807,6588,15.892,25.613,93,93,617
1983,5231,5643,10624,251709,235134,1789,18.321,70,0.717,51738,15401,36337,6.550,22.004,18548,712,17836,0.303,7.888,33190,14.115,15.777,53,53,513
1983,5232,119,133,6682,6363,20,16.194,(D),(D),791,148,643,2.326,12.431,176,(D),175,(D),2.766,615,9.665,5.532,0,0,0
1983,5239,13456,13823,124343,105528,3973,33.399,118,0.992,54815,36037,18778,34.149,51.944,18061,499,17562,0.473,17.115,36754,34.829,34.230,77,77,271
1983,5241,6236,30626,1246907,1210939,3290,11.345,38,0.131,169663,52984,116679,4.375,14.011,99652,487,99165,0.040,8.229,70011,5.782,16.459,33,33,326
1983,5242,94864,99621,734476,659149,17039,18.670,330,0.362,221678,117387,104291,17.809,33.631,71340,1249,70091,0.189,10.823,150338,22.808,21.646,266,266,947
1983,5250,1850,2055,36903,35282,314,16.509,8,0.421,6504,3203,3301,9.078,18.434,3148,24,3124,0.068,8.922,3356,9.512,17.845,5,5,8
1983,5311,95905,97988,484295,467945,12397,13.419,1193,1.291,101312,47298,54014,10.108,21.650,68831,4701,64130,1.005,14.709,32481,6.941,29.418,908,913,3433
1983,5312,31747,32932,171407,162991,5714,18.813,596,1.962,41979,19730,22249,12.105,25.755,25683,2278,23405,1.398,15.757,16296,9.998,31.515,459,459,1834
1983,5313,19814,20467,197212,184295,3759,19.991,431,2.292,47688,20346,27342,11.040,25.876,22144,1411,20733,0.766,12.016,25544,13.860,24.031,353,353,1167
1983,5321,5373,8824,101966,100057,1208,13.658,1249,14.122,26712,8349,18363,8.344,26.697,23130,11995,11135,11.988,23.117,3582,3.580,46.234,637,660,3503
1983,5322,9667,11658,93631,93524,2450,21.730,1683,14.927,24256,11419,12837,12.210,25.936,24499,8030,16469,8.586,26.195,-243,-0.260,51.871,1170,1187,5110
1983,5323,2704,3104,21204,21560,576,19.203,367,12.235,5140,2345,2795,10.877,23.841,5964,2101,3863,9.745,27.663,-824,-3.822,47.682,263,264,1479
1983,5324,4859,5631,50353,50647,958,17.807,456,8.476,10761,4698,6063,9.276,21.247,11501,2443,9058,4.824,22.708,-740,-1.461,42.494,291,292,1381
1983,5331,901,960,10872,10412,153,17.259,6,0.677,2726,1024,1702,9.835,26.183,1781,21,1760,0.202,17.106,945,9.077,34.212,6,6,21
1983,5411,118417,122086,641090,624148,16661,14.032,9966,8.393,118177,44708,73469,7.163,18.934,84281,29136,55145,4.668,13.503,33896,5.431,27.007,7295,7350,21843
1983,5412,50259,53158,415610,408661,9204,17.831,6123,11.862,78697,33434,45263,8.181,19.257,64651,27856,36795,6.816,15.820,14046,3.437,31.640,4445,4555,20957
1983,5413,46773,51335,609106,625478,8199,16.290,6189,12.297,109614,42812,66802,6.845,17.525,143050,33810,109240,5.405,22.871,-33436,-5.346,35.050,4204,4235,19314
1983,5414,11841,12079,77056,78511,2314,19.156,2316,19.172,17953,7789,10164,9.921,22.867,20742,9366,11376,11.930,26.419,-2789,-3.552,45.734,1849,1852,7091
1983,5415,4960,5916,53995,48921,2977,62.176,721,15.058,21796,14070,7726,28.761,44.554,12122,7577,4545,15.488,24.779,9674,19.775,49.558,411,418,1478
1983,5416,29817,30971,254529,240888,8832,31.704,2605,9.351,79497,39591,39906,16.435,33.002,52279,13178,39101,5.471,21.703,27218,11.299,43.405,1762,1765,8905
1983,5417,5542,6784,395513,397566,1150,17.859,461,7.159,43029,17093,25936,4.299,10.823,48028,11229,36799,2.824,12.081,-4999,-1.257,21.646,215,219,1664
1983,5418,21688,23724,284829,279171,4106,17.794,2809,12.173,56537,24103,32434,8.634,20.252,45363,17794,27569,6.374,16.249,11174,4.003,32.498,2081,2094,11256
1983,5419,26495,29228,191919,185013,4245,15.191,1677,6.001,45841,17621,28220,9.524,24.777,31438,6837,24601,3.695,16.992,14403,7.785,33.985,1192,1211,4481
1983,5511,22650,42538,2715940,2730201,4428,10.494,3740,8.864,451618,145615,306003,5.333,16.542,480030,105748,374282,3.873,17.582,-28412,-1.041,33.083,298,314,4041
1983,5611,8877,9329,116905,109392,2088,24.681,350,4.137,33017,14540,18477,13.292,30.182,17933,2028,15905,1.854,16.393,15084,13.789,32.787,164,166,894
1983,5612,125,128,7643,6520,55,50.926,15,13.889,4484,3859,625,59.187,68.773,2282,219,2063,3.359,35.000,2202,33.773,70.000,8,8,129
1983,5613,11164,14670,546900,552751,2455,16.740,2446,16.679,154461,38161,116300,6.904,27.944,165615,36834,128781,6.664,29.962,-11154,-2.018,55.888,1579,1595,20924
1983,5614,17271,19400,196654,197510,3150,16.317,2961,15.338,39618,14529,25089,7.356,20.059,41284,14151,27133,7.165,20.902,-1666,-0.844,40.117,2307,2318,9925
1983,5615,18686,21892,156951,153614,3322,15.690,1883,8.894,35027,13297,21730,8.656,22.802,28198,12285,15913,7.997,18.356,6829,4.446,36.713,1299,1337,6339
1983,5616,10009,12302,370208,370240,2245,18.155,2373,19.190,84296,27972,56324,7.555,22.768,83130,36242,46888,9.789,22.453,1166,0.315,44.906,1810,1824,18835
1983,5617,51987,54945,690546,676638,12323,23.856,5743,11.118,158274,60689,97585,8.969,23.391,130869,37108,93761,5.484,19.341,27405,4.050,38.682,4529,4539,26337
1983,5619,10835,11676,150086,150496,2165,18.196,2609,21.928,34100,12145,21955,8.070,22.658,35191,14636,20555,9.725,23.383,-1091,-0.725,45.317,2044,2048,10183
1983,5621,4203,4341,83276,82834,506,12.346,21,0.512,9353,2355,6998,2.843,11.291,8460,83,8377,0.100,10.213,893,1.078,20.427,16,16,43
1983,5622,2101,2593,44585,42181,296,12.094,5,0.204,8215,2865,5350,6.792,19.476,3412,11,3401,0.026,8.089,4803,11.387,16.178,(D),(D),(D)
1983,5629,4276,4490,37318,37577,672,15.393,423,9.690,8307,3239,5068,8.620,22.107,8813,2019,6794,5.373,23.453,-506,-1.347,44.213,288,288,1272
1983,6111,12673,13012,355109,347178,702,5.543,6,0.047,35863,6949,28914,2.002,10.330,19868,51,19817,0.015,5.723,15995,4.607,11.445,(D),(D),(D)
1983,6112,426,522,34885,33337,42,8.375,(D),(D),5143,585,4558,1.755,15.428,2128,(D),2126,(D),6.383,3015,9.044,12.767,0,0,0
1983,6113,1982,2305,898967,881301,129,5.756,(D),(D),74022,6916,67106,0.785,8.399,38712,(D),38700,(D),4.393,35310,4.007,8.785,0,0,0
1983,6114,1752,2005,32027,30384,407,21.365,207,10.866,7517,2569,4948,8.455,24.740,4312,1155,3157,3.801,14.192,3205,10.548,28.384,157,159,719
1983,6115,2901,3316,47947,47458,513,15.401,543,16.301,9371,3740,5631,7.881,19.746,8490,3616,4874,7.619,17.890,881,1.856,35.779,368,390,2449
1983,6116,10107,10597,85142,84696,2028,19.670,1454,14.103,19161,8469,10692,9.999,22.623,18283,6615,11668,7.810,21.587,878,1.037,43.173,1111,1119,4408
1983,6117,1306,1326,16259,16007,290,23.321,125,10.052,2627,1076,1551,6.722,16.412,2111,437,1674,2.730,13.188,516,3.224,26.376,79,80,301
1983,6211,177201,182779,987126,962346,17378,9.720,9410,5.263,166915,63064,103851,6.553,17.345,116911,32306,84605,3.357,12.149,50004,5.196,24.297,7258,7308,23645
1983,6212,92631,94785,418816,409598,6745,7.225,3880,4.156,68452,21744,46708,5.309,16.712,49830,13281,36549,3.242,12.166,18622,4.546,24.331,2929,2972,10381
1983,6213,38581,40388,129853,123420,6326,16.357,2898,7.493,32922,16311,16611,13.216,26.675,20021,7743,12278,6.274,16.222,12901,10.453,32.444,1995,2028,5610
1983,6214,5129,6474,104815,100643,1177,19.070,573,9.284,22822,9987,12835,9.923,22.676,14360,4884,9476,4.853,14.268,8462,8.408,28.537,370,371,2442
1983,6215,3963,4975,64332,63741,686,14.101,466,9.579,11521,4087,7434,6.412,18.075,10465,4325,6140,6.785,16.418,1056,1.657,32.836,316,338,3143
1983,6216,3287,4330,161460,155611,858,21.004,368,9.009,38953,14389,24564,9.247,25.032,27092,4602,22490,2.957,17.410,11861,7.622,34.820,232,237,2465
1983,6219,3260,3797,72295,68512,755,21.412,213,6.041,16927,6223,10704,9.083,24.707,9265,2558,6707,3.734,13.523,7662,11.184,27.047,131,133,1714
1983,6221,3649,4798,3048293,2891150,291,6.254,(D),(D),410362,281567,128795,9.739,14.194,90660,(D),90656,(D),3.136,319702,11.058,6.272,0,0,0
1983,6222,354,488,183057,113947,70,15.436,(D),(D),137814,136458,1356,119.756,120.946,2130,(D),2121,(D),1.869,135684,119.077,3.739,0,0,0
1983,6223,197,239,55151,48541,19,8.279,0,0.000,14681,11326,3355,23.333,30.245,1045,0,1045,0.000,2.153,13636,28.092,4.306,0,0,0
1983,6231,6735,9741,788088,780935,732,7.597,521,5.407,94754,41272,53482,5.285,12.133,79787,32694,47093,4.187,10.217,14967,1.917,20.434,308,327,17496
1983,6232,3852,5109,114859,109171,786,16.268,231,4.781,24140,10941,13199,10.022,22.112,12501,2543,9958,2.329,11.451,11639,10.661,22.902,155,157,1765
1983,6233,8661,10355,389662,388622,1340,13.137,1030,10.098,60018,27395,32623,7.049,15.444,57183,29753,27430,7.656,14.714,2835,0.730,29.429,628,647,17323
1983,6239,2582,3162,75077,73172,346,11.221,189,6.129,12324,4986,7338,6.814,16.843,8463,2195,6268,3.000,11.566,3861,5.277,23.132,114,119,1362
1983,6241,12680,17381,251918,247289,2511,15.000,1229,7.342,58895,27340,31555,11.056,23.816,48304,8860,39444,3.583,19.533,10591,4.283,39.067,650,675,4518
1983,6242,3570,4202,37138,36497,591,14.634,264,6.537,8141,3722,4419,10.198,22.306,6753,1353,5400,3.707,18.503,1388,3.803,37.006,132,136,661
1983,6243,3646,5343,229301,222033,650,12.407,442,8.437,52904,9881,43023,4.450,23.827,37608,7274,30334,3.276,16.938,15296,6.889,33.876,190,202,2992
1983,6244,27043,31862,266416,263083,4562,14.713,2853,9.201,54067,23799,30268,9.046,20.551,47795,14893,32902,5.661,18.167,6272,2.384,36.335,2030,2074,9954
1983,7111,4869,4930,67261,66007,859,17.497,818,16.662,20049,7266,12783,11.008,30.374,17806,5654,12152,8.566,26.976,2243,3.398,53.952,591,593,3782
1983,7112,2155,2251,61406,59707,438,19.982,320,14.599,13185,5517,7668,9.240,22.083,9664,3408,6256,5.708,16.186,3521,5.897,32.371,238,241,1544
1983,7113,2094,2134,26315,25726,389,18.550,315,15.021,8584,3196,5388,12.423,33.368,7485,2692,4793,10.464,29.096,1099,4.272,58.191,215,216,2048
1983,7114,926,940,9875,10161,171,18.086,182,19.249,2903,1261,1642,12.411,28.571,3474,1277,2197,12.568,34.191,-571,-5.620,57.143,142,142,654
1983,7115,6841,6858,37970,35418,2647,43.454,1114,18.288,15465,9216,6249,26.021,43.665,10184,3795,6389,10.715,28.754,5281,14.911,57.508,788,788,2470
1983,7121,1990,2131,32161,31753,197,9.591,43,2.093,3412,721,2691,2.271,10.745,2620,287,2333,0.904,8.251,792,2.494,16.502,22,22,216
1983,7131,2293,2768,62048,59030,675,25.262,483,18.076,13558,4827,8731,8.177,22.968,7062,2366,4696,4.008,11.963,6496,11.005,23.927,369,380,1545
1983,7132,698,717,17737,18249,128,17.952,120,16.830,2288,1092,1196,5.984,12.538,3286,1202,2084,6.587,18.006,-998,-5.469,25.075,90,90,1054
1983,7139,31738,33698,464976,465073,4859,14.781,3208,9.759,83091,35699,47392,7.676,17.866,83244,24574,58670,5.284,17.899,-153,-0.033,35.732,2396,2418,17233
1983,7211,28670,32934,1062579,1073070,4175,12.793,3576,10.958,174445,85018,89427,7.923,16.257,196191,69453,126738,6.472,18.283,-21746,-2.027,32.513,2510,2544,36386
1983,7212,3522,3777,20046,20127,557,15.083,389,10.533,5442,2187,3255,10.866,27.039,5495,1978,3517,9.828,27.302,-53,-0.263,54.078,235,235,1403
1983,7213,4743,4850,22649,22319,343,7.088,321,6.634,4039,1138,2901,5.099,18.097,3317,928,2389,4.158,14.862,722,3.235,29.724,229,232,735
1983,7223,17070,26333,477581,480233,4610,17.575,4406,16.797,116327,59006,57321,12.287,24.223,120932,61958,58974,12.902,25.182,-4605,-0.959,48.446,2310,2329,19861
1983,7224,59348,60157,324580,324593,9431,15.726,9058,15.104,90079,50761,39318,15.638,27.751,89915,39884,50031,12.287,27.701,164,0.051,55.402,7190,7211,31249
1983,7225,187041,241121,4085516,4007262,40954,17.400,29449,12.512,964789,522038,442751,13.027,24.076,806301,326180,480121,8.140,20.121,158488,3.955,40.242,20682,21313,205121
1983,8111,93126,97523,437721,432888,16147,16.995,11127,11.711,100117,48894,51223,11.295,23.128,90447,34753,55694,8.028,20.894,9670,2.234,41.788,8423,8479,26787
1983,8112,9437,10550,66237,63249,1686,16.336,1228,11.898,16949,10704,6245,16.924,26.797,10900,4792,6108,7.576,17.234,6049,9.564,34.467,869,877,2775
1983,8113,17447,18362,128822,134463,2640,14.479,2382,13.064,23833,9262,14571,6.888,17.725,35029,11095,23934,8.251,26.051,-11196,-8.326,35.449,1815,1818,8021
1983,8114,22290,23975,136871,136605,4094,17.323,3410,14.429,28317,14118,14199,10.335,20.729,27749,11010,16739,8.060,20.313,568,0.416,40.627,2427,2441,7016
1983,8121,80328,89300,433717,425388,11863,13.384,10540,11.891,99395,44506,54889,10.462,23.366,83449,34515,48934,8.114,19.617,15946,3.749,39.234,7863,7957,24777
1983,8122,17019,19773,112123,111069,1467,7.520,938,4.808,16510,5328,11182,4.797,14.865,14420,3049,11371,2.745,12.983,2090,1.882,25.966,609,627,2073
1983,8123,32505,38359,329664,330650,4695,12.324,4168,10.941,52270,22263,30007,6.733,15.808,54314,20320,33994,6.145,16.426,-2044,-0.618,31.617,3034,3177,14327
1983,8129,11561,18261,191186,189900,3787,21.308,2811,15.816,47644,18244,29400,9.607,25.089,45892,21180,24712,11.153,24.166,1752,0.923,48.333,1584,1643,12767
1983,8131,78434,78548,744649,722603,7130,9.506,44,0.059,99974,22989,76985,3.181,13.835,56111,151,55960,0.021,7.765,43863,6.070,15.530,(D),(D),(D)
1983,8132,6878,7853,104740,104434,836,10.921,440,5.748,17266,3883,13383,3.718,16.533,16759,3596,13163,3.443,16.047,507,0.485,32.095,219,228,1356
1983,8133,6688,7823,82397,81822,956,12.403,726,9.419,16348,4782,11566,5.844,19.980,15242,3966,11276,4.847,18.628,1106,1.352,37.257,401,429,2390
1983,8134,28297,29637,246461,244783,2766,9.553,1399,4.832,36502,9913,26589,4.050,14.912,33109,6005,27104,2.453,13.526,3393,1.386,27.052,923,924,3523
1983,8139,54384,56546,423921,417333,4681,8.519,1484,2.701,75647,23376,52271,5.601,18.126,62823,6463,56360,1.549,15.053,12824,3.073,30.107,1000,1005,4259
1984,2111,7920,9916,187693,177242,1271,12.839,1238,12.506,53260,9529,43731,5.376,30.049,33762,11049,22713,6.234,19.049,19498,11.001,38.097,793,808,4456
1984,2121,2746,3455,185016,185613,583,16.850,593,17.139,33234,10581,22653,5.701,17.905,34076,11638,22438,6.270,18.359,-842,-0.454,35.810,455,455,6326
1984,2122,542,701,46663,46268,160,22.906,155,22.190,8369,2107,6262,4.554,18.088,7764,2211,5553,4.779,16.781,605,1.308,33.561,111,114,899
1984,2123,3562,5028,100144,98315,456,9.101,421,8.402,18059,5552,12507,5.647,18.369,14293,4414,9879,4.490,14.538,3766,3.831,29.076,255,257,1240
1984,2131,11016,12773,292656,293785,2126,16.622,2160,16.888,69569,24432,45137,8.316,23.680,72465,25965,46500,8.838,24.666,-2896,-0.986,47.360,1621,1630,14245
1984,2211,1616,5831,585805,582047,222,3.875,17,0.297,30021,7662,22359,1.316,5.158,22610,203,22407,0.035,3.885,7411,1.273,7.769,13,13,131
1984,2212,534,2402,139193,137400,151,6.478,9,0.386,8786,2972,5814,2.163,6.394,5090,12,5078,0.009,3.705,3696,2.690,7.409,6,6,7
1984,2213,3697,3997,30848,30095,329,8.529,50,1.296,3451,1126,2325,3.741,11.467,2004,100,1904,0.332,6.659,1447,4.808,13.318,39,39,82
1984,2361,88616,88997,516097,468951,21766,25.657,13442,15.845,209689,84548,125141,18.029,44.715,115279,48381,66898,10.317,24.582,94410,20.132,49.165,9693,9695,36569
1984,2362,35771,36362,596827,565877,5924,16.772,3840,10.872,184749,40097,144652,7.086,32.648,122369,24822,97547,4.386,21.625,62380,11.024,43.249,2748,2751,17884
1984,2371,12937,13274,315056,316944,1766,13.426,1526,11.601,71074,14860,56214,4.689,22.425,75700,14438,61262,4.555,23.884,-4626,-1.460,44.850,1144,1146,10151
1984,2372,8073,8187,69591,61686,2327,30.240,1343,17.453,28740,14126,14614,22.900,46.591,12920,5344,7576,8.663,20.945,15820,25.646,41.890,1051,1052,4111
1984,2373,9776,10063,204439,194398,1240,12.491,968,9.751,57685,11921,45764,6.132,29.674,37826,9070,28756,4.666,19.458,19859,10.216,38.916,715,715,6315
1984,2379,4655,4745,75470,71768,927,20.054,682,14.754,24932,6292,18640,8.767,34.740,17585,3973,13612,5.536,24.503,7347,10.237,49.005,510,512,2473
1984,2381,63999,64374,590301,548384,11913,19.157,7537,12.120,210460,60437,150023,11.021,38.378,126298,40576,85722,7.399,23.031,84162,15.347,46.062,5567,5570,30985
1984,2382,99672,101589,1040008,984499,15701,15.927,9679,9.819,280627,68826,211801,6.991,28.505,169476,44602,124874,4.530,17.214,111151,11.290,34.429,7371,7378,34510
1984,2383,65487,65883,540946,503263,13695,21.580,8850,13.946,190516,58642,131874,11.652,37.856,115426,37163,78263,7.384,22.936,75090,14.921,45.871,6597,6599,29247
1984,2389,34313,34559,338679,327440,5964,17.696,4250,12.611,98274,26621,71653,8.130,30.013,76821,19628,57193,5.994,23.461,21453,6.552,46.922,3115,3115,14410
1984,3111,1803,2456,60404,61313,179,7.321,157,6.421,7949,2755,5194,4.493,12.965,9902,2335,7567,3.808,16.150,-1953,-3.185,25.929,106,106,690
1984,3112,547,893,69131,71835,60,6.726,58,6.502,4403,1015,3388,1.413,6.129,9785,3453,6332,4.807,13.622,-5382,-7.492,12.259,28,28,172
1984,3113,1423,1743,86567,86029,240,13.805,231,13.287,10828,2989,7839,3.474,12.586,10030,4179,5851,4.858,11.659,798,0.928,23.318,114,114,982
1984,3114,1243,1719,177356,176357,114,6.592,135,7.806,23687,3319,20368,1.882,13.431,21885,4720,17165,2.676,12.409,1802,1.022,24.819,77,77,961
1984,3115,1805,2508,133786,134218,136,5.374,181,7.153,13281,3366,9915,2.508,9.895,14144,4276,9868,3.186,10.538,-863,-0.643,19.790,115,116,1314
1984,3116,4261,4859,330624,326111,344,7.113,299,6.182,38108,7513,30595,2.304,11.686,29469,10812,18657,3.315,9.036,8639,2.649,18.073,203,206,3416
1984,3117,759,870,45113,46332,56,6.331,85,9.610,6804,1078,5726,2.327,14.685,9183,2214,6969,4.779,19.820,-2379,-5.135,29.371,54,56,1080
1984,3118,8847,10286,305896,305548,1396,13.700,1203,11.806,35181,12430,22751,4.068,11.514,34230,15123,19107,4.949,11.203,951,0.311,22.406,892,902,7592
1984,3119,2022,2382,121767,120195,186,7.776,206,8.612,15757,5466,10291,4.548,13.110,12521,4500,8021,3.744,10.417,3236,2.692,20.834,148,149,1799
1984,3121,1973,2542,172229,172625,180,7.067,190,7.460,16389,4712,11677,2.730,9.494,17021,5605,11416,3.247,9.860,-632,-0.366,18.988,125,125,1653
1984,3122,102,157,41662,42353,7,4.361,14,8.723,3109,419,2690,0.989,7.341,4670,274,4396,0.647,11.026,-1561,-3.686,14.681,7,7,18
1984,3131,452,673,110340,107424,33,4.885,38,5.625,12216,2117,10099,1.971,11.372,6350,1997,4353,1.859,5.911,5866,5.461,11.822,23,23,636
1984,3132,1731,2113,303312,298456,126,5.909,165,7.737,32497,7490,25007,2.510,10.888,22906,7399,15507,2.479,7.675,9591,3.214,15.350,110,110,2600
1984,3133,1587,1835,113321,109959,157,8.593,141,7.718,15569,5056,10513,4.598,14.159,8840,3467,5373,3.153,8.039,6729,6.120,16.079,104,104,1247
1984,3141,3866,4157,123956,118658,435,10.403,484,11.575,21558,3534,18024,2.978,18.168,10994,5678,5316,4.785,9.265,10564,8.903,18.531,379,382,2496
1984,3149,3513,3653,130678,125926,460,12.695,401,11.067,24110,7374,16736,5.856,19.146,14706,7221,7485,5.734,11.678,9404,7.468,23.357,316,317,4287
1984,3151,1360,1484,148687,144304,123,8.255,135,9.060,20326,4169,16157,2.889,14.086,11835,5069,6766,3.513,8.201,8491,5.884,16.403,105,105,1781
1984,3152,11585,13138,894135,872172,1467,10.942,2005,14.955,153864,44782,109082,5.135,17.641,110328,48728,61600,5.587,12.650,43536,4.992,25.300,1729,1741,34226
1984,3159,1882,1990,83569,79859,249,12.636,210,10.657,16260,5501,10759,6.888,20.361,8706,3332,5374,4.172,10.902,7554,9.459,21.804,168,168,2197
1984,3161,360,395,18338,18976,35,8.816,39,9.824,2061,329,1732,1.734,10.861,3291,1244,2047,6.556,17.343,-1230,-6.482,21.722,30,30,452
1984,3162,486,701,120541,124042,33,4.542,84,11.562,10974,2761,8213,2.226,8.847,18107,5828,12279,4.698,14.598,-7133,-5.750,17.694,49,51,1785
1984,3169,1257,1305,50067,50730,121,9.043,187,13.976,7402,2035,5367,4.011,14.591,8628,2695,5933,5.312,17.008,-1226,-2.417,29.182,151,153,1773
1984,3211,4847,5342,141802,136152,525,9.815,539,10.077,25706,5760,19946,4.231,18.880,14358,5725,8633,4.205,10.546,11348,8.335,21.091,392,392,2421
1984,3212,1051,1310,88706,84395,138,10.689,100,7.746,15183,3790,11393,4.491,17.990,6514,2339,4175,2.771,7.718,8669,10.272,15.437,61,61,607
1984,3219,8546,9287,277599,261860,1078,11.682,960,10.403,62032,13404,48628,5.119,23.689,30800,12463,18337,4.759,11.762,31232,11.927,23.524,720,726,6081
1984,3221,248,585,205275,204309,22,3.707,39,6.571,11167,3993,7174,1.954,5.466,8991,3098,5893,1.516,4.401,2176,1.065,8.801,15,15,255
1984,3222,3618,5172,396549,387858,272,5.278,234,4.541,43343,8763,34580,2.259,11.175,26116,10195,15921,2.629,6.733,17227,4.442,13.467,145,148,2442
1984,3231,35131,36719,722657,701556,3729,10.249,3061,8.413,111875,26342,85533,3.755,15.947,69146,28531,40615,4.067,9.856,42729,6.091,19.712,2438,2440,14366
1984,3241,1459,2341,267152,270402,222,9.510,209,8.953,23351,4895,18456,1.810,8.636,29987,7733,22254,2.860,11.090,-6636,-2.454,17.271,94,95,1422
1984,3251,1186,2278,250433,255092,176,7.776,147,6.494,23563,13644,9919,5.349,9.237,32654,19213,13441,7.532,12.801,-9091,-3.564,18.474,52,52,498
1984,3252,363,596,139415,139467,38,6.360,41,6.862,8963,2269,6694,1.627,6.427,8905,2523,6382,1.809,6.385,58,0.042,12.770,17,17,482
1984,3253,698,1050,47449,48574,96,9.023,124,11.654,4141,1356,2785,2.792,8.525,6327,2665,3662,5.487,13.026,-2186,-4.500,17.050,42,42,294
1984,3254,1018,1248,162354,162143,115,9.222,113,9.062,14423,2708,11715,1.670,8.895,13597,3874,9723,2.389,8.386,826,0.509,16.772,71,71,1297
1984,3255,1655,2109,73816,73112,131,6.254,102,4.870,8581,2019,6562,2.762,11.737,7171,2545,4626,3.481,9.808,1410,1.929,19.616,53,59,511
1984,3256,2040,2287,123637,123253,177,7.755,168,7.360,11934,2055,9879,1.667,9.683,11085,3994,7091,3.241,8.994,849,0.689,17.987,117,124,1443
1984,3259,1769,2295,98256,95664,228,10.082,161,7.119,13060,4548,8512,4.754,13.652,7918,1838,6080,1.921,8.277,5142,5.375,16.554,114,114,800
1984,3261,10087,11706,574798,540943,1016,8.729,883,7.586,116248,25793,90455,4.768,21.490,49100,20867,28233,3.858,9.077,67148,12.413,18.153,609,616,8329
1984,3262,2001,2378,186716,180530,215,9.133,167,7.094,24946,4041,20905,2.238,13.818,12710,5962,6748,3.303,7.040,12236,6.778,14.081,110,110,845
1984,3271,1299,1584,82539,78767,176,11.136,169,10.693,15185,4568,10617,5.799,19.278,7955,3933,4022,4.993,10.099,7230,9.179,20.199,114,114,604
1984,3272,1495,1771,153865,151234,180,10.152,184,10.378,18404,2342,16062,1.549,12.169,12935,5015,7920,3.316,8.553,5469,3.616,17.106,133,133,1001
1984,3273,6949,8941,176743,169695,610,6.821,613,6.855,35456,7088,28368,4.177,20.894,21383,6073,15310,3.579,12.601,14073,8.293,25.202,399,405,3263
1984,3274,235,333,16892,16407,36,10.714,42,12.500,2357,558,1799,3.401,14.366,1449,855,594,5.211,8.832,908,5.534,17.664,33,33,127
1984,3279,1845,2123,80343,78000,176,8.280,181,8.516,13211,3357,9854,4.304,16.937,8563,3831,4732,4.912,10.978,4648,5.959,21.957,126,128,937
1984,3311,244,275,120914,115411,38,13.645,45,16.158,13642,3723,9919,3.226,11.820,2795,1169,1626,1.013,2.422,10847,9.399,4.844,28,29,319
1984,3312,502,675,64575,61711,51,7.478,65,9.531,10851,2475,8376,4.011,17.584,5135,2516,2619,4.077,8.321,5716,9.263,16.642,38,38,685
1984,3313,474,699,129418,123773,38,5.468,30,4.317,18584,4516,14068,3.649,15.015,7450,2880,4570,2.327,6.019,11134,8.995,12.038,10,10,225
1984,3314,719,888,86934,85133,86,9.734,77,8.715,12799,4270,8529,5.016,15.034,9294,4688,4606,5.507,10.917,3505,4.117,21.834,42,43,367
1984,3315,2788,3107,227556,214725,159,5.093,189,6.054,45713,10597,35116,4.935,21.289,20203,12065,8138,5.619,9.409,25510,11.880,18.818,115,116,1797
1984,3321,3153,3377,147443,139763,227,6.733,216,6.407,28550,5893,22657,4.216,20.428,13158,6860,6298,4.908,9.415,15392,11.013,18.829,144,146,2704
1984,3322,1223,1349,80282,80238,96,7.074,112,8.254,9232,1611,7621,2.008,11.506,9151,5200,3951,6.481,11.405,81,0.101,22.810,76,76,2307
1984,3323,9839,10644,329840,321821,808,7.546,935,8.732,59589,11855,47734,3.684,18.516,43684,16556,27128,5.144,13.574,15905,4.942,27.148,710,715,7797
1984,3324,1418,1792,126655,126283,96,5.301,134,7.399,14502,3231,11271,2.559,11.484,13776,4680,9096,3.706,10.909,726,0.575,21.818,78,78,1750
1984,3325,914,994,82302,78686,96,9.717,84,8.502,13207,3544,9663,4.504,16.784,6140,2897,3243,3.682,7.803,7067,8.981,15.606,56,56,473
1984,3326,1628,1838,69551,65386,152,8.407,92,5.088,13955,2702,11253,4.132,21.342,5571,2346,3225,3.588,8.520,8384,12.822,17.040,55,56,989
1984,3327,20666,20992,331575,311941,1824,8.685,1844,8.780,68782,11419,57363,3.661,22.050,29529,12175,17354,3.903,9.466,39253,12.583,18.932,1448,1448,7487
1984,3328,5351,5674,128554,120114,417,7.359,402,7.094,27203,4282,22921,3.565,22.648,10329,4211,6118,3.506,8.599,16874,14.048,17.199,321,321,2855
1984,3329,5181,5718,360295,347612,694,12.300,543,9.623,58248,16377,41871,4.711,16.757,33258,12768,20490,3.673,9.568,24990,7.189,19.135,389,391,4429
1984,3331,3041,3434,247375,248295,265,7.577,392,11.208,36315,4998,31317,2.013,14.626,38169,12610,25559,5.079,15.372,-1854,-0.747,29.252,242,242,1870
1984,3332,3690,3948,171314,164238,305,7.752,278,7.066,31755,10026,21729,6.105,19.335,17905,7412,10493,4.513,10.902,13850,8.433,21.804,193,195,2476
1984,3333,2016,2136,157760,156371,179,8.465,136,6.432,21271,8420,12851,5.385,13.603,18227,8997,9230,5.754,11.656,3044,1.947,23.313,91,92,940
1984,3334,1759,1984,165431,160520,150,7.382,246,12.106,25448,2832,22616,1.764,15.853,15299,7909,7390,4.927,9.531,10149,6.323,19.062,172,173,1417
1984,3335,9364,9790,229326,222228,623,6.343,688,7.004,39609,6636,32973,2.986,17.824,25437,9615,15822,4.327,11.446,14172,6.377,22.893,505,506,3118
1984,3336,744,908,150590,147712,49,5.408,45,4.967,17673,1190,16483,0.806,11.965,11976,3069,8907,2.078,8.108,5697,3.857,16.215,18,18,138
1984,3339,5867,6449,323205,317188,427,6.596,477,7.368,47382,10321,37061,3.254,14.938,35664,13008,22656,4.101,11.244,11718,3.694,22.488,327,327,3262
1984,3341,1605,1823,362436,349281,310,17.539,199,11.259,66332,16353,49979,4.682,18.991,40546,11799,28747,3.378,11.608,25786,7.383,23.217,130,131,2320
1984,3342,1807,2006,287726,277679,182,9.091,174,8.691,46866,6758,40108,2.434,16.878,26288,5831,20457,2.100,9.467,20578,7.411,18.934,109,109,1656
1984,3343,389,413,49057,47876,33,7.801,53,12.530,6939,1090,5849,2.277,14.494,4547,2350,2197,4.909,9.497,2392,4.996,18.995,36,36,291
1984,3344,4244,4813,541731,501329,631,13.350,458,9.690,111936,23444,88492,4.676,22.328,31178,11908,19270,2.375,6.219,80758,16.109,12.438,335,335,3645
1984,3345,3951,4544,660741,644832,409,9.082,328,7.283,87903,27343,60560,4.240,13.632,56636,20166,36470,3.127,8.783,31267,4.849,17.566,196,196,1797
1984,3346,606,628,20926,19123,93,14.704,102,16.126,6464,3968,2496,20.750,33.803,2955,1580,1375,8.263,15.453,3509,18.350,30.906,72,72,1024
1984,3351,1178,1294,85430,81542,104,8.065,95,7.367,14406,3046,11360,3.735,17.667,6512,2279,4233,2.795,7.986,7894,9.681,15.972,69,69,869
1984,3352,356,455,127540,121424,35,7.692,35,7.692,22091,1313,20778,1.081,18.193,9897,4979,4918,4.101,8.151,12194,10.042,16.302,21,21,190
1984,3353,1933,2426,251156,243849,163,6.720,162,6.679,35919,7291,28628,2.990,14.730,21020,6045,14975,2.479,8.620,14899,6.110,17.240,101,101,734
1984,3359,1906,2262,212183,201711,276,12.404,202,9.079,36341,8670,27671,4.298,18.016,15483,5866,9617,2.908,7.676,20858,10.341,15.352,140,140,2010
1984,3361,193,248,268801,244686,32,13.115,24,9.836,50029,3728,46301,1.524,20.446,2349,270,2079,0.110,0.960,47680,19.486,1.920,21,21,223
1984,3362,1683,1868,110237,97967,205,11.141,149,8.098,33331,5498,27833,5.612,34.023,9078,5351,3727,5.462,9.266,24253,24.756,18.533,101,102,1075
1984,3363,3681,4373,654645,603537,409,9.406,360,8.279,132726,24856,107870,4.118,21.991,29865,17435,12430,2.889,4.948,102861,17.043,9.897,235,235,2477
1984,3364,1209,1469,672181,667813,113,7.716,104,7.101,55016,12440,42576,1.863,8.238,47219,16636,30583,2.491,7.071,7797,1.168,14.141,67,67,860
1984,3365,168,201,29674,27628,13,6.311,23,11.165,6199,128,6071,0.463,22.438,1961,868,1093,3.142,7.098,4238,15.340,14.196,11,11,107
1984,3366,1105,1209,165175,162756,125,10.267,142,11.663,25662,3942,21720,2.422,15.767,20500,3358,17142,2.063,12.596,5162,3.172,25.191,106,106,1409
1984,3369,427,438,38412,36771,56,12.771,57,12.999,6069,1671,4398,4.544,16.505,2570,673,1897,1.830,6.989,3499,9.516,13.978,47,47,471
1984,3371,11551,12169,373713,355299,1590,13.198,1347,11.181,70073,16604,53469,4.673,19.722,32916,17072,15844,4.805,9.264,37157,10.458,18.529,1033,1044,9184
1984,3372,2467,2603,136726,127710,269,10.502,186,7.261,29649,5180,24469,4.056,23.216,11540,5148,6392,4.031,9.036,18109,14.180,18.072,144,146,2575
1984,3379,1062,1179,40802,38671,92,7.708,121,10.138,7520,1226,6294,3.170,19.446,3243,1614,1629,4.174,8.386,4277,11.060,16.772,87,100,1168
1984,3391,9859,10438,224709,219442,1217,11.737,1079,10.406,33560,8240,25320,3.755,15.293,23062,8377,14685,3.817,10.509,10498,4.784,21.019,807,810,4024
1984,3399,14412,15036,427352,413066,1701,11.351,1601,10.683,79728,21493,58235,5.203,19.302,51423,21928,29495,5.309,12.449,28305,6.852,24.898,1281,1283,9343
1984,4231,23430,28747,315652,306595,2759,9.624,2600,9.070,52231,14658,37573,4.781,17.036,34343,13979,20364,4.559,11.201,17888,5.834,22.403,1854,1906,8840
1984,4232,7849,8934,103157,98968,1130,12.755,980,11.062,20981,4768,16213,4.818,21.200,12486,5288,7198,5.343,12.616,8495,8.584,25.232,701,714,3033
1984,4233,7515,9218,116578,109281,1189,13.077,937,10.306,26879,7384,19495,6.757,24.596,12369,5310,7059,4.859,11.319,14510,13.278,22.637,608,611,3237
1984,4234,22171,29993,506459,484950,4889,16.811,3066,10.543,113270,43608,69662,8.992,23.357,70612,32416,38196,6.684,14.561,42658,8.796,29.121,1845,1890,10376
1984,4235,6484,8802,126581,123197,957,10.915,889,10.139,21892,5750,16142,4.667,17.770,15185,7031,8154,5.707,12.326,6707,5.444,24.652,496,515,3230
1984,4236,14643,21152,297224,276772,2618,12.619,1806,8.705,76876,34502,42374,12.466,27.776,34865,13774,21091,4.977,12.597,42011,15.179,25.194,1199,1227,6684
1984,4237,10785,14132,156537,152089,1222,8.679,1119,7.947,25943,7704,18239,5.065,17.058,17118,6227,10891,4.094,11.255,8825,5.803,22.511,812,827,3853
1984,4238,46606,60683,632487,621199,5620,9.270,5507,9.083,106032,31593,74439,5.086,17.069,83359,29749,53610,4.789,13.419,22673,3.650,26.838,3437,3535,16559
1984,4239,22151,23718,222950,211929,3843,16.452,3124,13.374,53859,16702,37157,7.881,25.414,31574,13673,17901,6.452,14.898,22285,10.515,29.797,2458,2475,9251
1984,4241,7838,10425,144063,141833,1037,10.026,873,8.440,22656,6035,16621,4.255,15.974,18267,8354,9913,5.890,12.879,4389,3.094,25.759,496,505,3694
1984,4242,2724,3446,99515,96465,465,13.656,383,11.248,15059,6983,8076,7.239,15.611,9209,3514,5695,3.643,9.547,5850,6.064,19.093,265,266,1965
1984,4243,10882,11784,129651,124506,1785,15.367,1449,12.474,30275,9129,21146,7.332,24.316,19978,8645,11333,6.943,16.046,10297,8.270,32.092,1124,1134,5477
1984,4244,27138,33276,607831,595248,3615,10.931,3206,9.694,99648,26557,73091,4.462,16.741,74502,26037,48465,4.374,12.516,25146,4.224,25.032,2385,2427,16360
1984,4245,8220,11287,98898,100490,648,5.686,868,7.616,13354,3872,9482,3.853,13.289,16454,4886,11568,4.862,16.374,-3100,-3.085,26.578,569,602,3340
1984,4246,6830,10156,116345,116804,1158,11.553,892,8.900,18856,5630,13226,4.820,16.143,19943,5330,14613,4.563,17.074,-1087,-0.931,32.287,497,528,2568
1984,4247,11537,15008,150195,150169,978,6.443,1320,8.696,25485,5749,19736,3.828,16.971,25198,8858,16340,5.899,16.780,287,0.191,33.560,817,847,5383
1984,4248,4552,5654,139415,137720,321,5.630,417,7.313,16727,3502,13225,2.543,12.146,13297,5120,8177,3.718,9.655,3430,2.491,19.310,314,321,3213
1984,4249,19747,23997,249184,241771,3219,13.609,2531,10.701,46549,15019,31530,6.212,19.253,31685,12029,19656,4.975,13.105,14864,6.148,26.211,1801,1814,7389
1984,4251,28896,31755,298370,289726,3674,11.732,2797,8.931,57882,19704,38178,6.801,19.978,40636,14235,26401,4.913,14.026,17246,5.953,28.051,1897,1904,8377
1984,4411,37402,38443,838860,794480,4209,11.078,3312,8.717,148423,38173,110250,4.805,18.682,59843,26277,33566,3.307,7.532,88580,11.149,15.065,2742,2752,20880
1984,4412,11104,11534,79660,74779,1370,11.959,1213,10.589,19699,5542,14157,7.411,26.343,9952,4019,5933,5.375,13.309,9747,13.034,26.617,959,970,3246
1984,4413,45961,67834,458813,437960,7143,10.768,4151,6.257,90979,36934,54045,8.433,20.773,49240,17875,31365,4.081,11.243,41739,9.530,22.486,2767,2878,11653
1984,4421,22127,26705,211715,204653,3065,11.548,2739,10.319,42470,14001,28469,6.841,20.752,28260,12870,15390,6.289,13.809,14210,6.943,27.618,1968,2051,8442
1984,4422,20154,24032,136070,129190,3647,15.521,2578,10.971,34301,13443,20858,10.406,26.551,20493,8588,11905,6.648,15.863,13808,10.688,31.725,1915,1961,6107
1984,4431,24574,32277,194119,184012,5516,17.453,4173,13.203,52251,24875,27376,13.518,28.395,31767,15758,16009,8.564,17.264,20484,11.132,34.527,2862,3025,10534
1984,4441,56115,70889,684770,657402,6264,8.888,5436,7.713,128750,41066,87684,6.247,19.585,73916,25654,48262,3.902,11.244,54834,8.341,22.487,3917,3969,16591
1984,4442,14613,17750,123443,120601,2070,11.863,1468,8.413,22651,8360,14291,6.932,18.782,16844,5241,11603,4.346,13.967,5807,4.815,27.933,1109,1125,3802
1984,4451,65607,109171,1959779,1917081,11374,10.403,11705,10.705,321564,138830,182734,7.242,16.774,237772,100149,137623,5.224,12.403,83792,4.371,24.806,7693,7875,42652
1984,4452,23615,28535,180933,179448,4159,14.511,4410,15.387,40927,18161,22766,10.121,22.807,38122,18070,20052,10.070,21.244,2805,1.563,42.488,3091,3146,12063
1984,4453,28960,34345,168197,168620,3889,11.313,3951,11.493,32065,13205,18860,7.831,19.016,32877,13604,19273,8.068,19.498,-812,-0.482,38.032,3082,3119,9776
1984,4461,44420,64582,591133,572182,7055,11.170,4207,6.661,107468,44492,62976,7.776,18.782,68363,25667,42696,4.486,11.948,39105,6.834,23.896,2878,2967,15002
1984,4471,95714,127894,785411,766537,15579,12.106,17158,13.333,182143,77949,104194,10.169,23.762,144455,70641,73814,9.216,18.845,37688,4.917,37.690,11814,12065,46694
1984,4481,57520,97851,790115,785559,12506,12.895,10765,11.100,164293,80084,84209,10.195,20.914,152070,50778,101292,6.464,19.358,12223,1.556,38.716,7046,7495,28119
1984,4482,12480,36148,195656,189983,3767,10.514,3127,8.728,42226,17931,24295,9.438,22.226,30753,11724,19029,6.171,16.187,11473,6.039,32.375,1385,1477,5125
1984,4483,18185,25787,148294,146831,2996,11.749,2421,9.494,28389,10806,17583,7.360,19.335,25275,9856,15419,6.713,17.214,3114,2.121,34.427,1563,1610,5505
1984,4511,32055,42394,265299,261150,5816,13.793,5360,12.712,54051,23976,30075,9.181,20.697,45630,19008,26622,7.279,17.473,8421,3.225,34.945,3848,4016,12403
1984,4512,7859,11778,76695,74648,1605,13.821,1275,10.979,15949,6489,9460,8.693,21.366,11814,4955,6859,6.638,15.826,4135,5.539,31.653,904,947,3228
1984,4521,563,9827,1518578,1465577,639,6.560,468,4.804,184305,67735,116570,4.622,12.576,79841,24757,55084,1.689,5.448,104464,7.128,10.896,32,33,890
1984,4529,12854,24321,356314,345194,2798,11.621,2311,9.598,60987,29222,31765,8.465,17.667,38454,13949,24505,4.041,11.140,22533,6.528,22.280,1393,1427,4971
1984,4531,21897,23198,111551,108010,3434,15.106,2502,11.007,24874,9767,15107,9.043,23.029,17890,7241,10649,6.704,16.563,6984,6.466,33.127,1944,1972,5756
1984,4532,25797,31501,203408,195122,5187,16.858,3721,12.094,48945,19599,29346,10.044,25.084,32455,14594,17861,7.479,16.633,16490,8.451,33.266,2761,2847,9235
1984,4533,9459,11360,53832,51620,1868,16.786,1405,12.625,12343,5789,6554,11.215,23.912,8049,3438,4611,6.660,15.593,4294,8.319,31.186,1096,1101,2533
1984,4539,26854,32592,150248,144328,5106,15.847,4362,13.538,41217,17322,23895,12.002,28.558,28978,14790,14188,10.247,20.078,12239,8.480,40.156,3109,3194,10754
1984,4541,5888,7494,97478,95300,1115,15.038,956,12.894,20208,8506,11702,8.925,21.205,15916,7207,8709,7.562,16.701,4292,4.504,33.402,621,625,2227
1984,4542,4057,5357,80303,78650,613,11.591,476,9.001,11709,3429,8280,4.360,14.888,8330,2873,5457,3.653,10.591,3379,4.296,21.183,339,348,1687
1984,4543,16485,22116,197148,193392,2188,9.961,1887,8.591,33342,11037,22305,5.707,17.241,25626,9779,15847,5.057,13.251,7716,3.990,26.502,1378,1388,5498
1984,4811,1054,2813,264375,260787,337,12.700,18,0.678,26768,3655,23113,1.402,10.264,20265,50,20215,0.019,7.771,6503,2.494,15.541,14,14,44
1984,4812,457,679,18473,15988,132,21.308,13,2.098,5585,658,4927,4.116,34.934,630,52,578,0.325,3.941,4955,30.993,7.881,13,13,52
1984,4831,399,650,34081,33256,64,10.306,6,0.966,6594,3444,3150,10.356,19.828,5118,23,5095,0.069,15.390,1476,4.438,30.779,5,5,14
1984,4832,379,437,14687,14267,41,9.785,5,1.193,2237,526,1711,3.687,15.680,1437,11,1426,0.077,10.072,800,5.607,20.144,4,4,10
1984,4841,20664,26009,501676,464937,4848,20.301,591,2.475,106459,29127,77332,6.265,22.898,32511,1968,30543,0.423,6.993,73948,15.905,13.985,485,485,1585
1984,4842,42635,46534,563467,525155,7606,17.640,773,1.793,128168,34004,94164,6.475,24.406,51544,2677,48867,0.510,9.815,76624,14.591,19.630,603,603,2087
1984,4851,402,436,18942,18473,51,12.319,7,1.691,2121,943,1178,5.105,11.482,1268,151,1117,0.817,6.864,853,4.618,13.729,7,7,151
1984,4852,334,732,30715,30686,99,14.505,0,0.000,3775,1689,2086,5.504,12.302,3675,0,3675,0.000,11.976,100,0.326,23.953,0,0,0
1984,4853,5132,5198,53184,50692,881,18.305,111,2.306,11420,4332,7088,8.546,22.528,6476,333,6143,0.657,12.775,4944,9.753,25.550,92,92,260
1984,4854,3409,3608,95352,92021,289,8.302,35,1.005,13332,3263,10069,3.546,14.488,6611,209,6402,0.227,7.184,6721,7.304,14.368,30,30,198
1984,4855,571,608,12872,12163,119,21.558,7,1.268,3059,1368,1691,11.247,25.150,1664,18,1646,0.148,13.681,1395,11.469,27.362,6,6,17
1984,4859,985,1024,17023,16141,203,21.723,24,2.568,3483,1372,2111,8.500,21.579,1686,95,1591,0.589,10.446,1797,11.133,20.892,21,21,91
1984,4861,74,310,11461,11579,10,3.279,0,0.000,873,54,819,0.466,7.540,1064,0,1064,0.000,9.189,-191,-1.650,15.079,0,0,0
1984,4862,239,1287,59444,59148,87,6.985,4,0.321,4533,1369,3164,2.315,7.664,3903,309,3594,0.522,6.599,630,1.065,13.198,(D),(D),(D)
1984,4869,61,345,7503,7392,32,9.682,3,0.908,700,230,470,3.111,9.470,479,8,471,0.108,6.480,221,2.990,12.960,(D),(D),(D)
1984,4871,186,190,2370,2312,42,24.277,8,4.624,493,188,305,8.131,21.324,355,44,311,1.903,15.355,138,5.969,30.709,5,5,15
1984,4872,683,689,10123,9562,127,19.345,62,9.444,2513,747,1766,7.813,26.282,1403,225,1178,2.353,14.673,1110,11.609,29.347,46,46,163
1984,4879,47,61,1221,1108,12,21.429,(D),(D),305,55,250,4.966,27.540,64,(D),58,(D),5.779,241,21.761,11.558,0,0,0
1984,4881,2090,2647,60939,57034,422,17.189,38,1.548,12567,3924,8643,6.880,22.034,4674,281,4393,0.493,8.195,7893,13.839,16.390,29,29,131
1984,4882,296,396,8394,7693,49,13.049,8,2.130,1910,492,1418,6.396,24.829,464,53,411,0.689,6.032,1446,18.798,12.064,5,5,43
1984,4883,2116,2540,108825,104603,290,12.053,22,0.914,28460,8514,19946,8.139,27.208,20345,175,20170,0.167,19.450,8115,7.758,38.899,17,17,155
1984,4884,1606,2205,32528,31727,441,20.763,279,13.136,6685,2749,3936,8.665,21.070,5007,970,4037,3.057,15.782,1678,5.289,31.563,232,232,764
1984,4885,5175,7023,87427,81990,1263,19.612,97,1.506,20274,6779,13495,8.268,24.728,9479,569,8910,0.694,11.561,10795,13.166,23.122,84,84,482
1984,4889,393,396,4801,4761,77,20.671,30,8.054,940,453,487,9.515,19.744,906,64,842,1.344,19.030,34,0.714,38.059,25,25,52
1984,4921,1332,2111,105068,100435,556,29.989,42,2.265,18479,5597,12882,5.573,18.399,9236,294,8942,0.293,9.196,9243,9.203,18.392,34,34,281
1984,4922,1229,1267,8982,6860,539,52.766,48,4.699,4994,3578,1416,52.157,72.799,732,179,553,2.609,10.671,4262,62.128,21.341,44,44,174
1984,4931,6210,9634,380671,373704,762,7.897,792,8.208,62423,15688,46735,4.198,16.704,47973,13909,34064,3.722,12.837,14450,3.867,25.674,289,298,2359
1984,5111,13364,15329,628440,616543,1603,10.542,1356,8.918,70998,21551,49447,3.495,11.516,47761,18022,29739,2.923,7.747,23237,3.769,15.493,1097,1099,8345
1984,5112,7149,8431,145396,137390,1405,16.739,1330,15.846,41173,13168,28005,9.584,29.968,25056,11264,13792,8.199,18.237,16117,11.731,36.474,925,939,5524
1984,5121,9142,14242,205800,200290,2083,14.650,2036,14.319,51324,14199,37125,7.089,25.625,39838,13977,25861,6.978,19.890,11486,5.735,39.780,1089,1150,6388
1984,5122,1695,1702,12035,11739,518,32.931,260,16.529,4198,2434,1764,20.734,35.761,3734,1240,2494,10.563,31.809,464,3.953,63.617,196,196,861
1984,5151,6255,7353,227369,217143,961,13.908,74,1.071,34537,16016,18521,7.376,15.905,14080,756,13324,0.348,6.484,20457,9.421,12.968,64,64,714
1984,5152,9,9,91,83,4,50.000,(D),(D),23,20,3,24.242,27.879,7,(D),5,(D),8.485,16,19.394,16.970,(D),(D),(D)
1984,5171,2157,13471,877969,826585,4164,36.451,69,0.604,313420,235855,77565,28.534,37.917,201820,366,201454,0.044,24.416,111600,13.501,48.832,62,62,339
1984,5172,724,1574,64752,62163,444,32.421,35,2.556,19324,11918,7406,19.172,31.086,13357,508,12849,0.817,21.487,5967,9.599,42.974,28,28,143
1984,5174,720,1273,52377,48268,207,17.640,8,0.682,13558,5050,8508,10.463,28.089,5276,22,5254,0.046,10.931,8282,17.159,21.862,7,7,21
1984,5179,1377,2653,76193,69818,667,28.480,45,1.921,27884,16934,10950,24.254,39.938,14205,218,13987,0.312,20.346,13679,19.592,40.692,42,42,201
1984,5182,5862,7753,237443,229976,1192,15.552,1015,13.243,47620,17294,30326,7.520,20.707,32701,10745,21956,4.672,14.219,14919,6.487,28.439,634,642,3936
1984,5191,2228,2661,31292,30403,393,15.238,229,8.879,5600,2253,3347,7.410,18.419,3827,2144,1683,7.052,12.588,1773,5.832,25.175,172,172,1174
1984,5211,36,77,24131,24281,(D),(D),0,0.000,516,(D),431,(D),2.125,819,0,819,0.000,3.373,-303,-1.248,4.250,0,0,0
1984,5221,20366,69519,1897802,1856680,3851,5.686,260,0.384,228500,67013,161487,3.609,12.307,146694,2855,143839,0.154,7.901,81806,4.406,15.802,231,231,2636
1984,5222,22255,39397,382350,356177,3516,9.281,490,1.293,79563,28055,51508,7.877,22.338,27233,2030,25203,0.570,7.646,52330,14.692,15.292,403,404,1694
1984,5223,3477,3933,49988,46158,1065,30.595,161,4.625,13601,6526,7075,14.138,29.466,5919,629,5290,1.363,12.823,7682,16.643,25.647,145,145,488
1984,5231,6276,11921,286625,264461,2336,21.543,181,1.669,63402,21758,41644,8.227,23.974,19035,1224,17811,0.463,7.198,44367,16.776,14.395,149,149,828
1984,5232,127,142,6737,6588,21,15.970,0,0.000,550,146,404,2.216,8.349,272,0,272,0.000,4.129,278,4.220,8.257,0,0,0
1984,5239,14433,14830,162969,145123,3562,26.922,364,2.751,71820,25659,46161,17.681,49.489,34762,1967,32795,1.355,23.953,37058,25.536,47.907,262,262,1210
1984,5241,6519,30494,1243733,1225889,2614,8.936,129,0.441,148884,50217,98667,4.096,12.145,113673,1704,111969,0.139,9.273,35211,2.872,18.545,104,104,1301
1984,5242,97016,101846,735987,678024,14577,15.292,1529,1.604,190528,80944,109584,11.938,28.100,74485,6074,68411,0.896,10.986,116043,17.115,21.971,1223,1223,4540
1984,5250,1917,2139,36226,34719,294,14.627,36,1.791,6639,2478,4161,7.137,19.122,3892,222,3670,0.639,11.210,2747,7.912,22.420,25,25,180
1984,5311,96577,98675,499342,470524,13621,14.644,2298,2.471,112888,50722,62166,10.780,23.992,55677,7223,48454,1.535,11.833,57211,12.159,23.666,1766,1768,5514
1984,5312,34300,35727,192769,176546,7209,22.067,1093,3.346,56033,24327,31706,13.779,31.739,23584,3092,20492,1.751,13.359,32449,18.380,26.717,867,867,2409
1984,5313,21517,22318,223969,205164,4686,23.023,757,3.719,60819,22829,37990,11.127,29.644,23068,2604,20464,1.269,11.244,37751,18.400,22.487,636,636,2108
1984,5321,5634,9100,109621,105883,1413,15.753,1153,12.854,23571,8206,15365,7.750,22.261,16134,6924,9210,6.539,15.238,7437,7.024,30.475,672,724,3995
1984,5322,10994,14022,130382,112556,4216,32.868,1826,14.236,60269,42346,17923,37.622,53.546,22504,9919,12585,8.813,19.994,37765,33.552,39.987,1346,1359,6487
1984,5323,2905,3580,26091,24183,849,25.427,367,10.991,9226,5343,3883,22.094,38.152,5286,1613,3673,6.670,21.859,3940,16.293,43.718,247,248,1046
1984,5324,5483,6738,72088,61392,1599,25.870,485,7.847,30117,18587,11530,30.276,49.057,7864,2875,4989,4.683,12.809,22253,36.247,25.619,331,335,1924
1984,5331,926,971,11862,10992,164,18.232,21,2.335,2992,972,2020,8.843,27.220,1246,42,1204,0.382,11.336,1746,15.884,22.671,19,19,40
1984,5411,121832,125500,696421,671198,15024,12.143,11475,9.275,131712,44662,87050,6.654,19.623,81662,30184,51478,4.497,12.167,50050,7.457,24.333,8428,8487,22714
1984,5412,53747,56659,433685,424117,9719,17.698,6235,11.353,81340,33447,47893,7.886,19.179,62046,30309,31737,7.146,14.629,19294,4.549,29.259,4564,4623,25079
1984,5413,50116,54870,693838,664596,9320,17.562,5716,10.771,162208,48399,113809,7.282,24.407,103423,32014,71409,4.817,15.562,58785,8.845,31.124,4039,4080,17387
1984,5414,12478,12698,85550,80938,2392,19.313,1767,14.267,23004,7976,15028,9.854,28.422,13886,6648,7238,8.214,17.156,9118,11.265,34.313,1374,1381,5015
1984,5415,7879,9011,81876,67933,4192,56.069,1123,15.020,38310,23948,14362,35.253,56.394,10570,5715,4855,8.413,15.560,27740,40.835,31.119,815,818,3154
1984,5416,33535,34709,280858,259912,9775,30.047,5422,16.666,103123,44208,58915,17.009,39.676,59853,27988,31865,10.768,23.028,43270,16.648,46.056,4108,4128,17647
1984,5417,5877,7133,404872,398194,1142,16.331,862,12.327,53354,18016,35338,4.524,13.399,40361,11578,28783,2.908,10.136,12993,3.263,20.272,551,553,2685
1984,5418,22914,25058,316864,299762,4303,17.670,2892,11.876,76171,26563,49608,8.861,25.410,41826,17405,24421,5.806,13.953,34345,11.457,27.906,2212,2218,11471
1984,5419,27951,30910,206893,198209,4296,14.432,2009,6.749,47740,17898,29842,9.030,24.086,30517,8287,22230,4.181,15.396,17223,8.689,30.793,1483,1497,6002
1984,5511,23391,43595,2822048,2761986,4524,10.607,2636,6.180,480803,150285,330518,5.441,17.408,360750,76630,284120,2.774,13.061,120053,4.347,26.123,394,408,5006
1984,5611,9488,9974,134008,126338,2115,21.759,1607,16.533,39274,14632,24642,11.582,31.087,24209,8877,15332,7.026,19.162,15065,11.924,38.324,1237,1239,5416
1984,5612,152,166,12293,9271,80,59.480,17,12.639,6268,4572,1696,49.318,67.612,402,204,198,2.201,4.336,5866,63.276,8.673,13,13,88
1984,5613,12073,15832,731419,649545,2999,19.608,1925,12.586,265543,62337,203206,9.597,40.881,101155,29265,71890,4.505,15.573,164388,25.308,31.146,1393,1406,14889
1984,5614,17997,20196,207972,199243,3258,16.499,2359,11.946,48004,15959,32045,8.010,24.093,30622,12125,18497,6.086,15.369,17382,8.724,30.738,1815,1835,7704
1984,5615,20221,23684,176349,166809,3708,16.270,1920,8.425,42228,15881,26347,9.520,25.315,23170,9029,14141,5.413,13.890,19058,11.425,27.780,1399,1433,6700
1984,5616,10573,12903,400185,385378,2222,17.620,1637,12.981,85906,23573,62333,6.117,22.291,55515,18648,36867,4.839,14.405,30391,7.886,28.811,1228,1228,12158
1984,5617,56774,59818,757389,719883,13703,24.325,6734,11.954,189714,59912,129802,8.322,26.353,114748,40675,74073,5.650,15.940,74966,10.414,31.880,5423,5437,28520
1984,5619,11457,12298,164552,155929,2175,18.155,1539,12.846,44263,14535,29728,9.322,28.387,26911,9649,17262,6.188,17.259,17352,11.128,34.517,1126,1136,6151
1984,5621,4116,4225,89923,84809,503,12.536,78,1.944,15117,2291,12826,2.701,17.825,4847,347,4500,0.409,5.715,10270,12.110,11.430,70,70,322
1984,5622,2093,2627,46094,43948,273,10.896,30,1.197,8853,2876,5977,6.544,20.144,4469,153,4316,0.348,10.169,4384,9.975,20.338,25,25,120
1984,5629,4359,4612,39680,37673,682,15.208,427,9.522,10698,3293,7405,8.741,28.397,6684,2409,4275,6.395,17.742,4014,10.655,35.484,340,340,1703
1984,6111,13024,13420,368536,359477,819,6.285,39,0.299,37139,6918,30221,1.924,10.331,19190,404,18786,0.112,5.338,17949,4.993,10.677,26,26,206
1984,6112,419,529,35766,34940,47,9.279,(D),(D),4463,1459,3004,4.176,12.773,2889,(D),2854,(D),8.268,1574,4.505,16.537,(D),(D),(D)
1984,6113,2007,2321,899760,890325,104,4.577,6,0.264,72310,2593,69717,0.291,8.122,53486,202,53284,0.023,6.007,18824,2.114,12.015,4,4,198
1984,6114,1928,2216,35527,33661,491,23.348,265,12.601,8925,3457,5468,10.270,26.514,5125,1639,3486,4.869,15.225,3800,11.289,30.451,206,207,1097
1984,6115,3092,3507,50883,49775,564,16.484,393,11.486,9742,3256,6486,6.542,19.572,7527,3053,4474,6.134,15.122,2215,4.450,30.244,275,290,2552
1984,6116,10600,11094,89970,87549,2154,19.871,1646,15.185,21235,7939,13296,9.068,24.255,16370,7155,9215,8.173,18.698,4865,5.557,37.396,1313,1324,5484
1984,6117,1413,1434,17515,16599,294,21.220,197,14.219,3984,1936,2048,11.663,24.001,2230,851,1379,5.127,13.435,1754,10.567,26.869,140,140,467
1984,6211,179947,185715,1061350,1029621,14432,7.833,11517,6.250,177573,57360,120213,5.571,17.246,113324,38055,75269,3.696,11.006,64249,6.240,22.013,9069,9137,29815
1984,6212,94403,96612,441380,430084,6334,6.619,4507,4.710,71219,21639,49580,5.031,16.559,48762,14677,34085,3.413,11.338,22457,5.222,22.676,3451,3489,11697
1984,6213,41832,43668,145551,137463,6653,15.826,3392,8.069,37374,17003,20371,12.369,27.189,21055,9054,12001,6.587,15.317,16319,11.872,30.634,2437,2479,6995
1984,6214,5576,7092,107528,100937,1273,18.829,611,9.037,26383,13431,12952,13.306,26.138,13099,5492,7607,5.441,12.977,13284,13.161,25.955,415,418,3199
1984,6215,4178,5218,69575,66814,763,14.965,524,10.278,14613,5591,9022,8.368,21.871,9285,4033,5252,6.036,13.897,5328,7.974,27.794,360,398,2547
1984,6216,3891,5140,192999,177935,1204,25.414,399,8.422,52742,20004,32738,11.242,29.641,22456,6965,15491,3.914,12.620,30286,17.021,25.241,257,262,3736
1984,6219,3701,4298,79840,74333,893,22.364,283,7.087,20750,8552,12198,11.505,27.915,9664,2939,6725,3.954,13.001,11086,14.914,26.002,186,189,2033
1984,6221,3642,4881,3097810,3069548,226,4.734,12,0.251,265711,176888,88823,5.763,8.656,207190,6990,200200,0.228,6.750,58521,1.907,13.500,9,9,6942
1984,6222,365,512,213574,211438,51,10.462,(D),(D),50515,44509,6006,21.051,23.891,48646,(D),48376,(D),23.007,1869,0.884,46.015,(D),(D),(D)
1984,6223,198,240,59833,67738,11,4.671,(D),(D),5951,1929,4022,2.848,8.785,23120,(D),23115,(D),34.132,-17169,-25.346,17.571,0,0,0
1984,6231,6720,9902,809967,798847,707,7.197,551,5.609,95975,39962,56013,5.002,12.014,73799,33754,40045,4.225,9.238,22176,2.776,18.476,351,358,19780
1984,6232,4252,5668,129260,122093,813,15.088,254,4.714,25224,10508,14716,8.607,20.660,11070,3037,8033,2.487,9.067,14154,11.593,18.134,162,163,1975
1984,6233,8874,10591,387120,388490,1307,12.469,1089,10.389,53731,19911,33820,5.125,13.831,56665,33337,23328,8.581,14.586,-2934,-0.755,27.661,707,719,20051
1984,6239,2720,3338,78986,77030,345,10.615,169,5.200,10413,3433,6980,4.457,13.518,6548,1809,4739,2.348,8.501,3865,5.018,17.001,115,115,1281
1984,6241,13486,18517,261105,255685,2205,12.232,1225,6.795,44223,12134,32089,4.746,17.296,33654,7942,25712,3.106,13.162,10569,4.134,26.325,745,779,4127
1984,6242,3939,4637,39836,38311,670,15.117,260,5.866,7823,2821,5002,7.363,20.420,4785,1664,3121,4.343,12.490,3038,7.930,24.980,152,156,848
1984,6243,3838,5507,229784,229736,612,11.282,447,8.240,37219,8142,29077,3.544,16.201,37125,6861,30264,2.986,16.160,94,0.041,32.320,216,237,3351
1984,6244,29137,34217,296231,281377,5398,16.346,3011,9.118,68393,27573,40820,9.799,24.307,38374,15342,23032,5.452,13.638,30019,10.669,27.276,2342,2362,10959
1984,7111,4925,4978,66343,66838,870,17.551,828,16.704,15644,5255,10389,7.862,23.406,16415,4601,11814,6.884,24.559,-771,-1.154,46.812,609,610,3234
1984,7112,2126,2218,62651,62044,398,17.788,437,19.531,14166,5441,8725,8.770,22.832,13462,4558,8904,7.346,21.698,704,1.135,43.395,325,326,2286
1984,7113,2130,2166,30843,28615,375,17.511,326,15.223,10122,2581,7541,9.020,35.374,5677,2595,3082,9.069,19.840,4445,15.534,39.679,236,237,1860
1984,7114,980,994,11374,10650,200,20.704,144,14.907,3693,1227,2466,11.521,34.676,2302,1047,1255,9.831,21.615,1391,13.061,43.230,110,110,775
1984,7115,8232,8248,48200,43190,3044,40.709,1503,20.100,20652,9974,10678,23.094,47.817,10284,3933,6351,9.106,23.811,10368,24.006,47.623,1116,1116,2959
1984,7121,2134,2283,36176,35481,244,10.993,117,5.271,4287,772,3515,2.176,12.083,2846,620,2226,1.747,8.021,1441,4.061,16.043,88,88,437
1984,7131,1919,2395,58186,59976,381,14.813,735,28.577,6038,2206,3832,3.678,10.067,9543,4351,5192,7.255,15.911,-3505,-5.844,20.135,618,623,2456
1984,7132,691,715,19585,18589,136,19.021,136,19.021,4578,1239,3339,6.665,24.627,2659,894,1765,4.809,14.304,1919,10.323,28.608,110,110,634
1984,7139,32130,34196,482946,470929,4639,13.742,3763,11.147,95805,35392,60413,7.515,20.344,71636,24876,46760,5.282,15.212,24169,5.132,30.423,2897,2927,17794
1984,7211,29036,33441,1142172,1105292,4599,13.845,4152,12.499,228743,108752,119991,9.839,20.695,155142,67434,87708,6.101,14.036,73601,6.659,28.073,3007,3050,42272
1984,7212,3645,3897,21635,20775,578,15.085,447,11.666,6165,2290,3875,11.023,29.675,4457,1710,2747,8.231,21.454,1708,8.221,42.907,307,309,1146
1984,7213,4637,4746,22292,22339,306,6.392,388,8.105,3666,1144,2522,5.121,16.411,3811,1243,2568,5.564,17.060,-145,-0.649,32.822,279,279,986
1984,7223,16983,26724,494230,486141,4570,17.236,4152,15.659,117442,54520,62922,11.215,24.158,101018,48326,52692,9.941,20.780,16424,3.378,41.559,2523,2552,19835
1984,7224,57497,58286,323723,323875,8779,14.823,10659,17.997,88874,46093,42781,14.232,27.441,88915,47120,41795,14.549,27.454,-41,-0.013,54.882,8578,8600,38154
1984,7225,193189,249152,4384980,4240058,42785,17.448,34910,14.237,1051368,566880,484488,13.370,24.796,762181,377443,384738,8.902,17.976,289187,6.820,35.951,25539,26112,228374
1984,8111,98511,103054,492921,465530,17853,17.795,12393,12.353,130905,56716,74189,12.183,28.120,76038,36110,39928,7.757,16.334,54867,11.786,32.667,9571,9624,28509
1984,8112,9729,10962,73097,69424,1717,15.949,1324,12.299,19281,10342,8939,14.897,27.773,11724,5699,6025,8.209,16.888,7557,10.885,33.775,989,993,3113
1984,8113,18043,18946,140592,134854,2723,14.598,2137,11.457,32059,10703,21356,7.937,23.773,20423,7799,12624,5.783,15.145,11636,8.629,30.289,1655,1661,6007
1984,8114,23304,24899,147744,142333,4198,17.186,3254,13.321,34490,13907,20583,9.771,24.232,23666,10982,12684,7.716,16.627,10824,7.605,33.255,2447,2457,6906
1984,8121,81034,90143,455218,446936,12266,13.645,11770,13.093,102725,45744,56981,10.235,22.984,85279,40765,44514,9.121,19.081,17446,3.903,38.162,9362,9536,30924
1984,8122,17400,20110,114966,113279,1503,7.566,1012,5.095,16431,4884,11547,4.311,14.505,13036,3223,9813,2.845,11.508,3395,2.997,23.016,684,707,2432
1984,8123,32550,38394,338545,334484,4622,12.056,4507,11.756,57321,22561,34760,6.745,17.137,49425,20348,29077,6.083,14.776,7896,2.361,29.553,3447,3576,14990
1984,8129,12534,19429,198610,193988,3823,20.500,2263,12.135,46791,20361,26430,10.496,24.121,37520,13351,24169,6.882,19.341,9271,4.779,38.683,1105,1166,6216
1984,8131,114708,114816,896416,818830,38359,40.049,285,0.298,215078,109399,105679,13.360,26.267,60411,889,59522,0.109,7.378,154667,18.889,14.755,97,97,376
1984,8132,7340,8346,110522,106345,981,12.201,370,4.602,20842,5404,15438,5.082,19.598,12506,2181,10325,2.051,11.760,8336,7.839,23.520,226,229,1222
1984,8133,7016,8173,87817,86990,961,12.000,631,7.880,16083,3951,12132,4.542,18.488,14462,3545,10917,4.075,16.625,1621,1.863,33.250,388,389,2087
1984,8134,28840,30183,253863,251456,2227,7.443,1703,5.692,37654,8386,29268,3.335,14.974,32912,6500,26412,2.585,13.089,4742,1.886,26.177,1183,1183,3610
1984,8139,55273,57446,432063,420804,4943,8.841,1872,3.348,77550,21022,56528,4.996,18.429,55283,7266,48017,1.727,13.137,22267,5.292,26.275,1318,1322,5429
1985,2111,8049,9971,164569,164859,1282,12.886,1238,12.443,30901,10018,20883,6.077,18.744,31393,13305,18088,8.071,19.042,-492,-0.298,37.488,828,842,4970
1985,2121,2645,3321,172893,179005,545,16.079,682,20.121,24210,8868,15342,4.954,13.525,36622,13245,23377,7.399,20.459,-12412,-6.934,27.050,500,504,7684
1985,2122,481,641,40789,43644,101,15.019,164,24.387,6211,2906,3305,6.658,14.231,11837,3369,8468,7.719,27.122,-5626,-12.891,28.462,109,109,1314
1985,2123,3559,5080,105608,103149,482,9.530,437,8.641,19896,8253,11643,8.001,19.289,14879,5937,8942,5.756,14.425,5017,4.864,28.850,300,305,2320
1985,2131,10972,12693,289135,290550,1963,15.388,2090,16.384,64010,17612,46398,6.062,22.031,67041,27782,39259,9.562,23.074,-3031,-1.043,44.061,1513,1514,14189
1985,2211,1623,5789,592321,586788,156,2.727,21,0.367,30139,3495,26644,0.596,5.136,19031,670,18361,0.114,3.243,11108,1.893,6.487,18,18,666
1985,2212,551,2427,138682,137272,135,5.709,10,0.423,9568,3651,5917,2.660,6.970,6876,60,6816,0.044,5.009,2692,1.961,10.018,7,7,52
1985,2213,3672,3964,30804,30152,314,8.171,72,1.874,3616,1123,2493,3.725,11.993,2367,242,2125,0.803,7.850,1249,4.142,15.701,60,60,189
1985,2361,93845,94204,559511,538963,21472,23.407,16527,18.017,203220,82472,120748,15.302,37.706,162141,68058,94083,12.628,30.084,41079,7.622,60.168,11662,11663,49589
1985,2362,36485,37110,659283,627642,5922,16.170,4950,13.516,206245,46938,159307,7.478,32.860,142557,43255,99302,6.892,22.713,63688,10.147,45.426,3676,3681,32503
1985,2371,13056,13388,321778,318044,1687,12.649,1586,11.891,99490,41635,57855,13.091,31.282,92671,20890,71781,6.568,29.138,6819,2.144,58.276,1192,1198,13211
1985,2372,9027,9176,85031,77123,2671,30.775,1677,19.323,34744,17228,17516,22.338,45.050,18617,8261,10356,10.712,24.140,16127,20.911,48.279,1333,1333,6560
1985,2373,10048,10343,214765,210277,1255,12.269,1027,10.040,51871,9341,42530,4.442,24.668,42997,10235,32762,4.867,20.448,8874,4.220,40.896,757,761,7022
1985,2379,4887,4983,98763,98847,944,19.414,703,14.458,24868,6017,18851,6.087,25.158,24805,4783,20022,4.839,25.094,63,0.064,50.189,515,515,3248
1985,2381,67167,67552,649325,618882,12307,18.665,9075,13.763,213518,63461,150057,10.254,34.501,152133,52982,99151,8.561,24.582,61385,9.919,49.164,6747,6749,41815
1985,2382,105055,106986,1117548,1078767,16968,16.274,11527,11.055,292676,75909,216767,7.037,27.131,215871,73396,142475,6.804,20.011,76805,7.120,40.022,8862,8868,54411
1985,2383,68921,69334,596854,569443,14199,21.010,10698,15.829,197190,61364,135826,10.776,34.629,142319,49931,92388,8.768,24.993,54871,9.636,49.985,7992,7994,39332
1985,2389,36228,36473,345724,338757,6574,18.515,4639,13.066,107976,35887,72089,10.594,31.874,94898,24517,70381,7.237,28.014,13078,3.861,56.027,3431,3431,17462
1985,3111,1736,2374,57285,58345,195,8.263,167,7.076,7336,2271,5065,3.892,12.573,9349,3632,5717,6.225,16.024,-2013,-3.450,25.147,98,99,1003
1985,3112,524,872,68644,68801,58,6.598,72,8.191,6810,3104,3706,4.512,9.898,7289,2153,5136,3.129,10.594,-479,-0.696,19.796,40,40,346
1985,3113,1482,1779,86824,86642,247,14.050,205,11.661,12286,6628,5658,7.650,14.180,12199,4235,7964,4.888,14.080,87,0.100,28.160,129,134,1140
1985,3114,1223,1687,181400,179332,102,5.984,137,8.038,24469,2546,21923,1.420,13.645,20024,5184,14840,2.891,11.166,4445,2.479,22.332,84,84,1301
1985,3115,1760,2441,135465,134336,162,6.555,223,9.023,16123,5605,10518,4.172,12.002,14203,5770,8433,4.295,10.573,1920,1.429,21.145,138,139,1959
1985,3116,4134,4713,326760,327252,391,8.302,384,8.154,38394,7690,30704,2.350,11.732,39204,16543,22661,5.055,11.980,-810,-0.248,23.465,275,277,7835
1985,3117,728,834,41413,43330,62,7.286,96,11.281,7838,1442,6396,3.328,18.089,11849,6620,5229,15.278,27.346,-4011,-9.257,36.179,56,56,1845
1985,3118,8890,10352,307112,306507,1473,14.269,1415,13.707,40798,12186,28612,3.976,13.311,39598,17980,21618,5.866,12.919,1200,0.392,25.838,1079,1096,10332
1985,3119,2036,2406,121668,121553,250,10.454,221,9.241,14821,3616,11205,2.975,12.193,14667,6744,7923,5.548,12.066,154,0.127,24.133,150,150,2950
1985,3121,1954,2498,168756,169721,189,7.545,203,8.104,15964,5862,10102,3.454,9.406,17795,5660,12135,3.335,10.485,-1831,-1.079,18.812,133,134,2247
1985,3122,108,156,41168,41365,15,9.646,14,9.003,2743,402,2341,0.972,6.631,2956,332,2624,0.803,7.146,-213,-0.515,13.262,7,7,69
1985,3131,441,653,100672,105598,34,5.140,51,7.710,6291,2460,3831,2.330,5.957,16052,4379,11673,4.147,15.201,-9761,-9.244,11.915,28,28,1149
1985,3132,1684,2051,271357,287383,164,7.917,205,9.896,19877,8765,11112,3.050,6.917,52022,18313,33709,6.372,18.102,-32145,-11.185,13.833,142,144,2299
1985,3133,1595,1840,104555,109028,177,9.604,183,9.929,9778,4147,5631,3.804,8.968,18686,8134,10552,7.461,17.139,-8908,-8.170,17.937,129,129,1918
1985,3141,3905,4199,126164,125620,533,12.754,493,11.797,17902,6331,11571,5.040,14.251,16917,5617,11300,4.471,13.467,985,0.784,26.934,372,374,2719
1985,3149,3691,3826,127172,128737,643,17.225,457,12.242,21806,11539,10267,8.963,16.938,24907,9534,15373,7.406,19.347,-3101,-2.409,33.877,370,372,5740
1985,3151,1364,1487,141244,145115,156,10.498,154,10.363,15953,5975,9978,4.117,10.993,23556,10336,13220,7.123,16.233,-7603,-5.239,21.987,119,120,4200
1985,3152,11744,13221,821457,857409,2139,16.236,2046,15.530,112136,48679,63457,5.677,13.078,182799,74531,108268,8.693,21.320,-70663,-8.241,26.157,1686,1699,43585
1985,3159,1943,2043,79072,81053,323,15.994,276,13.667,12379,4955,7424,6.113,15.273,16418,5951,10467,7.342,20.256,-4039,-4.983,30.546,235,236,3815
1985,3161,360,392,16166,17139,39,9.911,42,10.673,1830,648,1182,3.781,10.677,3811,1422,2389,8.297,22.236,-1981,-11.558,21.355,35,35,1009
1985,3162,451,632,102966,111405,41,6.170,106,15.952,9594,3518,6076,3.158,8.612,26636,9992,16644,8.969,23.909,-17042,-15.297,17.224,59,61,3106
1985,3169,1251,1300,44936,47406,152,11.701,150,11.547,6023,1945,4078,4.103,12.705,10974,2779,8195,5.862,23.149,-4951,-10.444,25.410,114,114,1579
1985,3211,4876,5365,138490,140311,643,12.013,618,11.546,19491,7502,11989,5.347,13.891,23163,7248,15915,5.166,16.508,-3672,-2.617,27.783,479,480,4301
1985,3212,1137,1383,86507,87694,187,13.842,123,9.104,10475,4416,6059,5.036,11.945,12649,5732,6917,6.536,14.424,-2174,-2.479,23.890,79,79,1657
1985,3219,8879,9607,277548,276955,1401,14.843,1065,11.283,46577,16539,30038,5.972,16.818,45478,19083,26395,6.890,16.421,1099,0.397,32.841,795,797,11351
1985,3221,242,569,201061,203996,30,5.217,42,7.304,13873,7615,6258,3.733,6.801,19378,12780,6598,6.265,9.499,-5505,-2.699,13.601,15,15,2058
1985,3222,3624,5222,402259,398783,402,7.750,332,6.401,45184,16628,28556,4.170,11.330,38528,14675,23853,3.680,9.661,6656,1.669,19.323,199,199,4365
1985,3231,37078,38697,752118,735882,5263,13.953,3307,8.767,115433,36015,79418,4.894,15.686,82482,36961,45521,5.023,11.209,32951,4.478,22.417,2598,2609,22258
1985,3241,1439,2328,234873,250062,200,8.574,209,8.960,13170,4742,8428,1.896,5.267,44021,17946,26075,7.177,17.604,-30851,-12.337,10.533,113,118,2967
1985,3251,1155,2310,241377,246044,222,9.671,193,8.408,23197,12582,10615,5.114,9.428,32202,20927,11275,8.505,13.088,-9005,-3.660,18.856,81,84,1723
1985,3252,375,621,138071,138679,70,11.513,44,7.237,9470,5902,3568,4.256,6.829,10750,3911,6839,2.820,7.752,-1280,-0.923,13.657,21,21,371
1985,3253,677,1021,47631,47477,90,8.704,116,11.219,5181,2190,2991,4.613,10.913,4929,2295,2634,4.834,10.382,252,0.531,20.764,54,54,645
1985,3254,1015,1250,161347,161699,135,10.839,126,10.116,14357,3077,11280,1.903,8.879,15060,3896,11164,2.409,9.314,-703,-0.435,17.758,80,80,1607
1985,3255,1677,2161,76871,75351,207,9.686,159,7.440,11200,4889,6311,6.488,14.864,8411,4260,4151,5.654,11.162,2789,3.701,22.325,96,100,1562
1985,3256,2084,2332,123253,122952,231,10.006,184,7.971,14360,4626,9734,3.762,11.679,13802,5563,8239,4.525,11.226,558,0.454,22.451,130,130,1070
1985,3259,1817,2353,127889,128405,263,11.317,205,8.821,12380,4467,7913,3.479,9.641,13210,5584,7626,4.349,10.288,-830,-0.646,19.283,121,121,1278
1985,3261,10391,12064,590744,582187,1320,11.112,950,7.997,94497,31249,63248,5.368,16.231,76807,32344,44463,5.556,13.193,17690,3.039,26.386,655,663,13385
1985,3262,2046,2424,205000,196232,252,10.518,196,8.180,32908,19156,13752,9.762,16.770,15904,5054,10850,2.576,8.105,17004,8.665,16.209,142,142,1881
1985,3271,1328,1604,77133,79803,222,13.945,198,12.437,8015,1981,6034,2.482,10.043,13335,5723,7612,7.171,16.710,-5320,-6.666,20.087,133,133,1660
1985,3272,1569,1849,155781,154538,278,15.406,189,10.474,21648,14365,7283,9.295,14.008,19682,6989,12693,4.523,12.736,1966,1.272,25.472,133,133,929
1985,3273,6883,8977,186868,182002,753,8.408,710,7.928,36293,11013,25280,6.051,19.941,26668,9360,17308,5.143,14.653,9625,5.288,29.305,474,479,5831
1985,3274,224,323,17221,16954,29,8.855,38,11.603,1586,286,1300,1.687,9.355,1038,496,542,2.926,6.123,548,3.232,12.245,29,29,263
1985,3279,1910,2214,80430,80727,266,12.205,197,9.039,9473,2909,6564,3.604,11.735,9947,3588,6359,4.445,12.322,-474,-0.587,23.469,146,146,1662
1985,3311,277,320,124285,123241,67,22.371,26,8.681,10541,6722,3819,5.454,8.553,8318,623,7695,0.506,6.749,2223,1.804,13.499,19,19,189
1985,3312,507,677,63658,64166,63,9.272,68,10.007,8226,5426,2800,8.456,12.820,9285,3979,5306,6.201,14.470,-1059,-1.650,25.640,32,32,789
1985,3313,443,657,122328,125029,44,6.677,48,7.284,11218,4206,7012,3.364,8.972,16751,6883,9868,5.505,13.398,-5533,-4.425,17.945,20,20,766
1985,3314,740,899,87164,87612,89,9.900,89,9.900,9661,3328,6333,3.799,11.027,10611,4750,5861,5.422,12.111,-950,-1.084,22.054,60,60,870
1985,3315,2789,3094,224724,226007,213,6.857,238,7.661,25823,8146,17677,3.604,11.426,28337,13112,15225,5.802,12.538,-2514,-1.112,22.852,137,137,3344
1985,3321,3174,3408,146347,145958,238,7.018,205,6.045,17354,4341,13013,2.974,11.890,16630,5220,11410,3.576,11.394,724,0.496,22.787,146,146,2984
1985,3322,1245,1364,79869,80100,132,9.717,121,8.907,7633,2259,5374,2.820,9.529,7972,2943,5029,3.674,9.953,-339,-0.423,19.059,81,82,1396
1985,3323,9924,10760,340452,334259,1064,9.947,938,8.769,59752,16994,42758,5.084,17.876,47197,18197,29000,5.444,14.120,12555,3.756,28.240,699,714,10531
1985,3324,1433,1811,130562,128597,158,8.780,135,7.502,16660,7296,9364,5.674,12.955,12306,4427,7879,3.443,9.569,4354,3.386,19.139,73,73,1085
1985,3325,936,1020,83406,82933,99,9.792,81,8.012,9441,4984,4457,6.010,11.384,8621,3266,5355,3.938,10.395,820,0.989,20.790,56,56,1097
1985,3326,1729,1930,68413,68909,223,11.790,146,7.719,9053,2741,6312,3.978,13.138,10116,4887,5229,7.092,14.680,-1063,-1.543,26.275,102,102,2293
1985,3327,21591,21905,350329,340882,2687,12.537,1743,8.132,62530,15219,47311,4.465,18.344,43926,19696,24230,5.778,12.886,18604,5.458,25.772,1399,1400,11827
1985,3328,5524,5841,135717,132295,576,10.003,411,7.137,22817,7275,15542,5.499,17.247,15981,6044,9937,4.569,12.080,6836,5.167,24.160,318,319,3603
1985,3329,5616,6141,367807,364254,892,14.979,520,8.732,46903,12694,34209,3.485,12.876,39730,17188,22542,4.719,10.907,7173,1.969,21.814,341,342,4890
1985,3331,3036,3404,237790,242074,332,9.705,366,10.699,28234,8174,20060,3.377,11.663,36954,11219,25735,4.635,15.266,-8720,-3.602,23.327,238,238,2946
1985,3332,3756,4016,173660,172576,400,10.052,327,8.217,25745,8082,17663,4.683,14.918,23595,10964,12631,6.353,13.672,2150,1.246,27.344,225,226,3179
1985,3333,2054,2169,159563,158220,217,10.079,185,8.593,20767,6001,14766,3.793,13.125,17821,8384,9437,5.299,11.263,2946,1.862,22.527,121,122,2045
1985,3334,1749,1962,167129,165764,194,9.855,207,10.516,23519,6728,16791,4.059,14.188,20800,8664,12136,5.227,12.548,2719,1.640,25.096,145,145,3547
1985,3335,9597,10008,247890,238590,875,8.843,649,6.559,43066,12462,30604,5.223,18.050,24510,10724,13786,4.495,10.273,18556,7.777,20.546,486,486,4327
1985,3336,741,908,145663,147948,60,6.637,52,5.752,11688,3667,8021,2.479,7.900,16440,4748,11692,3.209,11.112,-4752,-3.212,15.800,30,30,553
1985,3339,5885,6461,329976,325414,564,8.745,541,8.388,46663,15533,31130,4.773,14.340,37681,17042,20639,5.237,11.579,8982,2.760,23.159,364,366,5690
1985,3341,1653,1851,360656,356920,317,17.456,247,13.601,56167,11436,44731,3.204,15.737,48149,14490,33659,4.060,13.490,8018,2.246,26.980,176,177,4451
1985,3342,1843,2061,302087,294655,236,11.594,185,9.089,54328,16904,37424,5.737,18.438,40053,14431,25622,4.898,13.593,14275,4.845,27.186,125,128,3642
1985,3343,373,397,45855,46996,40,9.901,54,13.366,4420,898,3522,1.911,9.405,6488,1740,4748,3.702,13.806,-2068,-4.400,18.810,42,42,988
1985,3344,4591,5198,550699,544265,876,17.516,482,9.638,84575,24295,60280,4.464,15.539,71844,25727,46117,4.727,13.200,12731,2.339,26.400,337,339,8020
1985,3345,4176,4753,689423,674197,569,12.244,357,7.682,87228,22402,64826,3.323,12.938,56811,22866,33945,3.392,8.426,30417,4.512,16.853,206,207,4588
1985,3346,634,659,22192,21589,121,18.716,96,14.849,5605,3553,2052,16.457,25.962,4493,968,3525,4.484,20.812,1112,5.151,41.623,74,74,628
1985,3351,1180,1303,86786,85817,131,10.104,118,9.101,11981,3343,8638,3.895,13.961,9937,3872,6065,4.512,11.579,2044,2.382,23.159,86,87,1622
1985,3352,346,443,116687,121957,34,7.581,45,10.033,6120,796,5324,0.653,5.018,16568,3525,13043,2.890,13.585,-10448,-8.567,10.036,28,28,618
1985,3353,1965,2490,250298,251724,240,9.760,178,7.239,31295,12215,19080,4.853,12.432,33667,12048,21619,4.786,13.375,-2372,-0.942,24.865,98,99,2219
1985,3359,2076,2425,215971,214659,362,15.394,215,9.143,26371,9254,17117,4.311,12.285,23789,9170,14619,4.272,11.082,2582,1.203,22.164,129,130,2244
1985,3361,201,256,285968,277387,47,18.688,38,15.109,62376,36876,25500,13.294,22.487,43647,34561,9086,12.460,15.735,18729,6.752,31.470,27,27,194
1985,3362,1769,1959,113764,111708,277,14.491,182,9.521,23019,10178,12841,9.111,20.606,18912,5928,12984,5.307,16.930,4107,3.677,33.860,135,135,3003
1985,3363,3809,4514,662654,659357,526,11.831,390,8.772,64984,17641,47343,2.675,9.856,58995,18489,40506,2.804,8.947,5989,0.908,17.895,266,269,6342
1985,3364,1273,1533,719862,696151,176,11.698,119,7.910,85924,24323,61601,3.494,12.343,38305,21093,17212,3.030,5.502,47619,6.840,11.005,76,76,1735
1985,3365,164,189,29961,29758,11,5.670,21,10.825,2585,703,1882,2.362,8.687,2181,649,1532,2.181,7.329,404,1.358,14.658,8,9,172
1985,3366,1140,1230,160772,162295,170,13.963,145,11.910,18476,2989,15487,1.842,11.384,21356,5523,15833,3.403,13.159,-2880,-1.775,22.768,97,98,1744
1985,3369,456,466,37747,38190,87,19.205,61,13.466,4810,832,3978,2.179,12.595,5978,2839,3139,7.434,15.653,-1168,-3.058,25.190,45,45,653
1985,3371,12291,12937,385416,379837,2198,17.483,1468,11.677,61059,22082,38977,5.814,16.075,50105,20355,29750,5.359,13.191,10954,2.884,26.382,1161,1169,12915
1985,3372,2638,2781,148892,142793,419,15.556,244,9.059,26711,8079,18632,5.658,18.706,14497,5054,9443,3.539,10.152,12214,8.554,20.305,192,193,2914
1985,3379,1091,1223,41781,41113,150,12.495,105,8.746,6830,2916,3914,7.093,16.613,5548,2132,3416,5.186,13.495,1282,3.118,26.989,85,86,1590
1985,3391,9990,10501,225893,224599,1317,12.585,1244,11.888,31581,12439,19142,5.538,14.061,29051,12541,16510,5.584,12.935,2530,1.126,25.869,889,894,6342
1985,3399,14904,15477,405644,415610,2265,14.859,1798,11.795,61283,20790,40493,5.002,14.745,81288,37367,43921,8.991,19.559,-20005,-4.813,29.491,1396,1401,15012
1985,4231,23091,28185,318354,317264,2694,9.465,3250,11.418,51429,14412,37017,4.543,16.210,49394,24471,24923,7.713,15.569,2035,0.641,31.137,2200,2268,14352
1985,4232,8015,9116,106868,105238,1211,13.410,1040,11.517,20014,5520,14494,5.245,19.018,16917,7976,8941,7.579,16.075,3097,2.943,32.150,786,793,5612
1985,4233,7591,9396,119687,118638,1214,13.035,1049,11.263,21597,6889,14708,5.807,18.204,19560,9089,10471,7.661,16.487,2037,1.717,32.974,793,799,5783
1985,4234,22856,31320,564882,538412,4985,16.257,3671,11.972,131737,52728,79009,9.793,24.468,79630,42281,37349,7.853,14.790,52107,9.678,29.580,2365,2423,14925
1985,4235,6572,8851,132881,129715,1016,11.515,960,10.881,23374,8253,15121,6.362,18.020,17092,7809,9283,6.020,13.177,6282,4.843,26.353,566,582,4188
1985,4236,14904,21757,314441,307071,2867,13.357,2282,10.632,67748,26200,41548,8.532,22.063,53224,24354,28870,7.931,17.333,14524,4.730,34.666,1428,1478,11884
1985,4237,10828,14263,159713,157942,1351,9.523,1199,8.451,24373,7051,17322,4.464,15.432,20830,10179,10651,6.445,13.188,3543,2.243,26.377,857,875,6372
1985,4238,46635,60618,645472,640365,5703,9.405,5748,9.479,102801,31608,71193,4.936,16.054,92540,38298,54242,5.981,14.451,10261,1.602,28.902,3766,3865,23464
1985,4239,22949,24439,229635,226833,3998,16.599,3293,13.672,47193,16722,30471,7.372,20.805,41575,18295,23280,8.065,18.328,5618,2.477,36.657,2569,2587,13144
1985,4241,8007,10685,155237,150001,1066,10.088,831,7.864,27547,8741,18806,5.827,18.365,16846,6280,10566,4.187,11.231,10701,7.134,22.461,581,587,3811
1985,4242,2740,3517,96014,97381,527,15.122,463,13.286,13626,4270,9356,4.385,13.993,16384,7625,8759,7.830,16.825,-2758,-2.832,27.985,346,346,4260
1985,4243,11055,11964,133989,132144,1892,15.928,1721,14.488,30785,11264,19521,8.524,23.297,27222,10578,16644,8.005,20.600,3563,2.696,41.201,1346,1360,7172
1985,4244,27138,33244,620449,616103,3747,11.251,3866,11.608,104282,30460,73822,4.944,16.926,95246,41672,53574,6.764,15.459,9036,1.467,30.919,2846,2896,24152
1985,4245,7889,10831,95152,96820,639,5.783,1077,9.747,13596,4398,9198,4.542,14.043,17003,6821,10182,7.045,17.562,-3407,-3.519,28.085,705,759,4750
1985,4246,7012,10432,121746,120552,1199,11.650,918,8.920,23135,7393,15742,6.133,19.191,20429,5643,14786,4.681,16.946,2706,2.245,33.893,548,564,2916
1985,4247,11041,14360,150119,150173,840,5.718,1502,10.224,25529,6251,19278,4.163,17.000,25689,12107,13582,8.062,17.106,-160,-0.107,33.999,959,987,7107
1985,4248,4443,5518,137755,138533,306,5.480,437,7.827,13565,3170,10395,2.288,9.792,15139,4715,10424,3.404,10.928,-1574,-1.136,19.584,324,329,3162
1985,4249,19937,24137,255751,252123,3270,13.586,3135,13.025,48227,16125,32102,6.396,19.128,41272,18539,22733,7.353,16.370,6955,2.759,32.740,2207,2241,12000
1985,4251,29687,32549,306942,302217,3983,12.391,3174,9.874,57858,18540,39318,6.135,19.145,48578,19138,29440,6.333,16.074,9280,3.071,32.148,2130,2139,11528
1985,4411,37560,38678,884313,860562,4234,10.982,3985,10.336,137402,41712,95690,4.847,15.967,89770,40829,48941,4.744,10.432,47632,5.535,20.863,3232,3253,31987
1985,4412,11167,11614,81698,80429,1402,12.121,1308,11.308,17411,6069,11342,7.546,21.648,14904,6387,8517,7.941,18.531,2507,3.117,37.061,1056,1074,5355
1985,4413,47085,67800,468531,464416,7452,10.986,7521,11.087,91908,38236,53672,8.233,19.790,82131,44736,37395,9.633,17.685,9777,2.105,35.370,3517,3669,16053
1985,4421,21935,26782,218759,215153,3152,11.786,3075,11.498,41389,15054,26335,6.997,19.237,34298,16578,17720,7.705,15.941,7091,3.296,31.883,2314,2416,12250
1985,4422,20373,24597,143176,139445,3808,15.678,3191,13.138,33379,14747,18632,10.576,23.937,25930,12109,13821,8.684,18.595,7449,5.342,37.190,2410,2492,8809
1985,4431,24021,31824,207539,200749,5162,16.130,5517,17.240,54474,23333,31141,11.623,27.135,40820,23597,17223,11.754,20.334,13654,6.802,40.668,3795,4015,17426
1985,4441,56059,71323,715197,700038,6758,9.501,6368,8.953,123926,43226,80700,6.175,17.703,93884,40020,53864,5.717,13.411,30042,4.291,26.823,4675,4786,26007
1985,4442,14801,17848,128907,126293,1956,10.989,1860,10.449,25179,7925,17254,6.275,19.937,19977,8300,11677,6.572,15.818,5202,4.119,31.636,1328,1345,5729
1985,4451,64532,107590,2044897,2002498,11526,10.634,13119,12.104,349344,154301,195043,7.705,17.445,263742,128250,135492,6.405,13.171,85602,4.275,26.341,8795,9062,55503
1985,4452,22997,27747,179899,180421,4021,14.296,4780,16.995,40960,17093,23867,9.474,22.702,41919,20951,20968,11.612,23.234,-959,-0.532,45.405,3631,3725,15559
1985,4453,28387,33640,169069,168538,3623,10.664,4292,12.633,32967,13013,19954,7.721,19.561,31791,13911,17880,8.254,18.863,1176,0.698,37.726,3336,3412,10652
1985,4461,45166,67134,632713,611951,8021,12.175,5518,8.376,119681,55597,64084,9.085,19.557,77412,33342,44070,5.448,12.650,42269,6.907,25.300,3888,4010,22315
1985,4471,92605,124741,816500,801376,14882,11.783,17992,14.246,189149,80294,108855,10.020,23.603,158752,84531,74221,10.548,19.810,30397,3.793,39.620,12220,12612,53767
1985,4481,55436,96317,838624,814465,11693,12.047,13175,13.574,192967,75179,117788,9.230,23.692,145724,69766,75958,8.566,17.892,47243,5.800,35.784,8358,8843,38715
1985,4482,12053,36507,196479,196162,4138,11.389,3790,10.431,40314,19680,20634,10.033,20.551,40233,14123,26110,7.200,20.510,81,0.041,41.020,1802,1971,7319
1985,4483,18344,25973,152035,150275,3150,12.169,2975,11.493,29335,12495,16840,8.315,19.521,25703,11545,14158,7.683,17.104,3632,2.417,34.208,1962,2325,8777
1985,4511,31679,40333,266359,266017,5898,14.254,7987,19.303,59217,26626,32591,10.009,22.261,57179,32557,24622,12.239,21.495,2038,0.766,42.989,4577,4753,15600
1985,4512,7885,11774,80206,78578,1536,13.037,1552,13.173,16426,5854,10572,7.450,20.904,13433,6071,7362,7.726,17.095,2993,3.809,34.190,1022,1087,3633
1985,4521,527,9924,1572487,1545892,420,4.253,325,3.291,141772,50667,91105,3.278,9.171,90647,22226,68421,1.438,5.864,51125,3.307,11.727,47,55,2425
1985,4529,12433,24033,372733,362304,2644,10.931,2953,12.209,68791,29262,39529,8.077,18.987,48398,27219,21179,7.513,13.358,20393,5.629,26.717,1792,1828,8128
1985,4531,22372,23705,119497,115524,3543,15.112,3022,12.890,28473,10576,17897,9.155,24.647,20448,9617,10831,8.325,17.700,8025,6.947,35.400,2426,2455,7768
1985,4532,26710,32670,219159,211349,5577,17.372,4445,13.846,51746,23822,27924,11.271,24.484,36029,17140,18889,8.110,17.047,15717,7.437,34.094,3368,3461,12019
1985,4533,9374,11289,56381,54891,1696,14.987,1751,15.473,12786,4996,7790,9.102,23.293,9873,4967,4906,9.049,17.987,2913,5.307,35.973,1397,1410,3832
1985,4539,26682,32130,154239,152169,4843,14.973,5273,16.302,39179,16991,22188,11.166,25.747,35272,18127,17145,11.912,23.179,3907,2.568,46.359,3768,3861,13082
1985,4541,5915,7463,97230,97210,986,13.194,1006,13.462,16572,4799,11773,4.937,17.048,16734,9234,7500,9.499,17.214,-162,-0.167,34.095,763,767,3954
1985,4542,3998,5131,79420,79291,541,10.318,766,14.609,13532,3251,10281,4.100,17.066,13154,6777,6377,8.547,16.590,378,0.477,33.179,447,491,3086
1985,4543,16307,21954,204688,200245,2112,9.595,2227,10.117,41098,11604,29494,5.795,20.524,32125,13125,19000,6.554,16.043,8973,4.481,32.086,1648,1670,8475
1985,4811,1014,2846,290096,275123,310,11.481,18,0.667,48353,4802,43551,1.745,17.575,18777,104,18673,0.038,6.825,29576,10.750,13.650,15,15,98
1985,4812,461,751,21623,19233,179,26.677,19,2.832,5697,1543,4154,8.023,29.622,857,83,774,0.432,4.456,4840,25.166,8.912,16,16,73
1985,4831,370,609,33519,33421,51,8.673,9,1.531,5433,886,4547,2.651,16.256,5302,19,5283,0.057,15.865,131,0.392,31.729,7,7,17
1985,4832,366,432,14615,14352,48,11.679,6,1.460,2463,642,1821,4.473,17.162,2021,31,1990,0.216,14.082,442,3.080,28.164,5,5,26
1985,4841,20791,26052,514208,492370,4600,19.004,907,3.747,93636,27068,66568,5.497,19.017,50269,4808,45461,0.977,10.210,43367,8.808,20.419,767,767,2869
1985,4842,43729,47586,589377,559878,7799,17.612,1190,2.687,119860,37263,82597,6.656,21.408,61329,4306,57023,0.769,10.954,58531,10.454,21.908,944,944,3471
1985,4851,389,413,19250,18711,42,10.606,8,2.020,2348,398,1950,2.127,12.549,1210,29,1181,0.155,6.467,1138,6.082,12.934,8,8,29
1985,4852,345,715,28412,28972,39,5.603,(D),(D),2555,239,2316,0.825,8.819,3645,(D),3644,(D),12.581,-1090,-3.762,17.638,(D),(D),(D)
1985,4853,5037,5091,53316,50989,874,18.503,139,2.943,10830,3739,7091,7.333,21.240,6255,474,5781,0.930,12.267,4575,8.973,24.535,127,127,451
1985,4854,3333,3544,96704,93368,283,8.239,65,1.892,12150,2725,9425,2.919,13.013,5303,390,4913,0.418,5.680,6847,7.333,11.359,56,56,367
1985,4855,605,642,12741,12338,113,19.104,12,2.029,2279,706,1573,5.722,18.472,1473,27,1446,0.219,11.939,806,6.533,23.878,8,8,17
1985,4859,997,1027,16628,15748,206,21.730,48,5.063,3559,1377,2182,8.744,22.600,1785,156,1629,0.991,11.335,1774,11.265,22.670,44,44,148
1985,4861,68,294,10707,10924,10,3.448,(D),(D),443,127,316,1.163,4.055,886,(D),879,(D),8.111,-443,-4.055,8.111,(D),(D),(D)
1985,4862,249,1327,60053,58511,139,11.036,4,0.318,6001,3145,2856,5.375,10.256,3079,93,2986,0.159,5.262,2922,4.994,10.525,3,3,89
1985,4869,64,348,7628,7504,15,4.399,(D),(D),830,82,748,1.093,11.062,555,(D),551,(D),7.397,275,3.665,14.793,0,0,0
1985,4871,202,205,2916,2580,50,27.322,6,3.279,951,271,680,10.504,36.860,282,11,271,0.426,10.930,669,25.930,21.860,5,5,10
1985,4872,682,689,9637,9730,127,18.941,90,13.423,1774,633,1141,6.506,18.233,1897,356,1541,3.659,19.497,-123,-1.264,36.466,74,74,328
1985,4879,52,68,1365,1280,18,29.032,6,9.677,256,82,174,6.409,20.008,83,22,61,1.719,6.487,173,13.521,12.974,5,5,21
1985,4881,2113,2686,62323,58777,441,17.682,57,2.285,14079,6023,8056,10.247,23.953,6820,199,6621,0.339,11.603,7259,12.350,23.207,44,44,163
1985,4882,299,406,8673,8162,62,16.424,5,1.325,1731,738,993,9.042,21.208,720,10,710,0.123,8.821,1011,12.387,17.643,(D),(D),(D)
1985,4883,2050,2443,93287,93299,294,12.694,40,1.727,19869,5142,14727,5.511,21.296,19703,239,19464,0.256,21.118,166,0.178,42.236,33,33,214
1985,4884,1469,2010,31429,31342,329,16.251,358,17.683,5690,1573,4117,5.019,18.155,5465,1473,3992,4.700,17.437,225,0.718,34.873,309,309,1201
1985,4885,5484,7418,92476,86727,1270,18.475,182,2.648,20719,7306,13413,8.424,23.890,9285,860,8425,0.992,10.706,11434,13.184,21.412,148,148,697
1985,4889,398,399,4510,4224,86,23.025,35,9.371,1171,452,719,10.701,27.723,603,99,504,2.344,14.276,568,13.447,28.551,29,29,86
1985,4921,1343,2253,115842,109232,484,23.587,82,3.996,19648,3999,15649,3.661,17.987,6345,1523,4822,1.394,5.809,13303,12.179,11.618,70,70,302
1985,4922,1546,1588,11727,9861,621,46.957,90,6.805,4856,3260,1596,33.060,49.244,1166,278,888,2.819,11.824,3690,37.420,23.649,73,73,187
1985,4931,6261,9792,402239,391302,919,9.436,813,8.348,68686,21562,47124,5.510,17.553,47011,15876,31135,4.057,12.014,21675,5.539,24.028,363,372,3655
1985,5111,13914,15962,659564,644292,2194,14.023,1561,9.977,80742,25689,55053,3.987,12.532,49786,23347,26439,3.624,7.727,30956,4.805,15.454,1216,1229,11657
1985,5112,6862,8049,155383,153019,1168,14.168,1558,18.899,36478,8069,28409,5.273,23.839,31834,15368,16466,10.043,20.804,4644,3.035,41.608,1075,1086,7414
1985,5121,9367,14426,221035,213464,2332,16.271,2144,14.960,79060,44284,34776,20.745,37.037,67527,38462,29065,18.018,31.634,11533,5.403,63.268,1325,1382,8681
1985,5122,1913,1919,13164,12567,546,30.199,324,17.920,4571,2249,2322,17.897,36.374,3421,1286,2135,10.234,27.223,1150,9.151,54.446,252,252,1046
1985,5151,6245,7376,230427,219805,931,13.388,87,1.251,35923,18615,17308,8.469,16.343,14755,879,13876,0.400,6.713,21168,9.630,13.426,71,71,761
1985,5152,10,10,498,290,4,44.444,(D),(D),433,417,16,143.793,149.310,4,(D),1,(D),1.379,429,147.931,2.759,(D),(D),(D)
1985,5171,2332,14055,816990,825513,2044,15.594,150,1.144,146071,64122,81949,7.768,17.695,163665,1030,162635,0.125,19.826,-17594,-2.131,35.389,131,131,927
1985,5172,716,1622,62950,62149,312,20.752,75,4.988,11857,5150,6707,8.287,19.078,10467,419,10048,0.674,16.842,1390,2.237,33.684,67,67,379
1985,5174,712,1326,57337,52487,248,20.521,13,1.076,16093,8873,7220,16.905,30.661,6311,48,6263,0.091,12.024,9782,18.637,24.048,9,9,35
1985,5179,1395,2769,80155,75861,542,21.251,105,4.117,20611,8547,12064,11.267,27.169,12522,500,12022,0.659,16.507,8089,10.663,33.013,95,95,440
1985,5182,5911,7869,257119,245852,1295,16.573,1185,15.165,66166,25534,40632,10.386,26.913,42470,22667,19803,9.220,17.275,23696,9.638,34.549,702,715,8388
1985,5191,2338,2779,34890,32797,383,14.141,242,8.935,7264,2421,4843,7.382,22.148,3007,1238,1769,3.775,9.169,4257,12.980,18.337,183,183,991
1985,5211,42,81,24895,24722,6,7.643,(D),(D),867,244,623,0.987,3.507,523,(D),522,(D),2.116,344,1.391,4.231,(D),(D),(D)
1985,5221,20183,70188,1927753,1882695,4132,6.047,424,0.620,242443,61194,181249,3.250,12.877,151571,6033,145538,0.320,8.051,90872,4.827,16.101,398,398,5903
1985,5222,21829,39471,398065,377431,3694,9.738,616,1.624,80150,29568,50582,7.834,21.236,38844,3494,35350,0.926,10.292,41306,10.944,20.583,511,512,3001
1985,5223,3674,4122,53624,50677,1006,26.741,286,7.602,15047,6006,9041,11.852,29.692,8860,1566,7294,3.090,17.483,6187,12.209,34.967,271,271,1223
1985,5231,6140,12380,288692,279750,2110,18.385,304,2.649,49940,16704,33236,5.971,17.852,31867,1942,29925,0.694,11.391,18073,6.460,22.782,261,261,1867
1985,5232,119,134,6747,6545,16,12.698,0,0.000,748,127,621,1.941,11.429,328,0,328,0.000,5.012,420,6.418,10.024,0,0,0
1985,5239,13846,14266,188886,169874,3021,23.083,664,5.074,58193,21543,36650,12.682,34.257,20737,3316,17421,1.952,12.207,37456,22.049,24.415,504,504,2503
1985,5241,6519,29956,1275927,1235095,2518,8.746,189,0.656,181136,47923,133213,3.880,14.666,100348,1446,98902,0.117,8.125,80788,6.541,16.249,179,179,1430
1985,5242,95672,100433,692353,636675,12869,13.525,2308,2.426,178269,62464,115805,9.811,28.000,67166,9163,58003,1.439,10.550,111103,17.451,21.099,1798,1798,6374
1985,5250,1866,2115,20558,18032,298,15.024,35,1.765,6867,2794,4073,15.495,38.083,1768,125,1643,0.693,9.805,5099,28.278,19.610,20,20,90
1985,5311,94610,97096,509937,477907,13902,15.175,2933,3.202,125246,57787,67459,12.092,26.207,61180,9532,51648,1.995,12.802,64066,13.406,25.603,2458,2461,7821
1985,5312,35382,37048,206426,193049,6909,20.081,1623,4.717,56477,22880,33597,11.852,29.255,29946,5044,24902,2.613,15.512,26531,13.743,31.024,1353,1353,4230
1985,5313,22270,23191,247670,228146,4537,21.155,1048,4.887,65306,25934,39372,11.367,28.625,26561,3606,22955,1.581,11.642,38745,16.983,23.284,902,902,3110
1985,5321,5795,9327,122819,116501,1401,15.201,1180,12.803,29800,9654,20146,8.287,25.579,17286,7436,9850,6.383,14.838,12514,10.742,29.675,732,760,3939
1985,5322,13798,16948,146266,138610,5245,33.796,2388,15.387,45445,22753,22692,16.415,32.786,30516,14282,16234,10.304,22.016,14929,10.771,44.032,1600,1625,8230
1985,5323,3200,3970,29362,27690,833,22.043,451,11.934,8635,3881,4754,14.016,31.185,5316,2390,2926,8.631,19.199,3319,11.986,38.397,284,284,1226
1985,5324,6195,7463,78213,75112,1456,20.508,729,10.268,20981,8390,12591,11.170,27.933,15129,5862,9267,7.804,20.142,5852,7.791,40.284,441,443,2284
1985,5331,924,962,11972,11195,163,18.192,31,3.460,3104,1202,1902,10.737,27.728,1525,95,1430,0.849,13.623,1579,14.105,27.246,27,27,82
1985,5411,123693,127375,736793,715912,15516,12.281,13458,10.652,139619,46852,92767,6.544,19.502,97060,45138,51922,6.305,13.558,42559,5.945,27.115,10165,10232,35172
1985,5412,56496,59413,450389,431555,10231,17.625,7500,12.920,96790,36307,60483,8.413,22.428,58954,27605,31349,6.397,13.661,37836,8.767,27.322,5569,5629,20904
1985,5413,53197,58152,768476,736835,10175,18.057,6571,11.661,175236,52370,122866,7.107,23.782,112149,40934,71215,5.555,15.220,63087,8.562,30.441,4803,4837,25904
1985,5414,13249,13459,90610,87803,2743,20.993,1958,14.985,23929,9443,14486,10.755,27.253,18477,8722,9755,9.934,21.044,5452,6.209,42.088,1553,1556,5818
1985,5415,10103,11293,114767,98371,4400,43.382,2099,20.695,52855,35081,17774,35.662,53.730,19972,12128,7844,12.329,20.303,32883,33.428,40.605,1551,1554,6928
1985,5416,37043,38291,309987,293845,10338,28.491,6326,17.434,107223,47920,59303,16.308,36.490,74829,35870,38959,12.207,25.465,32394,11.024,50.931,4979,4993,26772
1985,5417,6126,7413,430628,422117,1173,16.146,877,12.072,60881,18410,42471,4.361,14.423,43516,10506,33010,2.489,10.309,17365,4.114,20.618,556,560,3575
1985,5418,24312,26554,341794,329472,4805,18.603,3355,12.989,79888,27920,51968,8.474,24.247,54862,25698,29164,7.800,16.652,25026,7.596,33.303,2624,2645,17959
1985,5419,28561,31873,219196,212928,4222,13.618,2481,8.003,50700,17256,33444,8.104,23.811,38172,11379,26793,5.344,17.927,12528,5.884,35.854,1933,1945,7724
1985,5511,23728,43776,2971387,2888703,4275,9.882,3241,7.492,550797,158827,391970,5.498,19.067,387705,116168,271537,4.021,13.421,163092,5.646,26.843,522,535,6957
1985,5611,9996,10527,156840,146564,2238,21.816,1701,16.581,48086,17514,30572,11.950,32.809,27367,12287,15080,8.383,18.672,20719,14.136,37.345,1349,1355,9115
1985,5612,173,210,19974,16041,71,37.566,29,15.344,9374,2085,7289,12.998,58.438,1870,1301,569,8.110,11.658,7504,46.780,23.315,22,22,1048
1985,5613,13150,17359,933941,832667,3469,20.888,1967,11.844,341311,83711,257600,10.053,40.990,137924,37302,100622,4.480,16.564,203387,24.426,33.128,1449,1470,25671
1985,5614,18574,20935,225100,217238,3517,17.115,2745,13.358,51314,18038,33276,8.303,23.621,35331,14352,20979,6.607,16.264,15983,7.357,32.528,2183,2201,10296
1985,5615,21324,24824,191571,183627,3730,15.398,2531,10.448,44189,14253,29936,7.762,24.065,28305,13919,14386,7.580,15.414,15884,8.650,30.829,1863,1933,10257
1985,5616,11080,13506,425755,413730,2381,18.019,1797,13.599,103419,26319,77100,6.361,24.997,80010,26267,53743,6.349,19.339,23409,5.658,38.677,1356,1357,14223
1985,5617,60724,63980,836442,791409,14934,24.582,8480,13.958,236273,82777,153496,10.459,29.855,146417,53832,92585,6.802,18.501,89856,11.354,37.002,6819,6842,38201
1985,5619,12162,13021,182969,174445,2424,19.156,1690,13.355,46399,14095,32304,8.080,26.598,29616,11104,18512,6.365,16.977,16783,9.621,33.955,1290,1296,7441
1985,5621,3926,4028,94851,90446,447,11.600,98,2.543,14025,2884,11141,3.189,15.507,5291,487,4804,0.538,5.850,8734,9.657,11.700,87,87,467
1985,5622,2020,2599,51636,47694,274,11.062,30,1.211,11695,3689,8006,7.735,24.521,3889,115,3774,0.241,8.154,7806,16.367,16.308,25,25,105
1985,5629,4465,4733,42081,40201,766,16.736,454,9.919,11474,4111,7363,10.226,28.542,7714,2622,5092,6.522,19.189,3760,9.353,38.377,347,347,2029
1985,6111,13047,13456,379029,369711,642,4.879,46,0.350,39913,6379,33534,1.725,10.796,21187,278,20909,0.075,5.731,18726,5.065,11.461,32,32,207
1985,6112,416,522,36398,35424,42,8.350,4,0.795,4571,833,3738,2.352,12.904,2607,12,2595,0.034,7.360,1964,5.544,14.719,(D),(D),(D)
1985,6113,2006,2322,908795,897028,92,4.039,4,0.176,84544,2341,82203,0.261,9.425,60985,45,60940,0.005,6.799,23559,2.626,13.597,(D),(D),(D)
1985,6114,2061,2383,40634,38146,499,21.696,333,14.478,10433,3419,7014,8.963,27.351,5536,2107,3429,5.524,14.513,4897,12.838,29.026,257,258,1368
1985,6115,3167,3643,45450,48123,574,16.049,441,12.330,10372,3665,6707,7.616,21.553,15356,11681,3675,24.273,31.910,-4984,-10.357,43.106,310,313,1768
1985,6116,10627,11122,90265,89744,2115,19.052,2073,18.674,21691,9390,12301,10.463,24.170,20623,8828,11795,9.837,22.980,1068,1.190,45.960,1647,1661,6599
1985,6117,1478,1498,18053,17768,310,21.182,241,16.467,3484,1622,1862,9.129,19.609,2830,1278,1552,7.193,15.928,654,3.681,31.856,184,184,852
1985,6211,181222,187324,1118274,1092283,15133,8.114,13511,7.244,204380,65112,139268,5.961,18.711,152682,55978,96704,5.125,13.978,51698,4.733,27.956,10974,11078,43175
1985,6212,95508,97685,462343,451882,6534,6.726,5450,5.610,78822,22728,56094,5.030,17.443,58149,20025,38124,4.431,12.868,20673,4.575,25.736,4260,4333,16085
1985,6213,44271,46084,159690,152485,6992,15.582,4568,10.180,41755,18419,23336,12.079,27.383,27314,13534,13780,8.876,17.913,14441,9.470,35.825,3432,3495,11039
1985,6214,5905,7630,124484,116451,1287,17.457,772,10.471,31078,14106,16972,12.113,26.688,14991,8142,6849,6.992,12.873,16087,13.814,25.747,552,563,5489
1985,6215,4364,5328,69645,69796,796,15.069,705,13.346,14642,5228,9414,7.490,20.978,14667,9300,5367,13.325,21.014,-25,-0.036,41.957,475,501,4862
1985,6216,4422,5771,222194,208663,1293,23.703,661,12.117,66108,23559,42549,11.290,31.682,38852,14261,24591,6.834,18.619,27256,13.062,37.239,441,456,7200
1985,6219,4149,4802,90876,84761,996,22.160,381,8.477,26531,12029,14502,14.192,31.301,13986,5828,8158,6.876,16.501,12545,14.801,33.001,237,243,2732
1985,6221,3570,4832,3087085,3028022,256,5.435,12,0.255,379529,250876,128653,8.285,12.534,267481,1311,266170,0.043,8.834,112048,3.700,17.667,10,10,1269
1985,6222,381,545,279237,251307,69,13.450,5,0.975,111409,87806,23603,34.940,44.332,52355,28163,24192,11.207,20.833,59054,23.499,41.666,3,3,124
1985,6223,196,232,68500,63470,13,5.752,(D),(D),11881,8409,3472,13.249,18.719,2336,(D),2335,(D),3.680,9545,15.039,7.361,(D),(D),(D)
1985,6231,6755,10126,856688,833252,828,8.272,595,5.944,119850,49468,70382,5.937,14.383,73245,34175,39070,4.101,8.790,46605,5.593,17.581,406,420,24313
1985,6232,4541,6132,143547,135822,857,14.537,384,6.513,28520,10911,17609,8.033,20.998,12940,4470,8470,3.291,9.527,15580,11.471,19.054,285,286,3146
1985,6233,8976,10802,391965,390102,1429,13.351,1232,11.510,61443,25292,36151,6.483,15.751,57590,32748,24842,8.395,14.763,3853,0.988,29.526,875,892,24174
1985,6239,2838,3500,84185,80938,373,10.918,206,6.030,14107,4076,10031,5.036,17.429,7686,3359,4327,4.150,9.496,6421,7.933,18.992,142,143,2402
1985,6241,14161,19228,276139,268818,2055,10.880,1373,7.270,47400,12318,35082,4.582,17.633,32463,12739,19724,4.739,12.076,14937,5.557,24.152,882,900,8953
1985,6242,4128,4813,42383,41152,528,11.171,355,7.511,7473,2251,5222,5.470,18.160,4918,1657,3261,4.027,11.951,2555,6.209,23.902,229,229,1129
1985,6243,3943,5645,245605,237792,527,9.448,393,7.046,47136,7337,39799,3.085,19.822,31705,8161,23544,3.432,13.333,15431,6.489,26.666,245,248,5231
1985,6244,30450,35841,325022,310771,5337,15.237,3706,10.581,71836,29228,42608,9.405,23.115,43202,19034,24168,6.125,13.902,28634,9.214,27.803,2945,2974,14532
1985,7111,4941,4991,67361,66953,908,18.206,901,18.065,18385,5059,13326,7.556,27.460,17470,8040,9430,12.009,26.093,915,1.367,52.186,684,686,6717
1985,7112,2148,2248,65358,63924,423,18.973,386,17.313,19201,5511,13690,8.621,30.037,16273,6608,9665,10.337,25.457,2928,4.580,50.914,314,315,4741
1985,7113,2168,2209,32925,31864,413,18.893,367,16.789,10936,3449,7487,10.824,34.321,8695,2351,6344,7.378,27.288,2241,7.033,54.576,274,274,1446
1985,7114,1007,1020,11144,11272,206,20.437,182,18.056,3780,1396,2384,12.385,33.534,4012,2233,1779,19.810,35.593,-232,-2.058,67.069,150,151,1957
1985,7115,9745,9771,60049,55966,3364,37.428,1798,20.004,29872,20411,9461,36.471,53.376,21761,12270,9491,21.924,38.883,8111,14.493,77.766,1394,1394,11099
1985,7121,2235,2386,38579,37362,253,10.844,147,6.301,5713,1023,4690,2.738,15.291,3266,867,2399,2.321,8.742,2447,6.549,17.483,96,96,461
1985,7131,1663,2102,55548,57001,277,12.352,558,24.883,10120,1366,8754,2.396,17.754,12933,3236,9697,5.677,22.689,-2813,-4.935,35.508,432,451,2090
1985,7132,720,746,22338,20911,141,19.275,112,15.311,5483,2786,2697,13.323,26.221,2490,720,1770,3.443,11.908,2993,14.313,23.816,98,98,629
1985,7139,32557,34672,505594,492995,4754,13.871,3957,11.545,102454,35237,67217,7.148,20.782,77168,28061,49107,5.692,15.653,25286,5.129,31.306,3006,3029,21232
1985,7211,28965,33528,1202468,1174294,4568,13.633,4528,13.513,249107,123670,125437,10.531,21.213,193133,93716,99417,7.981,16.447,55974,4.767,32.893,3322,3378,59963
1985,7212,3692,3956,24290,23018,565,14.377,513,13.053,7309,3084,4225,13.398,31.753,4836,1821,3015,7.911,21.010,2473,10.744,42.019,370,374,1277
1985,7213,4479,4585,24084,23322,303,6.501,455,9.762,5047,2370,2677,10.162,21.641,3592,1495,2097,6.410,15.402,1455,6.239,30.804,326,326,1089
1985,7223,16829,26025,488016,490915,4669,17.704,5364,20.339,134212,66311,67901,13.508,27.339,138033,86428,51605,17.606,28.118,-3821,-0.778,54.678,2769,2871,26939
1985,7224,55056,55809,320884,322695,8349,14.624,10910,19.110,86773,45264,41509,14.027,26.890,90517,46620,43897,14.447,28.050,-3744,-1.160,53.780,8904,8937,37934
1985,7225,194982,254282,4639699,4516117,44563,17.701,39509,15.693,1144246,628343,515903,13.913,25.337,895907,436923,458984,9.675,19.838,248339,5.499,39.676,29977,30747,286093
1985,8111,102136,106895,534934,514206,18315,17.443,14529,13.837,137489,61665,75824,11.992,26.738,96422,47658,48764,9.268,18.752,41067,7.986,37.503,11500,11597,38132
1985,8112,9915,11247,79099,76204,1781,16.048,1483,13.363,19153,7656,11497,10.047,25.134,13530,5661,7869,7.429,17.755,5623,7.379,35.510,1131,1142,3840
1985,8113,18626,19569,149504,147077,3042,15.788,2439,12.659,34421,12463,21958,8.474,23.403,29838,12426,17412,8.449,20.287,4583,3.116,40.575,1880,1883,8774
1985,8114,23746,25328,153727,150948,4376,17.408,3995,15.893,31718,13208,18510,8.750,21.013,25991,13207,12784,8.749,17.219,5727,3.794,34.437,3046,3058,8697
1985,8121,80069,89213,472724,464327,13035,14.540,13905,15.511,108193,49763,58430,10.717,23.301,91505,45832,45673,9.871,19.707,16688,3.594,39.414,11176,11332,36246
1985,8122,17272,19998,115970,114803,1438,7.219,1284,6.445,17205,5151,12054,4.487,14.987,14918,4275,10643,3.724,12.994,2287,1.992,25.989,909,932,3324
1985,8123,32294,38146,346056,342223,4709,12.305,4953,12.943,58941,21517,37424,6.287,17.223,51281,26903,24378,7.861,14.985,7660,2.238,29.969,3824,3949,20652
1985,8129,13021,20107,202229,198187,3809,19.514,2633,13.489,49880,19364,30516,9.771,25.168,41297,16084,25213,8.116,20.837,8583,4.331,41.675,1604,1688,9505
1985,8131,119818,119917,941621,910138,11009,9.556,1588,1.378,143095,29915,113180,3.287,15.722,81018,3505,77513,0.385,8.902,62077,6.821,17.803,246,246,576
1985,8132,7494,8515,113079,110344,851,10.209,492,5.902,19074,4671,14403,4.233,17.286,13909,4165,9744,3.775,12.605,5165,4.681,25.210,357,364,3051
1985,8133,7110,8216,92521,89973,841,10.281,770,9.413,18048,4467,13581,4.965,20.059,13053,4888,8165,5.433,14.508,4995,5.552,29.016,520,534,3552
1985,8134,28109,29473,258400,256617,2030,6.802,2772,9.288,36402,7739,28663,3.016,14.185,32667,9270,23397,3.612,12.730,3735,1.455,25.460,1642,1642,5779
1985,8139,54689,56901,449347,433072,4609,8.265,2335,4.187,92384,24221,68163,5.593,21.332,59625,13160,46465,3.039,13.768,32759,7.564,27.536,1616,1621,10487
1986,2111,7857,9645,152345,158953,1104,11.253,1436,14.637,24231,7654,16577,4.815,15.244,37712,11183,26529,7.035,23.725,-13481,-8.481,30.488,980,990,4319
1986,2121,2568,3191,168384,170944,486,14.924,617,18.947,28323,8990,19333,5.259,16.569,33376,13728,19648,8.031,19.525,-5053,-2.956,33.137,412,413,5093
1986,2122,457,598,35191,37961,92,14.887,132,21.359,5492,2098,3394,5.527,14.468,11148,3847,7301,10.134,29.367,-5656,-14.900,28.935,81,81,982
1986,2123,3555,5066,102781,104285,456,8.982,478,9.415,15359,4891,10468,4.690,14.728,18502,7343,11159,7.041,17.742,-3143,-3.014,29.456,269,272,1883
1986,2131,10225,11858,236413,262700,1445,11.768,2288,18.633,43896,20195,23701,7.687,16.710,96037,23695,72342,9.020,36.558,-52141,-19.848,33.419,1685,1701,14863
1986,2211,1618,5821,596881,592348,254,4.449,30,0.525,39265,12815,26450,2.163,6.629,29576,216,29360,0.036,4.993,9689,1.636,9.986,26,26,212
1986,2212,529,2365,134779,134718,92,3.963,5,0.215,6616,1341,5275,0.995,4.911,6407,11,6396,0.008,4.756,209,0.155,9.512,5,5,11
1986,2213,3659,3935,31601,30642,288,7.532,65,1.700,3922,1339,2583,4.370,12.799,1961,167,1794,0.545,6.400,1961,6.400,12.799,54,54,150
1986,2361,99005,99366,597440,578711,22043,22.779,16853,17.415,208165,85572,122593,14.787,35.970,170572,69317,101255,11.978,29.474,37593,6.496,58.949,12037,12044,51746
1986,2362,37284,37938,684653,672222,5904,15.735,5071,13.515,191549,45366,146183,6.749,28.495,166382,41792,124590,6.217,24.751,25167,3.744,49.502,3771,3772,28964
1986,2371,13073,13400,305211,312646,1535,11.470,1501,11.216,62009,11770,50239,3.765,19.834,76315,15041,61274,4.811,24.409,-14306,-4.576,39.667,1099,1099,8497
1986,2372,9668,9809,89546,87458,2550,26.900,1891,19.948,31240,15614,15626,17.853,35.720,26955,11467,15488,13.112,30.821,4285,4.900,61.641,1490,1493,8850
1986,2373,10274,10569,231444,223601,1272,12.156,1062,10.149,63331,12351,50980,5.524,28.323,47199,9052,38147,4.048,21.109,16132,7.215,42.217,758,760,5620
1986,2379,4987,5074,75891,75259,896,17.831,798,15.881,24299,5271,19028,7.004,32.287,23051,6780,16271,9.009,30.629,1248,1.658,61.258,572,573,2992
1986,2381,70236,70617,691592,670058,12316,17.833,9205,13.329,215031,64169,150862,9.577,32.091,172091,53078,119013,7.921,25.683,42940,6.408,51.366,6753,6763,40818
1986,2382,109597,111278,1150228,1130597,16439,15.070,12055,11.051,272217,70134,202083,6.203,24.077,232745,71815,160930,6.352,20.586,39472,3.491,41.172,9060,9074,49880
1986,2383,72622,73054,631339,613828,14759,20.734,11018,15.478,194691,63552,131139,10.353,31.718,159802,54269,105533,8.841,26.034,34889,5.684,52.067,8051,8056,41801
1986,2389,37450,37700,360191,352597,6348,17.129,5069,13.678,102973,35292,67681,10.009,29.204,87902,27251,60651,7.729,24.930,15071,4.274,49.860,3723,3723,19763
1986,3111,1655,2285,56158,56174,151,6.627,138,6.057,7505,2841,4664,5.058,13.360,7517,1594,5923,2.838,13.382,-12,-0.021,26.721,78,78,635
1986,3112,502,855,66769,67042,45,5.236,54,6.283,5255,1629,3626,2.430,7.838,5862,1150,4712,1.715,8.744,-607,-0.905,15.677,33,33,314
1986,3113,1515,1833,81136,83489,287,15.931,224,12.434,10049,3835,6214,4.593,12.036,14957,6569,8388,7.868,17.915,-4908,-5.879,24.073,143,143,1018
1986,3114,1205,1670,181866,181238,127,7.578,139,8.294,22602,6502,16100,3.588,12.471,21593,5145,16448,2.839,11.914,1009,0.557,23.828,91,92,2074
1986,3115,1670,2334,132581,133545,150,6.318,230,9.688,15704,5386,10318,4.033,11.759,17664,9060,8604,6.784,13.227,-1960,-1.468,23.519,144,145,1988
1986,3116,3960,4540,337233,328644,334,7.336,360,7.907,45283,13845,31438,4.213,13.779,28033,9618,18415,2.927,8.530,17250,5.249,17.060,253,254,3781
1986,3117,724,819,41258,40579,80,9.756,82,10.000,7665,3415,4250,8.416,18.889,6366,1569,4797,3.867,15.688,1299,3.201,31.376,44,47,814
1986,3118,8928,10424,298399,302483,1461,14.067,1385,13.335,41957,16260,25697,5.376,13.871,49542,15916,33626,5.262,16.378,-7585,-2.508,27.742,1031,1051,7875
1986,3119,2046,2403,123369,121826,225,9.361,226,9.403,16097,3601,12496,2.956,13.213,13197,4444,8753,3.648,10.833,2900,2.380,21.665,161,161,2189
1986,3121,1903,2414,160983,163196,193,7.939,227,9.338,18143,6114,12029,3.746,11.117,22709,10219,12490,6.262,13.915,-4566,-2.798,22.235,133,135,2855
1986,3122,108,148,37548,39260,3,1.961,13,8.497,1751,15,1736,0.038,4.460,5188,1714,3474,4.366,13.214,-3437,-8.754,8.920,5,5,199
1986,3131,413,639,104229,101863,47,7.321,53,8.255,15199,7820,7379,7.677,14.921,10305,3746,6559,3.677,10.117,4894,4.804,20.233,27,27,1076
1986,3132,1622,1988,259353,262924,166,8.265,207,10.306,27395,12796,14599,4.867,10.419,35032,12973,22059,4.934,13.324,-7637,-2.905,20.839,141,142,2398
1986,3133,1563,1826,104362,103671,159,8.708,159,8.708,14413,5361,9052,5.171,13.903,12958,4706,8252,4.539,12.499,1455,1.403,24.998,110,111,1449
1986,3141,3858,4156,125133,124837,516,12.362,552,13.225,17280,5255,12025,4.209,13.842,16639,5975,10664,4.786,13.329,641,0.513,26.657,426,432,3022
1986,3149,3622,3759,123258,124752,489,12.925,538,14.220,21283,7189,14094,5.763,17.060,24128,12275,11853,9.840,19.341,-2845,-2.281,34.120,439,439,6224
1986,3151,1346,1463,139770,139288,126,8.566,142,9.653,16671,2864,13807,2.056,11.969,15665,7166,8499,5.145,11.246,1006,0.722,22.493,109,109,2568
1986,3152,11427,12847,793760,801539,1834,14.097,2160,16.603,132180,42728,89452,5.331,16.491,147026,64082,82944,7.995,18.343,-14846,-1.852,32.982,1761,1768,38999
1986,3159,1846,1932,73440,75437,239,12.107,323,16.363,10017,2336,7681,3.097,13.279,13710,5058,8652,6.705,18.174,-3693,-4.895,26.557,278,278,3607
1986,3161,343,376,14693,15212,38,9.922,52,13.577,2332,1158,1174,7.613,15.331,3324,1902,1422,12.504,21.852,-992,-6.521,30.661,43,45,1383
1986,3162,411,572,89725,94921,39,6.571,82,13.816,9073,3633,5440,3.827,9.558,19358,7716,11642,8.129,20.394,-10285,-10.835,19.117,49,51,1872
1986,3169,1154,1204,40555,42402,87,6.963,178,14.246,4815,1282,3533,3.023,11.356,8496,2824,5672,6.660,20.037,-3681,-8.681,22.711,141,141,1528
1986,3211,4647,5142,137219,137314,487,9.287,691,13.177,20777,7259,13518,5.286,15.131,20786,8495,12291,6.187,15.138,-9,-0.007,30.262,504,505,4411
1986,3212,1156,1410,88918,87371,156,11.191,124,8.895,12149,4686,7463,5.363,13.905,8959,3761,5198,4.305,10.254,3190,3.651,20.508,82,82,1308
1986,3219,8909,9626,280002,277064,1123,11.683,1096,11.402,50208,15995,34213,5.773,18.121,44534,18498,26036,6.676,16.074,5674,2.048,32.147,820,825,8422
1986,3221,229,555,199193,199189,27,4.830,35,6.261,15144,8798,6346,4.417,7.603,15416,6988,8428,3.508,7.739,-272,-0.137,15.206,14,14,294
1986,3222,3603,5193,398203,399322,355,6.837,353,6.799,41604,11683,29921,2.926,10.419,43129,19498,23631,4.883,10.801,-1525,-0.382,20.837,193,196,4686
1986,3231,38078,39730,764517,754826,4625,11.803,3538,9.029,105448,30159,75289,3.995,13.970,86054,30660,55394,4.062,11.401,19394,2.569,22.801,2807,2816,20528
1986,3241,1394,2308,210442,220782,215,9.303,221,9.563,10416,2440,7976,1.105,4.718,31319,6779,24540,3.070,14.185,-20903,-9.468,9.436,112,112,789
1986,3251,1139,2291,233284,237353,199,8.686,199,8.686,22831,9885,12946,4.165,9.619,30720,11265,19455,4.746,12.943,-7889,-3.324,19.238,74,75,1085
1986,3252,378,619,127725,132857,50,8.130,42,6.829,6622,3066,3556,2.308,4.984,16781,3712,13069,2.794,12.631,-10159,-7.647,9.969,13,13,135
1986,3253,665,994,44725,46112,70,6.938,100,9.911,4689,1723,2966,3.737,10.169,7463,2317,5146,5.025,16.185,-2774,-6.016,20.338,47,48,295
1986,3254,1030,1273,157693,158114,139,11.041,111,8.817,17539,5218,12321,3.300,11.093,18186,9442,8744,5.972,11.502,-647,-0.409,22.185,72,72,4278
1986,3255,1659,2146,76718,76686,166,7.743,162,7.556,9376,3059,6317,3.989,12.226,9301,3706,5595,4.833,12.129,75,0.098,24.257,94,94,683
1986,3256,2067,2307,118865,120850,196,8.468,211,9.116,11040,3648,7392,3.019,9.135,14860,4168,10692,3.449,12.296,-3820,-3.161,18.271,150,150,1606
1986,3259,1831,2424,127526,127375,292,12.228,220,9.213,12087,5740,6347,4.506,9.489,11705,4303,7402,3.378,9.189,382,0.300,18.379,112,117,1577
1986,3261,10314,12050,601370,593421,1122,9.326,1085,9.018,94205,29406,64799,4.955,15.875,78154,27869,50285,4.696,13.170,16051,2.705,26.340,776,783,12523
1986,3262,2006,2371,180574,191855,195,8.186,217,9.110,14957,5372,9585,2.800,7.796,37462,24538,12924,12.790,19.526,-22505,-11.730,15.592,149,149,1700
1986,3271,1320,1599,74035,75363,188,11.728,196,12.227,7507,1675,5832,2.223,9.961,10266,3346,6920,4.440,13.622,-2759,-3.661,19.922,146,146,1505
1986,3272,1570,1841,136923,145224,237,12.859,241,13.077,14702,5221,9481,3.595,10.124,31045,13835,17210,9.527,21.377,-16343,-11.254,20.247,158,159,1714
1986,3273,6763,8955,188703,187420,690,7.703,694,7.748,32471,9217,23254,4.918,17.325,29911,9393,20518,5.012,15.959,2560,1.366,31.919,444,464,4946
1986,3274,237,337,18434,17883,40,11.994,33,9.895,2245,1150,1095,6.431,12.554,1226,378,848,2.114,6.856,1019,5.698,13.712,21,21,51
1986,3279,1883,2180,78685,79354,182,8.295,210,9.572,9268,2629,6639,3.313,11.679,10685,3709,6976,4.674,13.465,-1417,-1.786,23.359,150,154,1762
1986,3311,300,336,109201,114396,56,17.178,36,11.043,5537,3784,1753,3.308,4.840,15764,1879,13885,1.643,13.780,-10227,-8.940,9.680,17,17,60
1986,3312,517,686,59213,60935,58,8.529,46,6.765,5333,2001,3332,3.284,8.752,8969,3146,5823,5.163,14.719,-3636,-5.967,17.504,23,23,378
1986,3313,433,639,114191,117969,42,6.507,55,8.521,7885,3285,4600,2.785,6.684,15327,6358,8969,5.390,12.992,-7442,-6.308,13.368,25,25,2550
1986,3314,691,841,77046,82025,59,6.789,115,13.234,5761,2332,3429,2.843,7.024,15715,7235,8480,8.821,19.159,-9954,-12.135,14.047,67,67,1531
1986,3315,2687,2959,216518,218084,185,6.166,268,8.932,27109,11288,15821,5.176,12.431,30449,12339,18110,5.658,13.962,-3340,-1.532,24.861,174,177,3916
1986,3321,3170,3378,139531,141928,207,6.108,229,6.757,15903,5861,10042,4.130,11.205,20838,6581,14257,4.637,14.682,-4935,-3.477,22.410,139,139,2700
1986,3322,1217,1339,76429,77577,106,7.878,119,8.844,7257,2571,4686,3.314,9.355,9296,3534,5762,4.555,11.983,-2039,-2.628,18.709,83,83,1786
1986,3323,9786,10574,334476,335378,872,8.189,1020,9.579,54048,12105,41943,3.609,16.116,55845,19976,35869,5.956,16.651,-1797,-0.536,32.231,702,708,9012
1986,3324,1419,1773,122691,126119,161,9.027,182,10.205,16595,7016,9579,5.563,13.158,23447,11189,12258,8.872,18.591,-6852,-5.433,26.316,87,91,1613
1986,3325,925,1012,80092,81433,74,7.352,63,6.259,7051,2139,4912,2.627,8.659,9741,3995,5746,4.906,11.962,-2690,-3.303,17.317,46,46,882
1986,3326,1649,1853,65042,66179,160,8.552,196,10.476,9030,2991,6039,4.520,13.645,11312,4643,6669,7.016,17.093,-2282,-3.448,27.290,144,144,1763
1986,3327,21739,22038,342951,345316,2089,9.504,1973,8.976,47068,11481,35587,3.325,13.630,51912,15779,36133,4.569,15.033,-4844,-1.403,27.261,1544,1545,9525
1986,3328,5467,5796,147104,141397,462,7.959,479,8.252,31860,6230,25630,4.406,22.532,20976,5910,15066,4.180,14.835,10884,7.697,29.670,358,360,4088
1986,3329,5616,6135,362210,363910,643,10.513,605,9.892,40134,13315,26819,3.659,11.029,43812,13726,30086,3.772,12.039,-3678,-1.011,22.057,422,422,5344
1986,3331,2901,3242,213259,223999,280,8.457,418,12.625,23853,11533,12320,5.149,10.649,45060,17067,27993,7.619,20.116,-21207,-9.467,21.297,263,265,5708
1986,3332,3734,3997,161957,166785,330,8.258,328,8.208,17366,6256,11110,3.751,10.412,26769,8062,18707,4.834,16.050,-9403,-5.638,20.824,223,223,2615
1986,3333,2070,2185,155902,157978,212,9.772,181,8.343,19669,6175,13494,3.909,12.451,23958,10076,13882,6.378,15.165,-4289,-2.715,24.901,113,113,2290
1986,3334,1696,1921,159751,161325,188,9.716,216,11.163,18894,6737,12157,4.176,11.712,22035,8386,13649,5.198,13.659,-3141,-1.947,23.424,155,155,2865
1986,3335,9606,10004,236529,241271,710,7.105,688,6.885,30877,10617,20260,4.400,12.798,40255,13719,26536,5.686,16.685,-9378,-3.887,25.595,503,504,4711
1986,3336,741,897,139756,141956,59,6.537,70,7.756,14396,9445,4951,6.653,10.141,18420,3679,14741,2.592,12.976,-4024,-2.835,20.282,35,35,345
1986,3339,5857,6441,329665,327368,536,8.326,529,8.217,47848,22203,25645,6.782,14.616,43475,15137,28338,4.624,13.280,4373,1.336,26.560,363,363,4913
1986,3341,1615,1780,311287,332435,251,13.937,293,16.269,30590,8056,22534,2.423,9.202,71877,21349,50528,6.422,21.621,-41287,-12.420,18.404,209,211,4479
1986,3342,1766,1980,276698,288031,178,8.860,236,11.747,32551,15789,16762,5.482,11.301,55041,19076,35965,6.623,19.109,-22490,-7.808,22.602,153,153,3013
1986,3343,367,391,44480,43200,43,11.040,40,10.270,6931,3690,3241,8.542,16.044,4496,664,3832,1.537,10.408,2435,5.637,20.815,28,28,321
1986,3344,4552,5209,518620,533334,668,12.873,628,12.103,62143,32709,29434,6.133,11.652,91544,18757,72787,3.517,17.164,-29401,-5.513,23.304,467,467,6396
1986,3345,4223,4823,690520,687455,446,9.320,371,7.753,70297,17407,52890,2.532,10.226,64234,21477,42757,3.124,9.344,6063,0.882,18.687,222,222,2574
1986,3346,620,644,26066,24772,100,15.456,106,16.383,8301,4149,4152,16.749,33.510,5702,3226,2476,13.023,23.018,2599,10.492,46.036,71,71,323
1986,3351,1193,1320,89127,87883,123,9.343,116,8.811,11710,2357,9353,2.682,13.325,9284,2428,6856,2.763,10.564,2426,2.761,21.128,77,77,717
1986,3352,334,432,116444,115982,30,6.904,35,8.055,9047,1675,7372,1.444,7.800,8233,1451,6782,1.251,7.099,814,0.702,14.197,20,21,501
1986,3353,2009,2516,242154,245702,207,8.272,180,7.193,24081,8843,15238,3.599,9.801,30999,10673,20326,4.344,12.617,-6918,-2.816,19.602,81,81,1935
1986,3359,2077,2431,204970,209630,268,11.097,236,9.772,22281,8375,13906,3.995,10.629,31524,13035,18489,6.218,15.038,-9243,-4.409,21.258,141,141,2110
1986,3361,205,261,286550,286170,35,13.592,28,10.874,26617,6288,20329,2.197,9.301,25153,1567,23586,0.548,8.790,1464,0.512,17.579,23,23,959
1986,3362,1782,1984,111310,111154,225,11.456,185,9.420,15953,6313,9640,5.680,14.352,15603,3747,11856,3.371,14.037,350,0.315,28.075,142,144,2018
1986,3363,3779,4550,650289,654457,481,10.658,407,9.018,59353,23471,35882,3.586,9.069,67442,22137,45305,3.383,10.305,-8089,-1.236,18.138,300,301,7259
1986,3364,1258,1533,740884,715754,139,9.067,139,9.067,102479,41249,61230,5.763,14.318,53159,39460,13699,5.513,7.427,49320,6.891,14.854,88,88,1898
1986,3365,166,189,27535,28743,16,8.466,16,8.466,2139,885,1254,3.079,7.442,4431,353,4078,1.228,15.416,-2292,-7.974,14.884,9,9,63
1986,3366,1145,1229,156686,158166,157,12.869,139,11.393,20197,3899,16298,2.465,12.770,23627,4418,19209,2.793,14.938,-3430,-2.169,25.539,96,96,1655
1986,3369,449,461,33450,35078,52,11.280,52,11.280,2222,447,1775,1.274,6.335,5562,2162,3400,6.163,15.856,-3340,-9.522,12.669,38,38,258
1986,3371,12555,13231,378366,379723,2010,15.365,1711,13.080,56809,20010,36799,5.270,14.961,60111,24341,35770,6.410,15.830,-3302,-0.870,29.921,1335,1343,12489
1986,3372,2664,2808,149317,147904,311,11.143,277,9.925,22270,8544,13726,5.777,15.057,19434,5932,13502,4.011,13.140,2836,1.917,26.279,223,223,3093
1986,3379,1077,1214,41410,41595,108,8.860,118,9.680,4621,812,3809,1.952,11.110,4933,2471,2462,5.941,11.860,-312,-0.750,22.219,91,91,881
1986,3391,10152,10638,221336,224073,1294,12.254,1137,10.768,32295,11144,21151,4.973,14.413,36999,18638,18361,8.318,16.512,-4704,-2.099,28.825,812,814,4319
1986,3399,14821,15383,401370,399350,1943,12.661,1870,12.185,64924,21734,43190,5.442,16.257,61122,22732,38390,5.692,15.305,3802,0.952,30.611,1467,1475,12683
1986,4231,22829,28041,315428,317149,2976,10.589,3102,11.038,51146,18442,32704,5.815,16.127,54636,20225,34411,6.377,17.227,-3490,-1.100,32.254,2111,2181,11916
1986,4232,8123,9263,107783,107202,1252,13.626,1103,12.004,20195,6783,13412,6.327,18.838,18888,7073,11815,6.598,17.619,1307,1.219,35.238,807,821,4579
1986,4233,7713,9612,122533,120996,1265,13.315,1042,10.968,23662,8400,15262,6.942,19.556,20467,8242,12225,6.812,16.916,3195,2.641,33.831,706,719,4951
1986,4234,23892,33033,585904,576859,5136,15.907,3647,11.295,105624,42825,62799,7.424,18.310,86989,35734,51255,6.195,15.080,18635,3.230,30.160,2203,2296,13547
1986,4235,6689,8891,131249,132382,963,10.850,932,10.501,19524,7608,11916,5.747,14.748,21810,8364,13446,6.318,16.475,-2286,-1.727,29.497,495,504,3346
1986,4236,15254,22417,323526,320769,2814,12.714,2246,10.148,58922,21087,37835,6.574,18.369,53228,21076,32152,6.570,16.594,5694,1.775,33.188,1398,1428,9508
1986,4237,10899,14506,161874,160782,1434,9.968,1194,8.300,25300,8701,16599,5.412,15.736,23040,8325,14715,5.178,14.330,2260,1.406,28.660,809,823,5055
1986,4238,46762,60988,642623,645775,6162,10.124,5915,9.718,100153,34444,65709,5.334,15.509,106169,39739,66430,6.154,16.441,-6016,-0.932,31.018,3694,3772,20320
1986,4239,23672,25238,235482,233435,4117,16.547,3402,13.673,49149,18210,30939,7.801,21.055,45219,17235,27984,7.383,19.371,3930,1.684,38.742,2590,2612,10924
1986,4241,8188,10887,156829,155868,1078,10.000,865,8.024,22496,6074,16422,3.897,14.433,20732,5666,15066,3.635,13.301,1764,1.132,26.602,583,595,3253
1986,4242,2836,3620,99441,97795,562,15.731,467,13.072,17225,3851,13374,3.938,17.613,13878,5797,8081,5.928,14.191,3347,3.422,28.382,326,335,2044
1986,4243,11259,12189,138231,136800,1952,16.162,1729,14.316,31617,10154,21463,7.423,23.112,28503,11721,16782,8.568,20.836,3114,2.276,41.671,1348,1356,6743
1986,4244,27224,33416,641605,632999,3976,11.919,3860,11.571,113324,35484,77840,5.606,17.903,96199,37570,58629,5.935,15.197,17125,2.705,30.395,2796,2820,18487
1986,4245,7474,10344,88703,91821,664,6.271,1154,10.898,12612,3704,8908,4.034,13.735,18707,7266,11441,7.913,20.373,-6095,-6.638,27.471,720,747,4097
1986,4246,7194,10461,121998,121995,1152,11.022,1133,10.841,21394,7187,14207,5.891,17.537,21285,9519,11766,7.803,17.448,109,0.089,34.895,553,556,3141
1986,4247,10749,14034,148699,149214,953,6.718,1257,8.861,25405,6718,18687,4.502,17.026,26186,8213,17973,5.504,17.549,-781,-0.523,34.052,773,802,4647
1986,4248,4286,5364,137530,137181,331,6.100,455,8.386,15581,3442,12139,2.509,11.358,14877,5059,9818,3.688,10.845,704,0.513,21.690,333,341,2929
1986,4249,20219,24228,261624,258449,3307,13.678,3205,13.256,51774,19551,32223,7.565,20.033,45332,18093,27239,7.001,17.540,6442,2.493,35.080,2148,2165,10038
1986,4251,30558,33373,307827,306691,4022,12.204,3191,9.682,55637,19325,36312,6.301,18.141,53098,19848,33250,6.472,17.313,2539,0.828,34.626,2101,2107,10705
1986,4411,38007,39285,940071,912209,4508,11.566,3891,9.983,149422,49385,100037,5.414,16.380,94049,34159,59890,3.745,10.310,55373,6.070,20.620,3120,3134,27626
1986,4412,11238,11761,84532,83170,1505,12.876,1359,11.627,18412,7147,11265,8.593,22.138,15615,5738,9877,6.899,18.775,2797,3.363,37.550,1098,1106,4698
1986,4413,48322,70965,491506,480638,8533,12.288,5484,7.897,101172,48274,52898,10.044,21.050,79212,26631,52581,5.541,16.481,21960,4.569,32.961,3522,3646,15663
1986,4421,21962,27489,227560,223172,3583,13.205,2871,10.581,46161,19351,26810,8.671,20.684,37311,13640,23671,6.112,16.718,8850,3.966,33.437,2128,2205,9545
1986,4422,21114,25915,151355,147249,4132,16.359,2820,11.164,37583,17398,20185,11.815,25.524,29681,10463,19218,7.106,20.157,7902,5.366,40.314,2018,2089,7142
1986,4431,23250,31275,214690,211052,4818,15.296,5263,16.709,54423,24965,29458,11.829,25.787,47806,22743,25063,10.776,22.651,6617,3.135,45.303,3644,3834,15419
1986,4441,56194,72095,743600,729932,6879,9.590,6150,8.574,132624,53698,78926,7.357,18.169,106310,36772,69538,5.038,14.564,26314,3.605,29.129,4317,4414,19675
1986,4442,15080,18242,132085,130842,2191,12.131,1829,10.127,25859,10196,15663,7.793,19.764,23143,7620,15523,5.824,17.688,2716,2.076,35.375,1260,1282,4933
1986,4451,64248,107503,2147648,2095765,12324,11.461,12378,11.511,381146,171941,209205,8.204,18.186,278638,113494,165144,5.415,13.295,102508,4.891,26.591,8031,8301,51343
1986,4452,22767,28008,180533,181210,4613,16.539,4379,15.700,43114,21988,21126,12.134,23.792,44601,19152,25449,10.569,24.613,-1487,-0.821,47.585,3293,3378,13989
1986,4453,27960,33246,165837,168739,3690,11.035,4079,12.198,32745,13821,18924,8.191,19.406,38574,14274,24300,8.459,22.860,-5829,-3.454,38.811,3112,3183,11108
1986,4461,45653,68403,636617,635540,7918,11.691,6571,9.702,112570,53827,58743,8.469,17.713,110323,45623,64700,7.179,17.359,2247,0.354,34.718,3849,3948,21225
1986,4471,90424,124962,837302,826939,16247,13.017,15950,12.779,195505,91234,104271,11.033,23.642,175515,76166,99349,9.211,21.225,19990,2.417,42.449,10833,11140,47948
1986,4481,55375,98843,895222,866477,13949,14.300,11353,11.639,209876,91531,118345,10.564,24.222,151239,58708,92531,6.775,17.454,58637,6.767,34.909,7196,7741,30619
1986,4482,11785,36626,198125,200883,4300,11.757,4197,11.475,43299,20478,22821,10.194,21.554,48940,20082,28858,9.997,24.363,-5641,-2.808,43.109,1686,1904,7295
1986,4483,18812,27529,158139,154948,4206,15.717,2671,9.981,36012,19389,16623,12.513,23.241,29855,10742,19113,6.933,19.268,6157,3.974,38.536,1778,1838,7226
1986,4511,31974,41241,280541,273949,6358,15.596,5411,13.273,65928,29155,36773,10.643,24.066,53022,22078,30944,8.059,19.355,12906,4.711,38.709,3899,4010,14105
1986,4512,8029,12200,81884,80561,1713,14.293,1283,10.705,18176,7865,10311,9.763,22.562,15538,5138,10400,6.378,19.287,2638,3.275,38.574,881,904,2897
1986,4521,496,10165,1600983,1587879,607,6.029,412,4.092,189892,89595,100297,5.642,11.959,163265,36553,126712,2.302,10.282,26627,1.677,20.564,40,44,1366
1986,4529,12206,24131,391777,382617,2742,11.386,2644,10.979,77823,41428,36395,10.828,20.340,60588,21576,39012,5.639,15.835,17235,4.505,31.670,1629,1674,8272
1986,4531,22882,24326,125573,122452,3642,15.185,2959,12.337,28961,11438,17523,9.341,23.651,22602,9313,13289,7.605,18.458,6359,5.193,36.916,2263,2303,7220
1986,4532,27955,34403,228408,223785,6231,18.570,4534,13.512,52389,24945,27444,11.147,23.410,43131,17531,25600,7.834,19.273,9258,4.137,38.547,3283,3396,11913
1986,4533,9438,11431,57052,56418,1831,16.147,1648,14.533,13602,6275,7327,11.122,24.109,12190,4673,7517,8.283,21.607,1412,2.503,43.213,1288,1293,3527
1986,4539,26549,32106,156897,155766,4936,15.378,4920,15.328,40001,18184,21817,11.674,25.680,37735,17862,19873,11.467,24.225,2266,1.455,48.451,3515,3634,12537
1986,4541,5334,6584,91288,94109,811,11.564,1669,23.799,16345,5569,10776,5.918,17.368,22637,11107,11530,11.802,24.054,-6292,-6.686,34.736,1121,1125,3611
1986,4542,3997,5025,73475,76288,565,11.124,673,13.251,11666,3372,8294,4.420,15.292,17596,7196,10400,9.433,23.065,-5930,-7.773,30.584,402,403,2159
1986,4543,16171,22414,221610,212940,2746,12.387,2256,10.176,52690,28602,24088,13.432,24.744,36188,13647,22541,6.409,16.994,16502,7.750,33.989,1635,1654,7515
1986,4811,916,2713,292240,283184,237,9.110,14,0.538,40269,3803,36466,1.343,14.220,22404,46,22358,0.016,7.911,17865,6.309,15.823,11,11,37
1986,4812,435,708,25133,22492,96,14.371,16,2.395,6000,2272,3728,10.102,26.677,697,79,618,0.351,3.099,5303,23.578,6.198,11,11,73
1986,4831,368,648,31948,32507,82,13.399,10,1.634,4438,1729,2709,5.319,13.653,5503,25,5478,0.077,16.929,-1065,-3.276,27.305,9,9,23
1986,4832,351,413,13087,13132,36,9.057,5,1.258,2015,937,1078,7.135,15.344,2111,9,2102,0.069,16.075,-96,-0.731,30.688,4,4,8
1986,4841,20074,25664,529267,511767,4289,17.862,984,4.098,98334,35061,63273,6.851,19.215,62959,4010,58949,0.784,12.302,35375,6.912,24.605,846,846,3432
1986,4842,44597,48638,593609,575040,7979,17.613,1306,2.883,119465,42064,77401,7.315,20.775,82543,4972,77571,0.865,14.354,36922,6.421,28.709,952,952,3649
1986,4851,370,398,19156,18770,45,11.780,13,3.403,2105,749,1356,3.991,11.215,1321,110,1211,0.586,7.038,784,4.177,14.076,12,12,107
1986,4852,322,779,30196,28533,130,18.156,4,0.559,7454,4769,2685,16.714,26.124,3589,4,3585,0.014,12.578,3865,13.546,25.157,4,4,4
1986,4853,4495,4541,50337,49329,580,13.412,147,3.399,8927,2425,6502,4.916,18.097,6877,380,6497,0.770,13.941,2050,4.156,27.882,129,129,332
1986,4854,3192,3407,97143,94209,249,7.525,53,1.602,15594,4275,11319,4.538,16.553,9779,166,9613,0.176,10.380,5815,6.172,20.760,43,43,139
1986,4855,574,625,13657,12627,98,16.911,7,1.208,3509,1515,1994,11.998,27.790,1379,87,1292,0.689,10.921,2130,16.869,21.842,4,4,11
1986,4859,897,932,16621,15524,147,16.733,40,4.553,3667,1303,2364,8.393,23.621,1445,155,1290,0.998,9.308,2222,14.313,18.616,36,36,148
1986,4861,62,279,9863,9848,15,5.515,(D),(D),898,97,801,0.985,9.119,845,(D),843,(D),8.580,53,0.538,17.161,0,0,0
1986,4862,233,1218,57759,57448,55,4.616,(D),(D),4031,2403,1628,4.183,7.017,3631,(D),3614,(D),6.320,400,0.696,12.641,(D),(D),(D)
1986,4869,63,339,8941,8116,21,6.373,(D),(D),2345,672,1673,8.280,28.895,682,(D),652,(D),8.404,1663,20.492,16.807,(D),(D),(D)
1986,4871,194,199,2960,2831,45,24.590,13,7.104,664,350,314,12.363,23.455,409,97,312,3.426,14.447,255,9.007,28.894,10,10,55
1986,4872,690,697,9886,9541,133,19.602,96,14.149,2271,769,1502,8.060,23.803,1620,389,1231,4.077,16.979,651,6.823,33.959,72,72,303
1986,4879,49,67,1534,1427,11,17.600,(D),(D),268,73,195,5.117,18.787,54,(D),51,(D),3.785,214,15.002,7.571,(D),(D),(D)
1986,4881,1944,2496,63072,60545,278,11.642,62,2.596,10597,3243,7354,5.356,17.503,5457,292,5165,0.482,9.013,5140,8.490,18.026,42,42,186
1986,4882,325,457,9144,8618,101,24.485,12,2.909,2343,1083,1260,12.567,27.187,1227,38,1189,0.441,14.238,1116,12.950,28.475,10,10,31
1986,4883,1999,2387,87332,87860,299,13.268,32,1.420,16910,4845,12065,5.514,19.247,17562,198,17364,0.225,19.989,-652,-0.742,38.493,26,26,155
1986,4884,1222,1699,30149,30289,218,12.348,351,19.881,5146,1134,4012,3.744,16.990,5309,1602,3707,5.289,17.528,-163,-0.538,33.979,307,309,1333
1986,4885,5839,7862,99971,94059,1431,19.741,205,2.828,24068,9500,14568,10.100,25.588,12223,1273,10950,1.353,12.995,11845,12.593,25.990,166,166,1018
1986,4889,439,442,5226,4766,105,25.990,29,7.178,1523,625,898,13.115,31.959,605,130,475,2.728,12.695,918,19.263,25.391,24,24,78
1986,4921,1314,2210,127161,119551,378,18.323,84,4.072,22599,5807,16792,4.857,18.903,7773,528,7245,0.442,6.502,14826,12.401,13.004,71,71,497
1986,4922,1899,1981,17259,14033,736,44.059,115,6.884,8138,5307,2831,37.818,57.992,1749,362,1387,2.580,12.463,6389,45.528,24.927,91,91,250
1986,4931,6408,9945,401569,401710,1036,10.503,873,8.851,62825,20672,42153,5.146,15.639,63423,17553,45870,4.370,15.788,-598,-0.149,31.279,358,361,3508
1986,5111,14081,16204,675121,666684,2010,12.503,1755,10.917,80495,24493,56002,3.674,12.074,63834,24567,39267,3.685,9.575,16661,2.499,19.150,1368,1372,13169
1986,5112,6381,7411,158484,158417,928,12.024,1542,19.979,34341,9270,25071,5.852,21.678,34438,17002,17436,10.732,21.739,-97,-0.061,43.355,1014,1026,6062
1986,5121,9442,14476,240288,230801,2412,16.687,2369,16.389,66029,22253,43776,9.642,28.609,48064,17638,30426,7.642,20.825,17965,7.784,41.650,1308,1370,7172
1986,5122,1951,1955,13221,12932,481,24.922,431,22.332,4579,2021,2558,15.628,35.408,3926,2123,1803,16.417,30.359,653,5.049,60.718,345,345,1611
1986,5151,5777,6786,220563,214215,594,9.106,69,1.058,35199,11808,23391,5.512,16.432,23346,560,22786,0.261,10.898,11853,5.533,21.797,56,56,323
1986,5152,10,10,511,476,4,47.059,(D),(D),76,16,60,3.361,15.966,8,(D),5,(D),1.681,68,14.286,3.361,(D),(D),(D)
1986,5171,2282,13122,730151,737635,1350,10.772,172,1.372,84989,25572,59417,3.467,11.522,101078,1358,99720,0.184,13.703,-16089,-2.181,23.044,158,158,1316
1986,5172,678,1503,61110,59247,231,16.296,60,4.233,9770,5148,4622,8.689,16.490,6119,309,5810,0.522,10.328,3651,6.162,20.656,57,57,302
1986,5174,669,1195,57494,52125,159,14.177,12,1.070,14746,4814,9932,9.236,28.290,4059,24,4035,0.046,7.787,10687,20.503,15.574,12,12,24
1986,5179,1319,2557,75949,72543,420,17.511,103,4.294,13601,4714,8887,6.498,18.749,7037,344,6693,0.474,9.701,6564,9.048,19.401,96,96,290
1986,5182,5983,7858,254544,255455,1220,15.519,1227,15.608,52402,18910,33492,7.402,20.513,54254,25650,28604,10.041,21.238,-1852,-0.725,41.026,612,618,4827
1986,5191,2335,2801,37240,35371,347,12.484,304,10.937,9360,5028,4332,14.215,26.462,5314,1686,3628,4.767,15.024,4046,11.439,30.047,223,223,1054
1986,5211,44,81,25647,25117,7,9.032,0,0.000,1464,298,1166,1.186,5.829,397,0,397,0.000,1.581,1067,4.248,3.161,0,0,0
1986,5221,19423,69491,1940071,1892102,4361,6.461,383,0.567,272531,80317,192214,4.245,14.404,175963,3491,172472,0.185,9.300,96568,5.104,18.600,355,355,3355
1986,5222,20734,37297,424822,394911,3026,8.386,596,1.652,96351,30549,65802,7.736,24.398,36724,2994,33730,0.758,9.299,59627,15.099,18.599,484,486,2575
1986,5223,3528,3914,52975,48909,800,21.906,276,7.558,15873,6417,9456,13.120,32.454,8033,1279,6754,2.615,16.425,7840,16.030,32.849,257,257,1170
1986,5231,5833,11426,313615,290279,1330,12.196,289,2.650,67868,12131,55737,4.179,23.380,22346,2012,20334,0.693,7.698,45522,15.682,15.396,243,243,1791
1986,5232,111,124,6700,6605,12,10.169,0,0.000,513,201,312,3.043,7.767,300,0,300,0.000,4.542,213,3.225,9.085,0,0,0
1986,5239,13644,14055,139779,125554,2647,20.304,611,4.687,48783,19125,29658,15.232,38.854,19920,3558,16362,2.834,15.866,28863,22.989,31.731,435,435,1815
1986,5241,6292,28021,1287399,1245331,1609,5.893,178,0.652,158148,25332,132816,2.034,12.699,72391,1452,70939,0.117,5.813,85757,6.886,11.626,161,161,1365
1986,5242,92099,96579,725353,679090,9594,10.337,2064,2.224,167626,54342,113284,8.002,24.684,75697,8271,67426,1.218,11.147,91929,13.537,22.294,1497,1497,5786
1986,5250,1865,2081,18642,17875,209,10.481,35,1.755,4812,1405,3407,7.860,26.920,3182,168,3014,0.940,17.801,1630,9.119,35.603,19,19,49
1986,5311,87409,90172,490029,469880,10161,11.757,2661,3.079,103575,39686,63889,8.446,22.043,63194,8775,54419,1.868,13.449,40381,8.594,26.898,2204,2205,7082
1986,5312,34024,35572,206813,196721,5256,15.572,1616,4.788,50793,17738,33055,9.017,25.820,30723,5372,25351,2.731,15.618,20070,10.202,31.235,1334,1334,4484
1986,5313,21362,22193,250517,236555,3475,16.565,1046,4.986,60764,20073,40691,8.486,25.687,32720,3916,28804,1.655,13.832,28044,11.855,27.664,898,898,3316
1986,5321,5865,9651,137409,130242,1551,16.337,1236,13.019,40334,12254,28080,9.409,30.969,25953,9143,16810,7.020,19.927,14381,11.042,39.854,759,804,5154
1986,5322,17507,21224,161678,150174,6843,35.906,2511,13.176,55001,30889,24112,20.569,36.625,32030,14434,17596,9.612,21.329,22971,15.296,42.657,1691,1721,9299
1986,5323,3463,4365,32167,30632,919,22.115,500,12.032,9375,4606,4769,15.037,30.606,6281,2672,3609,8.723,20.505,3094,10.101,41.010,355,358,1705
1986,5324,6929,8394,84224,80270,1810,22.891,836,10.573,23783,10807,12976,13.463,29.629,15656,5650,10006,7.039,19.504,8127,10.125,39.009,575,578,3366
1986,5331,855,891,11821,10975,123,14.471,41,4.824,3332,1143,2189,10.415,30.360,1588,140,1448,1.276,14.469,1744,15.891,28.938,32,32,113
1986,5411,126606,130685,796557,766380,15747,12.217,12161,9.435,158532,52123,106409,6.801,20.686,97206,37278,59928,4.864,12.684,61326,8.002,25.368,8979,9025,28987
1986,5412,59523,62649,484679,467348,10278,16.836,7074,11.588,99827,37455,62372,8.014,21.360,64794,25081,39713,5.367,13.864,35033,7.496,27.728,5171,5232,19179
1986,5413,55566,60998,801347,784590,10186,17.174,6810,11.482,170169,56600,113569,7.214,21.689,137309,39000,98309,4.971,17.501,32860,4.188,35.001,4889,4921,24889
1986,5414,13876,14104,95903,93411,2730,19.834,2050,14.894,24154,9902,14252,10.600,25.858,19236,7703,11533,8.246,20.593,4918,5.265,41.186,1653,1655,6030
1986,5415,12560,13883,141628,127225,5064,40.455,2333,18.638,53101,29637,23464,23.295,41.738,24132,10597,13535,8.329,18.968,28969,22.770,37.936,1807,1811,7246
1986,5416,39517,40938,333250,319188,10291,26.180,7032,17.889,110008,51279,58729,16.065,34.465,81647,36488,45159,11.432,25.580,28361,8.885,51.159,5460,5475,26515
1986,5417,6478,7866,441982,436349,1306,17.072,874,11.425,58025,13117,44908,3.006,13.298,46167,16460,29707,3.772,10.580,11858,2.718,21.161,555,558,4212
1986,5418,25553,27884,357300,349336,4946,18.171,3617,13.288,78187,30363,47824,8.692,22.382,61539,27833,33706,7.967,17.616,16648,4.766,35.232,2748,2759,18800
1986,5419,28854,32286,226519,221263,3793,11.993,2475,7.826,49938,15390,34548,6.956,22.570,39698,13229,26469,5.979,17.942,10240,4.628,35.883,1793,1802,9321
1986,5511,24059,44163,3025647,2988098,5093,11.762,3369,7.780,550636,187581,363055,6.278,18.428,474331,119648,354683,4.004,15.874,76305,2.554,31.748,517,568,6049
1986,5611,10804,11451,185229,170433,2524,22.960,1608,14.627,57700,22398,35302,13.142,33.855,28118,9538,18580,5.596,16.498,29582,17.357,32.996,1244,1248,6789
1986,5612,213,267,25077,22544,84,35.220,27,11.321,7478,4041,3437,17.925,33.171,2384,586,1798,2.599,10.575,5094,22.596,21.150,18,18,100
1986,5613,14334,19171,1048715,990210,4154,22.757,2320,12.710,322708,113444,209264,11.457,32.590,207240,48426,158814,4.890,20.929,115468,11.661,41.858,1573,1599,23662
1986,5614,19485,22047,243884,233985,3884,18.093,2723,12.685,59576,23686,35890,10.123,25.461,40084,16916,23168,7.230,17.131,19492,8.330,34.262,2063,2076,10632
1986,5615,22366,26143,200967,195931,4086,16.038,2755,10.813,45047,17230,27817,8.794,22.991,34676,13724,20952,7.005,17.698,10371,5.293,35.396,2019,2055,9719
1986,5616,11565,14163,456110,441018,2498,18.051,1849,13.361,102307,33619,68688,7.623,23.198,72356,26938,45418,6.108,16.407,29951,6.791,32.813,1407,1413,18366
1986,5617,63171,66302,881819,851840,14294,22.510,8690,13.685,229397,78539,150858,9.220,26.930,169228,56661,112567,6.652,19.866,60169,7.063,39.732,6801,6815,39284
1986,5619,12797,13788,197351,190280,2538,18.935,1770,13.205,48624,17551,31073,9.224,25.554,34341,10101,24240,5.308,18.048,14283,7.506,36.095,1348,1349,7523
1986,5621,3498,3599,91497,90148,312,8.903,123,3.510,10919,1908,9011,2.117,12.112,8178,1004,7174,1.114,9.072,2741,3.041,18.143,108,108,946
1986,5622,1900,2450,53867,51411,162,6.808,21,0.883,8824,1748,7076,3.400,17.164,3914,260,3654,0.506,7.613,4910,9.550,15.226,15,15,241
1986,5629,4551,4793,44981,43246,716,15.304,487,10.409,10892,3863,7029,8.933,25.186,7469,2860,4609,6.613,17.271,3423,7.915,34.542,355,355,1853
1986,6111,12746,13207,388493,380071,462,3.555,39,0.300,38755,4983,33772,1.311,10.197,22201,159,22042,0.042,5.841,16554,4.356,11.683,22,22,78
1986,6112,415,547,37610,36527,56,10.780,(D),(D),5327,1256,4071,3.439,14.584,3011,(D),3009,(D),8.243,2316,6.341,16.487,0,0,0
1986,6113,1968,2265,930889,922078,62,2.771,7,0.313,78143,2398,75745,0.260,8.475,60204,137,60067,0.015,6.529,17939,1.945,13.058,(D),(D),(D)
1986,6114,2177,2573,45239,43097,552,22.258,366,14.758,11602,4621,6981,10.722,26.921,7399,2800,4599,6.497,17.168,4203,9.753,34.337,282,288,2086
1986,6115,3314,3907,50305,47799,680,18.011,417,11.045,12919,4524,8395,9.465,27.028,7948,2829,5119,5.919,16.628,4971,10.400,33.256,273,280,1698
1986,6116,11007,11528,97224,93663,2274,20.084,1863,16.454,24940,10089,14851,10.772,26.627,17835,7851,9984,8.382,19.042,7105,7.586,38.083,1502,1521,6269
1986,6117,1559,1590,18491,18365,328,21.264,233,15.105,3695,1556,2139,8.473,20.120,3461,1209,2252,6.583,18.846,234,1.274,37.691,179,179,550
1986,6211,183005,190371,1184336,1154337,16029,8.486,13058,6.913,225069,74463,150606,6.451,19.498,164965,53581,111384,4.642,14.291,60104,5.207,28.582,10369,10429,40407
1986,6212,96789,99250,479479,470888,6650,6.754,5064,5.143,79699,23957,55742,5.088,16.925,62144,18625,43519,3.955,13.197,17555,3.728,26.394,3937,3978,15160
1986,6213,46767,48832,172619,166129,7268,15.319,4490,9.464,43894,19758,24136,11.893,26.422,30955,13239,17716,7.969,18.633,12939,7.789,37.266,3362,3401,10347
1986,6214,6351,8507,140628,133844,1643,20.317,803,9.930,36597,16798,19799,12.550,27.343,23161,7447,15714,5.564,17.304,13436,10.039,34.609,505,516,3853
1986,6215,4635,5881,80106,74858,1160,20.694,609,10.864,20996,8217,12779,10.977,28.048,10492,5518,4974,7.371,14.016,10504,14.032,28.032,433,449,3208
1986,6216,4818,6433,265277,246144,1390,22.744,747,12.223,80068,29177,50891,11.854,32.529,41443,7623,33820,3.097,16.837,38625,15.692,33.674,511,520,4493
1986,6219,4429,5119,96634,91848,960,19.778,430,8.859,24783,8488,16295,9.241,26.983,15055,4916,10139,5.352,16.391,9728,10.591,32.783,268,270,2500
1986,6221,3958,5230,3200029,3171037,274,5.374,12,0.235,250420,126397,124023,3.986,7.897,191944,1629,190315,0.051,6.053,58476,1.844,12.106,3,3,134
1986,6222,372,561,327436,316471,78,14.801,10,1.898,28167,11799,16368,3.728,8.900,6058,899,5159,0.284,1.914,22109,6.986,3.828,(D),(D),(D)
1986,6223,193,228,72477,69900,26,12.037,(D),(D),6881,3805,3076,5.444,9.844,1724,(D),1661,(D),2.466,5157,7.378,4.933,0,0,0
1986,6231,6881,10610,914423,887505,1043,10.052,575,5.542,139293,66936,72357,7.542,15.695,84549,32916,51633,3.709,9.527,54744,6.168,19.053,365,380,22263
1986,6232,4753,6733,160652,152167,1109,17.241,508,7.897,35947,15794,20153,10.379,23.623,19127,6636,12491,4.361,12.570,16820,11.054,25.140,343,352,4546
1986,6233,9351,11298,412099,402399,1800,16.284,1312,11.869,79178,38375,40803,9.537,19.677,59638,31208,28430,7.755,14.821,19540,4.856,29.641,868,898,20187
1986,6239,2978,3708,89517,86628,467,12.969,253,7.026,15987,6713,9274,7.749,18.455,10124,3368,6756,3.888,11.687,5863,6.768,23.374,151,160,2344
1986,6241,14932,20354,292200,284362,2490,12.579,1373,6.936,52778,15368,37410,5.404,18.560,36719,10424,26295,3.666,12.913,16059,5.647,25.826,818,824,5505
1986,6242,4328,5082,46304,44455,619,12.514,348,7.035,9219,3274,5945,7.365,20.738,5520,1338,4182,3.010,12.417,3699,8.321,24.834,215,215,748
1986,6243,4149,6049,253937,249680,789,13.504,376,6.436,43260,10819,32441,4.333,17.326,35071,5044,30027,2.020,14.046,8189,3.280,28.093,190,209,2120
1986,6244,31453,37249,343654,334036,5421,14.838,3991,10.924,75415,31661,43754,9.478,22.577,56294,21970,34324,6.577,16.853,19121,5.724,33.705,2984,3025,15206
1986,7111,5004,5057,68488,67961,840,16.726,770,15.333,17108,4995,12113,7.350,25.173,16039,3820,12219,5.621,23.600,1069,1.573,47.201,573,574,2730
1986,7112,2228,2329,66026,66063,454,19.825,376,16.419,15043,3871,11172,5.860,22.771,15125,3045,12080,4.609,22.895,-82,-0.124,45.541,290,292,1654
1986,7113,2242,2282,35540,34123,422,18.802,347,15.460,9972,3100,6872,9.085,29.224,7119,2771,4348,8.121,20.863,2853,8.361,41.726,244,244,2019
1986,7114,1023,1038,12174,11642,194,18.844,177,17.193,3927,1360,2567,11.682,33.731,2914,1024,1890,8.796,25.030,1013,8.701,50.060,139,139,800
1986,7115,10136,10160,63779,62027,2876,28.881,2472,24.824,22876,9957,12919,16.053,36.881,19383,9947,9436,16.037,31.250,3493,5.631,62.499,1898,1898,7611
1986,7121,2299,2452,41099,39861,239,9.872,177,7.311,5344,1227,4117,3.078,13.407,2850,667,2183,1.673,7.150,2494,6.257,14.300,125,125,511
1986,7131,1590,2144,60099,57700,413,19.463,369,17.389,11283,4067,7216,7.049,19.555,6429,3012,3417,5.220,11.142,4854,8.413,22.284,275,276,1637
1986,7132,712,735,21829,22080,121,16.351,131,17.703,3457,1042,2415,4.719,15.657,3924,1800,2124,8.152,17.772,-467,-2.115,31.314,96,96,883
1986,7139,33536,35994,527009,514658,5388,15.313,3771,10.717,109621,47242,62379,9.179,21.300,84952,29537,55415,5.739,16.507,24669,4.793,33.013,2781,2814,21279
1986,7211,29310,34236,1283511,1243881,5046,14.872,4432,13.063,280180,144453,135727,11.613,22.525,200316,85884,114432,6.905,16.104,79864,6.421,32.208,3187,3236,53788
1986,7212,3695,3967,24971,24604,516,13.052,489,12.369,6422,2187,4235,8.889,26.101,5691,1905,3786,7.743,23.130,731,2.971,46.261,349,350,1155
1986,7213,4288,4399,24750,24483,294,6.570,446,9.966,4501,1108,3393,4.526,18.385,4009,1752,2257,7.156,16.375,492,2.010,32.750,312,314,1377
1986,7223,17175,27520,536050,513002,5988,22.375,4472,16.710,163358,106742,56616,20.807,31.844,120151,52017,68134,10.140,23.421,43207,8.422,46.842,2517,2549,21877
1986,7224,53568,54327,318242,319242,8531,15.503,9932,18.049,88999,49402,39597,15.475,27.878,90631,45140,45491,14.140,28.389,-1632,-0.511,55.756,7984,8004,37371
1986,7225,199156,262701,4911245,4782397,47542,18.390,39179,15.155,1231031,714020,517011,14.930,25.741,971495,433050,538445,9.055,20.314,259536,5.427,40.628,28429,29185,284570
1986,8111,105485,111481,564223,549806,19546,17.899,14988,13.725,141555,73052,68503,13.287,25.746,112998,51179,61819,9.309,20.552,28557,5.194,41.105,11566,11650,40708
1986,8112,10174,11665,88961,84228,1931,16.859,1508,13.166,23703,11886,11817,14.112,28.141,14212,4983,9229,5.916,16.873,9491,11.268,33.746,1118,1119,3070
1986,8113,19174,20167,154114,151787,2940,14.791,2360,11.873,33162,12085,21077,7.962,21.848,28714,10864,17850,7.157,18.917,4448,2.930,37.835,1725,1729,6620
1986,8114,24292,25861,158843,156214,4340,16.954,3814,14.900,33747,13310,20437,8.520,21.603,28507,11143,17364,7.133,18.249,5240,3.354,36.497,2857,2859,8080
1986,8121,79996,88964,485327,478771,13537,15.203,13698,15.383,111485,56982,54503,11.902,23.286,98217,48321,49896,10.093,20.514,13268,2.771,41.029,10462,10662,36434
1986,8122,17141,19968,118726,116679,1536,7.740,1289,6.496,18775,5679,13096,4.867,16.091,14677,4493,10184,3.851,12.579,4098,3.512,25.158,921,942,3415
1986,8123,32687,38796,354199,350078,5458,14.193,4776,12.420,66213,29678,36535,8.478,18.914,57783,23841,33942,6.810,16.506,8430,2.408,33.012,3531,3668,16388
1986,8129,12988,20523,201411,197900,3986,19.975,2850,14.282,45720,18695,27025,9.447,23.103,38763,15729,23034,7.948,19.587,6957,3.515,39.174,1673,1759,9000
1986,8131,121425,121525,968523,948191,6767,5.702,1060,0.893,122815,19993,102822,2.109,12.953,82144,2455,79689,0.259,8.663,40671,4.289,17.326,149,149,297
1986,8132,7714,8750,116810,114455,890,10.430,456,5.344,19040,5300,13740,4.631,16.635,14223,3153,11070,2.755,12.427,4817,4.209,24.854,291,299,1916
1986,8133,7475,8601,98142,95294,1039,12.356,655,7.789,18660,5264,13396,5.524,19.582,12916,4382,8534,4.598,13.554,5744,6.028,27.108,390,411,2489
1986,8134,28529,29928,265991,262506,2325,7.825,1893,6.371,37940,8453,29487,3.220,14.453,31040,6574,24466,2.504,11.825,6900,2.629,23.649,1258,1258,4449
1986,8139,54728,56931,453900,445630,4484,8.053,1990,3.574,77561,20348,57213,4.566,17.405,61117,8199,52918,1.840,13.715,16444,3.690,27.429,1374,1375,5606
1987,2111,7318,8971,131317,143302,922,9.780,1835,19.464,19671,7332,12339,5.116,13.727,43671,15836,27835,11.051,30.475,-24000,-16.748,27.454,1206,1218,5771
1987,2121,2319,2903,148072,158685,509,17.112,652,21.920,23873,12924,10949,8.144,15.044,44774,20824,23950,13.123,28.216,-20901,-13.171,30.089,428,430,6844
1987,2122,483,615,35556,35743,141,23.096,132,21.622,8022,2717,5305,7.602,22.444,8592,2573,6019,7.199,24.039,-570,-1.595,44.888,62,63,243
1987,2123,3539,5024,102346,103004,487,9.635,548,10.842,16572,4794,11778,4.654,16.089,17896,6547,11349,6.356,17.374,-1324,-1.285,32.178,285,294,2446
1987,2131,8331,9807,165894,197664,1285,12.001,3085,28.813,33187,15752,17435,7.969,16.790,96707,35769,60938,18.096,48.925,-63520,-32.135,33.579,2063,2075,17776
1987,2211,1615,5753,592605,588562,201,3.551,17,0.300,32255,9665,22590,1.642,5.480,24294,188,24106,0.032,4.128,7961,1.353,8.255,14,14,166
1987,2212,532,2273,133978,132478,113,5.090,7,0.315,7850,2288,5562,1.727,5.926,4854,26,4828,0.020,3.664,2996,2.262,7.328,7,7,26
1987,2213,3579,3828,29715,28651,319,8.618,66,1.783,3908,1709,2199,5.965,13.640,1758,172,1586,0.600,6.136,2150,7.504,12.272,54,54,142
1987,2361,104332,104713,618335,595393,23930,23.606,17252,17.018,222225,93214,129011,15.656,37.324,176037,75804,100233,12.732,29.567,46188,7.758,59.133,12482,12486,56090
1987,2362,38389,39094,689604,689123,5896,15.214,5218,13.464,186738,47279,139459,6.861,27.098,186397,56803,129594,8.243,27.048,341,0.049,54.097,3881,3882,32692
1987,2371,13492,13780,304703,299943,1530,11.097,1544,11.199,73864,14254,59610,4.752,24.626,64487,21218,43269,7.074,21.500,9377,3.126,43.000,1125,1127,10417
1987,2372,9766,9928,75840,75805,2852,29.554,2296,23.793,28888,15845,13043,20.902,38.108,28618,15962,12656,21.057,37.752,270,0.356,75.504,1864,1867,12273
1987,2373,9615,9975,251923,252102,1230,12.402,1115,11.243,61414,10790,50624,4.280,24.361,62505,15010,47495,5.954,24.794,-1091,-0.433,48.722,849,850,7989
1987,2379,5300,5378,75129,76784,919,17.253,816,15.320,20437,6217,14220,8.097,26.616,23897,6203,17694,8.079,31.123,-3460,-4.506,53.233,614,614,4497
1987,2381,74947,75396,719485,707527,13398,18.260,9351,12.745,214360,67270,147090,9.508,30.297,190669,57280,133389,8.096,26.949,23691,3.348,53.897,7037,7040,44308
1987,2382,114044,116017,1207255,1184289,17133,15.060,12626,11.098,286942,84713,202229,7.153,24.229,240604,70747,169857,5.974,20.316,46338,3.913,40.633,9640,9647,51833
1987,2383,77896,78314,664688,645033,16665,22.013,11450,15.124,209300,71151,138149,11.031,32.448,169835,55417,114418,8.591,26.330,39465,6.118,52.659,8545,8545,41729
1987,2389,39402,39628,356105,348852,6999,18.087,5135,13.270,104060,32721,71339,9.380,29.829,90012,32856,57156,9.418,25.802,14048,4.027,51.605,3769,3769,21035
1987,3111,1544,2157,53304,53520,169,7.886,141,6.580,7431,2707,4724,5.058,13.885,7882,2379,5503,4.445,14.727,-451,-0.843,27.769,76,79,730
1987,3112,479,825,65423,66289,52,6.292,55,6.655,4851,1418,3433,2.139,7.318,6549,1843,4706,2.780,9.880,-1698,-2.562,14.636,28,28,544
1987,3113,1569,1867,83440,83234,249,13.387,235,12.634,12036,2443,9593,2.935,14.460,11593,3253,8340,3.908,13.928,443,0.532,27.856,147,147,1252
1987,3114,1153,1599,171856,170900,125,7.800,132,8.237,24067,6078,17989,3.556,14.083,21767,6652,15115,3.892,12.737,2300,1.346,25.473,85,87,1454
1987,3115,1566,2232,135450,134579,132,5.807,214,9.415,17082,5328,11754,3.959,12.693,15382,6945,8437,5.161,11.430,1700,1.263,22.860,131,132,2315
1987,3116,3755,4336,336174,335757,311,7.122,373,8.541,41753,9660,32093,2.877,12.435,40521,14659,25862,4.366,12.069,1232,0.367,24.137,260,261,4639
1987,3117,678,781,43132,41922,61,7.668,90,11.314,9733,3128,6605,7.461,23.217,7332,2772,4560,6.612,17.490,2401,5.727,34.979,58,58,818
1987,3118,9051,10600,304128,303258,1609,15.327,1405,13.384,42662,16112,26550,5.313,14.068,40661,19234,21427,6.342,13.408,2001,0.660,26.816,1017,1029,7811
1987,3119,1960,2330,128563,126461,227,9.742,227,9.742,18731,5848,12883,4.624,14.812,14393,4928,9465,3.897,11.381,4338,3.430,22.763,160,160,2504
1987,3121,1783,2262,146833,150332,225,9.836,276,12.066,15328,4587,10741,3.051,10.196,21863,10671,11192,7.098,14.543,-6535,-4.347,20.392,189,192,5040
1987,3122,96,134,33969,35238,8,5.839,14,10.219,1704,626,1078,1.776,4.836,4151,702,3449,1.992,11.780,-2447,-6.944,9.671,8,8,29
1987,3131,389,603,111402,111961,31,4.956,76,12.150,13042,2088,10954,1.865,11.649,14197,9862,4335,8.808,12.680,-1155,-1.032,23.297,34,35,1210
1987,3132,1606,1918,244013,250317,156,7.982,229,11.717,24834,5352,19482,2.138,9.921,37687,26054,11633,10.408,15.056,-12853,-5.135,19.842,127,131,3718
1987,3133,1461,1736,103762,104400,159,9.083,188,10.740,12643,3979,8664,3.811,12.110,14009,7718,6291,7.393,13.419,-1366,-1.308,24.220,115,116,1830
1987,3141,3713,4008,126579,126517,456,11.229,562,13.839,20480,5800,14680,4.584,16.188,20640,11380,9260,8.995,16.314,-160,-0.126,32.375,428,429,3695
1987,3149,3529,3654,114378,115657,480,13.099,501,13.672,18886,6170,12716,5.335,16.329,21456,10243,11213,8.856,18.551,-2570,-2.222,32.659,409,409,5256
1987,3151,1280,1388,135584,133566,150,10.757,163,11.689,20637,8361,12276,6.260,15.451,16588,5914,10674,4.428,12.419,4049,3.031,24.839,121,121,2534
1987,3152,11437,12800,790283,798942,2011,15.695,2037,15.898,129611,47081,82530,5.893,16.223,148471,63377,85094,7.933,18.583,-18860,-2.361,32.446,1646,1666,38895
1987,3159,1687,1764,67881,68472,209,11.512,312,17.185,10877,2443,8434,3.568,15.885,12047,4709,7338,6.877,17.594,-1170,-1.709,31.771,268,269,3656
1987,3161,333,364,15558,15340,19,5.080,39,10.428,2199,578,1621,3.768,14.336,1738,648,1090,4.224,11.330,461,3.005,22.660,28,28,300
1987,3162,384,517,79486,84062,36,6.636,87,16.037,6891,1231,5660,1.464,8.198,16118,7877,8241,9.371,19.174,-9227,-10.976,16.395,48,49,945
1987,3169,1126,1172,36210,37431,125,10.553,150,12.664,5440,1409,4031,3.764,14.533,8012,3919,4093,10.470,21.405,-2572,-6.871,29.067,99,100,1704
1987,3211,4545,5034,140410,138921,484,9.491,615,12.060,21548,6258,15290,4.505,15.511,18187,9398,8789,6.765,13.092,3361,2.419,26.183,425,428,4156
1987,3212,1264,1566,102917,100375,161,10.397,126,8.137,13663,3913,9750,3.898,13.612,8683,3261,5422,3.249,8.651,4980,4.961,17.301,77,77,1231
1987,3219,8898,9538,274552,272472,1247,13.164,1116,11.781,49592,12718,36874,4.668,18.201,45346,24100,21246,8.845,16.642,4246,1.558,33.285,803,809,13526
1987,3221,211,526,189227,191704,20,3.766,30,5.650,8012,2343,5669,1.222,4.179,12871,5910,6961,3.083,6.714,-4859,-2.535,8.359,11,11,1066
1987,3222,3574,5117,383424,383714,325,6.338,347,6.767,35186,9164,26022,2.388,9.170,35785,12060,23725,3.143,9.326,-599,-0.156,18.340,210,211,4157
1987,3231,39912,41669,798298,791239,5063,12.360,3653,8.918,108051,31526,76525,3.984,13.656,94014,34237,59777,4.327,11.882,14037,1.774,23.764,2883,2886,21345
1987,3241,1324,2205,176704,190130,203,9.083,263,11.767,13370,3865,9505,2.033,7.032,39879,18653,21226,9.811,20.975,-26509,-13.943,14.064,111,114,1461
1987,3251,1095,2204,230084,234519,169,7.501,267,11.851,21686,14438,7248,6.156,9.247,30992,17495,13497,7.460,13.215,-9306,-3.968,18.494,76,83,1368
1987,3252,352,602,126332,126771,63,10.588,49,8.235,10881,3635,7246,2.867,8.583,11839,5092,6747,4.017,9.339,-958,-0.756,17.166,19,20,977
1987,3253,633,918,42279,44142,50,5.238,123,12.886,3679,1206,2473,2.732,8.335,7392,3417,3975,7.741,16.746,-3713,-8.412,16.669,47,47,547
1987,3254,1034,1275,157870,158273,116,9.077,122,9.546,16283,3504,12779,2.214,10.288,16781,5616,11165,3.548,10.603,-498,-0.315,20.576,66,66,899
1987,3255,1610,2113,76340,77242,137,6.414,183,8.567,8468,2465,6003,3.191,10.963,10310,2918,7392,3.778,13.348,-1842,-2.385,21.926,116,116,1317
1987,3256,2029,2273,114885,115006,205,8.960,235,10.271,13513,4687,8826,4.075,11.750,13795,2799,10996,2.434,11.995,-282,-0.245,23.500,175,176,1503
1987,3259,2062,2621,132974,137208,218,8.203,291,10.950,11265,2736,8529,1.994,8.210,19566,7444,12122,5.425,14.260,-8301,-6.050,16.420,121,121,948
1987,3261,9625,11433,621862,613947,1108,9.700,1087,9.516,94540,29096,65444,4.739,15.399,78364,30649,47715,4.992,12.764,16176,2.635,25.528,727,733,11817
1987,3262,2113,2570,191098,190453,286,11.318,200,7.915,20119,9223,10896,4.843,10.564,19172,5684,13488,2.984,10.067,947,0.497,20.133,122,125,1839
1987,3271,1380,1664,80380,78462,225,13.603,205,12.394,12692,3867,8825,4.929,16.176,8667,3277,5390,4.177,11.046,4025,5.130,22.092,139,139,1179
1987,3272,1597,1859,139559,140160,200,10.707,218,11.670,12675,1785,10890,1.274,9.043,14206,5891,8315,4.203,10.136,-1531,-1.092,18.087,135,135,1437
1987,3273,6711,8985,190948,190643,746,8.280,795,8.824,33973,10477,23496,5.496,17.820,33551,12532,21019,6.574,17.599,422,0.221,35.198,453,467,5095
1987,3274,246,342,17563,18455,33,9.538,41,11.850,1303,474,829,2.568,7.061,3127,2039,1088,11.049,16.944,-1824,-9.884,14.121,18,18,92
1987,3279,1856,2141,71850,74103,221,10.320,222,10.367,7497,2234,5263,3.015,10.117,12247,4428,7819,5.976,16.527,-4750,-6.410,20.234,140,143,1492
1987,3311,313,357,112897,110684,66,19.214,39,11.354,14491,12354,2137,11.162,13.092,10791,3376,7415,3.050,9.749,3700,3.343,19.499,17,17,1479
1987,3312,509,688,58578,59988,61,8.847,64,9.282,6225,3126,3099,5.211,10.377,9177,4101,5076,6.836,15.298,-2952,-4.921,20.754,25,25,640
1987,3313,421,598,105394,109555,36,5.839,73,11.841,7037,2665,4372,2.433,6.423,15554,7492,8062,6.839,14.197,-8517,-7.774,12.847,17,18,1093
1987,3314,713,870,81041,82289,94,10.805,94,10.805,7138,3383,3755,4.111,8.674,9748,3978,5770,4.834,11.846,-2610,-3.172,17.349,44,45,377
1987,3315,2501,2757,203459,210444,176,6.266,280,9.968,19571,6944,12627,3.300,9.300,33402,10771,22631,5.118,15.872,-13831,-6.572,18.600,181,183,4626
1987,3321,3277,3487,138814,142146,252,7.233,246,7.061,16037,4828,11209,3.397,11.282,22696,9612,13084,6.762,15.967,-6659,-4.685,22.564,150,150,2791
1987,3322,1277,1402,76416,77062,94,6.667,110,7.801,7444,2211,5233,2.869,9.660,8579,2691,5888,3.492,11.133,-1135,-1.473,19.320,70,70,627
1987,3323,9976,10762,333742,342035,887,8.217,953,8.828,44835,13161,31674,3.848,13.108,61531,19570,41961,5.722,17.990,-16696,-4.881,26.217,665,683,8737
1987,3324,1459,1795,110460,114948,121,6.705,140,7.758,11576,2682,8894,2.333,10.071,20355,6940,13415,6.038,17.708,-8779,-7.637,20.141,66,67,1198
1987,3325,925,1007,73021,76868,60,5.894,82,8.055,4760,905,3855,1.177,6.192,12461,5801,6660,7.547,16.211,-7701,-10.019,12.385,54,56,1294
1987,3326,1542,1745,62944,63657,130,7.307,198,11.130,8412,2610,5802,4.100,13.215,9920,4259,5661,6.691,15.584,-1508,-2.369,26.429,130,130,1851
1987,3327,20841,21113,302497,306079,2323,11.065,2087,9.940,41068,12922,28146,4.222,13.417,48302,15969,32333,5.217,15.781,-7234,-2.363,26.835,1574,1578,10879
1987,3328,5462,5804,148290,146980,411,7.036,486,8.320,22334,3721,18613,2.532,15.195,19834,6233,13601,4.241,13.494,2500,1.701,26.989,370,370,3795
1987,3329,6209,6717,358524,362706,737,11.061,629,9.440,38466,14228,24238,3.923,10.605,46731,14167,32564,3.906,12.884,-8265,-2.279,21.211,416,419,5016
1987,3331,2865,3128,184784,195233,258,8.029,429,13.350,23813,6559,17254,3.360,12.197,44954,19787,25167,10.135,23.026,-21141,-10.829,24.395,225,225,2367
1987,3332,3984,4229,161023,165399,329,7.771,338,7.984,18936,6306,12630,3.813,11.449,27441,7304,20137,4.416,16.591,-8505,-5.142,22.897,239,239,2529
1987,3333,2170,2293,149652,152159,205,8.954,198,8.648,18350,8732,9618,5.739,12.060,22804,5589,17215,3.673,14.987,-4454,-2.927,24.120,120,120,1910
1987,3334,1622,1866,159891,161381,127,6.661,208,10.910,16000,3412,12588,2.114,9.914,19213,7766,11447,4.812,11.905,-3213,-1.991,19.829,150,152,2291
1987,3335,9199,9557,212109,219039,649,6.740,793,8.236,24271,7773,16498,3.549,11.081,38056,12956,25100,5.915,17.374,-13785,-6.293,22.161,566,567,4268
1987,3336,754,907,129733,134976,55,5.952,89,9.632,12155,7379,4776,5.467,9.005,23360,11273,12087,8.352,17.307,-11205,-8.301,18.011,39,40,700
1987,3339,5335,5923,312854,326805,510,8.546,600,10.054,32429,13760,18669,4.210,9.923,60531,26096,34435,7.985,18.522,-28102,-8.599,19.846,384,386,5083
1987,3341,1496,1633,278279,288223,269,16.382,287,17.479,27984,7881,20103,2.734,9.709,48238,18882,29356,6.551,16.736,-20254,-7.027,19.418,197,197,3369
1987,3342,1349,1531,244621,257877,165,10.536,235,15.006,22736,7972,14764,3.091,8.817,49729,19995,29734,7.754,19.284,-26993,-10.467,17.633,137,144,6000
1987,3343,358,378,29609,31473,36,9.375,48,12.500,3321,612,2709,1.945,10.552,6966,5434,1532,17.266,22.133,-3645,-11.581,21.104,30,30,283
1987,3344,4407,5010,513508,527218,598,11.833,685,13.555,59710,19592,40118,3.716,11.325,86288,46426,39862,8.806,16.367,-26578,-5.041,22.651,416,420,9059
1987,3345,4362,4998,680784,685775,505,10.173,437,8.803,57022,20741,36281,3.024,8.315,67666,22337,45329,3.257,9.867,-10644,-1.552,16.630,261,263,7280
1987,3346,679,716,42432,42115,123,17.348,109,15.374,7023,1504,5519,3.571,16.676,6277,3023,3254,7.178,14.905,746,1.771,29.809,81,81,751
1987,3351,1185,1313,86473,89376,102,7.655,141,10.582,8766,2233,6533,2.498,9.808,14860,7172,7688,8.025,16.626,-6094,-6.818,19.616,87,87,856
1987,3352,310,399,115095,113494,32,7.911,43,10.630,13998,5032,8966,4.434,12.334,10991,6566,4425,5.785,9.684,3007,2.649,19.369,25,25,525
1987,3353,2073,2554,232314,239053,217,8.523,201,7.895,21660,7889,13771,3.300,9.061,35430,13861,21569,5.798,14.821,-13770,-5.760,18.122,77,77,1450
1987,3359,2224,2567,191582,196550,257,10.031,247,9.641,19406,7227,12179,3.677,9.873,29335,10574,18761,5.380,14.925,-9929,-5.052,19.747,143,145,2368
1987,3361,221,277,252679,260861,49,17.982,40,14.679,22532,5032,17500,1.929,8.638,39599,13297,26302,5.097,15.180,-17067,-6.543,17.275,25,25,594
1987,3362,1840,2030,113997,113208,225,11.081,226,11.130,18195,4796,13399,4.236,16.072,16831,6284,10547,5.551,14.867,1364,1.205,29.735,169,171,2364
1987,3363,3855,4670,663311,670364,426,9.115,433,9.265,56575,19776,36799,2.950,8.439,71893,16015,55878,2.389,10.724,-15318,-2.285,16.879,309,309,4756
1987,3364,1373,1663,693088,688419,132,7.933,134,8.053,70231,22641,47590,3.289,10.202,59108,18489,40619,2.686,8.586,11123,1.616,17.172,92,93,1461
1987,3365,164,186,25695,27414,14,7.330,24,12.565,2777,1293,1484,4.717,10.130,6115,959,5156,3.498,22.307,-3338,-12.176,20.260,12,12,65
1987,3366,1188,1269,154235,156196,154,12.169,147,11.616,17992,3250,14742,2.081,11.519,22379,4346,18033,2.782,14.328,-4387,-2.809,23.038,95,95,1161
1987,3369,470,484,29945,30206,66,13.707,61,12.669,2815,698,2117,2.311,9.319,3314,1389,1925,4.599,10.972,-499,-1.652,18.639,48,48,487
1987,3371,12861,13537,389867,384834,1925,14.345,1689,12.587,59974,16852,43122,4.379,15.584,49991,22198,27793,5.768,12.990,9983,2.594,25.981,1315,1324,13161
1987,3372,2848,3009,154445,155063,320,10.720,272,9.112,21303,6407,14896,4.132,13.738,22471,9580,12891,6.178,14.492,-1168,-0.753,27.477,200,200,3350
1987,3379,1073,1224,41794,41403,119,9.770,107,8.785,6015,2647,3368,6.393,14.528,5296,1626,3670,3.927,12.791,719,1.737,25.583,84,84,1427
1987,3391,10431,10949,237031,235037,1272,11.669,1176,10.788,34555,10281,24274,4.374,14.702,30593,12889,17704,5.484,13.016,3962,1.686,26.033,856,861,5027
1987,3399,14968,15499,394887,395136,2071,13.451,1867,12.126,61958,17821,44137,4.510,15.680,62108,26009,36099,6.582,15.718,-150,-0.038,31.360,1439,1442,11719
1987,4231,23091,28286,316259,318494,2972,10.411,3493,12.236,54019,18184,35835,5.709,16.961,58606,24464,34142,7.681,18.401,-4587,-1.440,33.922,2167,2240,13918
1987,4232,8312,9477,113714,111953,1349,14.311,1248,13.239,23138,8056,15082,7.196,20.668,19730,8251,11479,7.370,17.624,3408,3.044,35.247,884,898,4753
1987,4233,8264,10533,136847,133731,1466,14.090,1209,11.620,29703,11484,18219,8.587,22.211,23762,9565,14197,7.152,17.769,5941,4.443,35.537,763,774,4512
1987,4234,25003,34567,612593,605297,5227,15.356,4171,12.254,125712,60708,65004,10.029,20.769,108821,52014,56807,8.593,17.978,16891,2.791,35.956,2253,2339,16326
1987,4235,6878,9011,130097,134470,978,10.753,1146,12.600,19984,7319,12665,5.443,14.861,28479,10886,17593,8.096,21.179,-8495,-6.317,29.723,589,609,4739
1987,4236,15430,22310,314769,319597,2655,11.875,2749,12.296,61001,19472,41529,6.093,19.087,71008,28896,42112,9.041,22.218,-10007,-3.131,38.174,1423,1483,8645
1987,4237,11024,14907,163250,163547,1405,9.468,1271,8.565,24571,6883,17688,4.209,15.024,25123,8441,16682,5.161,15.361,-552,-0.338,30.048,781,804,5025
1987,4238,47214,61252,644531,644281,5979,9.701,6739,10.934,111667,36249,75418,5.626,17.332,111267,42459,68808,6.590,17.270,400,0.062,34.540,3769,3871,20770
1987,4239,24313,25874,240542,237730,4153,16.195,3691,14.394,52953,18938,34015,7.966,22.274,47507,20320,27187,8.548,19.984,5446,2.291,39.967,2783,2805,13304
1987,4241,8385,11185,166954,160953,1205,10.898,950,8.591,30921,7101,23820,4.412,19.211,19185,6457,12728,4.012,11.920,11736,7.292,23.839,574,580,3186
1987,4242,2915,3854,106837,104276,616,16.174,525,13.785,21348,8215,13133,7.878,20.473,16045,6519,9526,6.252,15.387,5303,5.086,30.774,341,343,2405
1987,4243,11495,12406,148732,144361,2010,16.223,1978,15.964,36499,12307,24192,8.525,25.283,27709,11985,15724,8.302,19.194,8790,6.089,38.389,1444,1460,7154
1987,4244,27502,33923,667849,659429,4254,12.562,4138,12.219,123844,41885,81959,6.352,18.781,106756,41593,65163,6.307,16.189,17088,2.591,32.378,2923,2970,22732
1987,4245,7204,10103,88764,88741,670,6.532,978,9.535,15768,4342,11426,4.893,17.769,15913,5562,10351,6.268,17.932,-145,-0.163,35.537,601,625,3564
1987,4246,7461,10708,127240,126302,1260,11.726,1335,12.424,25432,9193,16239,7.279,20.136,23853,9792,14061,7.753,18.886,1579,1.250,37.771,605,627,2721
1987,4247,9921,12953,144261,142640,1145,8.737,1450,11.064,29612,9422,20190,6.605,20.760,26422,10067,16355,7.058,18.524,3190,2.236,37.047,761,789,4963
1987,4248,4037,5129,140547,138282,348,6.638,575,10.968,20419,6548,13871,4.735,14.766,15901,7001,8900,5.063,11.499,4518,3.267,22.998,383,402,4569
1987,4249,20641,25033,285949,282808,3517,14.143,3187,12.816,56499,19136,37363,6.766,19.978,49828,20754,29074,7.339,17.619,6671,2.359,35.238,2138,2155,10825
1987,4251,30427,32930,309130,307736,4164,12.732,3714,11.356,60214,22885,37329,7.437,19.567,57358,23972,33386,7.790,18.639,2856,0.928,37.277,2313,2325,12791
1987,4411,38442,40082,982804,962307,5007,12.625,4163,10.497,156679,64085,92594,6.660,16.282,115694,45845,69849,4.764,12.023,40985,4.259,24.045,3339,3359,36333
1987,4412,11461,12053,89959,87628,1512,12.611,1386,11.560,20917,7288,13629,8.317,23.870,16298,6841,9457,7.807,18.599,4619,5.271,37.198,1080,1096,5374
1987,4413,49550,73768,517243,506245,8441,11.633,6030,8.310,109093,47431,61662,9.369,21.549,87086,29359,57727,5.799,17.202,22007,4.347,34.405,3554,3690,16604
1987,4421,21936,27793,235824,233480,3464,12.497,3316,11.963,48446,18054,30392,7.733,20.750,43872,18243,25629,7.814,18.790,4574,1.959,37.581,2127,2240,10576
1987,4422,22444,27821,169242,162909,4332,15.884,3235,11.862,45129,18801,26328,11.541,27.702,32194,14638,17556,8.985,19.762,12935,7.940,39.524,2121,2184,7977
1987,4431,20042,27249,187450,193235,4215,14.873,6397,22.572,45883,19686,26197,10.188,23.745,57423,33039,24384,17.098,29.717,-11540,-5.972,47.489,3845,4106,19103
1987,4441,55430,71268,767077,748343,6892,9.661,7030,9.855,152002,55357,96645,7.397,20.312,115324,52379,62945,6.999,15.411,36678,4.901,30.821,4546,4656,24796
1987,4442,15827,19328,142991,141233,2173,11.340,1841,9.608,27737,9839,17898,6.967,19.639,24270,7464,16806,5.285,17.184,3467,2.455,34.369,1320,1330,5098
1987,4451,63133,95627,2194774,2139341,12742,13.198,14573,15.095,415655,204700,210955,9.568,19.429,305479,147645,157834,6.901,14.279,110176,5.150,28.558,8117,8412,57980
1987,4452,22105,26124,167745,169175,4190,15.771,5076,19.106,42541,20389,22152,12.052,25.146,45224,24405,20819,14.426,26.732,-2683,-1.586,50.292,3386,3479,14965
1987,4453,27331,32359,157485,160799,3588,10.945,4437,13.534,31943,12941,19002,8.048,19.865,38466,16761,21705,10.424,23.922,-6523,-4.057,39.730,3242,3294,11974
1987,4461,47382,73774,698763,673855,7525,10.299,6101,8.350,147359,56174,91185,8.336,21.868,96411,37195,59216,5.520,14.307,50948,7.561,28.615,3900,4009,21529
1987,4471,87476,135941,946571,926062,16593,12.256,15482,11.435,227918,100434,127484,10.845,24.612,185993,75030,110963,8.102,20.084,41925,4.527,40.169,10260,10504,46757
1987,4481,55148,101879,922007,911144,15837,15.758,13085,13.020,215453,112812,102641,12.381,23.646,194274,74712,119562,8.200,21.322,21179,2.324,42.644,7399,7901,32378
1987,4482,11306,36855,200102,200062,4240,11.527,4099,11.143,43195,19820,23375,9.907,21.591,42350,16628,25722,8.311,21.168,845,0.422,42.337,1738,2005,7901
1987,4483,18883,27951,171597,164898,3675,13.245,3267,11.774,46071,16384,29687,9.936,27.939,31754,14634,17120,8.875,19.257,14317,8.682,38.514,2018,2094,8451
1987,4511,32015,41650,293991,285931,6479,15.668,5882,14.224,72456,32861,39595,11.493,25.340,55775,24564,31211,8.591,19.506,16681,5.834,39.013,4048,4199,14913
1987,4512,8024,12242,82395,81040,1765,14.578,1496,12.356,17885,7433,10452,9.172,22.069,15405,6840,8565,8.440,19.009,2480,3.060,38.018,947,982,3637
1987,4521,292,9466,1564235,1573462,582,6.136,619,6.526,161055,79909,81146,5.079,10.236,182184,66273,115911,4.212,11.579,-21129,-1.343,20.471,41,54,3022
1987,4529,11537,24055,412813,409559,2710,11.235,2842,11.782,71980,33672,38308,8.222,17.575,64734,23972,40762,5.853,15.806,7246,1.769,31.612,1638,1672,7863
1987,4531,22739,24224,122875,122682,3437,14.264,3181,13.201,26482,10583,15899,8.626,21.586,26224,10716,15508,8.735,21.376,258,0.210,42.751,2391,2414,7886
1987,4532,29269,36260,225164,225714,6418,18.126,4714,13.313,56353,24629,31724,10.912,24.967,56853,32249,24604,14.288,25.188,-500,-0.222,49.933,3360,3421,12864
1987,4533,8986,11101,56525,55955,1836,16.695,1628,14.804,12555,5420,7135,9.686,22.438,11391,5063,6328,9.048,20.357,1164,2.080,40.715,1251,1257,3651
1987,4539,23017,26749,137387,135821,4861,18.022,5308,19.679,39642,17894,21748,13.175,29.187,36623,19589,17034,14.423,26.964,3019,2.223,53.928,3586,3791,13712
1987,4541,5335,6619,99000,95375,948,14.376,899,13.633,22492,7205,15287,7.554,23.583,15300,7078,8222,7.421,16.042,7192,7.541,32.084,667,671,3870
1987,4542,3883,4849,71978,72456,616,12.655,653,13.416,13063,4784,8279,6.603,18.029,14128,5466,8662,7.544,19.499,-1065,-1.470,36.058,412,414,2230
1987,4543,16039,21917,218220,221794,2068,9.259,2904,13.002,44237,12534,31703,5.651,19.945,50805,28784,22021,12.978,22.906,-6568,-2.961,39.890,1688,1704,7675
1987,4811,648,2419,295792,282997,315,13.898,10,0.441,40819,7244,33575,2.560,14.424,14830,19,14811,0.007,5.240,25989,9.184,10.481,10,10,19
1987,4812,398,710,15191,14051,150,23.274,19,2.948,4989,2576,2413,18.334,35.508,2632,204,2428,1.452,18.732,2357,16.775,37.465,16,16,197
1987,4831,309,601,31480,30300,79,13.958,9,1.590,7936,3124,4812,10.310,26.192,5553,109,5444,0.360,18.327,2383,7.865,36.654,8,8,106
1987,4832,308,343,12637,11848,36,10.959,7,2.131,2786,279,2507,2.355,23.516,1252,21,1231,0.177,10.568,1534,12.948,21.135,6,6,12
1987,4841,19725,25547,523097,493763,4553,19.170,961,4.046,109237,36966,72271,7.487,22.123,50529,4501,46028,0.912,10.233,58708,11.890,20.467,804,804,3926
1987,4842,47963,52258,550573,522384,9735,20.273,1257,2.618,126555,48645,77910,9.312,24.226,70350,5662,64688,1.084,13.467,56205,10.759,26.934,959,959,4589
1987,4851,356,382,29102,28037,40,10.870,12,3.261,3051,695,2356,2.479,10.882,1021,27,994,0.096,3.642,2030,7.240,7.283,11,11,26
1987,4852,302,470,18649,18079,64,14.562,3,0.683,2992,991,2001,5.482,16.550,1885,3,1882,0.017,10.427,1107,6.123,20.854,(D),(D),(D)
1987,4853,4325,4358,47314,45118,792,19.662,132,3.277,9882,3627,6255,8.039,21.903,5416,365,5051,0.809,12.004,4466,9.899,24.008,114,114,289
1987,4854,2974,3218,92662,87086,320,10.381,49,1.590,17592,6065,11527,6.964,20.201,6314,223,6091,0.256,7.250,11278,12.950,14.501,42,42,207
1987,4855,630,670,15921,14706,112,18.108,9,1.455,3880,1399,2481,9.513,26.384,1438,34,1404,0.231,9.778,2442,16.605,19.557,7,7,19
1987,4859,843,871,15721,14551,185,23.241,35,4.397,3946,1580,2366,10.858,27.118,1682,209,1473,1.436,11.559,2264,15.559,23.119,29,29,154
1987,4861,56,266,8604,8723,27,10.672,(D),(D),866,294,572,3.370,9.928,1048,(D),1046,(D),12.014,-182,-2.086,19.856,(D),(D),(D)
1987,4862,227,1198,58791,57901,62,5.304,4,0.342,5806,1041,4765,1.798,10.028,4042,30,4012,0.052,6.981,1764,3.047,13.962,4,4,30
1987,4869,63,327,7327,8016,13,4.056,0,0.000,437,144,293,1.796,5.452,1843,0,1843,0.000,22.992,-1406,-17.540,10.903,0,0,0
1987,4871,223,228,4159,3732,44,20.903,9,4.276,1434,332,1102,8.897,38.430,551,17,534,0.456,14.766,883,23.663,29.532,7,7,14
1987,4872,642,651,8811,8207,142,22.611,96,15.287,2346,656,1690,7.993,28.585,1173,408,765,4.971,14.293,1173,14.293,28.585,75,75,227
1987,4879,45,67,859,1113,12,18.898,5,7.874,173,73,100,6.562,15.551,668,11,657,0.989,60.045,-495,-44.494,31.101,4,4,10
1987,4881,1908,2407,61992,58331,368,16.392,44,1.960,13239,5139,8100,8.810,22.696,5838,146,5692,0.250,10.008,7401,12.688,20.017,34,34,133
1987,4882,341,490,10857,9816,96,21.525,8,1.794,2789,1500,1289,15.281,28.413,778,32,746,0.326,7.926,2011,20.487,15.852,6,6,29
1987,4883,2066,2469,86788,83533,340,14.684,33,1.425,23281,6794,16487,8.133,27.870,16909,743,16166,0.889,20.242,6372,7.628,40.485,28,28,730
1987,4884,490,533,6346,6820,120,18.086,381,57.423,1580,888,692,13.021,23.169,2545,1817,728,26.644,37.319,-965,-14.151,46.338,323,323,1281
1987,4885,6531,8657,102318,96190,1596,20.006,237,2.971,25324,10410,14914,10.822,26.327,13211,1655,11556,1.721,13.734,12113,12.593,27.469,196,196,1551
1987,4889,510,518,5846,5470,149,32.568,28,6.120,1726,695,1031,12.707,31.557,998,66,932,1.207,18.247,728,13.310,36.493,20,20,50
1987,4921,1626,2929,346201,317914,630,23.774,72,2.717,74680,13246,61434,4.167,23.491,17828,294,17534,0.092,5.608,56852,17.883,11.216,61,61,231
1987,4922,3688,3919,53099,49907,862,24.343,106,2.994,13702,6048,7654,12.119,27.455,7383,355,7028,0.711,14.794,6319,12.662,29.587,81,81,236
1987,4931,6191,9805,400949,398725,1171,12.065,972,10.015,73004,28284,44720,7.094,18.309,67853,27890,39963,6.995,17.018,5151,1.292,34.035,372,377,3801
1987,5111,13896,16173,676095,673176,1784,11.013,1835,11.328,74981,23998,50983,3.565,11.138,69125,30170,38955,4.482,10.268,5856,0.870,20.537,1393,1408,12580
1987,5112,2687,3068,64164,66813,661,18.612,1628,45.840,17336,6852,10484,10.255,25.947,22539,16829,5710,25.188,33.734,-5203,-7.787,51.894,1091,1102,8098
1987,5121,9686,14441,228589,236004,2424,16.739,2504,17.292,51201,19888,31313,8.427,21.695,64996,20144,44852,8.535,27.540,-13795,-5.845,43.390,1312,1373,7251
1987,5122,1761,1768,13032,12526,421,23.467,473,26.366,4971,1779,3192,14.203,39.687,3896,2459,1437,19.632,31.105,1075,8.582,62.209,389,389,1485
1987,5151,5525,6746,218979,207820,1160,18.725,58,0.936,44178,27142,17036,13.060,21.258,21317,289,21028,0.139,10.257,22861,11.000,20.515,51,51,241
1987,5152,6,12,1099,797,(D),(D),4,38.095,620,(D),124,(D),77.841,19,19,0,2.385,2.385,601,75.455,4.771,3,3,15
1987,5171,2546,15647,837325,813985,3067,21.618,148,1.043,207744,141910,65834,17.434,25.522,160243,1311,158932,0.161,19.686,47501,5.836,39.372,137,137,1178
1987,5172,619,1615,64861,62394,338,22.799,73,4.924,16044,9918,6126,15.896,25.714,11025,382,10643,0.612,17.670,5019,8.044,35.340,67,67,362
1987,5174,597,1215,60503,55215,201,17.995,5,0.448,16137,7705,8432,13.955,29.226,5393,11,5382,0.020,9.767,10744,19.458,19.535,5,5,11
1987,5179,1202,2673,73807,72918,572,23.476,99,4.063,15964,10254,5710,14.062,21.893,14103,263,13840,0.361,19.341,1861,2.552,38.682,93,93,240
1987,5182,5463,7164,241620,238469,1127,15.574,1272,17.578,55431,22547,32884,9.455,23.245,49021,22267,26754,9.338,20.557,6410,2.688,41.113,656,664,5522
1987,5191,2257,2723,36798,36636,334,12.302,318,11.713,5076,2055,3021,5.609,13.855,4803,2228,2575,6.082,13.110,273,0.745,26.220,222,223,1442
1987,5211,44,82,24565,24851,4,5.000,0,0.000,596,194,402,0.781,2.398,1144,0,1144,0.000,4.603,-548,-2.205,4.797,0,0,0
1987,5221,18342,70427,1966865,1928999,3737,5.437,356,0.518,248723,70294,178429,3.644,12.894,172478,5141,167337,0.267,8.941,76245,3.953,17.883,334,334,5047
1987,5222,19874,36567,452546,421623,3613,10.299,642,1.830,97621,30478,67143,7.229,23.154,35446,4441,31005,1.053,8.407,62175,14.747,16.814,509,509,2447
1987,5223,3954,4434,60798,54968,1073,26.665,253,6.287,16948,7194,9754,13.088,30.833,5253,1244,4009,2.263,9.557,11695,21.276,19.113,228,228,1088
1987,5231,5941,12293,349553,324579,1900,16.556,267,2.326,70905,18476,52429,5.692,21.845,20658,2283,18375,0.703,6.365,50247,15.481,12.729,225,225,2049
1987,5232,96,109,6971,6713,15,14.778,0,0.000,671,77,594,1.147,9.996,164,0,164,0.000,2.443,507,7.553,4.886,0,0,0
1987,5239,13695,14218,146384,127909,3547,27.916,523,4.116,54267,29129,25138,22.773,42.426,17743,2665,15078,2.084,13.872,36524,28.555,27.743,412,412,2060
1987,5241,6403,28077,1264814,1239339,4548,17.568,170,0.657,163957,44003,119954,3.551,13.229,110361,1134,109227,0.092,8.905,53596,4.325,17.810,153,153,1067
1987,5242,92570,97049,750732,692555,12749,13.917,1860,2.030,184657,80455,104202,11.617,26.663,67637,7075,60562,1.022,9.766,117020,16.897,19.533,1405,1405,4966
1987,5250,1860,2095,19648,17658,356,18.412,33,1.707,5870,2360,3510,13.365,33.243,1849,266,1583,1.506,10.471,4021,22.772,20.942,20,20,84
1987,5311,85857,89113,494313,466320,12536,14.896,2621,3.114,118133,54178,63955,11.618,25.333,62420,10422,51998,2.235,13.386,55713,11.947,26.771,2237,2240,7330
1987,5312,35751,37744,219969,203980,7253,20.802,1500,4.302,62104,27996,34108,13.725,30.446,29962,5530,24432,2.711,14.689,32142,15.757,29.377,1277,1277,4923
1987,5313,22499,23518,269940,249285,4743,21.889,1043,4.814,74337,31709,42628,12.720,29.820,33053,5119,27934,2.053,13.259,41284,16.561,26.518,905,905,4182
1987,5321,6131,10138,135421,137299,1719,17.091,1559,15.500,29099,13771,15328,10.030,21.194,33472,12739,20733,9.278,24.379,-4373,-3.185,42.388,877,937,5580
1987,5322,19134,23150,144712,141154,6880,32.083,3469,16.177,54855,30094,24761,21.320,38.862,48246,28426,19820,20.138,34.180,6609,4.682,68.360,2087,2119,11315
1987,5323,4188,5363,37535,37237,1000,19.207,687,13.195,9864,4560,5304,12.246,26.490,9356,4714,4642,12.660,25.126,508,1.364,50.252,423,429,2443
1987,5324,7863,9690,90557,92521,1747,18.466,1288,13.615,23262,8539,14723,9.229,25.143,27865,13233,14632,14.303,30.118,-4603,-4.975,50.285,711,718,4282
1987,5331,752,783,11734,10466,174,24.455,31,4.357,3842,1834,2008,17.524,36.711,1336,124,1212,1.185,12.766,2506,23.945,25.532,24,24,98
1987,5411,129360,133682,854580,824085,15859,12.015,12489,9.462,168012,55276,112736,6.708,20.388,106402,42020,64382,5.099,12.912,61610,7.476,25.823,9095,9152,31853
1987,5412,65310,69346,577334,560585,10980,16.228,7606,11.242,121566,42299,79267,7.546,21.686,87782,36822,50960,6.569,15.659,33784,6.027,31.318,5508,5553,24726
1987,5413,57695,63662,828459,820550,10484,16.819,7831,12.563,172485,57361,115124,6.991,21.021,156633,52214,104419,6.363,19.089,15852,1.932,38.178,5526,5559,25469
1987,5414,14565,14775,91813,90405,2756,18.995,2224,15.328,24052,9443,14609,10.445,26.605,21387,10113,11274,11.186,23.657,2665,2.948,47.314,1761,1766,7609
1987,5415,17761,20015,298830,275399,5235,27.829,2828,15.033,90477,37171,53306,13.497,32.853,43148,14410,28738,5.232,15.667,47329,17.186,31.335,2166,2170,9864
1987,5416,39655,41132,314695,306572,10434,25.934,8637,21.467,111526,52576,58950,17.150,36.378,95042,53280,41762,17.379,31.002,16484,5.377,62.003,6638,6645,38273
1987,5417,6555,7974,430230,429673,1396,17.927,1022,13.124,66120,20502,45618,4.772,15.388,64984,22677,42307,5.278,15.124,1136,0.264,30.248,592,595,4567
1987,5418,25205,27432,328892,328321,5035,18.680,4080,15.137,74446,27705,46741,8.438,22.675,72968,34641,38327,10.551,22.225,1478,0.450,44.449,3044,3082,20383
1987,5419,30290,33867,247948,242891,4268,12.913,2638,7.981,54567,19014,35553,7.828,22.466,44378,15440,28938,6.357,18.271,10189,4.195,36.541,1886,1888,8835
1987,5511,24020,43747,2976730,2996466,5303,12.262,4305,9.954,551311,177702,373609,5.930,18.399,592082,166141,425941,5.545,19.759,-40771,-1.361,36.797,526,556,9626
1987,5611,12407,13051,212397,200484,3135,25.194,1920,15.430,66381,31752,34629,15.838,33.110,42630,13342,29288,6.655,21.264,23751,11.847,42.527,1395,1402,8559
1987,5612,353,476,58126,57009,70,15.385,28,6.154,11797,5970,5827,10.472,20.693,8922,592,8330,1.038,15.650,2875,5.043,31.300,20,20,326
1987,5613,15294,20838,1094529,1065673,4387,21.885,2803,13.983,354397,124821,229576,11.713,33.256,297812,82486,215326,7.740,27.946,56585,5.310,55.892,1803,1820,37380
1987,5614,20512,23272,252517,242227,4122,18.167,2958,13.037,66244,25917,40327,10.699,27.348,46102,17382,28720,7.176,19.033,20142,8.315,38.065,2207,2223,10658
1987,5615,22658,26610,205771,201642,3986,15.142,3415,12.973,50033,20431,29602,10.132,24.813,41517,18847,22670,9.347,20.589,8516,4.223,41.179,2449,2523,12108
1987,5616,12000,14687,443781,451381,2553,17.571,2239,15.409,103499,45310,58189,10.038,22.929,116368,59806,56562,13.250,25.780,-12869,-2.851,45.859,1506,1646,25573
1987,5617,68901,72189,941129,908859,16649,24.348,9028,13.203,244967,92737,152230,10.204,26.953,180383,61539,118844,6.771,19.847,64584,7.106,39.694,7235,7248,41087
1987,5619,13655,14667,203181,194938,2805,19.670,1992,13.969,53983,20251,33732,10.388,27.692,37561,14198,23363,7.283,19.268,16422,8.424,38.536,1454,1459,9295
1987,5621,2610,2653,28873,27294,261,10.130,108,4.192,5502,1613,3889,5.910,20.159,2383,852,1531,3.122,8.731,3119,11.428,17.462,100,100,821
1987,5622,1560,2154,53893,49902,312,15.549,17,0.847,11532,3501,8031,7.016,23.109,3534,57,3477,0.114,7.082,7998,16.027,14.164,14,14,48
1987,5629,4556,4793,47384,44072,822,17.677,536,11.527,14156,4784,9372,10.855,32.120,7510,2764,4746,6.272,17.040,6646,15.080,34.081,377,377,1734
1987,6111,12960,13908,423652,416068,585,4.291,36,0.264,41402,7068,34334,1.699,9.951,26192,387,25805,0.093,6.295,15210,3.656,12.590,13,13,241
1987,6112,456,637,50188,47333,97,16.441,(D),(D),10167,2289,7878,4.836,21.480,4559,(D),2607,(D),9.632,5608,11.848,19.264,0,0,0
1987,6113,1932,2243,930232,915535,91,4.135,6,0.273,75594,2534,73060,0.277,8.257,45858,19,45839,0.002,5.009,29736,3.248,10.018,(D),(D),(D)
1987,6114,2198,2700,44558,43336,499,18.884,384,14.532,11078,4783,6295,11.037,25.563,8362,4360,4002,10.061,19.296,2716,6.267,38.591,277,280,2530
1987,6115,3735,4512,57716,54940,673,15.273,462,10.485,15647,4913,10734,8.943,28.480,9766,3398,6368,6.185,17.776,5881,10.705,35.552,318,325,2410
1987,6116,10775,11335,88534,86255,2173,19.343,1971,17.545,23352,10081,13271,11.688,27.073,18893,8570,10323,9.936,21.904,4459,5.170,43.808,1565,1579,6945
1987,6117,1630,1665,16345,16243,324,19.908,249,15.300,3365,1185,2180,7.296,20.717,3204,1599,1605,9.845,19.726,161,0.991,39.452,185,185,1103
1987,6211,183244,191185,1242707,1204025,16212,8.512,14780,7.760,258885,81542,177343,6.772,21.502,181630,61985,119645,5.148,15.085,77255,6.416,30.170,11579,11657,46880
1987,6212,97433,99956,490413,483384,6230,6.253,5577,5.598,78362,21317,57045,4.410,16.211,64239,20237,44002,4.187,13.289,14123,2.922,26.579,4195,4237,15606
1987,6213,48937,51258,187958,180017,7162,14.294,4856,9.692,48884,21177,27707,11.764,27.155,32801,14780,18021,8.210,18.221,16083,8.934,36.442,3624,3651,11545
1987,6214,7083,10605,179755,172025,2005,19.948,897,8.924,47496,20525,26971,11.931,27.610,32023,11428,20595,6.643,18.615,15473,8.995,37.231,544,560,6343
1987,6215,4808,6158,89212,85551,1006,16.631,788,13.027,23690,10227,13463,11.954,27.691,16581,7602,8979,8.886,19.382,7109,8.310,38.763,515,531,3318
1987,6216,4408,6229,293192,283222,1210,19.818,963,15.773,76705,25880,50825,9.138,27.083,57305,14994,42311,5.294,20.233,19400,6.850,40.467,638,641,6819
1987,6219,4785,5644,108964,106206,1094,20.323,572,10.626,27967,11650,16317,10.969,26.333,22522,11701,10821,11.017,21.206,5445,5.127,42.412,377,383,4973
1987,6221,4375,5792,3653242,3689320,673,12.320,14,0.256,574917,365504,209413,9.907,15.583,641765,700,641065,0.019,17.395,-66848,-1.812,31.167,9,9,444
1987,6222,518,814,279798,439052,281,41.691,(D),(D),153912,145300,8612,33.094,35.056,474889,(D),474870,(D),108.162,-320977,-73.107,70.111,(D),(D),(D)
1987,6223,221,263,98657,124831,67,29.067,(D),(D),30354,25848,4506,20.706,24.316,80469,(D),80464,(D),64.462,-50115,-40.146,48.632,(D),(D),(D)
1987,6231,6843,11083,967422,946891,1216,11.201,762,7.019,147853,77533,70320,8.188,15.615,107800,49399,58401,5.217,11.385,40053,4.230,22.769,470,485,31400
1987,6232,5036,7504,178027,171683,1067,14.766,511,7.072,37496,15979,21517,9.307,21.840,25119,8451,16668,4.922,14.631,12377,7.209,29.262,354,356,6102
1987,6233,9622,11690,397681,397518,1889,16.382,1571,13.624,80460,41637,38823,10.474,20.241,80480,48995,31485,12.325,20.246,-20,-0.005,40.481,970,1007,28405
1987,6239,3172,4033,103018,99307,494,12.568,289,7.353,18856,6947,11909,6.996,18.988,11351,4409,6942,4.440,11.430,7505,7.557,22.861,181,185,2944
1987,6241,15879,21282,304251,296363,2233,10.673,1511,7.222,52605,13576,39029,4.581,17.750,37129,9257,27872,3.124,12.528,15476,5.222,25.056,847,857,4542
1987,6242,4565,5365,50306,49280,529,9.993,386,7.292,9245,2187,7058,4.438,18.760,7123,2140,4983,4.343,14.454,2122,4.306,28.909,234,235,1015
1987,6243,4410,6472,260335,256044,713,11.297,392,6.211,48039,7751,40288,3.027,18.762,40131,6259,33872,2.445,15.674,7908,3.089,31.347,183,189,2933
1987,6244,31932,37868,349077,340869,5054,13.500,4194,11.203,72166,29917,42249,8.777,21.171,55896,22252,33644,6.528,16.398,16270,4.773,32.796,3189,3226,15876
1987,7111,5224,5270,72364,69947,963,18.555,803,15.472,23008,6857,16151,9.803,32.893,18513,5245,13268,7.499,26.467,4495,6.426,52.934,602,603,3242
1987,7112,2380,2503,72129,68962,497,20.336,379,15.507,19846,5521,14325,8.006,28.778,13289,3206,10083,4.649,19.270,6557,9.508,38.540,284,284,2119
1987,7113,2113,2165,30911,32057,407,18.988,364,16.982,8543,2746,5797,8.566,26.649,10847,2703,8144,8.432,33.837,-2304,-7.187,53.299,275,275,1998
1987,7114,1053,1073,11386,11459,199,18.721,179,16.839,3486,1180,2306,10.298,30.423,3615,1304,2311,11.380,31.549,-129,-1.126,60.846,136,136,1004
1987,7115,8803,8830,55806,56422,2495,27.587,2923,32.320,18944,7997,10947,14.174,33.576,20523,10795,9728,19.133,36.374,-1579,-2.799,67.151,2347,2347,8989
1987,7121,2693,2885,53062,51746,239,8.399,160,5.623,6778,1235,5543,2.387,13.099,4153,748,3405,1.446,8.026,2625,5.073,16.051,109,109,581
1987,7131,1640,2222,61098,61913,341,15.437,315,14.260,8902,3307,5595,5.341,14.378,10124,2927,7197,4.728,16.352,-1222,-1.974,28.756,232,235,2152
1987,7132,625,655,20529,19622,128,19.723,116,17.874,4293,1763,2530,8.985,21.879,2476,1320,1156,6.727,12.618,1817,9.260,25.237,91,91,1069
1987,7139,35287,38616,577053,559958,6174,16.488,3832,10.234,128205,55278,72927,9.872,22.895,94104,31602,62502,5.644,16.806,34101,6.090,33.611,2832,2845,22085
1987,7211,29555,34738,1288101,1290255,5267,15.279,4737,13.741,255153,134400,120753,10.417,19.775,258852,121433,137419,9.412,20.062,-3699,-0.287,39.551,3339,3425,67012
1987,7212,3754,4010,25381,24938,536,13.362,539,13.436,7248,2596,4652,10.410,29.065,6319,2664,3655,10.683,25.339,929,3.725,50.679,353,354,1355
1987,7213,3781,3877,21029,20334,318,8.104,412,10.499,4583,1214,3369,5.970,22.539,3324,1585,1739,7.795,16.347,1259,6.192,32.695,275,275,1106
1987,7223,17805,31345,578896,560294,8405,28.544,4606,15.642,166447,104552,61895,18.660,29.707,129192,61132,68060,10.911,23.058,37255,6.649,46.116,2615,2628,28334
1987,7224,52309,53035,313820,311350,8829,16.547,9474,17.756,90719,50278,40441,16.148,29.137,85657,42288,43369,13.582,27.512,5062,1.626,55.023,7604,7640,33588
1987,7225,204479,273459,5203788,5077427,49520,18.417,40364,15.012,1312773,722570,590203,14.231,25.855,1062975,479995,582980,9.454,20.935,249798,4.920,41.871,29874,30603,312234
1987,8111,110577,116908,599179,585172,20216,17.586,16306,14.185,153834,76493,77341,13.072,26.289,125691,59064,66627,10.093,21.479,28143,4.809,42.959,12012,12112,44256
1987,8112,10963,13048,106865,106712,2136,16.718,1593,12.468,24007,11695,12312,10.959,22.497,23499,8692,14807,8.145,22.021,508,0.476,44.042,1141,1142,3457
1987,8113,19690,20685,150485,152852,2920,14.226,2603,12.681,29161,10478,18683,6.855,19.078,33560,13142,20418,8.598,21.956,-4399,-2.878,38.156,1839,1841,8389
1987,8114,25272,26866,161175,159543,4656,17.575,3909,14.755,35517,16118,19399,10.103,22.262,32251,12927,19324,8.103,20.215,3266,2.047,40.429,2946,2954,8493
1987,8121,75600,84196,429430,428237,12827,15.147,13804,16.301,102368,52334,50034,12.221,23.905,100493,51692,48801,12.071,23.467,1875,0.438,46.933,10844,10953,38083
1987,8122,16944,20001,122710,120000,1605,8.066,1402,7.045,22107,6068,16039,5.057,18.423,16699,5354,11345,4.462,13.916,5408,4.507,27.832,961,981,4100
1987,8123,33118,39459,362553,358644,5781,14.758,5209,13.297,71549,30918,40631,8.621,19.950,63412,28651,34761,7.989,17.681,8137,2.269,35.362,3716,3863,18894
1987,8129,11934,20233,178021,175919,4231,21.589,2960,15.104,44669,19305,25364,10.974,25.392,40333,18065,22268,10.269,22.927,4336,2.465,45.854,1674,1739,8871
1987,8131,123569,123648,1004226,983185,6880,5.715,370,0.307,124567,20625,103942,2.098,12.670,82811,1139,81672,0.116,8.423,41756,4.247,16.845,77,77,156
1987,8132,7933,8987,119692,115764,954,10.928,440,5.040,20874,5237,15637,4.524,18.032,12989,2544,10445,2.198,11.220,7885,6.811,22.441,277,281,1590
1987,8133,7415,8544,96475,94946,966,11.467,727,8.630,18323,5883,12440,6.196,19.298,15285,5156,10129,5.430,16.099,3038,3.200,32.197,463,474,2902
1987,8134,29028,30444,266547,263467,2332,7.696,2045,6.749,38971,9019,29952,3.423,14.792,32841,7368,25473,2.797,12.465,6130,2.327,24.930,1397,1397,4889
1987,8139,54393,56608,451961,443280,4753,8.594,2152,3.891,78383,22033,56350,4.970,17.683,61345,9106,52239,2.054,13.839,17038,3.844,27.678,1457,1462,6045
1988,2111,7155,8733,124691,128233,1039,11.737,1278,14.437,21842,6880,14962,5.365,17.033,29155,9958,19197,7.766,22.736,-7313,-5.703,34.066,821,832,3323
1988,2121,2240,2813,145549,148907,479,16.751,572,20.003,24777,12057,12720,8.097,16.639,31713,12411,19302,8.335,21.297,-6936,-4.658,33.278,411,414,6952
1988,2122,500,641,41504,38445,158,25.260,127,20.304,11260,3427,7833,8.914,29.289,5436,1433,4003,3.727,14.140,5824,15.149,28.280,85,85,480
1988,2123,3545,5079,107411,104813,489,9.667,448,8.856,18817,7262,11555,6.929,17.953,13668,4631,9037,4.418,13.040,5149,4.913,26.081,261,263,1683
1988,2131,8139,9309,162241,163058,1321,13.839,1794,18.794,46815,10924,35891,6.699,28.711,48224,24334,23890,14.924,29.575,-1409,-0.864,57.421,1097,1107,6710
1988,2211,1713,6043,597723,594697,330,5.609,10,0.170,32115,10471,21644,1.761,5.400,25892,79,25813,0.013,4.354,6223,1.046,8.708,9,9,76
1988,2212,594,2511,141482,137551,270,11.361,(D),(D),13658,7572,6086,5.505,9.929,5864,(D),5862,(D),4.263,7794,5.666,8.526,0,0,0
1988,2213,3836,4100,31906,30581,366,9.315,24,0.611,4728,1845,2883,6.033,15.461,2051,91,1960,0.298,6.707,2677,8.754,13.414,18,18,53
1988,2361,107272,107664,636520,630047,22345,21.017,19659,18.490,204784,85622,119162,13.590,32.503,192015,81585,110430,12.949,30.476,12769,2.027,60.953,14538,14541,60570
1988,2362,38283,38982,702319,697956,5276,13.539,5247,13.465,188130,36452,151678,5.223,26.954,178143,48849,129294,6.999,25.524,9987,1.431,51.047,3979,3984,33064
1988,2371,13606,13893,301301,302712,1428,10.309,1346,9.717,65217,12781,52436,4.222,21.544,68536,16036,52500,5.297,22.641,-3319,-1.096,43.089,1010,1012,8919
1988,2372,9804,10030,77613,75698,2367,23.836,2168,21.832,29244,15205,14039,20.086,38.632,25429,12191,13238,16.105,33.593,3815,5.040,67.185,1759,1776,9895
1988,2373,9556,9947,263528,259716,1154,11.670,1038,10.497,57648,10998,46650,4.235,22.197,50014,11066,38948,4.261,19.257,7634,2.939,38.514,782,783,7143
1988,2379,5309,5372,68146,78632,826,15.278,895,16.554,17178,5813,11365,7.393,21.846,39235,21020,18215,26.732,49.897,-22057,-28.051,43.692,688,690,3607
1988,2381,76219,76665,732619,726651,12223,16.072,10995,14.457,204600,62119,142481,8.549,28.157,192257,59878,132379,8.240,26.458,12343,1.699,52.916,8318,8323,46561
1988,2382,117117,119108,1250436,1233232,16188,13.759,13280,11.287,269390,70058,199332,5.681,21.844,235598,67461,168137,5.470,19.104,33792,2.740,38.208,10183,10199,51647
1988,2383,79493,79931,669032,667416,15243,19.272,13565,17.151,192210,62094,130116,9.304,28.799,188674,64535,124139,9.669,28.269,3536,0.530,56.539,10412,10413,51683
1988,2389,40451,40677,366425,361404,6619,16.461,5683,14.134,99716,30902,68814,8.551,27.591,89763,27434,62329,7.591,24.837,9953,2.754,49.675,4324,4327,21563
1988,3111,1581,2189,54072,53663,207,9.594,144,6.674,8704,3712,4992,6.917,16.220,7980,3425,4555,6.382,14.871,724,1.349,29.741,79,80,1320
1988,3112,486,839,66243,65877,65,7.808,52,6.246,5796,1851,3945,2.810,8.798,5143,2075,3068,3.150,7.807,653,0.991,15.614,28,28,261
1988,3113,1588,1888,86732,85099,216,11.468,207,10.990,11793,2038,9755,2.395,13.858,8668,2320,6348,2.726,10.186,3125,3.672,20.372,135,139,998
1988,3114,1154,1587,169443,170675,139,8.726,151,9.479,25668,8771,16897,5.139,15.039,28143,12161,15982,7.125,16.489,-2475,-1.450,30.078,74,74,1902
1988,3115,1512,2147,136937,136783,131,5.964,230,10.471,16824,5980,10844,4.372,12.300,17149,8308,8841,6.074,12.537,-325,-0.238,24.600,133,133,1573
1988,3116,3794,4386,356144,348873,375,8.608,316,7.254,46896,13126,33770,3.762,13.442,31769,13141,18628,3.767,9.106,15127,4.336,18.212,228,228,4998
1988,3117,702,812,47337,45347,85,10.645,58,7.264,10816,4019,6797,8.863,23.852,6849,1351,5498,2.979,15.104,3967,8.748,30.207,42,42,787
1988,3118,9255,10833,309763,308113,1535,14.294,1346,12.534,43949,19148,24801,6.215,14.264,41472,16901,24571,5.485,13.460,2477,0.804,26.920,956,970,7361
1988,3119,2019,2385,131829,130818,267,11.273,234,9.880,17702,5546,12156,4.239,13.532,15899,5591,10308,4.274,12.154,1803,1.378,24.307,161,164,2527
1988,3121,1780,2284,148781,148235,225,9.864,219,9.601,20120,7967,12153,5.375,13.573,18822,6198,12624,4.181,12.697,1298,0.876,25.395,136,138,2417
1988,3122,95,133,35656,34714,10,7.519,10,7.519,4402,171,4231,0.493,12.681,2447,639,1808,1.841,7.049,1955,5.632,14.098,6,6,46
1988,3131,395,618,112756,111659,47,7.667,37,6.036,13128,5669,7459,5.077,11.757,11183,3190,7993,2.857,10.015,1945,1.742,20.031,22,22,915
1988,3132,1642,1969,257297,252442,185,9.470,154,7.883,26783,12210,14573,4.837,10.610,17323,5728,11595,2.269,6.862,9460,3.747,13.724,102,104,2151
1988,3133,1666,1962,109861,108008,261,13.898,93,4.952,15246,5537,9709,5.126,14.116,11509,3353,8156,3.104,10.656,3737,3.460,21.311,50,50,1005
1988,3141,3677,3975,130011,128881,424,10.599,475,11.874,17724,6551,11173,5.083,13.752,15441,6428,9013,4.988,11.981,2283,1.771,23.962,347,358,3467
1988,3149,3666,3789,118830,117269,516,13.821,405,10.848,21815,8326,13489,7.100,18.603,18550,7691,10859,6.558,15.818,3265,2.784,31.637,324,327,5565
1988,3151,1270,1393,135114,137075,153,10.952,161,11.525,16350,5890,10460,4.297,11.928,20461,6421,14040,4.684,14.927,-4111,-2.999,23.856,136,137,4725
1988,3152,11446,12802,779183,789366,2076,16.169,2150,16.746,127860,50175,77685,6.356,16.198,147234,67635,79599,8.568,18.652,-19374,-2.454,32.396,1809,1814,38945
1988,3159,1784,1867,70312,69964,311,17.088,217,11.923,12838,6121,6717,8.749,18.350,12164,4117,8047,5.884,17.386,674,0.963,34.772,173,174,3351
1988,3161,345,374,15139,15209,33,8.931,24,6.495,2153,591,1562,3.886,14.157,2308,586,1722,3.853,15.176,-155,-1.019,28.313,14,14,91
1988,3162,397,529,83402,82322,47,8.902,45,8.523,11242,2557,8685,3.106,13.656,8974,3410,5564,4.142,10.901,2268,2.755,21.802,28,28,1314
1988,3169,1126,1173,37950,37360,133,11.290,143,12.139,7384,2767,4617,7.406,19.765,6085,3099,2986,8.295,16.288,1299,3.477,32.575,108,108,782
1988,3211,4654,5170,148367,145653,562,10.983,456,8.911,24868,10165,14703,6.979,17.074,19501,9563,9938,6.566,13.389,5367,3.685,26.777,329,329,3225
1988,3212,1315,1620,107453,105794,181,11.295,146,9.111,14034,6175,7859,5.837,13.265,10609,4259,6350,4.026,10.028,3425,3.237,20.056,101,107,2286
1988,3219,9117,9774,286612,282419,1228,12.691,1033,10.675,47901,16730,31171,5.924,16.961,39476,13573,25903,4.806,13.978,8425,2.983,27.956,785,788,7692
1988,3221,234,555,191743,191245,36,6.551,25,4.550,9282,4033,5249,2.109,4.853,8170,2410,5760,1.260,4.272,1112,0.581,8.544,10,11,438
1988,3222,3630,5215,399461,394097,346,6.667,295,5.685,43165,13844,29321,3.513,10.953,32510,10442,22068,2.650,8.249,10655,2.704,16.498,199,201,4539
1988,3231,40959,42815,834361,820594,4922,11.637,3881,9.176,118968,37816,81152,4.608,14.498,91393,35485,55908,4.324,11.137,27575,3.360,22.275,3114,3119,22537
1988,3241,1309,2188,178266,177968,194,8.873,191,8.735,19204,5596,13608,3.144,10.791,17980,9776,8204,5.493,10.103,1224,0.688,20.206,94,97,3054
1988,3251,1158,2296,222044,227435,221,9.794,142,6.293,23955,8527,15428,3.749,10.533,34913,23063,11850,10.140,15.351,-10958,-4.818,21.065,45,45,1086
1988,3252,360,629,130822,128382,65,10.535,41,6.645,14184,7879,6305,6.137,11.048,9463,3062,6401,2.385,7.371,4721,3.677,14.742,20,20,445
1988,3253,620,896,42112,42323,69,7.599,93,10.242,4866,1988,2878,4.697,11.497,5264,2070,3194,4.891,12.438,-398,-0.940,22.995,46,49,471
1988,3254,1062,1310,163243,162323,129,9.938,105,8.089,16373,5214,11159,3.212,10.087,14879,5561,9318,3.426,9.166,1494,0.920,18.333,66,67,1907
1988,3255,1641,2159,79235,77767,183,8.543,149,6.956,10514,4044,6470,5.200,13.520,7693,3163,4530,4.067,9.892,2821,3.628,19.785,81,81,668
1988,3256,2035,2279,119584,118183,206,9.031,210,9.206,16188,3385,12803,2.864,13.697,13657,6150,7507,5.204,11.556,2531,2.142,23.112,147,148,1865
1988,3259,2143,2756,141833,138834,320,11.867,201,7.454,20372,9675,10697,6.969,14.674,14609,3429,11180,2.470,10.523,5763,4.151,21.045,118,120,1300
1988,3261,9848,11750,664513,646065,1162,10.000,902,7.762,110212,37153,73059,5.751,17.059,74093,26067,48026,4.035,11.468,36119,5.591,22.937,627,632,12184
1988,3262,2160,2605,193648,192839,241,9.294,217,8.369,20938,5410,15528,2.805,10.858,19338,10732,8606,5.565,10.028,1600,0.830,20.056,131,131,2066
1988,3271,1373,1660,83990,82787,189,11.317,209,12.515,12649,3606,9043,4.356,15.279,10172,4610,5562,5.569,12.287,2477,2.992,24.574,144,148,1445
1988,3272,1694,1948,144404,143001,252,13.190,177,9.265,16411,4096,12315,2.864,11.476,13646,5508,8138,3.852,9.543,2765,1.934,19.085,131,131,2493
1988,3273,6667,9048,189033,190508,734,8.127,701,7.762,31635,11006,20629,5.777,16.606,34198,11556,22642,6.066,17.951,-2563,-1.345,33.211,437,448,5333
1988,3274,253,348,18213,17923,40,11.511,39,11.223,2242,1188,1054,6.628,12.509,1743,668,1075,3.727,9.725,499,2.784,19.450,25,25,322
1988,3279,1903,2191,75055,73625,238,10.980,191,8.812,11153,3567,7586,4.845,15.148,8336,3762,4574,5.110,11.322,2817,3.826,22.645,129,129,1631
1988,3311,329,382,145392,134091,57,15.261,40,10.710,29269,21013,8256,15.671,21.828,6235,1005,5230,0.749,4.650,23034,17.178,9.300,28,28,415
1988,3312,523,703,64032,62052,65,9.292,58,8.292,9503,3286,6217,5.296,15.315,5413,2690,2723,4.335,8.723,4090,6.591,17.447,34,35,789
1988,3313,427,600,107432,106176,53,8.841,52,8.674,13771,7332,6439,6.906,12.970,11361,6415,4946,6.042,10.700,2410,2.270,21.400,22,22,786
1988,3314,742,891,83110,82663,86,9.734,71,8.036,9573,4080,5493,4.936,11.581,8810,4559,4251,5.515,10.658,763,0.923,21.316,35,36,535
1988,3315,2532,2792,214473,210501,211,7.582,193,6.935,29538,6821,22717,3.240,14.032,22068,10062,12006,4.780,10.484,7470,3.549,20.967,131,133,3401
1988,3321,3296,3508,146718,143541,226,6.450,218,6.221,20877,6130,14747,4.271,14.544,14636,6182,8454,4.307,10.196,6241,4.348,20.393,160,160,3147
1988,3322,1298,1423,77294,77311,109,7.709,91,6.436,8486,1744,6742,2.256,10.977,8535,2911,5624,3.765,11.040,-49,-0.063,21.953,63,63,1021
1988,3323,10030,10860,343294,339864,907,8.359,887,8.175,53556,14660,38896,4.313,15.758,46396,15746,30650,4.633,13.651,7160,2.107,27.303,646,650,8500
1988,3324,1480,1821,112259,111723,154,8.518,128,7.080,14768,4032,10736,3.609,13.218,13696,4050,9646,3.625,12.259,1072,0.960,24.518,81,81,1305
1988,3325,956,1057,77536,75677,112,10.821,68,6.570,10336,5157,5179,6.814,13.658,6723,1685,5038,2.227,8.884,3613,4.774,17.768,42,42,536
1988,3326,1617,1822,67723,66033,174,9.702,117,6.524,10003,2595,7408,3.930,15.149,6482,2825,3657,4.278,9.816,3521,5.332,19.633,73,73,1079
1988,3327,21231,21517,327806,316951,2183,10.227,1841,8.625,57544,15423,42121,4.866,18.156,35763,14164,21599,4.469,11.283,21781,6.872,22.567,1430,1431,9562
1988,3328,5501,5845,136984,143053,430,7.374,403,6.911,21829,4581,17248,3.202,15.259,32951,7204,25747,5.036,23.034,-11122,-7.775,30.519,305,305,3960
1988,3329,6437,6930,378459,369183,798,11.634,656,9.564,54424,18140,36284,4.914,14.742,35639,15368,20271,4.163,9.653,18785,5.088,19.307,474,475,4597
1988,3331,2908,3174,201160,194513,283,8.925,277,8.735,37799,10701,27098,5.501,19.433,24258,10954,13304,5.632,12.471,13541,6.962,24.942,190,192,5008
1988,3332,4093,4330,169906,166846,385,8.953,325,7.558,25865,6933,18932,4.155,15.502,19854,9802,10052,5.875,11.900,6011,3.603,23.799,241,241,4056
1988,3333,2236,2377,156557,153792,251,10.701,188,8.015,25018,10370,14648,6.743,16.267,19345,10131,9214,6.587,12.579,5673,3.689,25.157,129,129,2893
1988,3334,1636,1882,165380,164068,167,8.838,182,9.632,23222,8032,15190,4.896,14.154,20280,9272,11008,5.651,12.361,2942,1.793,24.721,119,120,2529
1988,3335,9216,9551,220040,216509,625,6.536,648,6.776,31519,8780,22739,4.055,14.558,24639,8572,16067,3.959,11.380,6880,3.178,22.760,473,475,2889
1988,3336,749,896,130312,130530,57,6.316,70,7.756,16891,6250,10641,4.788,12.940,17281,7320,9961,5.608,13.239,-390,-0.299,25.881,33,33,3543
1988,3339,5419,6011,322355,319389,490,8.178,451,7.527,47053,15130,31923,4.737,14.732,41200,21430,19770,6.710,12.900,5853,1.833,25.799,297,300,4032
1988,3341,1602,1744,270598,274542,308,18.059,231,13.544,38180,10143,28037,3.695,13.907,45639,18132,27507,6.604,16.624,-7459,-2.717,27.814,157,160,3338
1988,3342,1465,1645,251172,248736,205,12.845,107,6.704,36705,13396,23309,5.386,14.757,31709,12416,19293,4.992,12.748,4996,2.009,25.496,56,56,2182
1988,3343,374,395,31314,31742,54,13.864,43,11.040,3951,1309,2642,4.124,12.447,4575,1106,3469,3.484,14.413,-624,-1.966,24.894,29,29,523
1988,3344,4635,5258,527545,522728,750,14.556,539,10.461,71823,22796,49027,4.361,13.740,62472,22130,40342,4.234,11.951,9351,1.789,23.902,386,388,6617
1988,3345,4445,5100,679744,684237,565,11.121,526,10.353,64408,27701,36707,4.048,9.413,73954,29373,44581,4.293,10.808,-9546,-1.395,18.826,345,349,5019
1988,3346,740,783,56827,49320,148,19.733,82,10.933,19596,5179,14417,10.501,39.733,4999,1853,3146,3.757,10.136,14597,29.597,20.272,61,61,468
1988,3351,1178,1308,87799,87442,108,8.241,113,8.623,8437,2142,6295,2.450,9.649,7650,2122,5528,2.427,8.749,787,0.900,17.497,79,80,1151
1988,3352,328,411,113112,115357,53,12.911,52,12.667,16233,8551,7682,7.413,14.072,20776,15145,5631,13.129,18.010,-4543,-3.938,28.144,28,32,5056
1988,3353,2100,2584,238076,235646,218,8.471,197,7.655,30633,12720,17913,5.398,13.000,25510,8653,16857,3.672,10.826,5123,2.174,21.651,121,123,1268
1988,3359,2241,2598,194315,193744,284,10.978,262,10.128,34677,13321,21356,6.876,17.898,32929,18526,14403,9.562,16.996,1748,0.902,33.992,170,170,2189
1988,3361,226,286,244544,249945,46,16.254,40,14.134,17523,2475,15048,0.990,7.011,29237,1975,27262,0.790,11.697,-11714,-4.687,14.021,31,31,245
1988,3362,1869,2073,125028,121059,227,10.995,210,10.172,22891,9258,13633,7.648,18.909,15001,6323,8678,5.223,12.391,7890,6.517,24.783,160,160,3418
1988,3363,4003,4837,660177,663361,496,10.391,369,7.730,64524,23038,41486,3.473,9.727,70780,22066,48714,3.326,10.670,-6256,-0.943,19.454,237,238,6534
1988,3364,1406,1707,686510,676951,167,9.876,135,7.983,81767,34136,47631,5.043,12.079,63952,27764,36188,4.101,9.447,17815,2.632,18.894,84,84,944
1988,3365,163,195,28732,27157,33,17.277,25,13.089,7343,3356,3987,12.358,27.040,4043,2194,1849,8.079,14.888,3300,12.152,29.776,11,11,331
1988,3366,1235,1333,167386,161375,171,13.058,124,9.469,27307,6222,21085,3.856,16.922,15301,3133,12168,1.941,9.482,12006,7.440,18.963,93,93,1799
1988,3369,465,478,29310,29644,54,11.203,62,12.863,3109,674,2435,2.274,10.488,3867,837,3030,2.824,13.045,-758,-2.557,20.976,50,50,673
1988,3371,13213,13938,411552,403428,1986,14.416,1663,12.071,69961,27791,42170,6.889,17.342,54027,21255,32772,5.269,13.392,15934,3.950,26.784,1297,1308,13509
1988,3372,2962,3144,163449,160157,361,11.677,256,8.281,25013,8109,16905,5.063,15.618,18499,7525,10974,4.699,11.551,6514,4.067,23.101,193,193,2836
1988,3379,1107,1262,42106,41904,123,9.872,91,7.303,5683,1624,4059,3.876,13.562,5379,1342,4037,3.203,12.837,304,0.725,25.673,66,66,693
1988,3391,10460,11037,249860,244996,1182,10.735,1129,10.254,38671,12015,26656,4.904,15.784,29437,7858,21579,3.207,12.015,9234,3.769,24.031,849,850,4125
1988,3399,15564,16098,414136,409122,2272,14.328,1791,11.294,70355,21267,49088,5.198,17.197,60157,23916,36241,5.846,14.704,10198,2.493,29.408,1438,1446,14428
1988,4231,22742,27746,316723,316721,2700,9.632,3271,11.669,52001,16662,35339,5.261,16.419,51993,21821,30172,6.890,16.416,8,0.003,32.832,2104,2247,12523
1988,4232,8494,9688,119467,116805,1341,13.973,1159,12.077,25391,9083,16308,7.776,21.738,19878,7677,12201,6.573,17.018,5513,4.720,34.036,885,902,5315
1988,4233,8331,10757,142441,140270,1299,12.196,1087,10.206,26232,7753,18479,5.527,18.701,21850,8531,13319,6.082,15.577,4382,3.124,31.154,787,803,5247
1988,4234,25645,35151,618767,616363,4655,13.352,4080,11.703,111393,38205,73188,6.198,18.073,107681,52387,55294,8.499,17.470,3712,0.602,34.941,2493,2581,15931
1988,4235,6946,9148,138298,134591,948,10.427,836,9.195,25298,7398,17900,5.497,18.796,17622,6391,11231,4.748,13.093,7676,5.703,26.186,503,523,3152
1988,4236,15894,23029,329085,322687,3037,13.372,2403,10.580,64811,24993,39818,7.745,20.085,52285,23261,29024,7.209,16.203,12526,3.882,32.406,1370,1417,9750
1988,4237,11181,15237,167994,166197,1486,9.848,1192,7.899,25904,8742,17162,5.260,15.586,22441,7702,14739,4.634,13.503,3463,2.084,27.005,777,839,4559
1988,4238,47677,61997,662593,654898,6161,9.983,5594,9.064,117291,42189,75102,6.442,17.910,102311,41625,60686,6.356,15.622,14980,2.287,31.245,3483,3631,22153
1988,4239,24991,26639,257882,250115,4239,16.122,3548,13.494,60461,20357,40104,8.139,24.173,44491,19337,25154,7.731,17.788,15970,6.385,35.577,2817,2829,12993
1988,4241,8661,11724,173199,170500,1407,12.269,894,7.796,30370,9812,20558,5.755,17.812,24781,7435,17346,4.361,14.534,5589,3.278,29.069,584,592,3637
1988,4242,3015,3908,112250,110272,589,15.145,551,14.168,22048,9319,12729,8.451,19.994,18574,7190,11384,6.520,16.844,3474,3.150,33.688,323,325,2123
1988,4243,11682,12575,150916,151308,1900,15.179,1784,14.253,31670,10347,21323,6.838,20.931,32459,12109,20350,8.003,21.452,-789,-0.521,41.862,1386,1397,7558
1988,4244,27575,34117,679868,677774,3972,11.658,3881,11.391,117254,38699,78555,5.710,17.300,113494,45444,68050,6.705,16.745,3760,0.555,33.490,2801,2832,21320
1988,4245,7155,10112,88237,88833,693,6.844,720,7.111,14397,4117,10280,4.635,16.207,15558,4557,11001,5.130,17.514,-1161,-1.307,32.414,442,457,2930
1988,4246,7563,11040,127780,127407,1385,12.729,1066,9.797,24021,8636,15385,6.778,18.854,23085,8149,14936,6.396,18.119,936,0.735,36.238,597,634,3931
1988,4247,9727,12874,135994,140170,1039,8.023,1193,9.212,22587,6919,15668,4.936,16.114,30942,9232,21710,6.586,22.075,-8355,-5.961,32.228,734,748,5003
1988,4248,3937,5011,138400,139448,302,5.957,420,8.284,14934,3896,11038,2.794,10.709,16982,5131,11851,3.680,12.178,-2048,-1.469,21.419,299,308,2749
1988,4249,21187,25550,298518,293721,3580,14.121,3185,12.563,58091,21092,36999,7.181,19.778,48566,19202,29364,6.537,16.535,9525,3.243,33.069,2212,2247,11072
1988,4251,31366,33914,308333,310028,4088,12.215,3193,9.541,61738,25248,36490,8.144,19.914,66406,33085,33321,10.672,21.419,-4668,-1.506,39.827,2119,2131,23684
1988,4411,38966,40806,1010259,1000867,4655,11.482,4126,10.177,142199,57695,84504,5.765,14.208,123595,45947,77648,4.591,12.349,18604,1.859,24.698,3351,3380,36600
1988,4412,11477,12140,95397,93024,1354,11.179,1299,10.724,21704,9142,12562,9.828,23.332,16838,6196,10642,6.661,18.101,4866,5.231,36.201,1047,1054,4905
1988,4413,48651,72679,519297,519273,6342,8.653,7576,10.336,93740,35839,57901,6.902,18.052,93512,34666,58846,6.676,18.008,228,0.044,36.017,4711,5015,20437
1988,4421,22119,28349,241802,240084,3287,11.675,2896,10.286,46149,18232,27917,7.594,19.222,42666,15896,26770,6.621,17.771,3483,1.451,35.543,2095,2212,11147
1988,4422,23057,28862,183833,177392,4195,14.782,3229,11.378,44974,20149,24825,11.358,25.353,31978,12535,19443,7.066,18.027,12996,7.326,36.053,2229,2340,8453
1988,4431,21503,29773,209615,199029,5590,19.545,3246,11.349,56805,31116,25689,15.634,28.541,35451,14716,20735,7.394,17.812,21354,10.729,35.624,2103,2203,9579
1988,4441,55563,71726,784621,777048,6515,9.098,6284,8.775,131669,48962,82707,6.301,16.945,117549,43718,73831,5.626,15.128,14120,1.817,30.255,4194,4315,20918
1988,4442,16164,19674,151487,147922,2003,10.251,1736,8.884,30663,9030,21633,6.105,20.729,23422,7145,16277,4.830,15.834,7241,4.895,31.668,1177,1199,4551
1988,4451,63383,95842,2252146,2225704,12726,13.283,12649,13.203,404002,201458,202544,9.051,18.152,352212,163910,188302,7.364,15.825,51790,2.327,31.649,7759,8059,50421
1988,4452,21418,25691,165154,166738,3708,14.313,4140,15.980,38578,18764,19814,11.254,23.137,42216,17943,24273,10.761,25.319,-3638,-2.182,46.274,3189,3228,13228
1988,4453,27101,32059,155127,156397,3596,11.160,3921,12.169,30241,14151,16090,9.048,19.336,32864,13659,19205,8.734,21.013,-2623,-1.677,38.672,2912,2970,10308
1988,4461,48267,75829,711570,707973,8266,11.023,6582,8.778,133430,62066,71364,8.767,18.847,125557,47437,78120,6.700,17.735,7873,1.112,35.469,3905,4040,19623
1988,4471,86518,137539,956622,954584,16735,12.228,15371,11.231,215888,101458,114430,10.629,22.616,211294,82696,128598,8.663,22.135,4594,0.481,44.269,9471,9898,47798
1988,4481,55389,104321,946073,937989,14542,14.078,12485,12.087,219874,99636,120238,10.622,23.441,200600,71566,129034,7.630,21.386,19274,2.055,42.772,7265,7806,32032
1988,4482,11156,37219,202088,201192,4216,11.373,3917,10.567,43742,20314,23428,10.097,21.741,41872,15682,26190,7.795,20.812,1870,0.929,41.624,1620,1757,6445
1988,4483,19209,28864,176630,174657,3897,13.689,3105,10.907,40220,17173,23047,9.832,23.028,36984,13067,23917,7.482,21.175,3236,1.853,42.351,1940,2038,7255
1988,4511,32544,42580,310736,303346,6213,14.722,5458,12.933,71358,32321,39037,10.655,23.524,56629,23151,33478,7.632,18.668,14729,4.856,37.336,3901,4062,13884
1988,4512,8273,12691,87933,85355,1743,13.955,1342,10.744,19601,7241,12360,8.483,22.964,14566,5578,8988,6.535,17.065,5035,5.899,34.131,898,943,3622
1988,4521,270,9450,1616321,1583384,615,6.614,312,3.355,204785,82183,122602,5.190,12.933,143089,51358,91731,3.244,9.037,61696,3.896,18.074,16,20,4650
1988,4529,11543,24472,451330,441106,2739,11.204,2689,10.999,86189,39927,46262,9.052,19.539,66144,27106,39038,6.145,14.995,20045,4.544,29.990,1519,1628,9720
1988,4531,23495,25007,127375,126143,3585,14.537,2895,11.739,27185,10737,16448,8.512,21.551,24501,9142,15359,7.247,19.423,2684,2.128,38.847,2137,2183,6862
1988,4532,30439,38148,238271,231904,6730,18.062,4957,13.303,60559,27240,33319,11.746,26.114,47835,20955,26880,9.036,20.627,12724,5.487,41.254,3395,3617,13778
1988,4533,9448,11405,59265,57899,2016,17.887,1747,15.501,13707,6653,7054,11.491,23.674,11212,4309,6903,7.442,19.365,2495,4.309,38.730,1186,1201,2745
1988,4539,23759,27462,143825,140503,4730,17.436,4062,14.973,39780,18482,21298,13.154,28.313,33118,15675,17443,11.156,23.571,6662,4.742,47.142,2862,3101,11863
1988,4541,5505,6848,112582,105773,958,14.225,731,10.855,32066,13460,18606,12.725,30.316,17705,7619,10086,7.203,16.739,14361,13.577,33.477,554,563,3940
1988,4542,4021,4957,77083,74541,676,13.792,565,11.527,17445,5649,11796,7.578,23.403,12300,6314,5986,8.471,16.501,5145,6.902,33.002,380,384,4063
1988,4543,16373,22368,223456,221253,2521,11.363,2157,9.722,45427,12438,32989,5.622,20.532,40560,15210,25350,6.874,18.332,4867,2.200,36.664,1355,1382,7219
1988,4811,694,2720,422260,400599,332,12.981,7,0.274,65998,8281,57717,2.067,16.475,22069,88,21981,0.022,5.509,43929,10.966,11.018,6,6,86
1988,4812,821,894,13198,12081,171,21.085,5,0.617,3000,1040,1960,8.609,24.833,784,25,759,0.207,6.490,2216,18.344,12.980,4,4,23
1988,4831,332,607,32993,32431,79,12.908,89,14.542,6530,1042,5488,3.213,20.135,5356,2753,2603,8.489,16.515,1174,3.620,33.030,24,24,200
1988,4832,300,335,11392,12089,40,11.834,46,13.609,1628,286,1342,2.366,13.467,3014,906,2108,7.494,24.932,-1386,-11.465,26.934,31,31,361
1988,4841,20441,26720,569720,547565,4959,18.982,3768,14.423,135174,45420,89754,8.295,24.686,90195,32319,57876,5.902,16.472,44979,8.214,32.944,2791,2823,18162
1988,4842,47872,52437,562333,556141,8679,16.578,8508,16.252,132671,49672,82999,8.932,23.856,119590,47209,72381,8.489,21.504,13081,2.352,43.007,6623,6693,30975
1988,4851,390,424,31447,31142,60,15.132,5,1.261,2791,1124,1667,3.609,8.962,2240,283,1957,0.909,7.193,551,1.769,14.386,4,4,279
1988,4852,327,528,18853,18540,70,14.184,(D),(D),3606,1772,1834,9.558,19.450,2925,(D),2923,(D),15.777,681,3.673,31.553,(D),(D),(D)
1988,4853,4999,5046,52327,49575,988,21.589,49,1.071,11583,5165,6418,10.419,23.365,6114,169,5945,0.341,12.333,5469,11.032,24.666,45,45,158
1988,4854,3225,3579,102765,97573,434,12.863,24,0.711,22101,11421,10680,11.705,22.651,11420,267,11153,0.274,11.704,10681,10.947,23.408,16,16,246
1988,4855,729,777,18197,17015,137,19.269,5,0.703,4299,2043,2256,12.007,25.267,1983,31,1952,0.182,11.655,2316,13.612,23.310,4,4,30
1988,4859,1011,1039,18770,16986,238,25.730,10,1.081,4930,2357,2573,13.876,29.024,1426,30,1396,0.177,8.395,3504,20.629,16.790,9,9,27
1988,4861,61,303,9537,9050,46,16.399,(D),(D),1390,684,706,7.558,15.360,493,(D),488,(D),5.448,897,9.912,10.896,(D),(D),(D)
1988,4862,264,1312,58289,58571,137,11.004,3,0.241,7317,2531,4786,4.321,12.493,7889,54,7835,0.092,13.469,-572,-0.977,24.985,3,3,54
1988,4869,63,371,7930,7577,56,16.279,(D),(D),1462,376,1086,4.963,19.297,774,(D),755,(D),10.216,688,9.081,20.432,(D),(D),(D)
1988,4871,249,259,4430,4238,62,26.327,15,6.369,1045,273,772,6.442,24.661,688,50,638,1.180,16.236,357,8.425,32.472,13,13,48
1988,4872,707,716,7761,7780,165,24.229,95,13.950,1892,907,985,11.658,24.319,1932,736,1196,9.460,24.833,-40,-0.514,48.638,73,73,336
1988,4879,114,119,730,655,27,25.234,3,2.804,226,89,137,13.598,34.530,76,6,70,0.917,11.612,150,22.918,23.224,(D),(D),(D)
1988,4881,2151,2722,72190,66701,407,16.125,11,0.436,15897,4910,10987,7.361,23.833,5034,49,4985,0.073,7.547,10863,16.286,15.094,9,9,44
1988,4882,349,581,12693,12023,170,32.106,67,12.653,3600,1598,2002,13.291,29.943,2295,960,1335,7.985,19.088,1305,10.854,38.177,43,43,459
1988,4883,2056,2504,84461,85768,359,14.371,347,13.891,20510,8570,11940,9.992,23.913,23029,8634,14395,10.067,26.850,-2519,-2.937,47.827,257,258,3411
1988,4884,994,1102,8646,7411,646,78.541,87,10.578,4105,3027,1078,40.847,55.394,1648,787,861,10.620,22.239,2457,33.156,44.477,58,58,421
1988,4885,6797,9149,103878,101443,1579,17.859,964,10.903,25637,11492,14145,11.329,25.272,20486,7249,13237,7.146,20.195,5151,5.078,40.389,709,723,4797
1988,4889,582,599,7275,6805,145,25.709,75,13.298,2156,632,1524,9.287,31.683,1153,471,682,6.921,16.943,1003,14.739,33.887,59,60,396
1988,4921,1369,3679,303475,288589,931,28.089,202,6.094,58389,24927,33462,8.638,20.233,26183,2569,23614,0.890,9.073,32206,11.160,18.146,140,140,956
1988,4922,3856,4129,60922,58295,789,19.503,622,15.375,16430,6232,10198,10.691,28.184,11337,4144,7193,7.109,19.448,5093,8.737,38.896,516,517,3102
1988,4931,6277,9807,403950,403116,1131,11.531,1133,11.552,74360,24197,50163,6.002,18.446,73074,29281,43793,7.264,18.127,1286,0.319,36.255,403,414,3617
1988,5111,14130,16532,680933,678648,2003,12.245,1654,10.112,74060,27109,46951,3.995,10.913,69522,25717,43805,3.789,10.244,4538,0.669,20.488,1289,1293,13870
1988,5112,2898,3298,59979,56607,843,26.980,496,15.875,18669,9090,9579,16.058,32.980,12066,5784,6282,10.218,21.316,6603,11.665,42.631,345,349,2722
1988,5121,9488,14158,236167,232021,2294,16.031,2598,18.155,78894,42143,36751,18.163,34.003,70923,22489,48434,9.693,30.568,7971,3.435,61.135,1490,1621,9812
1988,5122,2067,2081,14075,13803,650,33.514,367,18.922,4736,2728,2008,19.764,34.311,4251,1744,2507,12.635,30.798,485,3.514,61.595,295,295,1187
1988,5151,6041,7515,235317,223054,1018,14.505,25,0.356,42411,21311,21100,9.554,19.014,17796,257,17539,0.115,7.978,24615,11.035,15.957,15,15,209
1988,5152,218,306,11675,10785,74,27.458,(D),(D),2625,1541,1084,14.289,24.340,867,(D),855,(D),8.039,1758,16.301,16.079,(D),(D),(D)
1988,5171,4145,20626,1000669,984434,1870,9.482,60,0.304,95188,34918,60270,3.547,9.669,63805,959,62846,0.097,6.481,31383,3.188,12.963,50,50,407
1988,5172,941,1513,31336,29092,442,33.883,25,1.916,8071,4108,3963,14.121,27.743,3448,99,3349,0.340,11.852,4623,15.891,23.705,21,21,89
1988,5174,172,298,17513,17396,53,19.343,5,1.825,3204,542,2662,3.116,18.419,2986,10,2976,0.057,17.165,218,1.253,34.331,4,4,8
1988,5179,808,1444,29495,28803,326,24.914,55,4.203,4564,2384,2180,8.277,15.846,3243,278,2965,0.965,11.259,1321,4.586,22.518,39,39,175
1988,5182,5465,7294,258460,250627,1167,16.132,1047,14.473,65349,29391,35958,11.727,26.074,49123,18999,30124,7.581,19.600,16226,6.474,39.200,638,647,5799
1988,5191,2435,2890,35805,36759,399,14.174,249,8.845,6476,2693,3783,7.326,17.617,8782,5547,3235,15.090,23.891,-2306,-6.273,35.235,168,168,579
1988,5211,47,86,24883,24748,4,4.762,0,0.000,951,64,887,0.259,3.843,708,0,708,0.000,2.861,243,0.982,5.722,0,0,0
1988,5221,16831,73703,1947025,1921007,5923,8.364,141,0.199,267482,101230,166252,5.270,13.924,213981,1622,212359,0.084,11.139,53501,2.785,22.278,131,131,1535
1988,5222,23032,41979,537531,522981,4695,11.786,406,1.019,101004,45585,55419,8.716,19.313,71578,1763,69815,0.337,13.687,29426,5.627,27.373,242,243,1171
1988,5223,4891,5584,66080,61241,1522,31.243,97,1.991,19002,11120,7882,18.158,31.028,9254,465,8789,0.759,15.111,9748,15.917,30.222,85,85,449
1988,5231,6817,13643,336909,336728,2265,18.023,114,0.907,58394,21656,36738,6.431,17.342,56422,770,55652,0.229,16.756,1972,0.586,33.512,100,100,742
1988,5232,98,112,7194,7093,10,9.346,0,0.000,742,28,714,0.395,10.462,530,0,530,0.000,7.473,212,2.989,14.945,0,0,0
1988,5239,15191,15830,143981,133999,3269,22.891,171,1.197,40667,19966,20701,14.900,30.349,20946,792,20154,0.591,15.632,19721,14.717,31.263,143,143,498
1988,5241,6923,36732,1320830,1289174,9252,28.780,83,0.258,195751,67139,128612,5.208,15.184,128118,564,127554,0.044,9.938,67633,5.246,19.876,57,57,385
1988,5242,100499,105702,733707,697964,13526,13.629,615,0.620,149263,67653,81610,9.693,21.386,79152,2958,76194,0.424,11.340,70111,10.045,22.681,511,511,2206
1988,5250,2185,2423,22866,21866,268,11.667,16,0.697,4876,2176,2700,9.952,22.300,2816,68,2748,0.311,12.879,2060,9.421,25.757,9,9,45
1988,5311,94417,98230,536053,508446,13521,14.665,1455,1.578,122679,60866,61813,11.971,24.128,67276,5121,62155,1.007,13.232,55403,10.897,26.463,1175,1194,3967
1988,5312,40087,42621,239443,227094,7495,19.077,829,2.110,64014,30196,33818,13.297,28.188,39018,2881,36137,1.269,17.181,24996,11.007,34.363,671,671,2334
1988,5313,25154,26553,306446,284105,5013,20.622,526,2.164,80775,35165,45610,12.377,28.431,36351,2757,33594,0.970,12.795,44424,15.636,25.590,434,434,1754
1988,5321,5908,10811,143746,139193,2097,20.011,1433,13.675,33108,15627,17481,11.227,23.786,23624,9702,13922,6.970,16.972,9484,6.814,33.944,870,894,4959
1988,5322,20308,25038,160073,151851,5258,21.842,3327,13.821,54461,25403,29058,16.729,35.865,38042,16365,21677,10.777,25.052,16419,10.813,50.105,2505,2605,11558
1988,5323,4265,5748,40656,39457,1051,18.877,690,12.393,11638,5256,6382,13.321,29.495,9225,3805,5420,9.643,23.380,2413,6.116,46.760,498,509,2697
1988,5324,8211,10179,95960,94456,1736,17.398,1334,13.369,25114,9678,15436,10.246,26.588,21957,8151,13806,8.629,23.246,3157,3.342,46.492,963,1001,5341
1988,5331,950,1029,16083,14224,287,32.193,12,1.346,6481,3608,2873,25.366,45.565,2797,38,2759,0.267,19.665,3684,25.901,39.329,11,11,36
1988,5411,132025,136972,900758,879950,15906,11.749,12724,9.399,160822,54457,106365,6.189,18.276,119149,42973,76176,4.884,13.540,41673,4.736,27.081,9312,9393,31028
1988,5412,67223,71439,619947,600590,11378,16.152,9387,13.326,134155,49506,84649,8.243,22.337,95546,40147,55399,6.685,15.909,38609,6.429,31.817,6898,6981,29652
1988,5413,59920,66424,894085,866681,10489,16.128,7711,11.857,194341,63994,130347,7.384,22.424,138914,46382,92532,5.352,16.028,55427,6.395,32.057,5590,5643,23388
1988,5414,15296,15525,94499,92689,3092,20.424,2320,15.325,25488,12494,12994,13.479,27.498,21837,9345,12492,10.082,23.559,3651,3.939,47.119,1832,1837,6448
1988,5415,19645,22305,334227,320490,5708,26.897,3542,16.690,89225,37168,52057,11.597,27.840,61714,27381,34333,8.543,19.256,27511,8.584,38.512,2595,2611,12781
1988,5416,43425,45163,359302,336333,12370,28.661,8363,19.377,130012,63851,66161,18.984,38.656,84046,39911,44135,11.867,24.989,45966,13.667,49.978,6600,6643,31352
1988,5417,6761,8242,435316,432418,1291,15.908,1038,12.790,61283,18278,43005,4.227,14.172,56224,21101,35123,4.880,13.002,5059,1.170,26.004,660,664,5979
1988,5418,26474,28765,345863,338711,5177,18.396,3931,13.968,80060,35346,44714,10.435,23.637,65567,26230,39337,7.744,19.358,14493,4.279,38.716,3018,3045,16369
1988,5419,31752,35407,264852,262650,4382,12.682,2674,7.739,58669,21322,37347,8.118,22.337,55421,14083,41338,5.362,21.101,3248,1.237,42.201,1893,1945,8940
1988,5511,25464,47163,3036287,3008226,8213,18.155,4361,9.640,647321,219551,427770,7.298,21.518,591395,175780,415615,5.843,19.659,55926,1.859,39.319,442,492,9432
1988,5611,12847,13696,240136,230506,2570,19.158,2008,14.968,70429,31609,38820,13.713,30.554,51296,21368,29928,9.270,22.254,19133,8.300,44.507,1525,1540,13388
1988,5612,426,596,63795,60734,133,23.729,62,11.062,13412,6271,7141,10.325,22.083,7019,2085,4934,3.433,11.557,6393,10.526,23.114,38,38,1197
1988,5613,16673,22884,1212155,1151577,4774,21.805,2794,12.761,424489,131344,293145,11.406,36.862,303859,80992,222867,7.033,26.386,120630,10.475,52.773,1923,1963,41884
1988,5614,21206,24106,282526,273475,4270,18.050,3371,14.250,72133,28873,43260,10.558,26.376,53659,23789,29870,8.699,19.621,18474,6.755,39.242,2637,2660,14622
1988,5615,23470,28025,220781,214483,4186,15.299,2857,10.442,53458,22974,30484,10.711,24.924,40797,16228,24569,7.566,19.021,12661,5.903,38.042,2134,2193,11158
1988,5616,12189,15003,481405,462005,2471,16.649,2149,14.479,139213,63800,75413,13.809,30.132,99097,50826,48271,11.001,21.449,40116,8.683,42.899,1518,1523,18125
1988,5617,75606,79491,1004832,971063,18089,24.113,9140,12.184,269728,108046,161682,11.127,27.777,202266,69628,132638,7.170,20.829,67462,6.947,41.659,7198,7221,45740
1988,5619,14183,15343,214492,207806,2951,19.681,2254,15.032,61459,27285,34174,13.130,29.575,47705,18746,28959,9.021,22.957,13754,6.619,45.913,1683,1701,11415
1988,5621,2825,2909,32420,29925,425,15.332,151,5.447,8027,4451,3576,14.874,26.824,3040,1256,1784,4.197,10.159,4987,16.665,20.317,104,104,1014
1988,5622,1769,2512,63250,58315,440,19.160,9,0.392,14431,6343,8088,10.877,24.747,4425,52,4373,0.089,7.588,10006,17.159,15.176,5,5,8
1988,5629,4863,5143,54477,51655,916,18.468,550,11.089,15507,6185,9322,11.974,30.020,9736,3418,6318,6.617,18.848,5771,11.172,37.696,427,428,2757
1988,6111,13406,14466,439792,431862,676,4.782,14,0.099,40740,7458,33282,1.727,9.434,24850,74,24776,0.017,5.754,15890,3.679,11.508,9,9,51
1988,6112,492,684,52982,51945,61,9.327,(D),(D),8109,2422,5687,4.663,15.611,5945,(D),5944,(D),11.445,2164,4.166,22.890,0,0,0
1988,6113,1991,2334,964436,961829,103,4.512,(D),(D),67808,3399,64409,0.353,7.050,62842,(D),62831,(D),6.534,4966,0.516,13.067,(D),(D),(D)
1988,6114,2384,2919,49200,46737,587,20.856,378,13.430,12974,4029,8945,8.621,27.760,8048,3982,4066,8.520,17.220,4926,10.540,34.440,260,266,3117
1988,6115,3924,4766,63968,61095,681,14.650,446,9.594,15654,4434,11220,7.258,25.623,10035,3206,6829,5.248,16.425,5619,9.197,32.851,305,319,1947
1988,6116,11579,12214,96077,90619,2560,21.720,1705,14.466,29828,11354,18474,12.529,32.916,18870,8815,10055,9.728,20.824,10958,12.092,41.647,1326,1335,6501
1988,6117,1688,1745,18206,17258,351,20.526,281,16.433,4606,1788,2818,10.361,26.690,2653,1028,1625,5.957,15.373,1953,11.317,30.746,209,211,764
1988,6211,183217,192277,1251644,1250289,15070,7.852,14376,7.490,217188,70776,146412,5.661,17.371,214567,64407,150160,5.151,17.161,2621,0.210,34.323,11338,11508,48914
1988,6212,98553,101299,504584,498287,6092,6.050,4890,4.856,78107,22457,55650,4.507,15.675,65514,16620,48894,3.335,13.148,12593,2.527,26.296,3758,3803,13171
1988,6213,52044,54586,206135,197472,7943,15.000,4679,8.836,52050,22942,29108,11.618,26.358,34841,13777,21064,6.977,17.644,17209,8.715,35.287,3295,3339,9797
1988,6214,7451,11213,187914,182289,1643,15.072,1019,9.348,43003,16355,26648,8.972,23.591,31761,11655,20106,6.394,17.423,11242,6.167,34.847,640,652,6728
1988,6215,5142,6602,95832,92815,1130,17.701,694,10.871,19672,7286,12386,7.850,21.195,13804,5770,8034,6.217,14.873,5868,6.322,29.745,459,469,3425
1988,6216,4755,6979,305841,301275,1558,23.528,844,12.745,80445,29409,51036,9.762,26.702,71177,25443,45734,8.445,23.625,9268,3.076,47.251,494,525,10071
1988,6219,5276,6109,117118,111800,1212,20.844,623,10.715,28876,11858,17018,10.606,25.828,18168,6435,11733,5.756,16.251,10708,9.578,32.501,450,461,3683
1988,6221,3760,5183,3640718,3603001,214,4.091,310,5.926,312301,100857,211444,2.799,8.668,237635,118467,119168,3.288,6.595,74666,2.072,13.191,137,147,67404
1988,6222,523,841,320268,303490,76,9.229,41,4.979,47450,33717,13733,11.110,15.635,14735,7491,7244,2.468,4.855,32715,10.780,9.710,17,17,3088
1988,6223,215,257,101865,98348,26,10.176,23,9.002,12183,6700,5483,6.813,12.388,5274,3375,1899,3.432,5.363,6909,7.025,10.725,9,9,900
1988,6231,6966,11508,1000428,982742,1030,9.124,591,5.235,134548,61354,73194,6.243,13.691,99769,35121,64648,3.574,10.152,34779,3.539,20.304,311,322,17525
1988,6232,5630,8835,201231,190793,1725,21.102,404,4.942,46104,22752,23352,11.925,24.164,25245,6193,19052,3.246,13.232,20859,10.933,26.463,235,241,3704
1988,6233,9993,12199,396763,397223,1934,16.198,1416,11.859,68009,30907,37102,7.781,17.121,69258,36021,33237,9.068,17.436,-1249,-0.314,34.242,929,945,21656
1988,6239,3324,4347,110767,107176,608,14.502,299,7.132,20267,7903,12364,7.374,18.910,13094,3920,9174,3.658,12.217,7173,6.693,24.435,188,189,2509
1988,6241,16936,22669,321351,313223,2826,12.854,1459,6.636,58629,18688,39941,5.966,18.718,42658,9413,33245,3.005,13.619,15971,5.099,27.238,797,806,5007
1988,6242,4896,5753,55557,53275,700,12.577,325,5.840,11630,4305,7325,8.081,21.830,7101,1635,5466,3.069,13.329,4529,8.501,26.658,186,191,977
1988,6243,4556,6730,262430,260894,686,10.371,455,6.879,45477,8104,37373,3.106,17.431,41925,7864,34061,3.014,16.070,3552,1.361,32.140,200,206,2259
1988,6244,33016,39537,373795,361503,5465,14.123,3783,9.776,80840,34995,45845,9.680,22.362,56319,21323,34996,5.898,15.579,24521,6.783,31.158,2846,2904,15418
1988,7111,5186,5236,70212,71602,903,17.184,941,17.907,18489,4630,13859,6.466,25.822,20969,6617,14352,9.241,29.285,-2480,-3.464,51.644,706,708,5303
1988,7112,2427,2556,68011,70445,464,18.311,420,16.575,12939,3688,9251,5.235,18.368,17776,3552,14224,5.042,25.234,-4837,-6.866,36.735,310,310,2486
1988,7113,2190,2242,33046,32295,416,18.841,348,15.761,8740,2545,6195,7.880,27.063,7157,2289,4868,7.088,22.161,1583,4.902,44.323,247,248,1562
1988,7114,1139,1159,11281,11241,243,21.735,161,14.401,3851,1450,2401,12.899,34.259,3737,2290,1447,20.372,33.244,114,1.014,66.489,124,124,1845
1988,7115,10509,10534,72216,64521,3868,39.666,2303,23.617,33745,15956,17789,24.730,52.301,18497,10267,8230,15.913,28.668,15248,23.633,57.337,1718,1721,5555
1988,7121,2831,3057,56006,54352,329,11.061,164,5.514,7572,1551,6021,2.854,13.932,4303,966,3337,1.777,7.917,3269,6.015,15.834,110,113,517
1988,7131,1654,2311,66265,63757,349,15.368,269,11.845,13578,5518,8060,8.655,21.296,8395,3190,5205,5.003,13.167,5183,8.129,26.334,206,208,1774
1988,7132,663,704,23583,22113,152,22.353,104,15.294,6140,3604,2536,16.298,27.766,3008,1673,1335,7.566,13.603,3132,14.164,27.206,85,85,867
1988,7139,37044,40315,595597,586188,6464,16.381,4757,12.055,123314,47457,75857,8.096,21.037,104656,40229,64427,6.863,17.854,18658,3.183,35.707,3562,3638,28132
1988,7211,29949,35748,1323210,1306147,5225,14.811,4287,12.152,275933,131951,143982,10.102,21.126,243225,115340,127885,8.831,18.622,32708,2.504,37.243,3009,3111,63641
1988,7212,3941,4234,26419,26035,630,15.297,399,9.688,7674,3425,4249,13.156,29.476,6929,3080,3849,11.830,26.615,745,2.862,53.229,251,253,1214
1988,7213,3711,3816,18491,19841,322,8.371,383,9.957,3647,1299,2348,6.547,18.382,6095,4444,1651,22.399,30.720,-2448,-12.338,36.763,270,270,4114
1988,7223,17592,31006,575543,578176,6472,20.760,6812,21.850,169666,87940,81726,15.210,29.345,175060,66450,108610,11.493,30.278,-5394,-0.933,58.690,3026,3074,28502
1988,7224,51646,52621,309566,311739,8066,15.264,8511,16.106,81474,43565,37909,13.975,26.135,86187,41324,44863,13.256,27.647,-4713,-1.512,52.271,6679,6706,33018
1988,7225,210841,284444,5407443,5313013,48819,17.485,38334,13.730,1260346,676307,584039,12.729,23.722,1078061,437695,640366,8.238,20.291,182285,3.431,40.582,27786,28584,279155
1988,8111,113709,120499,630402,615929,19297,16.241,15937,13.413,155218,73465,81753,11.928,25.201,126475,54730,71745,8.886,20.534,28743,4.667,41.068,12138,12336,43080
1988,8112,11359,13634,115746,112818,2235,16.702,1731,12.935,26485,11238,15247,9.961,23.476,20614,8325,12289,7.379,18.272,5871,5.204,36.544,1255,1263,4197
1988,8113,20088,21124,160582,155947,3025,14.475,2574,12.317,35655,12282,23373,7.876,22.864,26524,10310,16214,6.611,17.008,9131,5.855,34.017,1941,1945,6700
1988,8114,25369,27048,175187,169380,4436,16.455,4258,15.794,41385,18162,23223,10.723,24.433,30052,12867,17185,7.597,17.742,11333,6.691,35.485,3277,3288,9274
1988,8121,76566,85791,440184,434871,13751,16.172,12232,14.385,108869,59976,48893,13.792,25.035,98311,47742,50569,10.978,22.607,10558,2.428,45.214,9331,9444,31910
1988,8122,17193,20392,125322,123997,1612,7.996,1149,5.699,20463,7987,12476,6.441,16.503,17697,4061,13636,3.275,14.272,2766,2.231,28.544,762,819,2985
1988,8123,33716,40319,373043,369163,5618,14.066,4862,12.173,72247,30447,41800,8.248,19.571,64317,25823,38494,6.995,17.422,7930,2.148,34.845,3493,3617,18173
1988,8129,12598,21039,166405,161427,4111,20.427,2283,11.344,42144,19679,22465,12.191,26.107,32311,11301,21010,7.001,20.016,9833,6.091,40.032,1140,1166,5306
1988,8131,127864,127929,1044734,1022959,6268,5.021,83,0.066,127863,18647,109216,1.823,12.499,84278,307,83971,0.030,8.239,43585,4.261,16.477,22,22,48
1988,8132,8539,9724,129383,126010,1145,12.288,333,3.574,21530,6565,14965,5.210,17.086,14816,1975,12841,1.567,11.758,6714,5.328,23.516,241,242,1337
1988,8133,7857,9136,99207,98778,1181,13.336,621,7.012,17817,6076,11741,6.151,18.037,17128,3317,13811,3.358,17.340,689,0.698,34.680,412,415,2247
1988,8134,29687,31171,276094,272198,2454,7.961,1760,5.710,41082,9762,31320,3.586,15.093,33216,6944,26272,2.551,12.203,7866,2.890,24.406,1139,1143,4548
1988,8139,56647,58962,472098,461632,5001,8.734,1594,2.784,82896,22902,59994,4.961,17.957,62063,6899,55164,1.494,13.444,20833,4.513,26.889,1098,1100,4223
1989,2111,6919,8421,116763,121392,856,9.980,1168,13.618,16750,4890,11860,4.028,13.798,25956,10118,15838,8.335,21.382,-9206,-7.584,27.597,796,805,3457
1989,2121,2171,2731,137761,141113,437,15.751,524,18.886,20072,8579,11493,6.080,14.224,26594,10724,15870,7.600,18.846,-6522,-4.622,28.448,380,384,5391
1989,2122,483,643,44136,42748,115,17.913,113,17.601,8085,2421,5664,5.663,18.913,5463,2765,2698,6.468,12.780,2622,6.134,25.559,84,84,545
1989,2123,3507,5077,107878,108104,463,9.115,468,9.214,17364,7282,10082,6.736,16.062,17668,7048,10620,6.520,16.344,-304,-0.281,32.125,286,290,2840
1989,2131,7829,8974,160285,161409,1161,12.688,1514,16.546,45213,19447,25766,12.048,28.011,47884,21322,26562,13.210,29.666,-2671,-1.655,56.023,1005,1024,10204
1989,2211,1752,6123,595287,594913,247,4.108,27,0.449,26512,8052,18460,1.353,4.456,25743,248,25495,0.042,4.327,769,0.129,8.654,17,17,93
1989,2212,606,2486,139015,138312,214,8.781,116,4.760,10453,5076,5377,3.670,7.558,9304,2326,6978,1.682,6.727,1149,0.831,13.454,6,6,133
1989,2213,4038,4305,33362,32181,399,9.665,46,1.114,4890,1611,3279,5.006,15.195,2603,290,2313,0.901,8.089,2287,7.107,16.177,40,40,122
1989,2361,110344,110755,657449,647682,22282,20.387,19357,17.711,210875,86161,124714,13.303,32.558,191475,76160,115315,11.759,29.563,19400,2.995,59.126,14216,14224,57193
1989,2362,38502,39192,715044,708999,5072,12.969,4904,12.540,180278,39681,140597,5.597,25.427,168916,40332,128584,5.689,23.825,11362,1.603,47.649,3772,3781,29591
1989,2371,13572,13858,295470,297935,1386,10.002,1385,9.995,60306,12670,47636,4.253,20.241,65380,16051,49329,5.387,21.944,-5074,-1.703,40.483,1023,1024,8873
1989,2372,9913,10133,85116,81154,2191,21.737,2084,20.676,31069,15206,15863,18.737,38.284,23313,11602,11711,14.296,28.727,7756,9.557,57.454,1717,1720,8351
1989,2373,9538,9927,248691,255831,995,10.001,1039,10.443,45185,9326,35859,3.645,17.662,59332,10367,48965,4.052,23.192,-14147,-5.530,35.324,781,782,7069
1989,2379,5190,5260,67551,67195,740,13.956,825,15.559,19537,5620,13917,8.364,29.075,18879,6828,12051,10.161,28.096,658,0.979,56.192,635,636,3170
1989,2381,76924,77343,755220,743278,11521,14.973,10730,13.945,212403,57941,154462,7.795,28.577,188324,61101,127223,8.220,25.337,24079,3.240,50.674,8325,8336,50056
1989,2382,119933,121734,1287409,1267489,15821,13.135,13244,10.996,285731,71116,214615,5.611,22.543,246133,82753,163380,6.529,19.419,39598,3.124,38.838,10133,10153,55192
1989,2383,80515,80966,700827,686525,14192,17.646,13109,16.300,204530,60957,143573,8.879,29.792,175625,59380,116245,8.649,25.582,28905,4.210,51.163,10096,10103,46647
1989,2389,41029,41279,382804,373899,6095,14.890,5404,13.202,105237,32289,72948,8.636,28.146,86839,26966,59873,7.212,23.225,18398,4.921,46.451,4119,4119,20587
1989,3111,1543,2167,53753,53986,171,7.983,121,5.649,6767,1942,4825,3.597,12.535,7258,2029,5229,3.758,13.444,-491,-0.910,25.070,69,69,718
1989,3112,492,838,65919,66067,62,7.407,60,7.168,5175,1027,4148,1.554,7.833,5376,1705,3671,2.581,8.137,-201,-0.304,15.666,33,33,251
1989,3113,1606,1884,87640,87288,216,11.462,217,11.515,11569,3258,8311,3.732,13.254,10900,3162,7738,3.623,12.487,669,0.766,24.975,142,149,929
1989,3114,1186,1613,175140,172218,135,8.416,117,7.294,23088,4076,19012,2.367,13.406,17035,4818,12217,2.798,9.892,6053,3.515,19.783,71,74,1604
1989,3115,1479,2102,138340,137398,126,5.932,170,8.004,15784,4103,11681,2.986,11.488,14076,6011,8065,4.375,10.245,1708,1.243,20.489,94,95,1205
1989,3116,3778,4411,374287,365005,397,9.115,286,6.566,47231,14989,32242,4.107,12.940,28928,8104,20824,2.220,7.925,18303,5.014,15.851,207,207,3313
1989,3117,715,826,47496,46747,87,10.616,74,9.030,9648,2407,7241,5.149,20.639,8199,3176,5023,6.794,17.539,1449,3.100,35.079,49,49,1736
1989,3118,9263,10766,308555,308752,1363,12.617,1436,13.293,37236,11640,25596,3.770,12.060,37914,15762,22152,5.105,12.280,-678,-0.220,24.120,1050,1079,10026
1989,3119,2050,2419,132570,135027,264,10.966,241,10.010,16374,4896,11478,3.626,12.127,21665,6651,15014,4.926,16.045,-5291,-3.918,24.253,164,167,2364
1989,3121,1739,2210,140958,144102,200,8.955,247,11.059,12703,2412,10291,1.674,8.815,19085,8575,10510,5.951,13.244,-6382,-4.429,17.631,162,162,2095
1989,3122,98,133,36311,35817,10,7.463,12,8.955,4511,2257,2254,6.302,12.595,3410,322,3088,0.899,9.521,1101,3.074,19.042,8,8,186
1989,3131,402,624,110773,111932,43,6.919,38,6.114,10271,3045,7226,2.720,9.176,12747,4205,8542,3.757,11.388,-2476,-2.212,18.352,18,18,615
1989,3132,1645,1985,255013,256170,172,8.685,163,8.230,22261,6077,16184,2.372,8.690,24537,5739,18798,2.240,9.578,-2276,-0.888,17.380,124,124,1577
1989,3133,1700,1959,110248,110122,220,11.204,229,11.663,14085,4446,9639,4.037,12.790,13887,5653,8234,5.133,12.611,198,0.180,25.221,117,121,2094
1989,3141,3666,3971,134181,132073,430,10.811,443,11.138,18823,5145,13678,3.896,14.252,14330,3817,10513,2.890,10.850,4493,3.402,21.700,367,371,2409
1989,3149,3876,3990,121145,120165,612,15.737,410,10.543,22170,7871,14299,6.550,18.450,20138,8877,11261,7.387,16.759,2032,1.691,33.517,332,332,4638
1989,3151,1247,1371,137967,136384,126,9.130,144,10.435,18274,5362,12912,3.932,13.399,15394,3934,11460,2.885,11.287,2880,2.112,22.575,114,115,2145
1989,3152,11348,12673,773719,774398,2023,15.901,2122,16.679,126762,48543,78219,6.268,16.369,127788,58375,69413,7.538,16.502,-1026,-0.132,32.738,1792,1806,36610
1989,3159,1854,1929,71907,71832,294,15.449,242,12.717,11662,3364,8298,4.683,16.235,11550,4589,6961,6.389,16.079,112,0.156,32.158,209,209,3550
1989,3161,350,378,16203,15680,38,10.106,34,9.043,2474,308,2166,1.964,15.778,1449,575,874,3.667,9.241,1025,6.537,18.482,28,28,300
1989,3162,371,494,77575,80435,32,6.268,65,12.733,5575,561,5014,0.697,6.931,11194,4166,7028,5.179,13.917,-5619,-6.986,13.862,43,44,1030
1989,3169,1102,1152,37376,37679,118,10.151,139,11.957,5317,1157,4160,3.071,14.111,5963,2008,3955,5.329,15.826,-646,-1.714,28.223,117,117,1386
1989,3211,4586,5123,145675,147145,494,9.589,552,10.714,17479,4603,12876,3.128,11.879,20430,6808,13622,4.627,13.884,-2951,-2.006,23.758,429,429,3177
1989,3212,1316,1615,104395,105764,156,9.627,167,10.305,11472,3579,7893,3.384,10.847,13955,6882,7073,6.507,13.195,-2483,-2.348,21.694,105,105,2259
1989,3219,9181,9851,293062,288027,1151,11.743,1053,10.743,52642,15836,36806,5.498,18.277,42676,17369,25307,6.030,14.817,9966,3.460,29.633,791,794,8676
1989,3221,228,549,193570,192576,29,5.249,36,6.516,10185,2494,7691,1.295,5.289,8623,3753,4870,1.949,4.478,1562,0.811,8.955,18,18,726
1989,3222,3591,5184,400307,399629,294,5.657,320,6.157,35716,7517,28199,1.881,8.937,34230,11832,22398,2.961,8.565,1486,0.372,17.131,212,214,4854
1989,3231,41607,43545,850287,842518,4754,11.008,4037,9.348,110617,29492,81125,3.500,13.129,94873,34955,59918,4.149,11.261,15744,1.869,22.521,3168,3191,21706
1989,3241,1286,2203,158998,168131,170,7.729,163,7.411,9939,3417,6522,2.032,5.911,28367,18955,9412,11.274,16.872,-18428,-10.961,11.823,81,82,489
1989,3251,1157,2307,228867,224800,181,7.864,170,7.386,20710,7246,13464,3.223,9.213,12490,4795,7695,2.133,5.556,8220,3.657,11.112,76,76,753
1989,3252,362,640,135583,133429,52,8.144,49,7.674,9872,2379,7493,1.783,7.399,5577,2319,3258,1.738,4.180,4295,3.219,8.360,22,24,1345
1989,3253,621,886,42047,41986,70,7.865,78,8.764,4154,902,3252,2.148,9.894,3969,1820,2149,4.335,9.453,185,0.441,18.907,40,42,612
1989,3254,1069,1327,170131,165164,115,8.725,97,7.360,20267,4757,15510,2.880,12.271,10325,2893,7432,1.752,6.251,9942,6.019,12.503,58,58,494
1989,3255,1647,2174,78590,78939,166,7.664,150,6.925,8150,2332,5818,2.954,10.324,8655,3526,5129,4.467,10.964,-505,-0.640,20.649,85,86,1032
1989,3256,2034,2289,123345,121720,206,9.000,206,9.000,16246,4011,12235,3.295,13.347,13019,5143,7876,4.225,10.696,3227,2.651,21.392,144,144,1321
1989,3259,2101,2734,140499,141086,234,8.531,252,9.187,13250,2927,10323,2.075,9.391,14703,6567,8136,4.655,10.421,-1453,-1.030,18.783,142,142,2179
1989,3261,9952,11891,688740,676991,1146,9.698,998,8.445,104061,27427,76634,4.051,15.371,80160,31768,48392,4.693,11.841,23901,3.530,23.681,646,659,11440
1989,3262,2177,2643,203395,198257,259,9.895,208,7.947,24561,7085,17476,3.574,12.388,14265,5107,9158,2.576,7.195,10296,5.193,14.390,136,138,1531
1989,3271,1420,1709,83244,83492,207,12.292,157,9.323,9205,1643,7562,1.968,11.025,9861,2754,7107,3.299,11.811,-656,-0.786,22.050,108,109,1317
1989,3272,1742,1996,148037,146269,242,12.244,203,10.271,14503,2912,11591,1.991,9.915,10731,3296,7435,2.253,7.336,3772,2.579,14.673,147,147,1501
1989,3273,6471,9003,190518,190132,698,7.740,728,8.073,31463,9172,22291,4.824,16.548,30519,10303,20216,5.419,16.052,944,0.496,32.103,446,452,5395
1989,3274,249,339,18078,18096,29,8.418,40,11.611,1532,528,1004,2.918,8.466,1541,949,592,5.244,8.516,-9,-0.050,16.932,27,27,188
1989,3279,1922,2220,74611,74860,227,10.297,196,8.891,9086,3269,5817,4.367,12.137,9655,4340,5315,5.798,12.897,-569,-0.760,24.275,136,136,1799
1989,3311,324,375,146052,145703,29,7.652,37,9.763,5824,791,5033,0.543,3.997,5204,1104,4100,0.758,3.572,620,0.426,7.143,28,29,648
1989,3312,538,731,66714,65396,73,10.160,48,6.681,8187,3096,5091,4.734,12.519,5723,2411,3312,3.687,8.751,2464,3.768,17.503,23,23,424
1989,3313,413,592,107576,107588,36,6.045,43,7.221,8278,2010,6268,1.868,7.694,8203,3941,4262,3.663,7.624,75,0.070,15.249,21,21,311
1989,3314,736,900,88156,85594,87,9.704,80,8.924,11319,5311,6008,6.205,13.224,6035,2367,3668,2.765,7.051,5284,6.173,14.102,52,54,1049
1989,3315,2546,2816,228617,221689,217,7.733,197,7.021,31516,9425,22091,4.251,14.216,17575,7802,9773,3.519,7.928,13941,6.289,15.856,128,129,3051
1989,3321,3308,3510,147768,147075,261,7.442,255,7.271,18179,4187,13992,2.847,12.360,16708,7252,9456,4.931,11.360,1471,1.000,22.720,161,171,2213
1989,3322,1318,1454,82462,79919,126,8.738,102,7.074,10486,4140,6346,5.180,13.121,5600,1358,4242,1.699,7.007,4886,6.114,14.014,77,77,690
1989,3323,10111,10958,352594,347821,971,8.899,877,8.038,55087,13245,41842,3.808,15.838,45710,17438,28272,5.014,13.142,9377,2.696,26.284,653,662,8706
1989,3324,1497,1825,116599,114277,140,7.686,133,7.302,14702,2490,12212,2.179,12.865,10137,2612,7525,2.286,8.871,4565,3.995,17.741,94,103,1920
1989,3325,962,1056,73652,75534,99,9.357,103,9.735,9238,3337,5901,4.418,12.230,12983,7795,5188,10.320,17.188,-3745,-4.958,24.461,70,70,704
1989,3326,1763,1970,70719,69518,249,13.037,129,6.754,10154,2978,7176,4.284,14.606,7740,2778,4962,3.996,11.134,2414,3.473,22.268,85,85,1029
1989,3327,21417,21724,346435,338973,2015,9.326,1778,8.229,56528,12490,44038,3.685,16.676,41398,13639,27759,4.024,12.213,15130,4.463,24.426,1374,1376,9130
1989,3328,5523,5867,142803,139793,430,7.341,411,7.017,22343,5103,17240,3.650,15.983,16306,5352,10954,3.829,11.664,6037,4.319,23.329,302,303,3422
1989,3329,6752,7256,383721,378877,893,12.564,596,8.386,48345,16270,32075,4.294,12.760,38700,15816,22884,4.174,10.214,9645,2.546,20.429,449,451,5224
1989,3331,2925,3191,211305,206409,275,8.638,260,8.167,28765,4880,23885,2.364,13.936,18722,8554,10168,4.144,9.070,10043,4.866,18.141,179,180,2634
1989,3332,4181,4425,181455,176291,375,8.568,279,6.374,26663,6405,20258,3.633,15.124,16531,5106,11425,2.896,9.377,10132,5.747,18.754,203,203,2434
1989,3333,2243,2375,156995,156488,214,9.001,219,9.211,21225,6887,14338,4.401,13.563,20690,9146,11544,5.845,13.221,535,0.342,26.443,138,138,1327
1989,3334,1618,1870,162704,163430,165,8.802,174,9.282,19345,5756,13589,3.522,11.837,20602,10179,10423,6.228,12.606,-1257,-0.769,23.674,117,117,2710
1989,3335,9351,9681,232184,226250,735,7.641,611,6.352,33124,6986,26138,3.088,14.640,21241,9436,11805,4.171,9.388,11883,5.252,18.777,470,472,4808
1989,3336,746,895,133983,132617,60,6.689,64,7.135,15089,4012,11077,3.025,11.378,11917,5636,6281,4.250,8.986,3172,2.392,17.972,35,35,703
1989,3339,5383,5974,327700,324121,441,7.370,461,7.704,39966,8929,31037,2.755,12.331,32761,14238,18523,4.393,10.108,7205,2.223,20.215,313,314,4245
1989,3341,1634,1786,265467,269118,274,15.471,244,13.778,37538,8380,29158,3.114,13.949,45915,15351,30564,5.704,17.061,-8377,-3.113,27.897,185,186,7899
1989,3342,1587,1781,259731,256189,241,13.991,124,7.199,36251,11055,25196,4.315,14.150,28976,7128,21848,2.782,11.310,7275,2.840,22.621,75,75,1406
1989,3343,399,423,35138,33232,54,13.155,29,7.065,6161,973,5188,2.928,18.539,2282,413,1869,1.243,6.867,3879,11.672,13.734,23,23,249
1989,3344,4880,5502,535724,530572,776,14.441,519,9.659,74469,24688,49781,4.653,14.036,64931,26445,38486,4.984,12.238,9538,1.798,24.476,345,350,7092
1989,3345,4393,5017,675478,677031,399,7.902,464,9.189,76462,33863,42599,5.002,11.294,79870,31010,48860,4.580,11.797,-3408,-0.503,22.587,265,265,3036
1989,3346,746,782,47187,51678,115,14.734,112,14.350,9107,1833,7274,3.547,17.623,17973,6585,11388,12.742,34.779,-8866,-17.156,35.245,87,87,656
1989,3351,1178,1299,85428,86628,105,8.058,113,8.672,7628,1576,6052,1.819,8.806,9919,3803,6116,4.390,11.450,-2291,-2.645,17.611,83,83,937
1989,3352,337,416,110442,111887,46,11.071,45,10.830,10505,2467,8038,2.205,9.389,13345,6729,6616,6.014,11.927,-2840,-2.538,18.778,24,24,611
1989,3353,2125,2586,236548,237327,195,7.545,192,7.429,24374,3541,20833,1.492,10.270,25389,12655,12734,5.332,10.698,-1015,-0.428,20.540,100,106,1312
1989,3359,2192,2570,200330,197045,217,8.401,243,9.408,26524,10311,16213,5.233,13.461,20003,8906,11097,4.520,10.152,6521,3.309,20.303,158,159,1446
1989,3361,240,302,231392,237880,47,16.068,28,9.573,23119,3852,19267,1.619,9.719,36359,8957,27402,3.765,15.285,-13240,-5.566,19.438,20,20,856
1989,3362,1845,2050,124271,124093,200,9.699,224,10.863,18141,4847,13294,3.906,14.619,17620,8369,9251,6.744,14.199,521,0.420,28.398,158,159,2533
1989,3363,4074,4938,687200,673736,500,10.219,410,8.379,74687,17392,57295,2.581,11.086,48102,20700,27402,3.072,7.140,26585,3.946,14.279,263,266,4332
1989,3364,1420,1739,689605,675120,153,8.877,122,7.079,99348,67734,31614,10.033,14.716,67912,10878,57034,1.611,10.059,31436,4.656,20.119,88,90,5306
1989,3365,164,197,31996,30406,24,12.308,20,10.256,6062,1016,5046,3.342,19.937,2769,1438,1331,4.729,9.107,3293,10.830,18.214,13,13,269
1989,3366,1261,1375,166730,165499,161,11.908,115,8.506,20620,3911,16709,2.363,12.459,18176,4251,13925,2.569,10.983,2444,1.477,21.965,87,87,1950
1989,3369,476,489,30388,29768,60,12.435,47,9.741,3855,783,3072,2.630,12.950,2657,436,2221,1.465,8.926,1198,4.024,17.851,27,28,287
1989,3371,13414,14088,403134,407154,1892,13.493,1760,12.552,53844,16323,37521,4.009,13.224,61659,26673,34986,6.551,15.144,-7815,-1.919,26.449,1367,1384,13846
1989,3372,3121,3306,167546,165800,397,12.264,259,8.001,22889,8162,14727,4.923,13.805,19749,6186,13563,3.731,11.911,3140,1.894,23.823,195,195,2528
1989,3379,1142,1295,43186,42773,148,11.576,115,8.995,6338,2378,3960,5.560,14.818,5606,1952,3654,4.564,13.106,732,1.711,26.213,86,88,966
1989,3391,10483,10978,260602,254684,1092,9.928,1134,10.310,41263,10261,31002,4.029,16.202,29640,14231,15409,5.588,11.638,11623,4.564,23.276,786,787,4087
1989,3399,16120,16637,426065,419974,2270,13.850,1775,10.830,68624,20927,47697,4.983,16.340,56247,22188,34059,5.283,13.393,12377,2.947,26.786,1401,1401,11463
1989,4231,22538,27662,322747,319716,2696,9.745,2701,9.763,52148,18216,33932,5.698,16.311,45985,18349,27636,5.739,14.383,6163,1.928,28.766,1915,2027,11131
1989,4232,8538,9781,124140,121758,1279,13.133,1194,12.261,24505,8463,16042,6.951,20.126,19835,7451,12384,6.120,16.291,4670,3.835,32.581,919,932,5067
1989,4233,8416,10993,145770,146724,1262,11.591,1052,9.662,24815,8449,16366,5.758,16.913,26381,8200,18181,5.589,17.980,-1566,-1.067,33.826,748,764,4896
1989,4234,25228,34698,637542,626861,4314,12.404,4479,12.878,121844,43100,78744,6.876,19.437,99589,52494,47095,8.374,15.887,22255,3.550,31.774,2496,2591,18113
1989,4235,6988,9286,141745,140207,939,10.185,805,8.732,22769,7418,15351,5.291,16.240,20017,6692,13325,4.773,14.277,2752,1.963,28.553,506,531,3005
1989,4236,16211,23551,334637,331230,3012,12.931,2497,10.720,74619,27241,47378,8.224,22.528,68205,35924,32281,10.846,20.591,6414,1.936,41.183,1386,1436,9457
1989,4237,11148,15421,173702,171366,1387,9.048,1204,7.854,25880,8400,17480,4.902,15.102,21127,7620,13507,4.447,12.329,4753,2.774,24.657,854,884,5178
1989,4238,48773,63361,701524,683677,6301,10.031,5210,8.294,123132,36303,86829,5.310,18.010,87604,33438,54166,4.891,12.814,35528,5.197,25.627,3326,3485,18681
1989,4239,25079,26814,267111,261161,3719,13.952,3402,12.763,55277,16527,38750,6.328,21.166,43448,17755,25693,6.799,16.637,11829,4.529,33.273,2692,2717,11943
1989,4241,8846,11968,176401,174761,1180,9.960,938,7.918,25605,7747,17858,4.433,14.651,22310,7843,14467,4.488,12.766,3295,1.885,25.532,612,628,3827
1989,4242,3090,4108,116489,114477,701,17.457,516,12.850,21373,6630,14743,5.792,18.670,17281,9282,7999,8.108,15.096,4092,3.575,30.191,349,355,2789
1989,4243,11962,12899,161428,156327,2089,16.393,1777,13.945,37634,11982,25652,7.665,24.074,27317,10979,16338,7.023,17.474,10317,6.600,34.949,1444,1461,8205
1989,4244,27448,33993,698762,690761,3871,11.355,4064,11.922,115354,35505,79849,5.140,16.700,98757,41084,57673,5.948,14.297,16597,2.403,28.594,2959,3009,23240
1989,4245,6976,9943,85503,86701,594,5.924,762,7.599,12047,3806,8241,4.390,13.895,14476,3733,10743,4.306,16.696,-2429,-2.802,27.790,510,549,2740
1989,4246,7707,11208,133270,130390,1159,10.419,990,8.900,23801,6440,17361,4.939,18.254,18197,6674,11523,5.119,13.956,5604,4.298,27.912,543,564,3057
1989,4247,9445,12648,136768,137171,868,6.804,1085,8.505,23159,7454,15705,5.434,16.883,24101,8671,15430,6.321,17.570,-942,-0.687,33.767,709,728,4984
1989,4248,3868,4901,137844,138737,323,6.499,461,9.276,16825,5456,11369,3.933,12.127,18577,8641,9936,6.228,13.390,-1752,-1.263,24.255,310,328,3452
1989,4249,21624,26118,309875,304004,3514,13.598,2961,11.458,59073,20985,38088,6.903,19.432,47345,19000,28345,6.250,15.574,11728,3.858,31.148,2180,2204,11802
1989,4251,31868,34443,313664,310297,3759,11.005,3187,9.330,56638,17880,38758,5.762,18.253,49857,20479,29378,6.600,16.068,6781,2.185,32.135,2161,2172,11014
1989,4411,39360,41299,1029828,1019745,4744,11.555,4257,10.369,146009,57368,88641,5.626,14.318,126004,53822,72182,5.278,12.356,20005,1.962,24.713,3426,3451,41573
1989,4412,11451,12146,96955,96182,1301,10.721,1280,10.548,18587,6111,12476,6.354,19.325,16970,6889,10081,7.163,17.644,1617,1.681,35.287,1053,1074,5771
1989,4413,47008,71320,526852,522795,5245,7.290,6495,9.028,88162,29534,58628,5.649,16.864,79943,30556,49387,5.845,15.291,8219,1.572,30.583,4390,4694,20065
1989,4421,21999,28472,245859,244263,3108,10.943,2970,10.457,43503,15602,27901,6.387,17.810,40235,15012,25223,6.146,16.472,3268,1.338,32.944,2127,2310,10435
1989,4422,23267,29559,194719,189201,3892,13.331,3163,10.834,44713,17917,26796,9.470,23.633,33993,13090,20903,6.919,17.967,10720,5.666,35.933,2327,2425,8821
1989,4431,22748,32185,234947,222536,5833,18.812,3477,11.214,63199,32740,30459,14.712,28.399,38096,16086,22010,7.228,17.119,25103,11.280,34.238,2418,2573,10389
1989,4441,55602,72437,805869,796333,6373,8.834,5780,8.012,128631,49336,79295,6.195,16.153,110068,36553,73515,4.590,13.822,18563,2.331,27.644,4113,4238,22873
1989,4442,16272,19832,151925,151680,1851,9.378,1662,8.421,25222,8035,17187,5.297,16.628,24773,7405,17368,4.882,16.332,449,0.296,32.665,1231,1261,5105
1989,4451,63282,95724,2385413,2318861,11223,11.718,11322,11.822,392343,181568,210775,7.830,16.920,261640,114472,147168,4.937,11.283,130703,5.637,22.566,7618,7838,51931
1989,4452,20964,25134,165586,165311,3376,13.285,3934,15.480,37533,15415,22118,9.325,22.704,37167,17413,19754,10.533,22.483,366,0.221,44.966,2985,3057,13123
1989,4453,26769,31654,154985,155305,3405,10.682,3851,12.081,30233,12587,17646,8.105,19.467,30711,13556,17155,8.729,19.775,-478,-0.308,38.934,2956,3032,9984
1989,4461,48542,77201,742743,727540,7675,10.030,6319,8.258,136467,57769,78698,7.940,18.757,106837,41122,65715,5.652,14.685,29630,4.073,29.369,3999,4176,22194
1989,4471,85404,137669,984143,970139,14695,10.679,14559,10.581,213812,91936,121876,9.477,22.039,185022,79139,105883,8.157,19.072,28790,2.968,38.143,9182,9744,48019
1989,4481,54538,105617,959118,953363,14123,13.454,12835,12.227,204522,91235,113287,9.570,21.453,194910,71560,123350,7.506,20.444,9612,1.008,40.889,7741,8540,37460
1989,4482,10882,37474,215099,209125,4014,10.751,3740,10.017,47869,18416,29453,8.806,22.890,36129,14691,21438,7.025,17.276,11740,5.614,34.553,1574,1746,6538
1989,4483,19531,29991,183859,180476,4222,14.340,3126,10.617,41085,21686,19399,12.016,22.765,34178,13878,20300,7.690,18.938,6907,3.827,37.875,1900,2093,7692
1989,4511,33040,43555,323852,317335,6270,14.552,5335,12.382,69322,34257,35065,10.795,21.845,55744,23259,32485,7.329,17.566,13578,4.279,35.133,3933,4102,14549
1989,4512,8678,13591,91681,89804,2102,15.986,1218,9.263,19559,9029,10530,10.054,21.780,15668,5161,10507,5.747,17.447,3891,4.333,34.894,836,850,3048
1989,4521,261,9820,1608116,1603137,880,9.244,279,2.931,191802,95953,95849,5.985,11.964,184740,34775,149965,2.169,11.524,7062,0.441,23.047,12,21,2616
1989,4529,11464,24769,495225,484465,2487,10.036,2511,10.133,88880,29644,59236,6.119,18.346,69204,27448,41756,5.666,14.285,19676,4.061,28.569,1429,1529,10675
1989,4531,24288,25839,134157,130997,3668,14.405,2915,11.448,28994,11287,17707,8.616,22.133,22792,8944,13848,6.828,17.399,6202,4.734,34.798,2335,2374,7241
1989,4532,31044,38958,250206,244248,6052,15.685,5307,13.754,58958,25344,33614,10.376,24.139,47222,20669,26553,8.462,19.334,11736,4.805,38.667,3802,4422,14999
1989,4533,10010,11977,63979,61647,2060,17.586,1534,13.095,14627,7016,7611,11.381,23.727,10052,4086,5966,6.628,16.306,4575,7.421,32.611,1096,1103,2687
1989,4539,24928,28638,152563,148524,4933,17.532,3930,13.968,39896,17934,21962,12.075,26.862,31730,15126,16604,10.184,21.364,8166,5.498,42.727,2841,2977,11222
1989,4541,5806,7189,118214,116195,1131,16.104,799,11.377,23339,9143,14196,7.869,20.086,19193,5570,13623,4.794,16.518,4146,3.568,33.036,567,572,2701
1989,4542,4166,5075,77354,77375,727,14.495,608,12.122,12807,5826,6981,7.530,16.552,12892,4736,8156,6.121,16.662,-85,-0.110,33.104,392,405,2382
1989,4543,16626,22760,219603,220963,2485,11.017,2076,9.204,38973,13563,25410,6.138,17.638,41365,11501,29864,5.205,18.720,-2392,-1.083,35.276,1469,1520,7611
1989,4811,711,2726,404129,408752,306,11.699,85,3.250,49795,8261,41534,2.021,12.182,59700,2540,57160,0.621,14.605,-9905,-2.423,24.364,11,11,35
1989,4812,858,943,13523,12746,174,20.139,16,1.852,2971,898,2073,7.046,23.310,1403,44,1359,0.345,11.008,1568,12.302,22.016,11,11,32
1989,4831,353,630,32757,32778,93,15.061,68,11.012,5812,1839,3973,5.611,17.732,5688,1759,3929,5.366,17.353,124,0.378,34.707,31,31,617
1989,4832,312,343,12339,11733,55,16.272,45,13.314,2660,742,1918,6.324,22.672,1543,634,909,5.404,13.152,1117,9.521,26.303,28,29,135
1989,4841,21107,27358,584609,577279,4711,17.409,4116,15.210,106211,32019,74192,5.547,18.399,91522,44361,47161,7.684,15.854,14689,2.545,31.708,3046,3085,19705
1989,4842,48138,52713,572694,566303,8101,15.415,7779,14.802,125273,43512,81761,7.684,22.121,111812,48422,63390,8.551,19.744,13461,2.377,39.488,6036,6080,31308
1989,4851,411,439,33055,31619,64,15.572,8,1.946,4044,706,3338,2.233,12.790,1183,68,1115,0.215,3.741,2861,9.048,7.483,4,4,40
1989,4852,312,516,19066,18566,44,8.880,3,0.605,2685,360,2325,1.939,14.462,1642,14,1628,0.075,8.844,1043,5.618,17.688,(D),(D),(D)
1989,4853,5130,5182,51901,49337,1010,21.392,89,1.885,11277,4597,6680,9.318,22.857,6201,281,5920,0.570,12.569,5076,10.289,25.138,73,73,217
1989,4854,3208,3718,104102,99133,487,13.914,51,1.457,17907,8191,9716,8.263,18.064,7735,506,7229,0.510,7.803,10172,10.261,15.605,34,34,185
1989,4855,772,822,20205,19366,138,18.194,11,1.450,3681,1378,2303,7.116,19.008,2018,215,1803,1.110,10.420,1663,8.587,20.841,6,6,51
1989,4859,1049,1068,20033,18501,248,25.901,27,2.820,4797,1863,2934,10.070,25.928,1698,143,1555,0.773,9.178,3099,16.750,18.356,24,24,67
1989,4861,59,336,8884,8438,70,22.727,14,4.545,1965,1145,820,13.570,23.289,1031,155,876,1.837,12.219,934,11.070,24.439,(D),(D),(D)
1989,4862,257,1420,55917,56226,198,14.887,18,1.353,7362,2818,4544,5.012,13.094,8055,324,7731,0.576,14.326,-693,-1.233,26.187,4,5,256
1989,4869,67,355,6680,6877,28,7.910,26,7.345,714,278,436,4.043,10.383,1046,213,833,3.098,15.211,-332,-4.828,20.766,(D),(D),(D)
1989,4871,253,262,4679,4481,53,21.371,25,10.081,883,288,595,6.427,19.705,499,70,429,1.562,11.136,384,8.570,22.272,17,19,62
1989,4872,750,765,8886,8455,162,21.981,106,14.383,2675,1257,1418,14.867,31.638,1905,752,1153,8.894,22.531,770,9.107,45.062,79,79,604
1989,4879,107,111,778,699,16,14.747,11,10.138,301,199,102,28.469,43.062,138,41,97,5.866,19.742,163,23.319,39.485,7,7,34
1989,4881,2255,2908,79667,74622,462,17.159,31,1.151,18067,7362,10705,9.866,24.211,8064,87,7977,0.117,10.806,10003,13.405,21.613,23,23,55
1989,4882,371,581,15642,14287,73,12.500,79,13.527,3984,792,3192,5.544,27.885,1370,587,783,4.109,9.589,2614,18.296,19.178,23,58,330
1989,4883,2066,2489,82210,83301,298,11.973,298,11.973,14530,3598,10932,4.319,17.443,16672,5141,11531,6.172,20.014,-2142,-2.571,34.886,211,215,3299
1989,4884,1542,1639,11419,10024,740,54.212,192,14.066,4720,3332,1388,33.240,47.087,1923,850,1073,8.480,19.184,2797,27.903,38.368,132,147,647
1989,4885,7056,9370,109666,106520,1329,14.414,1029,11.161,23777,7673,16104,7.203,22.322,17797,7892,9905,7.409,16.708,5980,5.614,33.415,676,709,4878
1989,4889,610,639,7459,7312,145,23.558,98,15.922,1851,714,1137,9.765,25.316,1596,649,947,8.876,21.829,255,3.488,43.657,81,84,472
1989,4921,1400,3852,339426,318295,589,16.014,241,6.552,71232,24097,47135,7.571,22.379,29275,6816,22459,2.141,9.197,41957,13.182,18.395,174,178,1474
1989,4922,3783,4062,63461,62114,637,15.597,681,16.675,14288,4285,10003,6.899,23.003,11665,4620,7045,7.438,18.780,2623,4.223,37.560,569,573,3009
1989,4931,6320,10046,421337,414091,1164,11.703,965,9.702,79988,36079,43909,8.713,19.317,66255,20200,46055,4.878,16.000,13733,3.316,32.000,400,408,3303
1989,5111,14377,16844,689215,684107,2186,13.111,1845,11.065,75686,25190,50496,3.682,11.063,65868,26928,38940,3.936,9.628,9818,1.435,19.257,1393,1411,12524
1989,5112,3554,4048,75471,68196,1098,29.366,480,12.838,23818,9632,14186,14.124,34.926,9209,3955,5254,5.799,13.504,14609,21.422,27.007,332,338,2637
1989,5121,9513,13901,208262,222052,2062,14.690,2333,16.621,46604,17485,29119,7.874,20.988,72697,23090,49607,10.398,32.739,-26093,-11.751,41.976,1232,1315,8339
1989,5122,2307,2332,16959,15687,602,26.996,398,17.848,5412,2729,2683,17.397,34.500,2889,1196,1693,7.624,18.417,2523,16.083,36.833,317,317,976
1989,5151,6130,7662,239818,229680,1055,14.723,62,0.865,39956,20822,19134,9.066,17.396,19243,960,18283,0.418,8.378,20713,9.018,16.756,34,34,158
1989,5152,197,289,12579,11518,45,16.605,9,3.321,2658,498,2160,4.324,23.078,516,125,391,1.085,4.480,2142,18.598,8.960,(D),(D),(D)
1989,5171,4068,22222,1011538,982255,3530,17.148,257,1.248,172788,52905,119883,5.386,17.591,112267,5198,107069,0.529,11.430,60521,6.161,22.859,102,109,920
1989,5172,1024,1847,34413,31473,616,39.273,59,3.762,11331,5517,5814,17.529,36.002,5673,780,4893,2.478,18.025,5658,17.977,36.050,40,40,183
1989,5174,189,349,15522,14813,80,25.682,5,1.605,3310,1435,1875,9.687,22.345,1866,48,1818,0.324,12.597,1444,9.748,25.194,3,3,10
1989,5179,972,1715,29604,28646,522,34.581,111,7.353,7625,3737,3888,13.046,26.618,5862,1048,4814,3.659,20.464,1763,6.155,40.928,80,80,610
1989,5182,5455,7611,274801,272047,1352,18.129,1045,14.013,56739,22036,34703,8.100,20.856,51284,21082,30202,7.749,18.851,5455,2.005,37.702,625,632,6385
1989,5191,2643,3104,38930,37697,415,13.710,261,8.622,6284,2262,4022,6.000,16.670,3893,1334,2559,3.539,10.327,2391,6.343,20.654,203,203,961
1989,5211,47,85,25420,24950,6,7.273,(D),(D),1301,82,1219,0.329,5.214,371,(D),368,(D),1.487,930,3.727,2.974,0,0,0
1989,5221,18316,78433,2043926,2005483,6230,8.240,585,0.774,283129,108326,174803,5.401,14.118,205908,6610,199298,0.330,10.267,77221,3.850,20.535,252,252,2379
1989,5222,21164,39711,478408,459475,4258,11.199,880,2.314,94761,39676,55085,8.635,20.624,56994,6513,50481,1.417,12.404,37767,8.220,24.808,314,314,2501
1989,5223,5454,6213,69665,65020,1572,28.388,221,3.991,19001,9777,9224,15.037,29.223,9802,1133,8669,1.743,15.075,9199,14.148,30.151,177,178,824
1989,5231,6799,14531,334075,331702,2651,19.877,263,1.972,62687,27223,35464,8.207,18.899,58307,3541,54766,1.068,17.578,4380,1.320,35.156,182,182,986
1989,5232,92,110,7254,7176,16,15.686,0,0.000,578,203,375,2.829,8.055,434,0,434,0.000,6.048,144,2.007,12.097,0,0,0
1989,5239,15347,16030,170469,157283,3029,20.552,446,3.026,54717,27404,27313,17.423,34.789,29342,5066,24276,3.221,18.656,25375,16.133,37.311,308,308,1200
1989,5241,7025,38149,1394082,1324675,13123,39.592,3116,9.401,258220,125554,132666,9.478,19.493,127673,11126,116547,0.840,9.638,130547,9.855,19.276,115,115,1232
1989,5242,102256,107758,786158,740882,13079,12.823,1556,1.526,167783,69682,98101,9.405,22.646,77232,8690,68542,1.173,10.424,90551,12.222,20.849,1086,1086,4198
1989,5250,2154,2384,25694,24532,221,9.659,29,1.267,6842,3375,3467,13.758,27.890,4570,106,4464,0.432,18.629,2272,9.261,37.257,14,14,44
1989,5311,96128,100034,557984,524896,14353,15.287,2068,2.203,127469,59515,67954,11.338,24.285,61847,7298,54549,1.390,11.783,65622,12.502,23.565,1706,1730,5417
1989,5312,40851,43534,238751,228506,7279,17.973,1210,2.988,57803,24279,33524,10.625,25.296,37072,4137,32935,1.810,16.224,20731,9.072,32.447,964,964,2750
1989,5313,25692,27240,325452,307398,4769,18.875,821,3.249,75427,31017,44410,10.090,24.537,39411,4632,34779,1.507,12.821,36016,11.716,25.642,665,665,2917
1989,5321,5672,10532,140977,142604,1196,11.231,1431,13.437,27639,9037,18602,6.337,19.382,31182,9961,21221,6.985,21.866,-3543,-2.485,38.763,822,882,4629
1989,5322,20682,26137,178602,168793,5074,19.861,3896,15.250,57006,26293,30713,15.577,33.773,37292,17991,19301,10.659,22.093,19714,11.679,44.187,2961,3108,13790
1989,5323,4259,6037,43158,41687,1001,16.952,737,12.481,11753,5226,6527,12.536,28.193,8622,4076,4546,9.778,20.683,3131,7.511,41.365,484,523,2586
1989,5324,8254,10408,108481,102690,1534,14.872,1347,13.059,30165,9268,20897,9.025,29.375,18415,7528,10887,7.331,17.933,11750,11.442,35.865,943,980,4727
1989,5331,1009,1056,14385,13042,237,24.830,34,3.562,4236,1380,2856,10.581,32.480,1513,170,1343,1.303,11.601,2723,20.879,23.202,20,20,85
1989,5411,133758,138897,948494,924867,15192,11.023,13031,9.455,161005,52058,108947,5.629,17.408,113607,43353,70254,4.687,12.284,47398,5.125,24.567,9876,9968,31604
1989,5412,67492,71753,665200,639944,9968,14.016,8704,12.238,145401,44576,100825,6.966,22.721,95531,47043,48488,7.351,14.928,49870,7.793,29.856,6505,6577,25198
1989,5413,60692,67747,940293,916844,9748,14.621,7596,11.393,200068,66186,133882,7.219,21.821,153007,56060,96947,6.114,16.688,47061,5.133,33.377,5484,5566,27505
1989,5414,16132,16357,101822,98794,3125,19.550,2381,14.895,26492,11990,14502,12.136,26.816,20353,9521,10832,9.637,20.602,6139,6.214,41.203,1905,1908,6819
1989,5415,21908,24905,376901,356069,6443,27.220,3973,16.785,112785,50396,62389,14.153,31.675,71357,34562,36795,9.707,20.040,41428,11.635,40.080,2743,2772,14255
1989,5416,46499,48293,405338,382147,11379,24.422,7981,17.129,137626,63083,74543,16.508,36.014,91562,46096,45466,12.062,23.960,46064,12.054,47.920,6224,6266,29839
1989,5417,6640,8232,442280,440307,1038,12.648,988,12.039,57162,14820,42342,3.366,12.982,53092,16767,36325,3.808,12.058,4070,0.924,24.116,618,630,4892
1989,5418,27610,29913,362693,354117,5242,17.832,4210,14.321,83496,31752,51744,8.967,23.579,66992,28941,38051,8.173,18.918,16504,4.661,37.836,3275,3325,17652
1989,5419,33047,36754,282131,271263,4432,12.406,2375,6.648,62208,21345,40863,7.869,22.933,40722,12755,27967,4.702,15.012,21486,7.921,30.024,1744,1753,7964
1989,5511,26500,49590,3159336,3093660,6859,14.309,3546,7.398,620752,242372,378380,7.834,20.065,492494,107605,384889,3.478,15.919,128258,4.146,31.839,559,586,9903
1989,5611,12160,13137,247644,243514,1692,12.650,2169,16.216,59213,18567,40646,7.625,24.316,50715,20864,29851,8.568,20.826,8498,3.490,41.653,1663,1667,14243
1989,5612,422,723,70638,69090,207,31.245,86,12.981,19365,12430,6935,17.991,28.029,16457,4867,11590,7.044,23.820,2908,4.209,47.639,45,48,997
1989,5613,18112,25259,1385237,1299000,5353,22.199,3062,12.698,466458,168797,297661,12.994,35.909,296108,82634,213474,6.361,22.795,170350,13.114,45.590,2082,2138,50337
1989,5614,21933,25015,315093,297982,4247,17.276,3383,13.762,85553,36137,49416,12.127,28.711,51623,21803,29820,7.317,17.324,33930,11.387,34.648,2666,2687,12829
1989,5615,24499,29607,235920,228418,4387,15.202,2888,10.008,51723,20506,31217,8.977,22.644,36864,16296,20568,7.134,16.139,14859,6.505,32.278,2114,2187,11023
1989,5616,12423,15452,504238,493115,2554,16.751,2143,14.056,118815,40025,78790,8.117,24.095,96689,34691,61998,7.035,19.608,22126,4.487,39.216,1581,1600,19894
1989,5617,80724,84841,1068269,1028584,18488,22.980,9710,12.069,275303,94012,181291,9.140,26.765,197242,72862,124380,7.084,19.176,78061,7.589,38.352,7775,7809,44459
1989,5619,14856,16172,222043,218945,2869,18.178,2091,13.248,57903,20434,37469,9.333,26.446,51111,14997,36114,6.850,23.344,6792,3.102,46.688,1616,1635,10173
1989,5621,3135,3232,37689,35064,524,17.052,206,6.704,8974,4137,4837,11.799,25.594,3723,1962,1761,5.596,10.618,5251,14.976,21.236,154,155,1462
1989,5622,1860,2679,71003,65782,416,16.740,28,1.127,14907,5084,9823,7.729,22.661,4609,573,4036,0.871,7.006,10298,15.655,14.013,14,14,58
1989,5629,5059,5369,62579,59038,896,17.269,535,10.311,18653,4873,13780,8.254,31.595,11664,3097,8567,5.246,19.757,6989,11.838,39.514,419,419,2372
1989,6111,13524,14598,447950,439021,578,4.037,19,0.133,42416,7598,34818,1.731,9.662,24478,70,24408,0.016,5.576,17938,4.086,11.151,8,8,39
1989,6112,509,714,55671,53723,66,9.656,5,0.732,8271,2323,5948,4.324,15.396,4399,47,4352,0.087,8.188,3872,7.207,16.377,0,0,0
1989,6113,1991,2347,991794,971314,109,4.750,4,0.174,84838,7599,77239,0.782,8.734,43526,16,43510,0.002,4.481,41312,4.253,8.962,(D),(D),(D)
1989,6114,2618,3175,51695,51079,660,21.643,409,13.412,13361,5416,7945,10.603,26.158,12178,5489,6689,10.746,23.842,1183,2.316,47.683,277,302,3691
1989,6115,4157,5121,74339,69543,794,16.044,450,9.093,19175,7438,11737,10.696,27.573,9796,2920,6876,4.199,14.086,9379,13.487,28.172,292,308,1868
1989,6116,12330,13013,105360,100862,2556,20.254,1769,14.018,27339,11212,16127,11.116,27.105,18330,7795,10535,7.728,18.173,9009,8.932,36.347,1402,1410,6109
1989,6117,1750,1800,19239,18679,355,20.182,273,15.520,4158,1352,2806,7.238,22.260,3080,1228,1852,6.574,16.489,1078,5.771,32.978,209,209,1029
1989,6211,182467,192262,1312277,1282947,14047,7.307,14012,7.289,218864,66927,151937,5.217,17.059,160439,56394,104045,4.396,12.506,58425,4.554,25.011,11376,11540,43587
1989,6212,99379,102144,521366,512912,5872,5.773,5029,4.944,78958,22425,56533,4.372,15.394,62066,18337,43729,3.575,12.101,16892,3.293,24.201,4020,4097,15283
1989,6213,55788,58473,231235,218600,8648,15.290,4819,8.520,60501,26421,34080,12.086,27.677,35046,15565,19481,7.120,16.032,25455,11.645,32.064,3592,3694,12303
1989,6214,7624,11790,212574,200337,1547,13.480,920,8.016,48298,17317,30981,8.644,24.108,23735,10184,13551,5.083,11.848,24563,12.261,23.695,586,606,5424
1989,6215,5432,7110,111926,103969,1301,18.926,829,12.060,32480,15594,16886,14.999,31.240,16568,6746,9822,6.489,15.936,15912,15.305,31.871,506,519,3049
1989,6216,5163,7627,320736,313881,1458,19.833,907,12.338,83974,25260,58714,8.048,26.753,68876,18246,50630,5.813,21.943,15098,4.810,43.887,521,551,7814
1989,6219,5481,6338,126831,120112,1048,17.144,598,9.782,30713,10012,20701,8.336,25.570,17210,5414,11796,4.507,14.328,13503,11.242,28.657,389,393,2730
1989,6221,3476,4908,3714672,3663099,182,3.654,328,6.585,258653,62578,196075,1.708,7.061,154965,76133,78832,2.078,4.230,103688,2.831,8.461,199,204,38049
1989,6222,535,881,329765,324535,75,8.731,31,3.609,19109,7460,11649,2.299,5.888,8276,3589,4687,1.106,2.550,10833,3.338,5.100,11,11,671
1989,6223,218,277,110525,106271,31,11.632,10,3.752,12364,5135,7229,4.832,11.634,3665,2102,1563,1.978,3.449,8699,8.186,6.897,5,5,720
1989,6231,7113,11979,1074242,1038238,1059,9.010,609,5.181,158480,71923,86557,6.927,15.264,86445,36088,50357,3.476,8.326,72035,6.938,16.652,355,377,20627
1989,6232,6125,10089,221573,211563,1721,18.174,482,5.090,45989,20710,25279,9.789,21.738,26009,7523,18486,3.556,12.294,19980,9.444,24.587,318,322,4639
1989,6233,10337,12642,398186,397127,1907,15.348,1473,11.855,66864,28463,38401,7.167,16.837,64469,40150,24319,10.110,16.234,2395,0.603,32.468,928,984,26187
1989,6239,3469,4591,119960,115444,522,11.673,284,6.351,19702,5533,14169,4.793,17.066,10606,3175,7431,2.750,9.187,9096,7.879,18.374,180,185,1655
1989,6241,17891,23961,347148,335164,2738,11.724,1522,6.517,63104,18929,44175,5.648,18.828,39198,9947,29251,2.968,11.695,23906,7.133,23.390,920,924,5301
1989,6242,5222,6110,61378,58518,693,11.676,344,5.796,11470,3814,7656,6.518,19.601,5784,1484,4300,2.536,9.884,5686,9.717,19.768,221,222,964
1989,6243,4783,7099,275768,269822,780,11.273,420,6.070,46094,10459,35635,3.876,17.083,34335,4793,29542,1.776,12.725,11759,4.358,25.450,202,223,2072
1989,6244,34433,41427,398988,386461,5773,14.261,3880,9.585,79643,34672,44971,8.972,20.608,54441,22106,32335,5.720,14.087,25202,6.521,28.174,3046,3097,16781
1989,7111,5332,5377,75665,73243,953,17.924,833,15.667,18748,6083,12665,8.305,25.597,13906,4403,9503,6.011,18.986,4842,6.611,37.972,586,590,2846
1989,7112,2480,2607,66639,67396,490,18.956,446,17.253,14541,5373,9168,7.972,21.575,15863,4119,11744,6.112,23.537,-1322,-1.962,43.151,345,345,2521
1989,7113,2317,2366,38121,36411,469,20.365,343,14.894,11493,3227,8266,8.863,31.565,7986,2703,5283,7.424,21.933,3507,9.632,43.866,256,259,1953
1989,7114,1228,1248,11197,11300,248,20.624,157,13.056,2911,1387,1524,12.274,25.761,3124,1303,1821,11.531,27.646,-213,-1.885,51.522,115,116,919
1989,7115,12254,12284,77463,75751,3855,33.391,2377,20.589,28648,14512,14136,19.158,37.819,24559,8310,16249,10.970,32.421,4089,5.398,64.841,1777,1779,6171
1989,7121,2956,3224,60822,58408,314,9.995,149,4.743,9033,1181,7852,2.022,15.465,4143,647,3496,1.108,7.093,4890,8.372,14.187,115,116,529
1989,7131,1668,2518,76707,71915,457,18.959,242,10.039,16164,3663,12501,5.094,22.477,6892,836,6056,1.162,9.584,9272,12.893,19.167,188,189,641
1989,7132,721,774,26119,24832,158,21.395,87,11.781,5259,2195,3064,8.840,21.179,2654,1158,1496,4.663,10.688,2605,10.491,21.376,69,69,947
1989,7139,37251,40552,622701,609125,5618,13.915,5262,13.033,126326,44331,81995,7.278,20.739,98883,40788,58095,6.696,16.234,27443,4.505,32.467,4127,4221,30901
1989,7211,30260,36472,1401796,1363284,4992,13.827,4256,11.788,279092,132377,146715,9.710,20.472,203567,102829,100738,7.543,14.932,75525,5.540,29.864,3070,3151,62466
1989,7212,4066,4376,28345,27733,571,13.238,446,10.340,7412,3159,4253,11.391,26.726,6319,1771,4548,6.386,22.785,1093,3.941,45.570,309,313,1203
1989,7213,3670,3779,20321,19775,318,8.371,358,9.424,4487,2030,2457,10.266,22.691,3409,1228,2181,6.210,17.239,1078,5.451,34.479,260,260,958
1989,7223,17369,32013,591179,583621,5923,18.803,4899,15.552,149427,71553,77874,12.260,25.603,135545,59466,76079,10.189,23.225,13882,2.379,46.450,2899,2950,26543
1989,7224,51579,52589,320026,315131,8047,15.286,8154,15.489,86650,44403,42247,14.090,27.497,76534,37025,39509,11.749,24.286,10116,3.210,48.573,6587,6601,30027
1989,7225,216417,292718,5591602,5500677,47936,16.610,39710,13.759,1234799,653724,581075,11.884,22.448,1049085,458944,590141,8.343,19.072,185714,3.376,38.144,28980,30093,302533
1989,8111,117135,124784,676693,654527,19517,15.906,15359,12.517,168407,83504,84903,12.758,25.730,123854,54764,69090,8.367,18.923,44553,6.807,37.845,11916,12149,43298
1989,8112,11588,13799,125350,120460,2051,14.979,1838,13.423,30777,10628,20149,8.823,25.550,21398,10020,11378,8.318,17.764,9379,7.786,35.527,1247,1287,5013
1989,8113,20463,21559,169419,164989,2842,13.322,2390,11.203,35817,11918,23899,7.224,21.709,26875,11920,14955,7.225,16.289,8942,5.420,32.578,1847,1860,8513
1989,8114,25838,27640,184047,179330,4542,16.609,3954,14.459,40640,18948,21692,10.566,22.662,31427,13370,18057,7.456,17.525,9213,5.137,35.049,3048,3064,9776
1989,8121,77739,88269,466267,453969,14503,16.642,12259,14.067,120424,66693,53731,14.691,26.527,95935,42165,53770,9.288,21.133,24489,5.394,42.265,9829,10062,32017
1989,8122,17248,20544,127546,125146,1756,8.636,1337,6.575,22841,8690,14151,6.944,18.252,17817,6207,11610,4.960,14.237,5024,4.015,28.474,953,1018,4385
1989,8123,33744,40499,377920,375680,5363,13.273,5174,12.806,70087,28063,42024,7.470,18.656,65549,29274,36275,7.792,17.448,4538,1.208,34.896,3945,4164,20740
1989,8129,13208,22140,169653,167565,4009,18.725,2548,11.901,40920,18629,22291,11.117,24.420,37183,15468,21715,9.231,22.190,3737,2.230,44.380,1439,1531,8751
1989,8131,129691,129757,1076353,1054548,5987,4.718,280,0.221,127278,17091,110187,1.621,12.069,84074,618,83456,0.059,7.973,43204,4.097,15.945,56,56,119
1989,8132,8990,10342,141115,134639,1214,12.209,417,4.194,24958,7587,17371,5.635,18.537,12367,2641,9726,1.962,9.185,12591,9.352,18.371,251,261,1392
1989,8133,8286,9664,107159,103648,1098,11.647,625,6.630,19118,5824,13294,5.619,18.445,12026,2765,9261,2.668,11.603,7092,6.842,23.206,412,429,1913
1989,8134,30663,32198,289665,283518,2740,8.639,1775,5.597,42354,10343,32011,3.648,14.939,29947,6583,23364,2.322,10.563,12407,4.376,21.125,1271,1283,4150
1989,8139,57032,59334,487824,471898,4706,8.125,1885,3.254,85754,18943,66811,4.014,18.172,54361,8452,45909,1.791,11.520,31393,6.653,23.039,1315,1319,5945
1990,2111,6830,8251,120068,118233,873,10.475,1040,12.478,21778,8843,12935,7.479,18.420,18196,6047,12149,5.114,15.390,3582,3.030,30.780,666,679,3037
1990,2121,2097,2645,136410,136921,415,15.430,504,18.740,21106,8089,13017,5.908,15.415,22248,9405,12843,6.869,16.249,-1142,-0.834,30.829,362,365,4989
1990,2122,437,621,47887,45836,93,14.797,108,17.184,8382,2945,5437,6.425,18.287,4400,1826,2574,3.984,9.600,3982,8.688,19.199,82,82,938
1990,2123,3464,5098,105912,106174,413,8.111,401,7.875,17381,4775,12606,4.497,16.370,17876,6522,11354,6.143,16.837,-495,-0.466,32.741,248,253,1624
1990,2131,7882,8938,166948,164032,1265,14.104,1327,14.795,39598,10142,29456,6.183,24.140,33398,15391,18007,9.383,20.361,6200,3.780,40.721,871,882,6639
1990,2211,1745,6205,596362,594276,292,4.811,20,0.330,30760,7429,23331,1.250,5.176,26486,677,25809,0.114,4.457,4274,0.719,8.914,20,20,677
1990,2212,620,2574,143212,139231,264,10.780,14,0.572,13389,7568,5821,5.436,9.616,5931,316,5615,0.227,4.260,7458,5.357,8.520,6,6,13
1990,2213,4109,4372,33428,32688,365,8.640,70,1.657,3987,1358,2629,4.154,12.197,2534,225,2309,0.688,7.752,1453,4.445,15.504,62,62,206
1990,2361,114281,114697,665279,661749,23514,20.850,19674,17.445,210324,87594,122730,13.237,31.783,203424,79227,124197,11.972,30.740,6900,1.043,61.481,14471,14475,60325
1990,2362,38559,39226,730050,720275,5102,13.012,5067,12.923,177614,38161,139453,5.298,24.659,157403,36808,120595,5.110,21.853,20211,2.806,43.706,3881,3885,28257
1990,2371,13682,13982,310211,303664,1388,9.970,1267,9.101,73105,12565,60540,4.138,24.074,59519,13579,45940,4.472,19.600,13586,4.474,39.201,955,958,10014
1990,2372,9748,9957,83386,82893,2005,19.942,2199,21.872,25647,11311,14336,13.645,30.940,24684,12707,11977,15.329,29.778,963,1.162,59.557,1806,1808,9727
1990,2373,9494,9887,263646,256598,939,9.470,997,10.054,61326,8464,52862,3.299,23.900,47398,11293,36105,4.401,18.472,13928,5.428,36.943,732,733,7262
1990,2379,5097,5179,73797,70440,722,13.854,787,15.101,23485,6063,17422,8.607,33.341,16617,4256,12361,6.042,23.590,6868,9.750,47.181,608,608,2931
1990,2381,77775,78208,770940,762737,11486,14.771,10586,13.614,215451,60890,154561,7.983,28.247,199517,62935,136582,8.251,26.158,15934,2.089,52.316,8129,8139,51230
1990,2382,122535,124336,1304482,1297389,15745,12.793,13221,10.742,271292,67062,204230,5.169,20.911,257386,75920,181466,5.852,19.839,13906,1.072,39.678,10309,10323,58561
1990,2383,82036,82478,713307,707111,14590,17.863,12985,15.898,201489,65177,136312,9.217,28.495,188990,61032,127958,8.631,26.727,12499,1.768,53.454,10041,10050,48284
1990,2389,41686,41952,395359,389453,6150,14.783,5448,13.096,108500,29186,79314,7.494,27.860,96737,28537,68200,7.327,24.839,11763,3.020,49.678,4096,4098,22204
1990,3111,1523,2170,54023,53266,206,9.678,123,5.779,7729,2439,5290,4.579,14.510,6149,1709,4440,3.208,11.544,1580,2.966,23.088,81,82,700
1990,3112,500,852,65469,65623,47,5.552,36,4.253,3685,718,2967,1.094,5.615,4049,474,3575,0.722,6.170,-364,-0.555,11.231,24,24,204
1990,3113,1596,1871,86939,87204,198,10.549,210,11.188,8971,1716,7255,1.968,10.287,9328,2120,7208,2.431,10.697,-357,-0.409,20.575,151,152,1051
1990,3114,1174,1594,176325,175689,120,7.509,128,8.010,20271,3385,16886,1.927,11.538,19425,3768,15657,2.145,11.057,846,0.482,22.113,82,82,1599
1990,3115,1424,2035,136677,137507,120,5.814,178,8.624,12946,4053,8893,2.947,9.415,14747,5210,9537,3.789,10.725,-1801,-1.310,18.830,124,124,2055
1990,3116,3786,4405,384974,378605,399,9.176,286,6.577,42051,7041,35010,1.860,11.107,28880,8601,20279,2.272,7.628,13171,3.479,15.256,201,202,5217
1990,3117,702,810,46116,46778,71,8.669,89,10.867,7921,2457,5464,5.253,16.933,9250,2388,6862,5.105,19.774,-1329,-2.841,33.867,59,59,1289
1990,3118,9236,10662,306273,307097,1290,12.038,1398,13.046,34131,10843,23288,3.531,11.114,35638,13801,21837,4.494,11.605,-1507,-0.491,22.228,1025,1050,7701
1990,3119,2055,2426,132442,132257,232,9.599,214,8.854,15359,3837,11522,2.901,11.613,15226,5052,10174,3.820,11.512,133,0.101,23.025,149,149,1929
1990,3121,1740,2180,139731,139122,211,9.697,203,9.329,19070,8855,10215,6.365,13.707,18029,7654,10375,5.502,12.959,1041,0.748,25.918,139,140,1453
1990,3122,96,130,37603,36955,5,3.817,7,5.344,3515,2517,998,6.811,9.512,2093,69,2024,0.187,5.664,1422,3.848,11.327,3,3,10
1990,3131,399,635,108368,109560,47,7.431,42,6.640,9219,3191,6028,2.913,8.415,11507,2998,8509,2.736,10.503,-2288,-2.088,16.829,27,27,980
1990,3132,1645,1984,244117,249336,157,7.899,164,8.252,17460,5147,12313,2.064,7.003,28037,7765,20272,3.114,11.245,-10577,-4.242,14.005,123,123,3182
1990,3133,1829,2083,110646,110615,276,13.670,148,7.330,16348,7445,8903,6.731,14.779,16244,6483,9761,5.861,14.685,104,0.094,29.370,97,98,1375
1990,3141,3557,3865,133767,134042,434,11.090,531,13.568,19800,10571,9229,7.886,14.771,20825,9327,11498,6.958,15.536,-1025,-0.765,29.543,431,435,3364
1990,3149,3976,4091,121997,121361,569,14.077,471,11.653,20873,8279,12594,6.822,17.199,19811,7803,12008,6.430,16.324,1062,0.875,32.648,397,398,5990
1990,3151,1213,1338,132085,134530,146,10.799,174,12.870,18391,7871,10520,5.851,13.671,23495,6712,16783,4.989,17.465,-5104,-3.794,27.341,134,135,2185
1990,3152,11383,12665,730678,751856,2064,16.292,2071,16.348,102137,41765,60372,5.555,13.585,144952,57193,87759,7.607,19.279,-42815,-5.695,27.169,1712,1735,37525
1990,3159,1838,1919,67547,68973,263,13.677,271,14.093,9462,2873,6589,4.165,13.719,12399,4552,7847,6.600,17.977,-2937,-4.258,27.437,228,228,3007
1990,3161,339,365,16266,16237,27,7.248,42,11.275,1727,361,1366,2.223,10.637,1697,728,969,4.484,10.452,30,0.185,20.904,32,32,415
1990,3162,351,470,73306,75168,40,8.325,61,12.695,5931,1951,3980,2.596,7.890,9683,3183,6500,4.235,12.882,-3752,-4.992,15.781,46,49,1344
1990,3169,1073,1122,36424,36924,108,9.495,139,12.220,4732,770,3962,2.085,12.816,5775,1875,3900,5.078,15.640,-1043,-2.825,25.631,106,109,1419
1990,3211,4491,5032,144524,145298,453,8.928,537,10.583,16123,4984,11139,3.430,11.097,17813,5820,11993,4.006,12.260,-1690,-1.163,22.193,402,402,3210
1990,3212,1314,1622,104488,104313,146,9.026,137,8.470,11430,3098,8332,2.970,10.957,11240,4136,7104,3.965,10.775,190,0.182,21.551,95,95,1948
1990,3219,9181,9868,284604,289385,1061,10.754,1058,10.723,36997,11392,25605,3.937,12.785,46596,14539,32057,5.024,16.102,-9599,-3.317,25.569,834,838,10168
1990,3221,230,559,197152,194938,34,6.154,21,3.801,10780,4129,6651,2.118,5.530,6294,2376,3918,1.219,3.229,4486,2.301,6.457,9,9,297
1990,3222,3555,5200,401662,400924,301,5.801,279,5.377,33592,9516,24076,2.374,8.379,32098,8581,23517,2.140,8.006,1494,0.373,16.012,189,189,3242
1990,3231,42086,44086,852733,850788,4508,10.289,3966,9.052,102616,30629,71987,3.600,12.061,99107,34690,64417,4.077,11.649,3509,0.412,23.298,3222,3230,22838
1990,3241,1287,2210,157800,158209,169,7.677,152,6.904,8022,1713,6309,1.083,5.071,8862,1793,7069,1.133,5.601,-840,-0.531,10.141,82,82,686
1990,3251,1186,2362,235534,233267,179,7.664,126,5.395,16315,4351,11964,1.865,6.994,11872,2748,9124,1.178,5.089,4443,1.905,10.179,56,56,1040
1990,3252,375,658,133506,134777,56,8.602,42,6.452,6247,1482,4765,1.100,4.635,8657,3968,4689,2.944,6.423,-2410,-1.788,9.270,19,19,220
1990,3253,635,881,42340,42221,61,6.869,75,8.446,3955,685,3270,1.622,9.367,3703,1376,2327,3.259,8.771,252,0.597,17.541,32,32,630
1990,3254,1072,1332,174612,174019,109,8.214,99,7.460,16155,2378,13777,1.367,9.283,14673,2813,11860,1.616,8.432,1482,0.852,16.864,67,67,1075
1990,3255,1637,2159,78117,77980,143,6.622,144,6.668,7726,2456,5270,3.150,9.908,7544,2035,5509,2.610,9.674,182,0.233,19.349,87,87,721
1990,3256,2077,2348,124175,123301,237,10.216,181,7.802,13659,3336,10323,2.706,11.078,11887,2866,9021,2.324,9.641,1772,1.437,19.281,135,135,1526
1990,3259,2117,2780,140417,140310,244,8.821,216,7.809,14055,5411,8644,3.856,10.017,13528,3448,10080,2.457,9.642,527,0.376,19.283,143,146,1568
1990,3261,10085,12084,684029,686598,1105,9.223,899,7.504,83914,25410,58504,3.701,12.222,88858,26740,62118,3.895,12.942,-4944,-0.720,24.443,615,621,10020
1990,3262,2166,2645,196807,199890,215,8.141,207,7.838,13982,4523,9459,2.263,6.995,20157,4656,15501,2.329,10.084,-6175,-3.089,13.990,151,151,1737
1990,3271,1455,1755,82320,82765,218,12.638,158,9.159,7564,2219,5345,2.681,9.139,8411,1337,7074,1.615,10.163,-847,-1.023,18.278,119,119,794
1990,3272,1798,2062,145954,147047,263,12.927,208,10.224,12483,4219,8264,2.869,8.489,14600,4046,10554,2.752,9.929,-2117,-1.440,16.978,161,161,1584
1990,3273,6454,9111,189396,190039,706,7.792,605,6.677,30128,8458,21670,4.451,15.854,31335,8315,23020,4.375,16.489,-1207,-0.635,31.707,356,370,3989
1990,3274,260,373,18661,18132,60,16.878,25,7.032,2201,1307,894,7.208,12.139,1106,330,776,1.820,6.100,1095,6.039,12.199,22,22,171
1990,3279,1924,2230,75534,75107,216,9.690,214,9.601,9000,3174,5826,4.226,11.983,8196,2514,5682,3.347,10.912,804,1.070,21.825,153,153,1098
1990,3311,334,395,143854,145379,44,11.384,27,6.986,3275,836,2439,0.575,2.253,6315,426,5889,0.293,4.344,-3040,-2.091,4.505,20,20,254
1990,3312,542,735,64774,65857,52,7.075,52,7.075,4718,1256,3462,1.907,7.164,6932,1765,5167,2.680,10.526,-2214,-3.362,14.328,31,31,522
1990,3313,414,597,105711,106249,39,6.582,30,5.063,6205,1695,4510,1.595,5.840,7332,1420,5912,1.336,6.901,-1127,-1.061,11.680,18,19,648
1990,3314,748,913,86181,86834,84,9.266,71,7.832,7345,3332,4013,3.837,8.459,8916,4298,4618,4.950,10.268,-1571,-1.809,16.917,49,49,840
1990,3315,2572,2843,214803,221098,201,7.104,174,6.149,15599,4737,10862,2.142,7.055,28245,7259,20986,3.283,12.775,-12646,-5.720,14.111,114,114,1841
1990,3321,3330,3530,144583,146369,234,6.641,221,6.272,13317,3777,9540,2.580,9.098,17015,4590,12425,3.136,11.625,-3698,-2.526,18.197,167,167,2786
1990,3322,1327,1450,81018,81760,98,6.752,101,6.958,6779,1497,5282,1.831,8.291,8301,2809,5492,3.436,10.153,-1522,-1.862,16.583,67,67,617
1990,3323,10249,11096,345970,348952,933,8.451,820,7.428,43415,11860,31555,3.399,12.442,49368,14031,35337,4.021,14.148,-5953,-1.706,24.883,618,622,8001
1990,3324,1516,1846,114800,116077,137,7.458,119,6.478,11385,3342,8043,2.879,9.808,14087,4390,9697,3.782,12.136,-2702,-2.328,19.616,78,78,1140
1990,3325,971,1063,71145,72600,79,7.418,83,7.793,5679,1787,3892,2.461,7.822,8613,2402,6211,3.309,11.864,-2934,-4.041,15.645,55,56,550
1990,3326,1889,2085,70419,70656,256,12.546,167,8.184,8530,2596,5934,3.674,12.073,8993,3233,5760,4.576,12.728,-463,-0.655,24.145,122,122,1118
1990,3327,21428,21742,342423,344471,1777,8.189,1693,7.802,41543,10152,31391,2.947,12.060,45736,11053,34683,3.209,13.277,-4193,-1.217,24.120,1368,1371,8063
1990,3328,5514,5893,137813,140184,415,7.063,381,6.484,15909,4429,11480,3.159,11.349,20695,5754,14941,4.105,14.763,-4786,-3.414,22.697,296,298,3719
1990,3329,7023,7536,369666,376151,830,11.194,587,7.917,36910,12917,23993,3.434,9.813,49231,18218,31013,4.843,13.088,-12321,-3.276,19.625,438,439,4449
1990,3331,2893,3159,217431,213952,232,7.328,246,7.770,24566,6514,18052,3.045,11.482,17498,5172,12326,2.417,8.178,7068,3.304,16.357,163,163,2397
1990,3332,4198,4455,177302,178822,356,8.026,317,7.147,21236,5504,15732,3.078,11.875,24004,8839,15165,4.943,13.423,-2768,-1.548,23.751,239,239,2419
1990,3333,2267,2394,154362,155147,222,9.318,199,8.353,16212,3905,12307,2.517,10.449,17531,4668,12863,3.009,11.300,-1319,-0.850,20.899,144,146,1697
1990,3334,1627,1884,160646,161304,157,8.371,140,7.465,16438,6095,10343,3.779,10.191,17692,3438,14254,2.131,10.968,-1254,-0.777,20.381,91,91,984
1990,3335,9389,9732,232031,232454,607,6.248,573,5.898,22846,5729,17117,2.465,9.828,23748,5742,18006,2.470,10.216,-902,-0.388,19.656,454,455,3592
1990,3336,733,883,131036,132203,45,5.059,58,6.521,8200,1802,6398,1.363,6.203,10460,1507,8953,1.140,7.912,-2260,-1.709,12.405,39,39,556
1990,3339,5394,5994,325315,326158,433,7.240,406,6.789,35027,10465,24562,3.209,10.739,36813,11762,25051,3.606,11.287,-1786,-0.548,21.479,300,301,3718
1990,3341,1642,1789,269400,266651,228,12.791,215,12.062,36460,12758,23702,4.785,13.673,31230,7477,23753,2.804,11.712,5230,1.961,23.424,148,148,1948
1990,3342,1668,1874,244951,251727,244,13.337,155,8.472,30827,15761,15066,6.261,12.246,44530,20665,23865,8.209,17.690,-13703,-5.444,24.492,95,95,900
1990,3343,414,445,35669,35679,54,12.371,37,8.477,3930,1250,2680,3.504,11.015,3831,606,3225,1.699,10.738,99,0.277,21.475,28,28,390
1990,3344,5101,5731,519713,527836,756,13.446,539,9.586,53008,18361,34647,3.479,10.043,68946,21338,47608,4.043,13.062,-15938,-3.019,20.085,372,374,5387
1990,3345,4406,5043,643587,659146,373,7.414,349,6.937,49540,13638,35902,2.069,7.516,80287,19059,61228,2.891,12.180,-30747,-4.665,15.032,214,215,3292
1990,3346,749,793,56808,51761,115,14.631,101,12.850,16653,3937,12716,7.606,32.173,6810,1456,5354,2.813,13.157,9843,19.016,26.313,73,73,596
1990,3351,1173,1301,82093,83640,96,7.370,99,7.601,7008,2107,4901,2.519,8.379,10080,2215,7865,2.648,12.052,-3072,-3.673,16.758,74,75,1005
1990,3352,362,439,108052,109179,56,13.084,34,7.944,9564,3432,6132,3.143,8.760,11866,1976,9890,1.810,10.868,-2302,-2.108,17.520,23,23,232
1990,3353,2164,2645,229776,233360,216,8.257,158,6.040,19869,7230,12639,3.098,8.514,26939,5426,21513,2.325,11.544,-7070,-3.030,17.029,108,108,1219
1990,3359,2117,2479,193486,196392,141,5.586,231,9.152,16991,3278,13713,1.669,8.652,22700,6333,16367,3.225,11.559,-5709,-2.907,17.303,153,158,2673
1990,3361,245,303,222815,225526,31,10.214,32,10.544,16898,905,15993,0.401,7.493,21679,3358,18321,1.489,9.613,-4781,-2.120,14.985,24,24,182
1990,3362,1821,2024,110415,116877,190,9.348,207,10.185,11123,3168,7955,2.711,9.517,23696,5055,18641,4.325,20.274,-12573,-10.757,19.034,164,165,2336
1990,3363,4110,4999,659010,674005,458,9.219,396,7.971,52565,21105,31460,3.131,7.799,83094,14083,69011,2.089,12.328,-30529,-4.529,15.598,294,297,5920
1990,3364,1469,1806,694885,707214,185,10.437,118,6.657,58298,31472,26826,4.450,8.243,82509,32160,50349,4.547,11.667,-24211,-3.423,16.487,86,86,1511
1990,3365,169,210,34232,33051,27,13.268,14,6.880,5731,2597,3134,7.858,17.340,3332,565,2767,1.709,10.081,2399,7.258,20.163,8,8,202
1990,3366,1287,1390,160510,162833,159,11.522,139,10.072,16272,3211,13061,1.972,9.993,20891,3610,17281,2.217,12.830,-4619,-2.837,19.986,94,94,1249
1990,3369,461,473,28994,29689,49,10.219,62,12.930,2645,288,2357,0.970,8.909,3922,883,3039,2.974,13.210,-1277,-4.301,17.818,53,53,414
1990,3371,13445,14078,391048,396894,1829,12.993,1827,12.979,48340,17656,30684,4.449,12.180,59862,20387,39475,5.137,15.083,-11522,-2.903,24.359,1446,1462,13689
1990,3372,3175,3378,162868,164836,391,11.680,330,9.858,18890,5083,13807,3.084,11.460,22708,6509,16199,3.949,13.776,-3818,-2.316,22.920,268,268,3933
1990,3379,1144,1289,43869,43505,123,9.498,135,10.425,6979,2231,4748,5.128,16.042,6173,2538,3635,5.834,14.189,806,1.853,28.378,104,109,1259
1990,3391,10490,11038,268713,264066,1104,10.047,1005,9.146,36625,11158,25467,4.225,13.870,27168,8110,19058,3.071,10.288,9457,3.581,20.577,803,803,3931
1990,3399,16385,16923,423320,423573,2238,13.351,1917,11.436,59956,21676,38280,5.117,14.155,60732,17644,43088,4.166,14.338,-776,-0.183,28.310,1528,1531,10880
1990,4231,22279,27362,322410,322513,2466,8.970,2727,9.919,47457,13979,33478,4.334,14.715,47744,19615,28129,6.082,14.804,-287,-0.089,29.430,1951,2045,11905
1990,4232,8597,9844,123350,123578,1257,12.812,1191,12.139,21307,7632,13675,6.176,17.242,21877,8482,13395,6.864,17.703,-570,-0.461,34.484,895,916,5628
1990,4233,8410,11044,143416,144363,1171,10.631,1112,10.096,21102,6583,14519,4.560,14.617,23136,8252,14884,5.716,16.026,-2034,-1.409,29.235,785,811,5218
1990,4234,25566,35174,645090,640307,4301,12.321,3767,10.792,104937,33293,71644,5.200,16.389,95802,38013,57789,5.937,14.962,9135,1.427,29.924,2269,2378,17578
1990,4235,7082,9467,143112,142239,905,9.653,722,7.701,19226,5426,13800,3.815,13.517,17566,5172,12394,3.636,12.350,1660,1.167,24.699,471,497,3253
1990,4236,16642,24508,338487,335308,3313,13.794,2331,9.706,67536,30570,36966,9.117,20.142,60630,22899,37731,6.829,18.082,6906,2.060,36.164,1390,1437,9825
1990,4237,11219,15600,176442,174926,1317,8.491,1139,7.343,24181,7290,16891,4.167,13.824,21051,7071,13980,4.042,12.034,3130,1.789,24.068,773,795,4492
1990,4238,49141,64224,721305,710368,5948,9.325,5072,7.952,108985,32640,76345,4.595,15.342,87085,32799,54286,4.617,12.259,21900,3.083,24.518,3492,3620,19986
1990,4239,25140,27028,274263,271197,3601,13.389,3337,12.407,53035,17778,35257,6.555,19.556,47125,17990,29135,6.634,17.377,5910,2.179,34.753,2659,2689,12740
1990,4241,8988,12170,190334,183367,1204,9.973,1009,8.358,34525,17963,16562,9.796,18.828,21442,8095,13347,4.415,11.693,13083,7.135,23.387,660,674,4225
1990,4242,3169,4398,119276,117650,802,18.862,510,11.994,20257,8011,12246,6.809,17.218,16941,6615,10326,5.623,14.399,3316,2.819,28.799,341,348,2311
1990,4243,12095,13089,165867,163597,2008,15.445,1832,14.091,34427,10063,24364,6.151,21.044,29832,11920,17912,7.286,18.235,4595,2.809,36.470,1464,1487,8603
1990,4244,27324,33875,713013,707281,3663,10.787,3827,11.270,112016,35702,76314,5.048,15.838,100382,37481,62901,5.299,14.193,11634,1.645,28.385,2848,2887,22032
1990,4245,6704,9717,84388,84984,577,5.867,812,8.257,11635,3224,8411,3.794,13.691,12816,4913,7903,5.781,15.081,-1181,-1.390,27.382,566,599,3371
1990,4246,7873,11453,138967,136118,1226,10.830,960,8.481,23596,7357,16239,5.405,17.335,18018,5165,12853,3.795,13.237,5578,4.098,26.474,574,603,2972
1990,4247,9235,12312,138872,137519,751,6.021,1074,8.610,21694,5782,15912,4.205,15.775,19123,6221,12902,4.524,13.906,2571,1.870,27.812,632,651,3612
1990,4248,3724,4743,136403,136856,245,5.079,406,8.417,13747,3872,9875,2.829,10.045,14548,5346,9202,3.906,10.630,-801,-0.585,20.090,297,309,3173
1990,4249,22077,26753,326939,318593,3597,13.600,2989,11.301,63095,21782,41313,6.837,19.804,46487,19168,27319,6.016,14.591,16608,5.213,29.183,2251,2313,13234
1990,4251,32486,35150,322661,320485,3829,11.008,3094,8.895,57416,19704,37712,6.148,17.915,52541,16495,36046,5.147,16.394,4875,1.521,32.788,2207,2222,10720
1990,4411,39417,41435,990284,1010388,4595,11.102,4506,10.887,115264,50251,65013,4.973,11.408,155422,60737,94685,6.011,15.382,-40158,-3.975,22.816,3616,3656,48157
1990,4412,11135,11833,93264,94992,1151,9.603,1456,12.148,15845,6193,9652,6.520,16.680,19360,7467,11893,7.861,20.381,-3515,-3.700,33.361,1188,1221,6489
1990,4413,45665,69949,524257,525655,4895,6.934,6194,8.774,77587,25678,51909,4.885,14.760,79574,30359,49215,5.775,15.138,-1987,-0.378,29.520,4121,4424,20260
1990,4421,21808,28356,244339,245070,2877,10.128,2979,10.487,40727,15821,24906,6.456,16.619,42408,14719,27689,6.006,17.304,-1681,-0.686,33.237,2157,2341,10866
1990,4422,23307,29914,196098,195211,3629,12.216,3214,10.819,40060,16362,23698,8.382,20.521,38301,13494,24807,6.913,19.620,1759,0.901,39.241,2388,2544,9824
1990,4431,23856,34105,251343,243458,5863,17.684,3961,11.947,62938,32190,30748,13.222,25.852,47149,19342,27807,7.945,19.366,15789,6.485,38.733,2608,2852,12935
1990,4441,55395,72444,810319,807783,5712,7.884,5732,7.911,117058,41113,75945,5.090,14.491,112530,35328,77202,4.373,13.931,4528,0.561,27.861,4174,4367,22883
1990,4442,16314,19917,158615,155272,1730,8.705,1642,8.262,27347,7078,20269,4.558,17.612,20669,6515,14154,4.196,13.312,6678,4.301,26.623,1262,1286,5035
1990,4451,62668,94885,2481870,2433860,10768,11.297,11626,12.198,380440,171194,209246,7.034,15.631,283392,124551,158841,5.117,11.644,97048,3.987,23.287,7756,7965,51788
1990,4452,20350,24915,163251,164902,3597,14.387,3770,15.079,34993,15158,19835,9.192,21.221,38490,16252,22238,9.856,23.341,-3497,-2.121,42.441,2888,2939,12220
1990,4453,26452,31363,155065,156538,3440,10.917,3737,11.859,29535,12566,16969,8.027,18.868,32478,12892,19586,8.236,20.748,-2943,-1.880,37.735,2828,2881,9340
1990,4461,48583,78401,752094,748293,7986,10.260,6851,8.802,117930,57080,60850,7.628,15.760,110629,43374,67255,5.796,14.784,7301,0.976,29.568,4242,4411,22598
1990,4471,83257,136300,979929,981990,13054,9.530,14402,10.514,187756,81157,106599,8.265,19.120,191773,78278,113495,7.971,19.529,-4017,-0.409,38.240,9541,10065,50529
1990,4481,52829,106352,983639,972552,13255,12.486,12869,12.122,200252,89482,110770,9.201,20.590,176829,64855,111974,6.669,18.182,23423,2.408,36.364,8037,8757,35919
1990,4482,10500,36995,209263,212226,3458,9.289,3922,10.535,39846,16627,23219,7.835,18.775,45238,18268,26970,8.608,21.316,-5392,-2.541,37.551,1554,1746,6877
1990,4483,19687,29652,182818,183046,3389,11.410,3491,11.753,37491,15110,22381,8.255,20.482,37580,18056,19524,9.864,20.530,-89,-0.049,40.964,1996,2501,11067
1990,4511,33282,44078,335568,329839,5650,12.890,5161,11.774,68647,26847,41800,8.139,20.812,57531,20188,37343,6.121,17.442,11116,3.370,34.884,3951,4157,14465
1990,4512,8958,14181,100724,96244,1829,13.155,1274,9.163,22379,8197,14182,8.517,23.252,13471,5202,8269,5.405,13.997,8908,9.256,27.994,934,965,3726
1990,4521,230,9915,1653202,1621276,546,5.608,188,1.931,186322,69288,117034,4.274,11.492,123562,17943,105619,1.107,7.621,62760,3.871,15.243,11,11,513
1990,4529,11312,25062,507934,511543,2657,10.607,2632,10.507,70750,32747,38003,6.402,13.831,78538,25046,53492,4.896,15.353,-7788,-1.522,27.661,1405,1475,9096
1990,4531,24706,26219,137474,136001,3393,13.028,3043,11.684,27790,10649,17141,7.830,20.434,24772,10107,14665,7.432,18.215,3018,2.219,36.429,2418,2482,8191
1990,4532,31343,39700,270083,261000,5694,14.466,5017,12.746,65985,32330,33655,12.387,25.282,48395,19632,28763,7.522,18.542,17590,6.739,37.084,3894,4092,14928
1990,4533,10505,12562,67600,65470,2046,16.664,1478,12.038,14746,6443,8303,9.841,22.523,10531,4314,6217,6.589,16.085,4215,6.438,32.171,1169,1179,3094
1990,4539,25832,29838,161348,157092,5164,17.640,4038,13.793,42364,19302,23062,12.287,26.968,33772,15305,18467,9.743,21.498,8592,5.469,42.997,2996,3144,11420
1990,4541,5948,7321,126634,122135,1006,13.856,885,12.189,25453,7580,17873,6.206,20.840,16187,5753,10434,4.710,13.253,9266,7.587,26.507,601,611,3183
1990,4542,4304,5250,77337,77353,752,14.548,590,11.414,10868,4442,6426,5.743,14.050,10955,4343,6612,5.615,14.162,-87,-0.112,28.100,421,423,2026
1990,4543,16785,23207,227709,223886,2469,10.742,2025,8.810,41019,13549,27470,6.052,18.321,33348,10571,22777,4.722,14.895,7671,3.426,29.790,1588,1622,8251
1990,4811,693,2822,454395,418385,376,14.205,26,0.982,91885,18220,73665,4.355,21.962,18753,649,18104,0.155,4.482,73132,17.480,8.964,14,14,305
1990,4812,913,1008,14605,13731,191,20.772,14,1.523,2845,939,1906,6.839,20.720,1102,52,1050,0.379,8.026,1743,12.694,16.052,8,8,40
1990,4831,371,637,32884,32414,97,15.495,75,11.981,5892,1896,3996,5.849,18.177,4861,1941,2920,5.988,14.997,1031,3.181,29.993,39,46,919
1990,4832,297,332,12475,12482,33,9.778,44,13.037,1850,530,1320,4.246,14.822,1873,635,1238,5.088,15.006,-23,-0.184,29.644,30,30,375
1990,4841,21563,27961,601619,597055,4648,16.803,4050,14.641,106116,34446,71670,5.769,17.773,98501,31905,66596,5.344,16.498,7615,1.275,32.996,3137,3188,21377
1990,4842,47928,52501,571545,571350,7775,14.786,7940,15.100,117954,39054,78900,6.835,20.645,117735,47467,70268,8.308,20.606,219,0.038,41.213,6190,6245,33115
1990,4851,426,456,42746,41794,61,14.153,11,2.552,3580,1043,2537,2.496,8.566,1781,162,1619,0.388,4.261,1799,4.304,8.523,10,10,158
1990,4852,319,515,18306,18223,48,9.736,4,0.811,2985,1013,1972,5.559,16.380,2920,12,2908,0.066,16.024,65,0.357,32.047,4,4,12
1990,4853,5147,5192,52531,49547,907,18.825,159,3.300,11890,4804,7086,9.696,23.997,5899,501,5398,1.011,11.906,5991,12.092,23.812,136,136,421
1990,4854,3213,3741,110955,105699,319,8.832,61,1.689,19381,6373,13008,6.029,18.336,8878,253,8625,0.239,8.399,10503,9.937,16.799,50,50,207
1990,4855,789,840,19664,18522,130,16.582,18,2.296,4107,1427,2680,7.705,22.174,1818,43,1775,0.232,9.816,2289,12.359,19.631,8,8,22
1990,4859,1076,1096,20598,19467,234,23.482,35,3.512,4507,1821,2686,9.354,23.152,2256,219,2037,1.125,11.589,2251,11.563,23.178,33,33,216
1990,4861,61,334,9200,9083,14,4.275,(D),(D),804,57,747,0.628,8.852,566,(D),565,(D),6.232,238,2.620,12.464,(D),(D),(D)
1990,4862,259,1420,54252,54706,91,6.613,3,0.218,5055,1314,3741,2.402,9.240,5922,356,5566,0.651,10.825,-867,-1.585,18.481,(D),(D),(D)
1990,4869,68,358,6562,6569,31,9.038,(D),(D),587,164,423,2.497,8.936,596,(D),572,(D),9.073,-9,-0.137,17.872,0,0,0
1990,4871,260,270,4737,4624,52,20.392,22,8.627,943,316,627,6.834,20.394,727,174,553,3.763,15.722,216,4.671,31.445,16,16,153
1990,4872,818,835,11327,9987,184,23.000,114,14.250,4226,1253,2973,12.547,42.317,1615,460,1155,4.606,16.172,2611,26.145,32.344,88,88,336
1990,4879,116,123,907,809,31,28.311,4,3.653,318,163,155,20.148,39.308,121,49,72,6.057,14.957,197,24.351,29.913,4,4,49
1990,4881,2351,2921,82857,78152,458,16.810,65,2.386,15870,4643,11227,5.941,20.307,6309,556,5753,0.711,8.073,9561,12.234,16.145,32,32,93
1990,4882,388,580,16345,15844,87,15.130,77,13.391,2921,943,1978,5.952,18.437,2017,692,1325,4.368,12.731,904,5.706,25.462,33,33,286
1990,4883,2057,2475,83062,82486,272,10.968,282,11.371,14597,3406,11191,4.129,17.696,13434,4507,8927,5.464,16.286,1163,1.410,32.573,201,201,1793
1990,4884,1943,2032,12758,12119,698,38.100,298,16.266,4341,2532,1809,20.893,35.820,3092,1565,1527,12.914,25.514,1249,10.306,51.027,220,220,1037
1990,4885,7433,9917,120531,116289,1564,16.185,1057,10.938,29187,11167,18020,9.603,25.099,20554,8364,12190,7.192,17.675,8633,7.424,35.350,737,750,5127
1990,4889,693,722,8304,7911,166,24.322,87,12.747,2160,1320,840,16.687,27.305,1392,358,1034,4.526,17.597,768,9.709,35.194,72,72,280
1990,4921,1470,4043,353497,342515,613,15.922,227,5.896,39883,12940,26943,3.778,11.644,17462,3265,14197,0.953,5.098,22421,6.546,10.196,180,180,1102
1990,4922,3763,4055,65082,64356,646,15.923,650,16.022,13340,4348,8992,6.756,20.729,11790,4528,7262,7.036,18.320,1550,2.408,36.640,536,547,3852
1990,4931,6466,10328,435109,428217,1093,10.727,816,8.008,74883,28800,46083,6.726,17.487,60683,16041,44642,3.746,14.171,14200,3.316,28.342,390,403,3897
1990,5111,14719,17300,710243,699313,2253,13.203,1782,10.443,83840,30307,53533,4.334,11.989,62197,23907,38290,3.419,8.894,21643,3.095,17.788,1386,1402,11458
1990,5112,3866,4515,88211,81694,1081,25.148,648,15.075,24485,8455,16030,10.350,29.972,11446,5283,6163,6.467,14.011,13039,15.961,28.022,472,476,3444
1990,5121,9722,14388,244001,225731,2422,17.130,1924,13.608,79955,27637,52318,12.243,35.421,42809,21189,21620,9.387,18.965,37146,16.456,37.929,1183,1222,9008
1990,5122,2207,2231,17859,17265,370,16.339,437,19.298,4679,1505,3174,8.717,27.102,3551,1740,1811,10.078,20.568,1128,6.534,41.136,360,360,1436
1990,5151,6246,7774,237627,231437,1012,13.870,57,0.781,33319,15599,17720,6.740,14.397,21197,321,20876,0.139,9.159,12122,5.238,18.318,48,48,232
1990,5152,195,277,14512,13030,40,15.414,5,1.927,3558,1573,1985,12.073,27.307,628,8,620,0.061,4.820,2930,22.487,9.640,4,4,7
1990,5171,4117,21924,1012026,997989,1897,9.011,152,0.722,112937,32152,80785,3.222,11.316,85641,1525,84116,0.153,8.581,27296,2.735,17.163,137,137,1356
1990,5172,1140,2060,45148,38814,508,27.586,71,3.856,16646,8762,7884,22.575,42.887,3709,340,3369,0.876,9.556,12937,33.331,19.112,64,64,290
1990,5174,206,369,18475,16808,63,18.448,8,2.343,4743,2337,2406,13.904,28.219,1446,32,1414,0.190,8.603,3297,19.616,17.206,8,8,32
1990,5179,1114,1838,31813,29996,435,25.664,149,8.791,7543,3665,3878,12.218,25.147,3903,680,3223,2.267,13.012,3640,12.135,26.023,127,127,477
1990,5182,5501,7740,291145,283059,1243,16.176,1131,14.719,62021,26688,35333,9.428,21.911,45321,18976,26345,6.704,16.011,16700,5.900,32.022,623,632,5591
1990,5191,2678,3067,37134,37952,311,10.109,330,10.726,5327,2010,3317,5.296,14.036,6788,4491,2297,11.833,17.886,-1461,-3.850,28.072,206,206,1079
1990,5211,48,83,25188,25341,3,3.681,0,0.000,575,30,545,0.118,2.269,877,0,877,0.000,3.461,-302,-1.192,4.538,0,0,0
1990,5221,17794,79981,2088447,2039581,5085,6.549,409,0.527,281752,105514,176238,5.173,13.814,185081,4659,180422,0.228,9.074,96671,4.740,18.149,367,369,3845
1990,5222,21216,39858,495345,472267,4788,12.688,543,1.439,104810,39263,65547,8.314,22.193,58100,4855,53245,1.028,12.302,46710,9.891,24.605,424,424,3529
1990,5223,5981,7026,76194,71958,1792,28.460,333,5.289,20455,8893,11562,12.359,28.426,11929,1815,10114,2.522,16.578,8526,11.849,33.155,289,289,1680
1990,5231,6836,16627,317921,312237,4024,27.261,292,1.978,73215,33894,39321,10.855,23.449,60173,1465,58708,0.469,19.272,13042,4.177,38.543,254,254,1302
1990,5232,90,103,7407,7301,6,6.000,0,0.000,446,8,438,0.110,6.109,231,0,231,0.000,3.164,215,2.945,6.328,0,0,0
1990,5239,15817,16702,191566,175803,3243,21.119,550,3.582,54542,20417,34125,11.614,31.024,23048,3425,19623,1.948,13.110,31494,17.914,26.220,439,439,2221
1990,5241,7065,39074,1420301,1387071,4588,12.440,205,0.556,200192,65092,135100,4.693,14.433,135167,3151,132016,0.227,9.745,65025,4.688,19.490,169,169,928
1990,5242,104482,110711,901577,860786,14037,13.397,2169,2.070,189375,74329,115046,8.635,22.000,105986,13934,92052,1.619,12.313,83389,9.688,24.625,1632,1633,8891
1990,5250,2248,2460,38105,33243,294,12.618,34,1.459,12031,2812,9219,8.459,36.192,2733,188,2545,0.566,8.221,9298,27.970,16.443,21,21,102
1990,5311,97201,101650,575594,545005,13792,14.337,2884,2.998,130049,63073,66976,11.573,23.862,68927,9703,59224,1.780,12.647,61122,11.215,25.294,2471,2473,7781
1990,5312,41309,44187,244065,234602,7281,17.420,2499,5.979,58046,28342,29704,12.081,24.742,39261,7331,31930,3.125,16.735,18785,8.007,33.470,2015,2015,5959
1990,5313,25982,27648,338517,321800,4671,17.884,1612,6.172,79331,33399,45932,10.379,24.652,46157,5855,40302,1.819,14.343,33174,10.309,28.687,1374,1374,4909
1990,5321,5450,10282,143106,141933,1062,10.203,1316,12.643,23730,7590,16140,5.348,16.719,21467,8395,13072,5.915,15.125,2263,1.594,30.249,789,892,6365
1990,5322,20866,27063,191525,184857,5034,18.935,4080,15.346,56536,27177,29359,14.702,30.584,43305,18034,25271,9.756,23.426,13231,7.157,46.852,3191,3352,14804
1990,5323,4173,6036,43610,43135,664,11.012,652,10.813,9024,3162,5862,7.330,20.920,8051,3151,4900,7.305,18.665,973,2.256,37.329,445,462,2317
1990,5324,8110,10365,117443,113351,1271,12.250,1292,12.452,28279,10112,18167,8.921,24.948,20290,7683,12607,6.778,17.900,7989,7.048,35.800,909,930,5349
1990,5331,1046,1120,17640,16185,230,22.505,34,3.327,4866,1378,3488,8.514,30.066,1836,245,1591,1.514,11.344,3030,18.722,22.688,28,28,233
1990,5411,135984,141288,982715,965891,15036,10.741,12422,8.874,148796,49943,98853,5.171,15.405,114801,42140,72661,4.363,11.886,33995,3.520,23.771,9496,9561,32672
1990,5412,69642,73853,675635,670801,10300,14.145,8233,11.306,116604,44150,72454,6.582,17.383,107694,35764,71930,5.332,16.055,8910,1.328,32.109,6127,6181,24594
1990,5413,63092,70626,989387,965033,10537,15.277,7228,10.480,203011,67813,135198,7.027,21.037,154472,43600,110872,4.518,16.007,48539,5.030,32.014,5285,5348,26512
1990,5414,16882,17121,104036,103259,3319,19.827,2556,15.269,24400,10950,13450,10.604,23.630,22809,10785,12024,10.445,22.089,1591,1.541,44.178,2104,2108,8611
1990,5415,23894,27208,417475,396556,6719,25.797,4395,16.874,109588,49705,59883,12.534,27.635,68243,30145,38098,7.602,17.209,41345,10.426,34.418,3220,3243,16767
1990,5416,46587,48749,443906,426549,9573,19.924,8172,17.008,127088,50611,76477,11.865,29.795,92515,42702,49813,10.011,21.689,34573,8.105,43.378,6509,6539,34079
1990,5417,6855,8531,461432,451988,1115,13.305,813,9.702,54790,13675,41115,3.026,12.122,36151,7897,28254,1.747,7.998,18639,4.124,15.996,512,516,3640
1990,5418,28651,30974,391739,377575,5196,17.063,4152,13.635,91357,25189,66168,6.671,24.196,63838,25361,38477,6.717,16.907,27519,7.288,33.815,3283,3319,17914
1990,5419,34026,37860,299030,289880,4381,11.840,2662,7.194,63411,21287,42124,7.343,21.875,45013,13502,31511,4.658,15.528,18398,6.347,31.056,2024,2038,8633
1990,5511,27566,51802,3233682,3180213,6867,13.690,3581,7.139,556198,187683,368515,5.902,17.489,448395,94731,353664,2.979,14.100,107803,3.390,28.199,625,651,8721
1990,5611,12248,13277,256065,252191,2017,15.281,1861,14.100,67891,28835,39056,11.434,26.920,59892,29131,30761,11.551,23.749,7999,3.172,47.497,1419,1442,18868
1990,5612,451,798,75965,76129,140,18.241,79,10.293,14638,5371,9267,7.055,19.228,14651,4104,10547,5.391,19.245,-13,-0.017,38.456,35,35,1839
1990,5613,19215,26893,1555276,1471377,4823,18.492,3199,12.266,492728,161528,331200,10.978,33.488,326323,81253,245070,5.522,22.178,166405,11.309,44.356,2206,2253,44676
1990,5614,22813,26006,340218,328914,4317,16.926,3314,12.994,81664,30882,50782,9.389,24.828,58988,25659,33329,7.801,17.934,22676,6.894,35.868,2558,2607,16817
1990,5615,24954,30434,247250,242377,4139,13.782,3337,11.111,52769,20657,32112,8.523,21.771,42742,18277,24465,7.541,17.635,10027,4.137,35.269,2400,2522,13013
1990,5616,12830,16111,538344,524580,2660,16.845,2020,12.792,124194,41452,82742,7.902,23.675,96644,31872,64772,6.076,18.423,27550,5.252,36.846,1524,1537,19702
1990,5617,85511,89748,1117189,1085354,18754,21.884,10655,12.433,277047,99423,177624,9.160,25.526,213630,76562,137068,7.054,19.683,63417,5.843,39.366,8550,8572,47015
1990,5619,15537,16846,231573,227073,2985,18.071,2330,14.105,56769,21582,35187,9.504,25.000,47390,17071,30319,7.518,20.870,9379,4.130,41.740,1787,1803,11256
1990,5621,3300,3424,41055,39076,505,15.211,297,8.946,8995,3933,5062,10.065,23.020,5030,1900,3130,4.862,12.873,3965,10.147,25.745,255,255,1528
1990,5622,1912,2781,77727,72721,383,14.719,25,0.961,15866,4727,11139,6.500,21.818,5941,430,5511,0.591,8.170,9925,13.648,16.339,20,20,412
1990,5629,5266,5580,68681,65114,909,16.813,562,10.395,18897,5438,13459,8.352,29.022,11776,3594,8182,5.520,18.085,7121,10.936,36.171,452,452,2676
1990,6111,13557,14690,463874,453139,642,4.463,31,0.216,45576,7989,37587,1.763,10.058,24080,143,23937,0.032,5.314,21496,4.744,10.628,11,11,59
1990,6112,512,725,56577,55488,57,8.172,(D),(D),7433,2127,5306,3.833,13.396,5330,(D),5325,(D),9.606,2103,3.790,19.211,(D),(D),(D)
1990,6113,2025,2386,1031114,1005368,105,4.497,3,0.128,90689,20334,70355,2.023,9.020,39165,19,39146,0.002,3.896,51524,5.125,7.791,0,0,0
1990,6114,2815,3377,52341,51862,667,20.419,446,13.654,12327,4691,7636,9.045,23.769,11449,4938,6511,9.521,22.076,878,1.693,44.152,307,325,3255
1990,6115,4408,5405,76283,75699,754,14.367,440,8.384,16866,5307,11559,7.011,22.280,15713,4366,11347,5.768,20.757,1153,1.523,41.514,276,276,2143
1990,6116,13291,14045,117842,110992,2822,20.894,1744,12.913,31944,12761,19183,11.497,28.781,18016,7598,10418,6.846,16.232,13928,12.549,32.464,1373,1392,5830
1990,6117,1926,1974,20815,19998,434,23.048,252,13.383,4180,1495,2685,7.476,20.903,2577,1052,1525,5.261,12.887,1603,8.016,25.773,206,206,902
1990,6211,182824,193296,1393702,1356904,13915,7.217,12922,6.702,229755,68067,161688,5.016,16.932,156257,54109,102148,3.988,11.516,73498,5.417,23.031,10643,10799,41371
1990,6212,100321,103219,539890,530739,5635,5.487,4588,4.468,79095,20891,58204,3.936,14.903,60980,17012,43968,3.205,11.490,18115,3.413,22.979,3720,3764,14454
1990,6213,59156,62071,255584,243605,8620,14.298,5051,8.378,63305,25398,37907,10.426,25.987,39330,16156,23174,6.632,16.145,23975,9.842,32.290,3945,4004,12419
1990,6214,7761,12255,231035,222614,1454,12.103,972,8.091,44845,15529,29316,6.976,20.145,27850,10224,17626,4.593,12.510,16995,7.634,25.021,554,589,5374
1990,6215,5593,7309,118775,114953,1018,14.122,817,11.334,27788,10231,17557,8.900,24.173,19565,11028,8537,9.593,17.020,8223,7.153,34.040,547,571,3898
1990,6216,5323,8072,366670,345248,1222,15.533,812,10.322,90879,28602,62277,8.284,26.323,47474,13786,33688,3.993,13.751,43405,12.572,27.501,519,531,7651
1990,6219,5668,6625,137125,130771,993,15.565,502,7.869,30434,10074,20360,7.704,23.273,17563,6639,10924,5.077,13.430,12871,9.842,26.861,352,354,3692
1990,6221,3452,4918,3855710,3798886,146,2.961,172,3.488,236958,42267,194691,1.113,6.238,123808,45272,78536,1.192,3.259,113150,2.979,6.518,87,103,22387
1990,6222,561,936,339493,335768,67,7.330,23,2.516,16953,5740,11213,1.710,5.049,9158,1641,7517,0.489,2.727,7795,2.322,5.455,8,8,605
1990,6223,231,304,118264,115778,28,9.524,8,2.721,8580,3046,5534,2.631,7.411,3481,1319,2162,1.139,3.007,5099,4.404,6.013,5,5,1033
1990,6231,7336,12290,1121248,1098188,864,7.113,576,4.742,136232,51244,84988,4.666,12.405,91018,37772,53246,3.439,8.288,45214,4.117,16.576,284,310,18455
1990,6232,6534,11250,245387,234794,1690,15.805,575,5.378,48759,22123,26636,9.422,20.767,27016,8062,18954,3.434,11.506,21743,9.260,23.013,380,410,5010
1990,6233,10695,12960,402421,400520,1854,14.478,1546,12.072,66279,29354,36925,7.329,16.548,62990,35154,27836,8.777,15.727,3289,0.821,31.454,906,925,14473
1990,6239,3693,4931,127863,124014,611,12.815,285,5.977,20445,7442,13003,6.001,16.486,12790,3784,9006,3.051,10.313,7655,6.173,20.627,178,178,2142
1990,6241,19046,25670,373325,360667,3195,12.853,1570,6.316,63054,20608,42446,5.714,17.483,37775,9454,28321,2.621,10.474,25279,7.009,20.947,1061,1070,5845
1990,6242,5444,6363,65978,63387,673,10.780,433,6.936,12156,3847,8309,6.069,19.178,6935,2202,4733,3.474,10.941,5221,8.237,21.882,305,307,1379
1990,6243,4950,7454,286259,281767,746,10.216,442,6.053,43456,8160,35296,2.896,15.423,34557,5335,29222,1.893,12.264,8899,3.158,24.529,222,250,2676
1990,6244,35928,43580,431575,415256,6107,14.367,3962,9.321,87165,36802,50363,8.862,20.991,54299,21444,32855,5.164,13.076,32866,7.915,26.152,3164,3211,16946
1990,7111,5634,5679,84480,80005,1114,20.119,830,14.990,22317,6737,15580,8.421,27.895,13297,4617,8680,5.771,16.620,9020,11.274,33.241,628,629,3194
1990,7112,2558,2698,73114,70100,493,18.558,410,15.434,15601,4957,10644,7.071,22.255,9631,3083,6548,4.398,13.739,5970,8.516,27.478,314,314,2247
1990,7113,2439,2495,42548,40302,454,18.664,329,13.525,11875,3775,8100,9.367,29.465,7320,2050,5270,5.087,18.163,4555,11.302,36.326,248,249,1300
1990,7114,1342,1360,11862,11523,293,22.461,182,13.952,3326,1601,1725,13.895,28.865,2570,1358,1212,11.786,22.304,756,6.561,44.608,134,136,1055
1990,7115,11370,11410,83381,79786,1958,16.699,2588,22.072,28758,6529,22229,8.183,36.044,22103,11661,10442,14.615,27.703,6655,8.341,55.406,2076,2076,8581
1990,7121,3068,3334,63464,62103,321,9.791,210,6.405,7784,1681,6103,2.707,12.534,5053,838,4215,1.349,8.137,2731,4.398,16.273,144,147,611
1990,7131,1600,2487,81272,78984,321,12.814,357,14.251,12119,2427,9692,3.073,15.344,7242,2336,4906,2.958,9.169,4877,6.175,18.338,230,236,1462
1990,7132,785,847,26642,25248,181,22.291,111,13.670,5624,2913,2711,11.538,22.275,2843,963,1880,3.814,11.260,2781,11.015,22.521,78,78,788
1990,7139,37864,41028,649318,636995,5676,13.909,5239,12.838,127206,46146,81060,7.244,19.970,102156,39616,62540,6.219,16.037,25050,3.933,32.074,3997,4061,29631
1990,7211,30363,36875,1443663,1423721,4547,12.399,4143,11.297,255988,112289,143699,7.887,17.980,214931,95533,119398,6.710,15.096,41057,2.884,30.193,2990,3075,60660
1990,7212,4171,4476,28718,28476,579,13.069,488,11.015,6827,2325,4502,8.165,23.975,6199,2524,3675,8.864,21.770,628,2.205,43.539,314,330,1887
1990,7213,3619,3734,19622,19922,282,7.510,324,8.628,2994,869,2125,4.362,15.029,3576,1233,2343,6.189,17.950,-582,-2.921,30.058,234,234,793
1990,7223,17221,32375,591209,591742,5592,17.374,5213,16.197,142372,68762,73610,11.620,24.060,142899,61935,80964,10.467,24.149,-527,-0.089,48.120,2858,2889,26484
1990,7224,51795,52770,331831,325705,8203,15.569,8042,15.263,90131,47968,42163,14.727,27.673,78083,38142,39941,11.711,23.974,12048,3.699,47.947,6561,6588,32134
1990,7225,220127,298925,5733163,5662006,46692,15.783,40531,13.700,1200567,636737,563830,11.246,21.204,1059789,448390,611399,7.919,18.718,140778,2.486,37.435,30020,30970,301863
1990,8111,120265,128561,697439,687810,18836,14.866,15128,11.939,153662,70615,83047,10.267,22.341,134447,57413,77034,8.347,19.547,19215,2.794,39.094,12048,12188,46632
1990,8112,11968,14280,131873,130181,2143,15.244,1699,12.086,27835,10505,17330,8.070,21.382,24471,9383,15088,7.208,18.798,3364,2.584,37.595,1238,1266,4528
1990,8113,20899,22033,177269,173467,2856,13.101,2391,10.968,35586,11456,24130,6.604,20.515,28089,10654,17435,6.142,16.193,7497,4.322,32.386,1883,1891,7673
1990,8114,26418,28305,186189,185926,4527,16.174,3895,13.916,35652,14612,21040,7.859,19.175,35146,12481,22665,6.713,18.903,506,0.272,37.806,3045,3073,9477
1990,8121,77461,88111,473834,469854,13229,15.006,13321,15.111,111801,55297,56504,11.769,23.795,103700,50458,53242,10.739,22.071,8101,1.724,44.141,10278,10454,33776
1990,8122,17029,20460,130398,128248,1479,7.248,1369,6.709,20751,7315,13436,5.704,16.180,16448,4990,11458,3.891,12.825,4303,3.355,25.650,1047,1105,4135
1990,8123,34295,41196,382685,380754,5530,13.529,4887,11.956,65912,27023,38889,7.097,17.311,62072,24716,37356,6.491,16.302,3840,1.009,32.605,3789,3973,19196
1990,8129,13464,22371,175528,174549,3495,15.857,2835,12.862,41871,17645,24226,10.109,23.988,40048,14770,25278,8.462,22.944,1823,1.044,45.887,1677,1735,7734
1990,8131,131848,131911,1109093,1087212,6238,4.835,444,0.344,129681,19288,110393,1.774,11.928,85850,842,85008,0.077,7.896,43831,4.032,15.793,91,91,219
1990,8132,9410,10856,148450,143871,1152,10.975,433,4.125,24018,6441,17577,4.477,16.694,14814,2983,11831,2.073,10.297,9204,6.397,20.593,295,295,1765
1990,8133,8649,10121,115042,111779,1107,11.184,661,6.678,20909,5127,15782,4.587,18.706,14335,3653,10682,3.268,12.824,6574,5.881,25.649,448,450,2074
1990,8134,30977,32574,303647,296797,2308,7.127,1925,5.945,43822,9245,34577,3.115,14.765,29881,7042,22839,2.373,10.068,13941,4.697,20.136,1411,1412,5097
1990,8139,57828,60034,498330,488832,4779,8.138,2167,3.690,82580,20435,62145,4.180,16.893,63722,8967,54755,1.834,13.036,18858,3.858,26.071,1588,1597,6258
1991,2111,6894,8264,116552,117222,940,11.310,1034,12.441,19046,8110,10936,6.918,16.248,20504,8444,12060,7.203,17.492,-1458,-1.244,32.496,664,676,3209
1991,2121,1934,2458,128091,132271,332,13.058,501,19.705,18436,7714,10722,5.832,13.938,26623,11150,15473,8.430,20.128,-8187,-6.190,27.876,367,369,6123
1991,2122,411,589,45896,46689,79,13.134,104,17.290,3904,1325,2579,2.838,8.362,5422,1173,4249,2.512,11.613,-1518,-3.251,16.724,63,63,321
1991,2123,3503,5176,102276,104402,421,8.098,467,8.982,14693,5001,9692,4.790,14.074,18966,6258,12708,5.994,18.166,-4273,-4.093,28.147,266,271,2694
1991,2131,8619,9698,182233,177979,1314,13.660,1156,12.018,45344,16524,28820,9.284,25.477,36779,15198,21581,8.539,20.665,8565,4.812,41.330,824,833,7441
1991,2211,1703,6585,596934,594789,628,9.991,29,0.461,40773,18918,21855,3.181,6.855,36323,704,35619,0.118,6.107,4450,0.748,12.214,25,25,151
1991,2212,774,2838,144769,143784,229,8.394,9,0.330,11206,4865,6341,3.384,7.794,9314,23,9291,0.016,6.478,1892,1.316,12.956,6,6,13
1991,2213,4122,4474,32745,32156,419,9.725,88,2.042,4512,2355,2157,7.324,14.032,3341,556,2785,1.729,10.390,1171,3.642,20.780,71,71,182
1991,2361,113366,113794,576624,624539,20776,18.103,22717,19.794,152397,66719,85678,10.683,24.402,248208,88475,159733,14.166,39.743,-95811,-15.341,48.803,15709,15713,65155
1991,2362,37560,38216,651847,689299,4350,11.208,5540,14.274,122947,27218,95729,3.949,17.837,198443,48216,150227,6.995,28.789,-75496,-10.953,35.673,4149,4159,35017
1991,2371,13725,14061,295967,303662,1256,8.873,1446,10.215,55153,12402,42751,4.084,18.163,71085,14998,56087,4.939,23.409,-15932,-5.247,36.325,1061,1065,11650
1991,2372,9567,9778,79350,86140,1546,15.097,2471,24.130,20007,8410,11597,9.763,23.226,33547,13410,20137,15.568,38.945,-13540,-15.719,46.453,1987,1992,10026
1991,2373,9308,9704,235106,247629,812,8.265,1052,10.708,41818,7036,34782,2.841,16.887,66942,13370,53572,5.399,27.033,-25124,-10.146,33.775,762,765,9973
1991,2379,4880,4951,67401,71208,623,12.317,837,16.548,15430,3926,11504,5.513,21.669,22894,6434,16460,9.036,32.151,-7464,-10.482,43.338,620,620,4094
1991,2381,76424,76853,662616,718955,9800,12.567,12063,15.468,148879,44118,104761,6.136,20.708,261821,70535,191286,9.811,36.417,-112942,-15.709,41.415,8740,8745,54136
1991,2382,123587,125467,1207182,1259989,13958,11.087,14817,11.769,217324,58703,158621,4.659,17.248,323043,86943,236100,6.900,25.639,-105719,-8.390,34.496,11100,11123,66840
1991,2383,81561,82026,616672,668679,12967,15.669,14422,17.428,143162,51537,91625,7.707,21.410,248135,70729,177406,10.577,37.108,-104973,-15.699,42.819,10394,10404,53201
1991,2389,41442,41717,357469,377563,5335,12.675,6080,14.445,84793,26291,58502,6.963,22.458,124829,33445,91384,8.858,33.062,-40036,-10.604,44.916,4374,4376,23919
1991,3111,1630,2257,54740,54792,176,7.859,141,6.296,7116,2151,4965,3.926,12.987,7153,2598,4555,4.742,13.055,-37,-0.068,25.975,64,66,606
1991,3112,476,821,65527,65438,31,3.706,62,7.412,4407,857,3550,1.310,6.735,4269,1474,2795,2.253,6.524,138,0.211,13.047,43,43,555
1991,3113,1563,1813,86339,86731,181,9.880,219,11.954,8336,2125,6211,2.450,9.611,9063,2907,6156,3.352,10.450,-727,-0.838,19.223,141,144,2079
1991,3114,1182,1605,174323,175806,118,7.316,134,8.308,18686,4373,14313,2.487,10.629,21743,6249,15494,3.554,12.368,-3057,-1.739,21.258,93,93,3295
1991,3115,1366,1960,133591,135311,56,2.782,162,8.048,10976,1074,9902,0.794,8.112,14211,5942,8269,4.391,10.502,-3235,-2.391,16.223,105,106,2249
1991,3116,3843,4463,394647,389505,345,7.748,324,7.277,46839,9811,37028,2.519,12.025,36232,14628,21604,3.756,9.302,10607,2.723,18.604,236,238,7837
1991,3117,693,809,45596,45955,75,9.214,85,10.442,8108,2760,5348,6.006,17.644,8841,2772,6069,6.032,19.239,-733,-1.595,35.287,60,63,2253
1991,3118,9336,10759,306975,307322,1222,11.342,1252,11.621,35891,10766,25125,3.503,11.679,36816,12326,24490,4.011,11.980,-925,-0.301,23.357,938,950,8906
1991,3119,2160,2536,132151,132933,240,9.518,211,8.368,17309,5595,11714,4.209,13.021,18386,8708,9678,6.551,13.831,-1077,-0.810,26.042,149,153,4217
1991,3121,1738,2163,137934,138084,145,6.627,195,8.912,12967,1799,11168,1.303,9.391,13261,3564,9697,2.581,9.604,-294,-0.213,18.781,143,144,1657
1991,3122,89,121,35214,36305,7,5.668,12,9.717,1031,83,948,0.229,2.840,3113,256,2857,0.705,8.575,-2082,-5.735,5.680,8,8,37
1991,3131,384,624,97214,101933,34,5.410,43,6.842,6916,2907,4009,2.852,6.785,16326,2920,13406,2.865,16.016,-9410,-9.232,13.570,25,25,1341
1991,3132,1654,1996,231772,237386,170,8.483,186,9.281,15939,6176,9763,2.602,6.714,27071,8628,18443,3.635,11.404,-11132,-4.689,13.429,135,137,4663
1991,3133,1965,2227,107335,108629,318,14.597,221,10.145,12495,3804,8691,3.502,11.502,14797,4577,10220,4.213,13.622,-2302,-2.119,23.005,144,145,3293
1991,3141,3385,3669,119481,126770,339,9.006,529,14.054,10704,2914,7790,2.299,8.444,25249,8023,17226,6.329,19.917,-14545,-11.474,16.887,426,439,3751
1991,3149,3993,4105,113904,117838,489,11.830,546,13.209,16702,5605,11097,4.757,14.174,24578,10183,14395,8.642,20.857,-7876,-6.684,28.347,441,443,6159
1991,3151,1156,1278,119752,126179,107,8.134,182,13.835,11847,2062,9785,1.634,9.389,24632,8546,16086,6.773,19.521,-12785,-10.132,18.778,144,144,4946
1991,3152,11570,12763,689651,711081,2141,16.717,2229,17.405,106005,42765,63240,6.014,14.908,149066,68184,80882,9.589,20.963,-43061,-6.056,29.815,1804,1837,43555
1991,3159,1803,1881,62828,65465,256,13.431,306,16.055,8047,3011,5036,4.599,12.292,13326,5970,7356,9.119,20.356,-5279,-8.064,24.584,249,251,3324
1991,3161,337,365,15753,15980,37,10.095,40,10.914,2036,1272,764,7.960,12.741,2592,441,2151,2.760,16.221,-556,-3.479,25.483,31,31,259
1991,3162,349,459,63748,67808,26,5.514,51,10.817,3450,700,2750,1.032,5.088,11675,3815,7860,5.626,17.218,-8225,-12.130,10.176,35,35,1714
1991,3169,1065,1111,33421,34930,104,9.224,137,12.151,4191,1409,2782,4.034,11.998,7259,2695,4564,7.716,20.782,-3068,-8.783,23.997,108,110,2169
1991,3211,4380,4900,124738,132825,406,8.153,566,11.365,10421,3208,7213,2.415,7.846,26479,9230,17249,6.949,19.935,-16058,-12.090,15.691,419,420,4726
1991,3212,1294,1599,88692,96595,107,6.585,159,9.785,5974,2053,3921,2.125,6.185,21763,5964,15799,6.174,22.530,-15789,-16.346,12.369,115,116,3490
1991,3219,9277,9944,254393,271284,1048,10.485,1150,11.506,28168,9895,18273,3.647,10.383,61910,20097,41813,7.408,22.821,-33742,-12.438,20.766,858,862,12859
1991,3221,231,544,192818,194552,20,3.626,35,6.346,7217,2290,4927,1.177,3.710,10464,5978,4486,3.073,5.379,-3247,-1.669,7.419,11,11,956
1991,3222,3549,5175,391061,396454,260,4.983,346,6.631,29011,6061,22950,1.529,7.318,40027,14941,25086,3.769,10.096,-11016,-2.779,14.635,219,220,6092
1991,3231,42541,44500,817687,834325,4059,9.100,4268,9.569,85127,26574,58553,3.185,10.203,118082,46094,71988,5.525,14.153,-32955,-3.950,20.406,3423,3437,31906
1991,3241,1316,2273,152896,155683,162,7.132,159,7.000,7516,1696,5820,1.089,4.828,13091,2957,10134,1.899,8.409,-5575,-3.581,9.656,80,86,1268
1991,3251,1202,2429,240448,237255,175,7.269,132,5.483,18279,5226,13053,2.203,7.704,11798,4451,7347,1.876,4.973,6481,2.732,9.945,67,67,1069
1991,3252,359,634,132119,132686,28,4.318,57,8.790,5946,1132,4814,0.853,4.481,7052,1842,5210,1.388,5.315,-1106,-0.834,8.963,23,28,408
1991,3253,649,898,43572,43259,62,6.893,65,7.226,4159,1994,2165,4.609,9.614,3430,946,2484,2.187,7.929,729,1.685,15.858,40,40,433
1991,3254,1124,1394,176539,176864,126,9.081,113,8.144,15768,3282,12486,1.856,8.915,16215,5256,10959,2.972,9.168,-447,-0.253,17.831,73,75,3224
1991,3255,1674,2172,74232,76278,111,5.063,152,6.933,6969,1422,5547,1.864,9.136,10993,4368,6625,5.726,14.412,-4024,-5.275,18.273,76,78,1075
1991,3256,2105,2355,119297,122065,160,6.664,252,10.496,12961,3362,9599,2.754,10.618,18461,8268,10193,6.773,15.124,-5500,-4.506,21.236,183,185,2771
1991,3259,2182,2846,133566,134729,237,8.327,237,8.327,10276,3318,6958,2.463,7.627,12543,4155,8388,3.084,9.310,-2267,-1.683,15.254,159,159,2486
1991,3261,10252,12292,644048,664519,1004,8.174,986,8.027,66614,19865,46749,2.989,10.024,107856,32351,75505,4.868,16.231,-41242,-6.206,20.049,709,724,16991
1991,3262,2173,2661,188020,192053,250,9.515,183,6.965,12520,4587,7933,2.388,6.519,20295,5181,15114,2.698,10.567,-7775,-4.048,13.038,131,133,2999
1991,3271,1453,1758,76023,79247,190,10.771,202,11.451,6438,2919,3519,3.683,8.124,13035,3141,9894,3.964,16.449,-6597,-8.325,16.248,143,145,2040
1991,3272,1785,2047,133130,139575,188,9.087,232,11.213,7779,3255,4524,2.332,5.573,20468,6352,14116,4.551,14.665,-12689,-9.091,11.147,168,173,3925
1991,3273,6241,9082,168164,179044,651,7.137,730,8.003,20698,7105,13593,3.968,11.560,42472,11271,31201,6.295,23.722,-21774,-12.161,23.121,454,464,5392
1991,3274,241,336,16892,17771,16,4.513,53,14.951,750,120,630,0.675,4.220,2503,875,1628,4.924,14.085,-1753,-9.864,8.441,21,21,230
1991,3279,1911,2213,69069,72161,171,7.627,229,10.214,5554,1859,3695,2.576,7.697,11881,3425,8456,4.746,16.465,-6327,-8.768,15.393,154,155,1842
1991,3311,317,390,139291,141356,33,8.386,40,10.165,3888,999,2889,0.707,2.751,8119,777,7342,0.550,5.744,-4231,-2.993,5.501,34,35,689
1991,3312,535,724,61524,63420,37,5.010,66,8.937,6066,2540,3526,4.005,9.565,9600,4257,5343,6.712,15.137,-3534,-5.572,19.130,42,44,2708
1991,3313,406,581,98687,102629,17,2.860,44,7.401,3648,671,2977,0.654,3.555,11322,3945,7377,3.844,11.032,-7674,-7.477,7.109,22,23,2090
1991,3314,748,908,80330,83052,69,7.504,92,10.005,4041,1196,2845,1.440,4.866,9572,3363,6209,4.049,11.525,-5531,-6.660,9.731,63,63,705
1991,3315,2564,2830,199354,207038,155,5.427,207,7.248,13123,3845,9278,1.857,6.338,28495,7833,20662,3.783,13.763,-15372,-7.425,12.677,158,158,4064
1991,3321,3275,3481,135897,140345,198,5.628,272,7.732,11577,3518,8059,2.507,8.249,20644,7316,13328,5.213,14.709,-9067,-6.461,16.498,204,206,4546
1991,3322,1301,1430,72598,76073,105,7.325,112,7.813,6219,2727,3492,3.585,8.175,13003,6474,6529,8.510,17.093,-6784,-8.918,16.350,81,81,4366
1991,3323,10325,11142,316610,332823,804,7.153,1000,8.897,34648,11203,23445,3.366,10.410,66883,22567,44316,6.780,20.096,-32235,-9.685,20.821,753,756,13299
1991,3324,1539,1866,111546,114388,94,5.020,107,5.714,9843,1631,8212,1.426,8.605,15441,3335,12106,2.916,13.499,-5598,-4.894,17.210,73,73,2147
1991,3325,940,1029,65387,68785,53,5.094,76,7.304,3359,510,2849,0.741,4.883,10139,1865,8274,2.711,14.740,-6780,-9.857,9.767,54,54,763
1991,3326,1714,1895,64373,66925,139,7.234,192,9.992,5678,1712,3966,2.558,8.484,10802,3677,7125,5.494,16.140,-5124,-7.656,16.968,144,145,2275
1991,3327,21802,22137,327126,336633,1721,7.738,1927,8.665,35796,9014,26782,2.678,10.634,54725,17090,37635,5.077,16.257,-18929,-5.623,21.267,1517,1523,12746
1991,3328,5499,5882,129335,133594,358,6.051,427,7.217,12971,3263,9708,2.442,9.709,21401,6314,15087,4.726,16.019,-8430,-6.310,19.419,325,327,4349
1991,3329,6630,7147,347401,356928,517,7.162,661,9.156,29053,7364,21689,2.063,8.140,48014,14348,33666,4.020,13.452,-18961,-5.312,16.279,506,506,8105
1991,3331,2999,3261,204507,210717,252,7.725,254,7.787,18531,6029,12502,2.861,8.794,31158,8366,22792,3.970,14.787,-12627,-5.992,17.589,176,177,2828
1991,3332,4167,4419,161691,169264,288,6.449,382,8.554,15760,3574,12186,2.111,9.311,31020,13466,17554,7.956,18.326,-15260,-9.016,18.622,281,283,8130
1991,3333,2412,2545,144306,149079,211,8.330,187,7.383,11077,2527,8550,1.695,7.430,20878,6514,14364,4.369,14.005,-9801,-6.574,14.861,137,138,2713
1991,3334,1595,1852,146721,153714,119,6.355,160,8.545,11307,4333,6974,2.819,7.356,25351,7673,17678,4.992,16.492,-14044,-9.136,14.712,109,110,3438
1991,3335,9574,9914,220288,226085,607,6.108,655,6.591,19677,5399,14278,2.388,8.703,31260,9852,21408,4.358,13.827,-11583,-5.123,17.407,503,503,6336
1991,3336,748,891,124749,127849,42,4.693,50,5.587,6417,1338,5079,1.047,5.019,12502,2051,10451,1.604,9.779,-6085,-4.760,10.038,30,30,1042
1991,3339,5478,6099,315049,321429,403,6.575,463,7.554,29110,10419,18691,3.241,9.056,41981,13155,28826,4.093,13.061,-12871,-4.004,18.113,329,331,6808
1991,3341,1701,1828,246488,256514,245,13.355,258,14.064,25527,7225,18302,2.817,9.952,45794,21432,24362,8.355,17.852,-20267,-7.901,19.903,180,183,5141
1991,3342,1859,2057,228054,236741,207,10.085,198,9.647,23081,7087,15994,2.994,9.749,40178,12450,27728,5.259,16.971,-17097,-7.222,19.499,122,122,2876
1991,3343,411,442,31894,33575,44,9.821,56,12.500,2462,617,1845,1.838,7.333,5712,1604,4108,4.777,17.013,-3250,-9.680,14.666,49,49,1540
1991,3344,5256,5852,486291,503371,590,10.056,620,10.568,50955,16782,34173,3.334,10.123,84817,38523,46294,7.653,16.850,-33862,-6.727,20.246,431,438,16666
1991,3345,4463,5091,597926,620415,352,6.851,446,8.680,42731,18572,24159,2.993,6.887,88526,23999,64527,3.868,14.269,-45795,-7.381,13.775,295,298,8260
1991,3346,747,794,58215,57503,103,12.915,110,13.793,9660,2427,7233,4.221,16.799,8133,3192,4941,5.551,14.144,1527,2.656,28.287,85,86,1504
1991,3351,1198,1319,73449,77744,103,7.733,129,9.685,4855,1395,3460,1.794,6.245,13504,4641,8863,5.970,17.370,-8649,-11.125,12.490,100,102,2714
1991,3352,406,482,98261,103096,39,8.016,48,9.866,6724,1859,4865,1.803,6.522,16618,5405,11213,5.243,16.119,-9894,-9.597,13.044,28,28,595
1991,3353,2175,2626,214770,223259,147,5.519,222,8.335,12078,2002,10076,0.897,5.410,29103,10050,19053,4.502,13.036,-17025,-7.626,10.820,129,129,2457
1991,3359,2090,2446,180583,186539,145,5.836,222,8.935,14774,4190,10584,2.246,7.920,26578,9567,17011,5.129,14.248,-11804,-6.328,15.840,146,146,4644
1991,3361,245,299,191668,208029,33,10.784,47,15.359,10816,1113,9703,0.535,5.199,43803,1314,42489,0.632,21.056,-32987,-15.857,10.399,34,34,677
1991,3362,1782,1973,93890,101826,153,7.597,235,11.668,9728,2662,7066,2.614,9.554,25561,7839,17722,7.698,25.103,-15833,-15.549,19.107,165,167,3604
1991,3363,4205,5083,597461,628165,378,7.394,436,8.529,37350,12729,24621,2.026,5.946,98865,21044,77821,3.350,15.739,-61515,-9.793,11.892,311,319,8715
1991,3364,1501,1845,667701,681349,135,7.289,149,8.045,60373,44934,15439,6.595,8.861,87097,17697,69400,2.597,12.783,-26724,-3.922,17.722,104,104,2088
1991,3365,178,219,31732,32707,19,8.756,15,6.912,3457,444,3013,1.358,10.570,5655,1940,3715,5.932,17.290,-2198,-6.720,21.140,9,9,358
1991,3366,1305,1402,151649,156010,145,10.298,157,11.151,17223,2590,14633,1.660,11.040,25843,5572,20271,3.572,16.565,-8620,-5.525,22.079,118,119,2759
1991,3369,468,479,28160,28566,49,10.166,55,11.411,2433,243,2190,0.851,8.517,3346,601,2745,2.104,11.713,-913,-3.196,17.034,42,42,494
1991,3371,13109,13712,351649,371012,1585,11.431,1893,13.652,36818,12678,24140,3.417,9.924,75782,27234,48548,7.340,20.426,-38964,-10.502,19.847,1451,1462,19163
1991,3372,3044,3237,144824,154474,297,9.021,408,12.392,14354,5547,8807,3.591,9.292,33598,11843,21755,7.667,21.750,-19244,-12.458,18.584,321,322,6719
1991,3379,1112,1253,38569,41144,94,7.419,122,9.629,3110,1006,2104,2.445,7.559,8290,2132,6158,5.182,20.149,-5180,-12.590,15.118,102,102,1591
1991,3391,9989,10559,269249,269276,959,9.065,999,9.443,33879,8381,25498,3.112,12.582,33696,13829,19867,5.136,12.514,183,0.068,25.027,747,751,5251
1991,3399,16144,16663,390834,406077,1856,11.061,2088,12.444,45125,13230,31895,3.258,11.112,75639,28942,46697,7.127,18.627,-30514,-7.514,22.225,1698,1702,17156
1991,4231,21068,26276,298436,306963,2567,9.704,2923,11.049,39600,14697,24903,4.788,12.901,56548,21513,35035,7.008,18.422,-16948,-5.521,25.801,2029,2127,14858
1991,4232,8193,9415,113187,116433,1113,11.686,1331,13.975,17354,5994,11360,5.148,14.905,23808,9689,14119,8.322,20.448,-6454,-5.543,29.809,981,1007,6978
1991,4233,8126,10755,131437,136592,1085,10.005,1265,11.664,17839,6618,11221,4.845,13.060,28368,9209,19159,6.742,20.768,-10529,-7.708,26.120,842,859,5647
1991,4234,23481,33138,611953,615098,4867,14.859,4101,12.520,107185,46405,60780,7.544,17.426,113905,47948,65957,7.795,18.518,-6720,-1.093,34.851,2307,2420,20538
1991,4235,6853,9255,133392,137093,830,8.952,863,9.308,14573,5013,9560,3.657,10.630,21993,8037,13956,5.862,16.042,-7420,-5.412,21.260,558,586,4967
1991,4236,16459,24639,323390,329674,3043,12.479,2533,10.388,55875,23846,32029,7.233,16.949,68435,25525,42910,7.743,20.758,-12560,-3.810,33.897,1547,1611,12501
1991,4237,10767,15243,166180,169630,1354,8.902,1288,8.468,21305,8124,13181,4.789,12.560,28234,10578,17656,6.236,16.645,-6929,-4.085,25.119,790,811,5820
1991,4238,46721,62016,664056,680871,5572,8.966,5829,9.380,85400,28367,57033,4.166,12.543,119576,48250,71326,7.087,17.562,-34176,-5.019,25.086,3860,3995,30620
1991,4239,23527,25477,257250,260863,3537,13.889,3517,13.810,47445,17111,30334,6.559,18.188,55122,20633,34489,7.910,21.131,-7677,-2.943,36.375,2749,2769,15222
1991,4241,8734,11857,185498,186104,1089,9.179,1104,9.305,24960,7431,17529,3.993,13.412,26303,9898,16405,5.319,14.133,-1343,-0.722,26.824,705,714,6675
1991,4242,3212,4407,125845,122392,631,14.305,639,14.487,23747,10191,13556,8.327,19.402,16712,6454,10258,5.273,13.654,7035,5.748,27.309,364,373,2523
1991,4243,11878,12900,153507,157920,1945,15.025,2035,15.720,28779,10315,18464,6.532,18.224,37853,15824,22029,10.020,23.970,-9074,-5.746,36.448,1613,1640,10761
1991,4244,26041,32538,678780,685879,3694,11.325,3857,11.824,91374,30177,61197,4.400,13.322,105846,42985,62861,6.267,15.432,-14472,-2.110,26.644,2905,2963,28009
1991,4245,6377,9348,81087,82803,584,6.151,878,9.247,11220,3488,7732,4.212,13.550,14699,5066,9633,6.118,17.752,-3479,-4.202,27.101,558,604,3561
1991,4246,7727,11549,134774,135282,1460,12.858,1071,9.432,21781,9861,11920,7.289,16.100,22840,9759,13081,7.214,16.883,-1059,-0.783,32.201,573,589,3612
1991,4247,9045,12141,131356,134634,914,7.441,1198,9.753,19488,6935,12553,5.151,14.475,26115,9994,16121,7.423,19.397,-6627,-4.922,28.950,665,686,5428
1991,4248,3554,4554,131663,133531,235,5.045,444,9.531,12522,3503,9019,2.623,9.378,16186,6841,9345,5.123,12.122,-3664,-2.744,18.755,320,332,4803
1991,4249,22381,27241,315635,319480,3418,12.563,3350,12.313,51380,19339,32041,6.053,16.082,59639,24691,34948,7.728,18.668,-8259,-2.585,32.165,2413,2445,14309
1991,4251,31784,34430,301453,308288,3798,11.092,3417,9.980,46256,16437,29819,5.332,15.004,60016,21538,38478,6.986,19.468,-13760,-4.463,30.008,2284,2294,13451
1991,4411,38517,40580,918962,952317,4150,10.124,4970,12.125,98349,43579,54770,4.576,10.327,165049,70558,94491,7.409,17.331,-66700,-7.004,20.655,4016,4083,60179
1991,4412,9947,10640,74413,81421,1047,9.653,1460,13.461,11158,4445,6713,5.459,13.704,25342,12211,13131,14.997,31.125,-14184,-17.421,27.408,1161,1190,10450
1991,4413,41042,65414,483185,495210,4444,6.701,6250,9.424,67421,24371,43050,4.921,13.615,90914,32570,58344,6.577,18.359,-23493,-4.744,27.229,4223,4469,21493
1991,4421,20842,27547,226782,234610,2913,10.498,3317,11.954,34834,15597,19237,6.648,14.848,50605,17624,32981,7.512,21.570,-15771,-6.722,29.695,2282,2504,12886
1991,4422,21156,28172,177441,181870,3644,12.961,3530,12.556,33476,14868,18608,8.175,18.407,42201,14660,27541,8.061,23.204,-8725,-4.797,36.813,2477,2594,9873
1991,4431,24009,35268,255855,252850,5862,17.017,4222,12.256,57275,29270,28005,11.576,22.652,50726,21109,29617,8.348,20.062,6549,2.590,40.123,2860,3025,13833
1991,4441,52396,69472,756104,775629,5060,7.219,6308,8.999,95014,36004,59010,4.642,12.250,134355,47812,86543,6.164,17.322,-39341,-5.072,24.500,4413,4581,29979
1991,4442,15316,18944,151197,152804,1536,8.073,1701,8.940,22732,6659,16073,4.358,14.877,26081,7539,18542,4.934,17.068,-3349,-2.192,29.753,1263,1283,5477
1991,4451,61248,92574,2449557,2462135,9606,10.270,11523,12.320,304762,148645,156117,6.037,12.378,330348,118828,211520,4.826,13.417,-25586,-1.039,24.756,7476,7694,61202
1991,4452,18937,23171,150186,154606,3064,12.905,4209,17.727,29756,13655,16101,8.832,19.246,38636,18902,19734,12.226,24.990,-8880,-5.744,38.493,2774,2873,13185
1991,4453,26687,31366,149856,154889,2922,9.180,3851,12.098,25265,9028,16237,5.829,16.312,35588,15938,19650,10.290,22.977,-10323,-6.665,32.623,2823,2891,9786
1991,4461,49549,79606,781761,777747,6470,8.078,7449,9.300,122611,45279,77332,5.822,15.765,113473,47632,65841,6.124,14.590,9138,1.175,29.180,4584,4774,26111
1991,4471,79863,133285,939555,961401,12718,9.428,15931,11.810,171876,77608,94268,8.072,17.878,214869,86976,127893,9.047,22.350,-42993,-4.472,35.755,9900,10416,53276
1991,4481,49679,103465,978330,976991,12013,11.485,14272,13.645,196928,89168,107760,9.127,20.157,194365,78502,115863,8.035,19.894,2563,0.262,39.789,7888,9415,41929
1991,4482,9441,35482,194946,201732,2903,8.050,4066,11.275,30663,15707,14956,7.786,15.200,43593,16622,26971,8.240,21.609,-12930,-6.410,30.400,1579,1707,6673
1991,4483,19775,29461,171992,179043,3029,10.169,3678,12.348,29124,12372,16752,6.910,16.266,43492,18648,24844,10.415,24.291,-14368,-8.025,32.533,2165,2375,9553
1991,4511,33507,44820,333276,337097,5596,12.481,5631,12.559,62006,30186,31820,8.955,18.394,68863,25434,43429,7.545,20.428,-6857,-2.034,36.788,4178,4395,17129
1991,4512,9377,14813,107540,105533,1571,10.675,1377,9.357,21965,7175,14790,6.799,20.813,18035,6298,11737,5.968,17.089,3930,3.724,34.179,1017,1040,4227
1991,4521,282,9901,1590492,1621244,479,4.838,480,4.848,133240,65398,67842,4.034,8.218,199652,41982,157670,2.589,12.315,-66412,-4.096,16.437,22,36,2864
1991,4529,11466,25232,528324,529808,2387,9.353,2968,11.629,74600,38444,36156,7.256,14.081,78773,27850,50923,5.257,14.868,-4173,-0.788,28.161,1441,1560,7287
1991,4531,25210,26727,135103,137960,2993,11.140,3271,12.175,24029,9163,14866,6.642,17.417,29544,10862,18682,7.873,21.415,-5515,-3.998,34.835,2655,2690,8731
1991,4532,31725,40529,264861,268798,5193,12.790,5340,13.152,53124,24054,29070,8.949,19.764,61091,23774,37317,8.845,22.728,-7967,-2.964,39.527,4036,4206,16759
1991,4533,11298,13477,72540,71257,2037,15.343,1635,12.315,15173,6937,8236,9.735,21.293,12865,4940,7925,6.933,18.054,2308,3.239,36.109,1259,1273,3530
1991,4539,27411,31484,162564,165882,4628,14.718,4550,14.470,36522,17460,19062,10.526,22.017,43366,17644,25722,10.636,26.143,-6844,-4.126,44.034,3340,3451,13120
1991,4541,6460,7839,129185,128448,1148,14.859,922,11.934,23967,7407,16560,5.767,18.659,22497,8071,14426,6.283,17.514,1470,1.144,35.029,688,713,6287
1991,4542,4440,5434,67973,72465,824,15.269,749,13.879,8615,3887,4728,5.364,11.889,17494,9053,8441,12.493,24.141,-8879,-12.253,23.777,508,511,2615
1991,4543,16377,22686,222205,224662,2211,9.644,2689,11.730,38868,15030,23838,6.690,17.301,43546,17657,25889,7.859,19.383,-4678,-2.082,34.601,1712,1817,10677
1991,4811,521,2948,472448,455665,538,20.034,13,0.484,73491,12943,60548,2.840,16.128,39560,63,39497,0.014,8.682,33931,7.446,17.364,13,13,63
1991,4812,1134,1269,16211,16517,251,21.769,19,1.648,3088,1836,1252,11.116,18.696,3723,90,3633,0.545,22.540,-635,-3.845,37.392,14,14,69
1991,4831,379,659,37132,34640,84,12.854,73,11.171,10146,3340,6806,9.642,29.290,5005,2575,2430,7.434,14.449,5141,14.841,28.897,37,39,1349
1991,4832,303,346,13840,13287,53,15.565,42,12.335,2602,1086,1516,8.173,19.583,1522,592,930,4.455,11.455,1080,8.128,22.910,29,29,340
1991,4841,21458,27678,577441,589917,4257,15.269,4661,16.718,89814,29787,60027,5.049,15.225,114556,55227,59329,9.362,19.419,-24742,-4.194,30.450,3305,3352,34214
1991,4842,47004,51332,529325,549153,7224,13.921,8347,16.085,97032,34972,62060,6.368,17.669,137144,53436,83708,9.731,24.974,-40112,-7.304,35.339,6161,6235,36391
1991,4851,433,483,40800,40528,90,20.179,16,3.587,4945,3149,1796,7.770,12.201,4437,66,4371,0.163,10.948,508,1.253,21.896,13,13,59
1991,4852,395,599,16258,16159,141,26.454,9,1.689,3617,1561,2056,9.661,22.385,3464,283,3181,1.751,21.438,153,0.947,42.875,6,7,281
1991,4853,5049,5135,48967,48121,930,19.579,160,3.368,9713,4705,5008,9.778,20.185,7969,522,7447,1.085,16.561,1744,3.624,33.121,132,132,407
1991,4854,3142,3974,116817,111243,608,16.421,65,1.756,27952,17529,10423,15.757,25.127,16709,275,16434,0.247,15.020,11243,10.107,30.041,57,57,237
1991,4855,859,957,21130,20053,232,27.358,14,1.651,5321,3085,2236,15.384,26.535,3216,114,3102,0.568,16.038,2105,10.497,32.075,10,10,26
1991,4859,1041,1099,20775,19674,249,24.900,51,5.100,5370,3309,2061,16.819,27.295,3061,181,2880,0.920,15.559,2309,11.736,31.117,44,44,169
1991,4861,49,409,10042,9326,84,22.764,4,1.084,1976,1333,643,14.294,21.189,551,6,545,0.064,5.909,1425,15.281,11.817,3,3,6
1991,4862,282,1447,53310,52113,90,6.410,4,0.285,6525,2851,3674,5.471,12.521,4090,7,4083,0.013,7.848,2435,4.673,15.697,4,4,8
1991,4869,60,322,6489,6269,26,8.374,3,0.966,792,265,527,4.227,12.635,377,5,372,0.080,6.014,415,6.620,12.028,3,3,5
1991,4871,279,294,4568,4649,66,24.176,24,8.791,1139,524,615,11.271,24.500,1316,108,1208,2.323,28.307,-177,-3.807,49.000,17,17,46
1991,4872,914,933,12125,11835,190,21.300,108,12.108,2746,1259,1487,10.638,23.203,2196,958,1238,8.095,18.556,550,4.647,37.112,89,89,629
1991,4879,137,147,1182,1160,34,25.660,5,3.774,301,166,135,14.310,25.948,254,10,244,0.862,21.897,47,4.052,43.793,4,4,9
1991,4881,2333,2938,80133,77226,515,18.937,78,2.868,16956,7463,9493,9.664,21.956,10952,363,10589,0.470,14.182,6004,7.775,28.364,58,58,229
1991,4882,427,647,18103,17514,110,17.828,50,8.104,4434,2139,2295,12.213,25.317,3310,634,2676,3.620,18.899,1124,6.418,37.798,26,26,345
1991,4883,2035,2490,81088,81821,285,11.464,277,11.142,14340,4941,9399,6.039,17.526,16281,4468,11813,5.461,19.898,-1941,-2.372,35.052,204,206,2364
1991,4884,2302,2384,14493,13620,658,29.447,359,16.066,4961,3132,1829,22.996,36.426,3150,1372,1778,10.074,23.129,1811,13.297,46.257,264,267,932
1991,4885,8104,10702,114973,115774,1671,16.060,1077,10.351,23121,7726,15395,6.673,19.971,24873,10221,14652,8.828,21.484,-1752,-1.513,39.942,717,757,5481
1991,4889,767,802,8064,8192,158,20.440,100,12.937,1980,839,1141,10.242,24.171,2274,904,1370,11.036,27.760,-294,-3.589,48.343,84,84,650
1991,4921,1356,4056,377710,365330,495,12.475,319,8.039,42888,9419,33469,2.578,11.740,16467,5381,11086,1.473,4.507,26421,7.232,9.015,196,199,1243
1991,4922,3755,4041,60842,63150,682,16.810,714,17.599,12345,4860,7485,7.696,19.549,17087,9621,7466,15.235,27.058,-4742,-7.509,39.098,543,547,4016
1991,4931,6477,10565,433210,435569,1153,11.093,811,7.803,69493,25678,43815,5.895,15.955,74740,19579,55161,4.495,17.159,-5247,-1.205,31.909,403,412,7062
1991,5111,14913,17505,690024,701433,1914,10.906,2005,11.424,54669,17366,37303,2.476,7.794,77452,26062,51390,3.716,11.042,-22783,-3.248,15.588,1549,1564,17066
1991,5112,4309,5073,96861,93269,1042,21.304,678,13.862,21739,7889,13850,8.458,23.308,14994,7202,7792,7.722,16.076,6745,7.232,32.152,476,489,5141
1991,5121,9707,14348,240731,243477,2104,14.659,2113,14.722,44148,17745,26403,7.288,18.132,50257,22155,28102,9.099,20.641,-6109,-2.509,36.265,1202,1250,7933
1991,5122,1611,1641,14113,14096,298,17.576,407,24.005,3574,1612,1962,11.436,25.355,3492,1946,1546,13.805,24.773,82,0.582,49.546,330,330,1699
1991,5151,5992,7975,237855,231071,1220,16.463,91,1.228,37578,21536,16042,9.320,16.263,23962,590,23372,0.255,10.370,13616,5.893,20.740,66,66,303
1991,5152,208,326,14376,14272,72,24.490,8,2.721,2405,1437,968,10.069,16.852,2223,167,2056,1.170,15.576,182,1.275,31.153,7,7,14
1991,5171,3837,24755,999079,986549,5273,23.723,218,0.981,191321,115600,75721,11.718,19.393,167085,1843,165242,0.187,16.936,24236,2.457,33.873,188,188,1559
1991,5172,1195,2522,52940,49056,645,28.756,87,3.879,15909,9787,6122,19.951,32.431,8344,708,7636,1.443,17.009,7565,15.421,34.019,75,75,479
1991,5174,177,315,11137,10415,60,20.761,8,2.768,2283,537,1746,5.156,21.920,866,31,835,0.298,8.315,1417,13.605,16.630,6,6,12
1991,5179,1143,2006,32166,30804,610,33.814,206,11.419,9726,6329,3397,20.546,31.574,7022,1331,5691,4.321,22.796,2704,8.778,45.591,170,171,912
1991,5182,5521,7794,280927,291457,1296,16.575,1346,17.214,52375,20933,31442,7.182,17.970,73768,33757,40011,11.582,25.310,-21393,-7.340,35.940,607,618,9192
1991,5191,2615,3047,37202,38249,344,11.290,344,11.290,5795,3296,2499,8.617,15.151,7865,2501,5364,6.539,20.563,-2070,-5.412,30.302,227,241,2003
1991,5211,44,78,24886,24981,5,6.623,0,0.000,629,232,397,0.929,2.518,826,0,826,0.000,3.307,-197,-0.789,5.036,0,0,0
1991,5221,21985,97962,2087288,2076887,17823,19.950,572,0.640,402886,252202,150684,12.143,19.399,380150,8018,372132,0.386,18.304,22736,1.095,36.608,441,447,5496
1991,5222,14943,35823,436232,418534,6135,18.536,686,2.073,114187,73256,40931,17.503,27.283,79735,6578,73157,1.572,19.051,34452,8.232,38.102,546,554,5981
1991,5223,6649,8557,81160,75379,2570,34.448,377,5.053,27110,16614,10496,22.041,35.965,15906,1552,14354,2.059,21.102,11204,14.864,42.203,332,332,1439
1991,5231,6481,17619,303119,297409,3608,22.479,471,2.934,59854,30393,29461,10.219,20.125,49569,3182,46387,1.070,16.667,10285,3.458,33.334,322,324,2376
1991,5232,73,89,7385,7675,10,11.834,(D),(D),594,411,183,5.355,7.739,1182,(D),1180,(D),15.401,-588,-7.661,15.479,(D),(D),(D)
1991,5239,15295,16510,233134,217101,3334,21.873,799,5.242,62599,26813,35786,12.351,28.834,31151,8164,22987,3.760,14.349,31448,14.485,28.697,614,614,7429
1991,5241,8107,41194,1491251,1444858,4702,12.067,243,0.624,223761,99540,124221,6.889,15.487,132665,1669,130996,0.116,9.182,91096,6.305,18.364,221,221,1448
1991,5242,104573,115884,988047,997490,17102,15.715,2981,2.739,228285,108473,119812,10.875,22.886,251212,31589,219623,3.167,25.184,-22927,-2.298,45.772,2161,2166,23052
1991,5250,2877,3192,48337,46425,374,12.358,43,1.421,12608,4104,8504,8.840,27.158,8964,611,8353,1.316,19.309,3644,7.849,38.618,26,26,305
1991,5311,87712,94434,503342,489051,13135,14.640,3704,4.128,112536,58997,53539,12.064,23.011,83595,12472,71123,2.550,17.093,28941,5.918,34.187,3152,3154,10462
1991,5312,42032,47363,230234,228852,9086,20.477,3105,6.998,60902,36638,24264,16.010,26.612,58770,9604,49166,4.197,25.680,2132,0.932,51.361,2443,2447,7916
1991,5313,26084,28820,331780,323670,5310,19.568,1942,7.157,81140,43211,37929,13.350,25.069,64588,11158,53430,3.447,19.955,16552,5.114,39.910,1644,1647,9549
1991,5321,5025,9842,132015,136362,1121,11.265,1339,13.456,20786,9280,11506,6.805,15.243,29145,11514,17631,8.444,21.373,-8359,-6.130,30.487,766,826,7228
1991,5322,21115,28527,209181,200943,5497,19.721,4192,15.039,68415,43278,25137,21.538,34.047,53073,23323,29750,11.607,26.412,15342,7.635,52.824,2979,3169,14726
1991,5323,3856,5891,38713,39953,734,12.543,656,11.210,7623,3219,4404,8.057,19.080,10047,4323,5724,10.820,25.147,-2424,-6.067,38.160,406,427,2397
1991,5324,7537,10072,107125,110601,1381,13.702,1395,13.841,21541,8567,12974,7.746,19.476,28492,12459,16033,11.265,25.761,-6951,-6.285,38.953,978,998,7778
1991,5331,1064,1177,15123,14559,311,29.732,49,4.685,3459,1687,1772,11.588,23.759,2315,197,2118,1.353,15.901,1144,7.858,31.803,40,40,144
1991,5411,136878,142871,970002,975380,14913,10.506,13057,9.199,134681,50713,83968,5.199,13.808,146281,52224,94057,5.354,14.997,-11600,-1.189,27.616,10088,10160,41667
1991,5412,71624,75793,706239,700900,10161,13.561,8435,11.257,123150,48282,74868,6.889,17.570,113080,43621,69459,6.224,16.134,10070,1.437,32.267,6194,6281,26252
1991,5413,62969,71067,954052,966219,9716,13.798,8418,11.954,160383,52510,107873,5.435,16.599,184737,60002,124735,6.210,19.120,-24354,-2.521,33.198,5898,5982,34658
1991,5414,17061,17303,99469,101044,3098,18.055,2810,16.376,22800,10990,11810,10.877,22.565,25924,12619,13305,12.489,25.656,-3124,-3.092,45.129,2266,2275,10127
1991,5415,26414,29944,418333,420802,6492,22.148,5227,17.833,86868,35152,51716,8.354,20.643,92027,40861,51166,9.710,21.869,-5159,-1.226,41.287,3741,3778,22445
1991,5416,39062,41497,363044,368274,9463,23.168,8158,19.973,97239,43576,53663,11.833,26.404,107906,49614,58292,13.472,29.301,-10667,-2.896,52.808,6477,6507,37472
1991,5417,6808,8567,454049,457485,1218,14.486,900,10.704,57815,15273,42542,3.338,12.638,65162,18734,46428,4.095,14.244,-7347,-1.606,25.275,552,563,7494
1991,5418,29921,33684,401707,399580,6101,18.487,4736,14.351,81612,31221,50391,7.813,20.424,77116,34506,42610,8.636,19.299,4496,1.125,38.599,3800,3838,22976
1991,5419,34031,38674,306302,300006,4583,12.115,2892,7.645,60840,25155,35685,8.385,20.280,48738,15148,33590,5.049,16.246,12102,4.034,32.491,2225,2244,11191
1991,5511,28441,54328,3204695,3210672,6924,13.139,3664,6.953,516271,188134,328137,5.860,16.080,528393,119806,408587,3.731,16.457,-12122,-0.378,32.160,694,718,7638
1991,5611,12019,13248,260561,255732,2391,18.364,1935,14.862,67199,31170,36029,12.189,26.277,58395,26249,32146,10.264,22.834,8804,3.443,45.669,1395,1411,14833
1991,5612,462,886,76863,76416,193,22.854,110,13.025,12321,5887,6434,7.704,16.124,11302,4560,6742,5.967,14.790,1019,1.333,29.580,50,50,721
1991,5613,19655,27542,1496678,1528848,4767,17.481,4222,15.482,426726,163157,263569,10.672,27.912,489518,165240,324278,10.808,32.019,-62792,-4.107,55.823,2727,2824,108353
1991,5614,23646,27047,349977,343063,4552,17.172,3474,13.105,84507,37420,47087,10.908,24.633,69873,24669,45204,7.191,20.367,14634,4.266,40.735,2710,2741,17863
1991,5615,25229,31565,249106,250309,4379,14.042,3617,11.599,53193,26263,26930,10.492,21.251,55412,22731,32681,9.081,22.137,-2219,-0.887,42.502,2673,2787,14957
1991,5616,13159,16721,549788,546334,2476,15.018,2007,12.174,111845,40487,71358,7.411,20.472,105081,33761,71320,6.180,19.234,6764,1.238,38.468,1515,1535,20288
1991,5617,88535,92959,1099014,1101830,16948,18.774,11573,12.820,243290,90339,152951,8.199,22.081,248887,76509,172378,6.944,22.589,-5597,-0.508,44.161,9208,9249,56065
1991,5619,16028,17538,236526,229942,3244,19.000,2316,13.564,61600,27071,34529,11.773,26.789,48066,17331,30735,7.537,20.904,13534,5.886,41.807,1756,1760,12633
1991,5621,3879,4041,51391,49521,477,11.977,360,9.040,9581,2979,6602,6.016,19.347,5933,2219,3714,4.481,11.981,3648,7.367,23.962,298,298,1949
1991,5622,1515,2429,76469,71658,398,17.748,25,1.115,15092,5592,9500,7.804,21.061,5673,232,5441,0.324,7.917,9419,13.144,15.834,17,17,160
1991,5629,5042,5380,65240,64663,826,15.637,631,11.945,16090,5575,10515,8.622,24.883,15123,3313,11810,5.124,23.388,967,1.495,46.775,479,480,2421
1991,6111,13744,15049,483617,473464,691,4.696,21,0.143,45390,7495,37895,1.583,9.587,25221,133,25088,0.028,5.327,20169,4.260,10.654,9,9,69
1991,6112,520,739,57250,56214,56,7.854,4,0.561,6707,1392,5315,2.476,11.931,4548,6,4542,0.011,8.091,2159,3.841,16.181,(D),(D),(D)
1991,6113,2047,2413,1068515,1046936,99,4.183,6,0.254,86279,11993,74286,1.146,8.241,44324,43,44281,0.004,4.234,41955,4.007,8.467,3,3,24
1991,6114,3302,3823,51518,53345,661,17.669,497,13.285,9914,3527,6387,6.612,18.585,13669,5676,7993,10.640,25.624,-3755,-7.039,37.169,305,328,3760
1991,6115,4772,5742,74428,76355,745,13.151,591,10.432,14072,5783,8289,7.574,18.430,17794,6143,11651,8.045,23.304,-3722,-4.875,36.859,339,369,3823
1991,6116,14554,15361,123624,123405,2708,18.066,1965,13.109,27577,11723,15854,9.500,22.347,27142,11361,15781,9.206,21.994,435,0.352,43.989,1533,1541,8969
1991,6117,2156,2227,20465,20668,503,23.743,286,13.500,3750,1726,2024,8.351,18.144,4090,1633,2457,7.901,19.790,-340,-1.645,36.289,225,225,1222
1991,6211,181926,193382,1428851,1410224,13463,6.964,13367,6.914,217820,68496,149324,4.857,15.446,180524,67034,113490,4.753,12.801,37296,2.645,25.602,10883,11045,51046
1991,6212,100568,103623,545021,542803,5330,5.152,4991,4.824,73476,18971,54505,3.495,13.536,68822,20346,48476,3.748,12.679,4654,0.857,25.358,4116,4171,17477
1991,6213,61932,65198,269259,262927,8366,13.090,5793,9.064,59727,23963,35764,9.114,22.716,47386,20193,27193,7.680,18.023,12341,4.694,36.045,4485,4546,16763
1991,6214,7780,12785,243667,237572,1587,12.718,974,7.805,44593,15594,28999,6.564,18.770,32119,12755,19364,5.369,13.520,12474,5.251,27.039,548,574,6177
1991,6215,5973,7776,126642,124067,1056,13.628,1001,12.919,23891,8158,15733,6.576,19.257,18994,8057,10937,6.494,15.310,4897,3.947,30.619,659,679,5013
1991,6216,5327,8477,411647,390690,1383,16.790,903,10.963,106848,34532,72316,8.839,27.349,63622,19842,43780,5.079,16.285,43226,11.064,32.569,561,578,10722
1991,6219,5730,7282,140735,136204,1349,19.689,488,7.123,33227,16008,17219,11.753,24.395,24207,5346,18861,3.925,17.773,9020,6.622,35.545,354,357,3143
1991,6221,3440,4941,3945386,3904234,154,3.104,194,3.911,236220,51506,184714,1.319,6.050,153223,72564,80659,1.859,3.925,82997,2.126,7.849,116,119,45756
1991,6222,583,970,338695,337996,58,6.086,24,2.518,22153,13630,8523,4.033,6.554,20187,1802,18385,0.533,5.973,1966,0.582,11.945,9,10,844
1991,6223,233,321,114679,116231,26,8.267,13,4.134,9815,2783,7032,2.394,8.444,12459,3230,9229,2.779,10.719,-2644,-2.275,16.889,7,7,1242
1991,6231,7535,12664,1166998,1146555,756,6.012,576,4.581,133438,48749,84689,4.252,11.638,92808,33790,59018,2.947,8.095,40630,3.544,16.189,338,346,19627
1991,6232,7142,12963,273605,262730,1988,16.122,724,5.871,53177,23977,29200,9.126,20.240,31775,10569,21206,4.023,12.094,21402,8.146,24.188,492,499,6780
1991,6233,10546,12832,390272,392946,1796,14.122,1568,12.329,59767,23613,36154,6.009,15.210,65205,36679,28526,9.334,16.594,-5438,-1.384,30.420,1003,1024,20435
1991,6239,3714,5064,132219,129168,579,11.701,348,7.032,20280,6788,13492,5.255,15.701,14294,5656,8638,4.379,11.066,5986,4.634,22.133,200,204,3054
1991,6241,19798,26970,391021,383490,3228,12.272,1895,7.204,66580,20425,46155,5.326,17.362,51339,15302,36037,3.990,13.387,15241,3.974,26.775,1193,1206,10755
1991,6242,5552,6559,69284,67596,680,10.525,484,7.491,12717,3756,8961,5.557,18.813,9394,2977,6417,4.404,13.897,3323,4.916,27.795,337,338,2163
1991,6243,5002,7812,288858,286195,925,12.161,514,6.757,44521,10713,33808,3.743,15.556,39408,8346,31062,2.916,13.770,5113,1.787,27.539,255,277,4515
1991,6244,36049,44304,437988,428541,6113,14.101,4208,9.707,84422,37832,46590,8.828,19.700,65414,25893,39521,6.042,15.264,19008,4.436,30.529,3247,3326,19942
1991,7111,5902,5957,84781,84882,1072,18.214,929,15.785,19324,6233,13091,7.343,22.766,19594,5607,13987,6.606,23.084,-270,-0.318,45.532,677,677,4149
1991,7112,2714,2848,74225,73359,520,18.598,416,14.878,15388,5220,10168,7.116,20.976,13732,4376,9356,5.965,18.719,1656,2.257,37.438,322,325,3291
1991,7113,2549,2644,42392,42796,445,17.132,352,13.551,9560,3500,6060,8.178,22.339,10558,3103,7455,7.251,24.671,-998,-2.332,44.678,276,276,2397
1991,7114,1453,1476,13309,12529,287,19.972,209,14.544,4222,1971,2251,15.732,33.698,2656,1176,1480,9.386,21.199,1566,12.499,42.398,161,161,964
1991,7115,7171,7220,54302,59718,1238,15.983,2289,29.553,11832,4094,7738,6.856,19.813,22847,10771,12076,18.036,38.258,-11015,-18.445,39.626,1808,1809,7111
1991,7121,3079,3370,63731,63375,278,8.340,205,6.150,7475,1943,5532,3.066,11.795,6787,1510,5277,2.383,10.709,688,1.086,21.419,164,165,1347
1991,7131,1608,2506,90650,86006,286,11.351,313,12.423,17022,7785,9237,9.052,19.792,8152,1730,6422,2.011,9.478,8870,10.313,18.957,224,229,1250
1991,7132,851,937,28804,27707,174,19.301,103,11.425,5868,3076,2792,11.102,21.179,3654,1348,2306,4.865,13.188,2214,7.991,26.376,80,80,528
1991,7139,38439,41561,656764,652193,5185,12.491,5085,12.250,117099,45756,71343,7.016,17.955,107947,40957,66990,6.280,16.551,9152,1.403,33.103,3946,4062,30581
1991,7211,30004,36855,1424554,1435392,4344,11.818,4147,11.282,230802,122845,107957,8.558,16.079,252106,98645,153461,6.872,17.564,-21304,-1.484,32.159,3007,3050,64301
1991,7212,3938,4260,27178,27224,529,12.499,474,11.199,6009,2240,3769,8.228,22.073,6104,1697,4407,6.234,22.422,-95,-0.349,44.146,338,351,1217
1991,7213,3524,3628,18977,19238,247,6.710,353,9.590,2958,901,2057,4.684,15.376,3454,1435,2019,7.459,17.955,-496,-2.578,30.752,258,262,1090
1991,7223,16913,31964,557735,573500,5139,15.975,5551,17.255,117265,55840,61425,9.737,20.447,149332,67828,81504,11.827,26.039,-32067,-5.591,40.895,2744,2822,29904
1991,7224,50600,51552,323397,326770,7358,14.145,8291,15.939,80607,42510,38097,13.009,24.668,87175,41232,45943,12.618,26.678,-6568,-2.010,49.336,6827,6848,34127
1991,7225,221568,302778,5613623,5668529,45039,14.992,40332,13.425,1066090,601429,464661,10.610,18.807,1173934,462814,711120,8.165,20.710,-107844,-1.903,37.614,29712,30939,318809
1991,8111,120298,129649,666321,680834,17627,13.672,16186,12.554,131834,64665,67169,9.498,19.364,159950,67418,92532,9.902,23.493,-28116,-4.130,38.727,12450,12584,53182
1991,8112,12344,14985,131010,131644,2301,15.637,1761,11.967,29236,15590,13646,11.843,22.208,30621,11829,18792,8.986,23.261,-1385,-1.052,44.417,1257,1282,7997
1991,8113,20634,21758,169321,171572,2679,12.364,2498,11.529,29475,10919,18556,6.364,17.179,34187,11991,22196,6.989,19.926,-4712,-2.746,34.359,1885,1888,9178
1991,8114,26415,28249,174753,181089,4048,14.279,4250,14.991,27471,11130,16341,6.146,15.170,40104,14332,25772,7.914,22.146,-12633,-6.976,30.340,3175,3219,10447
1991,8121,77006,88285,470659,475757,11969,13.529,12341,13.949,102659,52094,50565,10.950,21.578,112387,44624,67763,9.380,23.623,-9728,-2.045,43.156,9758,9985,33285
1991,8122,17399,21071,131173,132538,1354,6.389,1598,7.540,21585,7604,13981,5.737,16.286,24156,7950,16206,5.998,18.226,-2571,-1.940,32.572,1198,1228,5314
1991,8123,34114,41314,379786,380628,5153,12.495,5008,12.143,65175,27724,37451,7.284,17.123,67210,26242,40968,6.894,17.658,-2035,-0.535,34.246,3806,3924,20035
1991,8129,13555,22861,162891,168141,3631,16.098,3019,13.385,32486,15865,16621,9.436,19.321,43070,15566,27504,9.258,25.615,-10584,-6.295,38.641,1718,1821,8859
1991,8131,134477,134554,1142847,1121597,6432,4.885,675,0.513,130366,18190,112176,1.622,11.623,87784,1442,86342,0.129,7.827,42582,3.797,15.653,153,153,380
1991,8132,9825,11533,147590,144878,1353,12.198,471,4.246,23414,8140,15274,5.619,16.161,18033,3163,14870,2.183,12.447,5381,3.714,24.894,325,328,2079
1991,8133,9001,10579,118370,116642,1139,11.001,688,6.645,19289,4761,14528,4.082,16.537,15741,3658,12083,3.136,13.495,3548,3.042,26.990,437,443,2434
1991,8134,31047,32783,308829,305724,2183,6.682,1953,5.978,42227,9990,32237,3.268,13.812,36019,8122,27897,2.657,11.782,6208,2.031,23.563,1458,1459,6150
1991,8139,61379,63683,511363,506263,4383,6.994,2359,3.764,78235,20290,57945,4.008,15.453,68372,13201,55171,2.608,13.505,9863,1.948,27.010,1755,1758,10706
1992,2111,6841,8081,116194,117733,782,9.481,1116,13.531,26643,6564,20079,5.575,22.630,29187,9986,19201,8.482,24.791,-2544,-2.161,45.260,631,634,3797
1992,2121,1600,2124,115410,120896,352,15.917,527,23.830,18947,9290,9657,7.684,15.672,29699,12653,17046,10.466,24.566,-10752,-8.894,31.344,367,372,5704
1992,2122,397,579,47098,46536,94,16.193,97,16.710,5430,2586,2844,5.557,11.668,4385,1347,3038,2.895,9.423,1045,2.246,18.846,57,59,433
1992,2123,3394,5027,97030,99273,327,6.426,451,8.862,11760,3102,8658,3.125,11.846,16157,4580,11577,4.614,16.275,-4397,-4.429,23.692,248,256,1671
1992,2131,7893,8930,148638,162926,1089,11.882,1560,17.020,26340,11210,15130,6.880,16.167,55164,18116,37048,11.119,33.858,-28824,-17.692,32.334,1034,1041,6871
1992,2211,1494,6818,633300,624279,451,6.834,13,0.197,64196,30297,33899,4.853,10.283,45512,599,44913,0.096,7.290,18684,2.993,14.581,10,10,95
1992,2212,583,2732,108321,106992,354,13.842,5,0.196,14192,9301,4891,8.693,13.265,11494,8,11486,0.007,10.743,2698,2.522,21.486,4,4,7
1992,2213,3707,4074,30138,29217,308,7.824,33,0.838,3808,1520,2288,5.203,13.034,1922,104,1818,0.356,6.578,1886,6.455,13.157,26,26,79
1992,2361,112625,113019,551703,556011,22160,19.596,22292,19.713,171283,70662,100621,12.709,30.806,180488,76761,103727,13.806,32.461,-9205,-1.656,61.611,15585,15596,56030
1992,2362,35927,36546,586631,610010,4342,11.734,5258,14.209,122984,29014,93970,4.756,20.161,170022,38014,132008,6.232,27.872,-47038,-7.711,40.322,3910,3910,26626
1992,2371,13811,14109,305671,310893,1246,8.767,1453,10.223,60187,8739,51448,2.811,19.359,70373,13443,56930,4.324,22.636,-10186,-3.276,38.719,1038,1039,8209
1992,2372,6539,6726,55279,58594,1155,15.844,2283,31.317,14591,6072,8519,10.363,24.902,21221,10849,10372,18.516,36.217,-6630,-11.315,49.804,1800,1807,8604
1992,2373,9362,9730,225697,228004,866,8.838,1004,10.246,45727,7532,38195,3.303,20.055,50392,9969,40423,4.372,22.101,-4665,-2.046,40.111,731,733,6113
1992,2379,4782,4861,64117,66873,620,12.501,817,16.473,14810,3695,11115,5.525,22.146,20261,5843,14418,8.737,30.298,-5451,-8.151,44.293,608,609,3696
1992,2381,75522,75931,639678,647851,10723,14.085,11123,14.610,171982,47795,124187,7.377,26.547,187816,56153,131663,8.668,28.991,-15834,-2.444,53.093,8026,8029,43056
1992,2382,120709,122683,1157194,1179781,13357,10.819,14900,12.069,221507,53507,168000,4.535,18.775,266574,67910,198664,5.756,22.595,-45067,-3.820,37.551,11062,11069,52421
1992,2383,80027,80484,580770,593289,13276,16.404,14172,17.511,155518,50006,105512,8.429,26.213,180401,60458,119943,10.190,30.407,-24883,-4.194,52.426,10392,10399,45915
1992,2389,40117,40375,331769,337134,5154,12.613,6129,14.999,80939,21248,59691,6.303,24.008,91741,28169,63572,8.355,27.212,-10802,-3.204,48.016,4404,4406,20507
1992,3111,1490,2123,53473,53450,146,6.915,123,5.825,6000,1503,4497,2.812,11.226,5912,1201,4711,2.247,11.061,88,0.165,22.122,77,77,512
1992,3112,457,808,65973,65666,57,7.090,49,6.095,6409,3002,3407,4.572,9.760,6070,2056,4014,3.131,9.244,339,0.516,18.488,25,25,655
1992,3113,1496,1721,84534,83195,177,10.228,196,11.326,10330,2196,8134,2.640,12.417,7826,2009,5817,2.415,9.407,2504,3.010,18.814,119,124,1078
1992,3114,1229,1668,176029,176974,141,8.525,113,6.832,18560,5130,13430,2.899,10.487,20405,4494,15911,2.539,11.530,-1845,-1.043,20.975,72,72,1730
1992,3115,1317,1897,133642,133294,90,4.703,123,6.428,11444,1719,9725,1.290,8.586,10831,2900,7931,2.176,8.126,613,0.460,16.251,80,81,981
1992,3116,3703,4311,393787,393747,289,6.703,290,6.726,33493,7662,25831,1.946,8.506,33409,11832,21577,3.005,8.485,84,0.021,16.970,206,207,4210
1992,3117,667,774,46338,46411,63,8.005,89,11.309,8409,1421,6988,3.062,18.119,8396,2859,5537,6.160,18.091,13,0.028,36.181,61,61,1810
1992,3118,9069,10290,304143,305334,1209,11.611,1454,13.964,36585,9903,26682,3.243,11.982,39357,16776,22581,5.494,12.890,-2772,-0.908,23.964,901,917,6588
1992,3119,2168,2539,130890,131385,237,9.371,217,8.580,14073,3518,10555,2.678,10.711,15211,4492,10719,3.419,11.577,-1138,-0.866,21.423,159,160,2596
1992,3121,1665,2098,131486,133811,152,7.252,148,7.061,9921,2036,7885,1.522,7.414,14728,3242,11486,2.423,11.007,-4807,-3.592,14.828,109,109,1401
1992,3122,77,112,37248,36354,6,5.405,4,3.604,2874,240,2634,0.660,7.906,1230,6,1224,0.017,3.383,1644,4.522,6.767,3,3,5
1992,3131,352,599,93414,93330,28,4.605,46,7.566,7893,1350,6543,1.446,8.457,7645,2839,4806,3.042,8.191,248,0.266,16.383,30,30,722
1992,3132,1598,1939,242213,242478,142,7.276,167,8.558,20249,5315,14934,2.192,8.351,21105,8136,12969,3.355,8.704,-856,-0.353,16.702,114,114,1085
1992,3133,1897,2112,105637,103667,223,10.524,237,11.185,13020,2445,10575,2.359,12.560,9047,2819,6228,2.719,8.727,3973,3.832,17.454,173,174,1699
1992,3141,3011,3298,121504,120951,262,7.671,497,14.551,14706,2254,12452,1.864,12.159,13655,4528,9127,3.744,11.290,1051,0.869,22.579,392,392,2890
1992,3149,3898,4015,111026,109968,461,11.481,462,11.505,18992,5284,13708,4.805,17.271,16686,6207,10479,5.644,15.174,2306,2.097,30.347,391,391,5228
1992,3151,1102,1230,117886,116514,145,11.712,161,13.005,14655,3190,11465,2.738,12.578,11888,4837,7051,4.151,10.203,2767,2.375,20.406,134,139,3321
1992,3152,11106,12261,689969,690865,2056,16.579,2337,18.844,115799,42260,73539,6.117,16.761,117957,59480,58477,8.609,17.074,-2158,-0.312,33.523,1966,1978,39748
1992,3159,1810,1895,65801,64817,235,12.291,269,14.069,11074,3504,7570,5.406,17.085,9052,2970,6082,4.582,13.966,2022,3.120,27.931,224,224,1985
1992,3161,305,337,17279,16824,25,7.321,34,9.956,2417,338,2079,2.009,14.366,1602,717,885,4.262,9.522,815,4.844,19.044,27,27,590
1992,3162,329,425,62265,62849,31,7.176,45,10.417,6016,802,5214,1.276,9.572,7151,2974,4177,4.732,11.378,-1135,-1.806,19.144,23,24,401
1992,3169,1063,1108,31796,32379,124,11.212,120,10.850,4549,1632,2917,5.040,14.049,5677,1905,3772,5.883,17.533,-1128,-3.484,28.098,92,92,748
1992,3211,4307,4820,127905,127857,414,8.486,531,10.884,14648,3825,10823,2.992,11.457,14463,5131,9332,4.013,11.312,185,0.145,22.624,399,401,3099
1992,3212,1280,1573,92073,90571,107,6.706,152,9.527,13116,3135,9981,3.461,14.482,10231,4428,5803,4.889,11.296,2885,3.185,22.592,107,107,1393
1992,3219,8937,9581,252868,250580,951,9.838,1123,11.617,39368,8748,30620,3.491,15.711,34689,11961,22728,4.773,13.843,4679,1.867,27.687,847,847,7203
1992,3221,213,524,190138,190287,22,4.171,29,5.498,7269,2637,4632,1.386,3.820,7720,2266,5454,1.191,4.057,-451,-0.237,7.640,15,15,190
1992,3222,3512,5153,397615,397070,267,5.164,302,5.841,35315,11994,23321,3.021,8.894,33577,9092,24485,2.290,8.456,1738,0.438,16.912,183,187,3500
1992,3231,42080,44101,815820,821326,3677,8.281,4277,9.633,92454,29335,63119,3.572,11.257,103961,33886,70075,4.126,12.658,-11507,-1.401,22.513,3482,3490,22437
1992,3241,1126,2041,150583,151100,108,5.185,192,9.217,10318,2303,8015,1.524,6.829,11276,4264,7012,2.822,7.463,-958,-0.634,13.657,82,82,861
1992,3251,1119,2304,242387,237326,131,5.626,180,7.730,24810,13489,11321,5.684,10.454,14967,5817,9150,2.451,6.307,9843,4.147,12.613,78,79,1429
1992,3252,327,617,141903,137141,48,7.862,35,5.733,16907,12327,4580,8.989,12.328,7491,1409,6082,1.027,5.462,9416,6.866,10.925,14,15,271
1992,3253,614,839,41692,42278,49,5.771,69,8.127,4014,1408,2606,3.330,9.494,4976,2679,2297,6.337,11.770,-962,-2.275,18.989,42,42,389
1992,3254,1059,1347,188756,184136,98,7.278,97,7.204,23572,4716,18856,2.561,12.801,14012,3361,10651,1.825,7.610,9560,5.192,15.219,63,63,1573
1992,3255,1604,2074,73101,73770,124,5.939,152,7.280,6714,1910,4804,2.589,9.101,8044,2220,5824,3.009,10.904,-1330,-1.803,18.203,86,89,602
1992,3256,1998,2239,120748,120987,158,6.976,210,9.272,13772,5248,8524,4.338,11.383,14255,6506,7749,5.377,11.782,-483,-0.399,22.766,153,153,1516
1992,3259,2236,2911,131232,132603,228,7.839,223,7.667,10933,3319,7614,2.503,8.245,13642,3804,9838,2.869,10.288,-2709,-2.043,16.490,119,119,849
1992,3261,10121,12191,672030,663023,890,7.289,929,7.608,87251,18007,69244,2.716,13.160,68736,20583,48153,3.104,10.367,18515,2.793,20.734,650,654,9032
1992,3262,2236,2721,184304,185129,198,7.290,188,6.922,15868,4157,11711,2.245,8.571,17640,5963,11677,3.221,9.528,-1772,-0.957,17.143,117,122,1345
1992,3271,1407,1700,74342,74604,147,8.534,192,11.147,8071,2430,5641,3.257,10.819,8561,2915,5646,3.907,11.475,-490,-0.657,21.637,128,128,943
1992,3272,1690,1954,132201,131841,179,9.082,213,10.807,11496,1925,9571,1.460,8.720,10555,3559,6996,2.699,8.006,941,0.714,16.012,151,151,1157
1992,3273,6056,8831,163596,166171,470,5.257,690,7.717,22689,5307,17382,3.194,13.654,27860,7740,20120,4.658,16.766,-5171,-3.112,27.308,356,363,3475
1992,3274,242,343,16808,17072,31,8.960,37,10.694,869,250,619,1.464,5.090,1402,535,867,3.134,8.213,-533,-3.122,10.181,28,28,229
1992,3279,1926,2224,67386,67933,189,8.500,188,8.455,8341,3627,4714,5.339,12.278,9445,2434,7011,3.583,13.903,-1104,-1.625,24.557,126,127,1255
1992,3311,229,287,135454,136698,22,7.273,53,17.521,6144,3005,3139,2.198,4.495,8541,1920,6621,1.405,6.248,-2397,-1.754,8.989,29,29,353
1992,3312,520,713,64459,64503,33,4.555,56,7.729,5443,1206,4237,1.870,8.438,5557,1868,3689,2.896,8.615,-114,-0.177,16.877,28,28,413
1992,3313,387,556,93660,95111,36,6.492,33,5.951,6349,2098,4251,2.206,6.675,9080,3417,5663,3.593,9.547,-2731,-2.871,13.351,15,15,145
1992,3314,771,931,77729,78562,66,7.036,80,8.529,6101,2867,3234,3.649,7.766,7924,2132,5792,2.714,10.086,-1823,-2.320,15.532,49,49,602
1992,3315,2400,2655,191760,195422,115,4.251,216,7.984,14289,2098,12191,1.074,7.312,21497,4754,16743,2.433,11.000,-7208,-3.688,14.624,158,159,1874
1992,3321,3179,3369,127081,128390,197,5.804,247,7.278,13512,3303,10209,2.573,10.524,15987,4712,11275,3.670,12.452,-2475,-1.928,21.048,183,184,2078
1992,3322,1335,1460,74789,74975,89,6.096,89,6.096,6395,913,5482,1.218,8.530,6758,1512,5246,2.017,9.014,-363,-0.484,17.059,65,65,691
1992,3323,10333,11104,311376,318021,666,5.898,1042,9.228,35577,7501,28076,2.359,11.187,48967,13952,35015,4.387,15.397,-13390,-4.210,22.374,758,766,7418
1992,3324,1533,1856,105836,108181,99,5.304,120,6.429,8685,1844,6841,1.705,8.028,13402,2713,10689,2.508,12.389,-4717,-4.360,16.056,79,80,1012
1992,3325,914,1000,66468,65258,71,7.093,73,7.293,6957,2443,4514,3.744,10.661,4699,594,4105,0.910,7.201,2258,3.460,14.401,51,51,266
1992,3326,1503,1676,62059,60963,98,5.770,143,8.419,7711,1362,6349,2.234,12.649,5496,1002,4494,1.644,9.015,2215,3.633,18.031,117,117,820
1992,3327,21713,22045,326033,331641,1806,8.170,1926,8.713,37247,10095,27152,3.044,11.231,48741,11535,37206,3.478,14.697,-11494,-3.466,22.462,1411,1417,7747
1992,3328,5330,5718,125919,126847,328,5.674,454,7.853,15754,3018,12736,2.379,12.420,17511,4919,12592,3.878,13.805,-1757,-1.385,24.839,346,350,3707
1992,3329,5722,6230,317238,322048,457,7.279,554,8.824,28640,9594,19046,2.979,8.893,38150,12186,25964,3.784,11.846,-9510,-2.953,17.786,411,412,3842
1992,3331,2734,2983,190235,196229,199,6.595,268,8.882,16526,4829,11697,2.461,8.422,28349,6379,21970,3.251,14.447,-11823,-6.025,16.844,164,166,1530
1992,3332,4017,4271,156314,159827,256,5.949,321,7.459,14696,4290,10406,2.684,9.195,21772,4499,17273,2.815,13.622,-7076,-4.427,18.390,240,242,2233
1992,3333,2410,2541,139444,140043,202,7.951,201,7.912,15089,3418,11671,2.441,10.775,16339,5228,11111,3.733,11.667,-1250,-0.893,21.549,129,129,855
1992,3334,1536,1784,147208,145572,127,7.071,151,8.408,17164,2926,14238,2.010,11.791,13736,5757,7979,3.955,9.436,3428,2.355,18.872,105,106,1149
1992,3335,9263,9598,204652,207792,509,5.265,649,6.713,20370,4204,16166,2.023,9.803,26763,7190,19573,3.460,12.880,-6393,-3.077,19.606,469,473,3808
1992,3336,771,911,118754,120208,53,5.837,47,5.176,6145,936,5209,0.779,5.112,9041,2604,6437,2.166,7.521,-2896,-2.409,10.224,28,28,445
1992,3339,5357,5970,296980,305472,435,7.289,431,7.222,24889,7375,17514,2.414,8.148,41779,12505,29274,4.094,13.677,-16890,-5.529,16.295,295,295,3045
1992,3341,1655,1762,195595,210342,245,13.893,248,14.063,22053,5334,16719,2.536,10.484,52094,18166,33928,8.636,24.766,-30041,-14.282,20.969,181,182,4714
1992,3342,1747,1945,215357,219672,170,8.669,202,10.301,21340,4977,16363,2.266,9.714,30135,7508,22627,3.418,13.718,-8795,-4.004,19.429,130,130,2313
1992,3343,388,419,31969,32370,44,10.353,56,13.176,3047,389,2658,1.202,9.413,3773,1114,2659,3.441,11.656,-726,-2.243,18.826,45,45,598
1992,3344,4966,5528,475052,485117,533,9.583,601,10.805,47495,15984,31511,3.295,9.790,67286,22398,44888,4.617,13.870,-19791,-4.080,19.581,425,426,7464
1992,3345,4542,5160,578359,603366,382,7.384,409,7.906,32448,8960,23488,1.485,5.378,82385,20345,62040,3.372,13.654,-49937,-8.276,10.756,251,254,2931
1992,3346,702,752,41441,48591,115,15.293,115,15.293,4801,1060,3741,2.181,9.880,18797,15746,3051,32.405,38.684,-13996,-28.804,19.761,79,80,1925
1992,3351,1157,1270,69844,70273,97,7.593,112,8.767,6037,1715,4322,2.440,8.591,6855,1260,5595,1.793,9.755,-818,-1.164,17.182,82,83,887
1992,3352,336,410,98740,97631,39,9.319,56,13.381,9923,1336,8587,1.368,10.164,7625,2043,5582,2.093,7.810,2298,2.354,15.620,35,35,295
1992,3353,2175,2611,203700,206075,163,6.227,176,6.724,16299,4815,11484,2.337,7.909,21300,6089,15211,2.955,10.336,-5001,-2.427,15.819,112,112,1354
1992,3359,1839,2202,173893,176221,149,6.680,206,9.236,17536,6674,10862,3.787,9.951,22066,6751,15315,3.831,12.522,-4530,-2.571,19.902,128,130,1543
1992,3361,232,287,212549,204490,36,12.435,41,14.162,26648,973,25675,0.476,13.031,10272,1544,8728,0.755,5.023,16376,8.008,10.046,34,34,289
1992,3362,1729,1916,97029,95043,165,8.472,228,11.707,17053,3651,13402,3.841,17.942,13078,6211,6867,6.535,13.760,3975,4.182,27.520,167,170,2539
1992,3363,4212,5108,632649,617412,330,6.424,388,7.553,74043,13926,60117,2.256,11.992,44217,13884,30333,2.249,7.162,29826,4.831,14.323,269,269,3226
1992,3364,1473,1809,646819,670544,121,6.643,146,8.015,60451,42138,18313,6.284,9.015,108765,52953,55812,7.897,16.220,-48314,-7.205,18.030,96,96,818
1992,3365,170,222,24356,28706,12,5.275,23,10.110,2389,261,2128,0.909,8.322,10389,7607,2782,26.500,36.191,-8000,-27.869,16.645,17,17,543
1992,3366,1303,1395,148376,149813,114,8.094,141,10.011,13802,2055,11747,1.372,9.213,17011,3908,13103,2.609,11.355,-3209,-2.142,18.426,99,99,1406
1992,3369,458,472,31714,31477,52,10.959,57,12.013,4856,2539,2317,8.066,15.427,4543,685,3858,2.176,14.433,313,0.994,28.866,44,44,376
1992,3371,12840,13399,346647,349827,1487,10.926,1908,14.020,42603,9313,33290,2.662,12.178,49154,18706,30448,5.347,14.051,-6551,-1.873,24.357,1435,1442,10884
1992,3372,3083,3272,143827,146130,268,8.083,355,10.707,16750,4460,12290,3.052,11.462,21297,5880,15417,4.024,14.574,-4547,-3.112,22.925,272,274,3873
1992,3379,1083,1219,39866,39861,75,6.034,123,9.895,4549,653,3896,1.638,11.412,4552,1577,2975,3.956,11.420,-3,-0.008,22.825,98,98,986
1992,3391,10584,11157,269348,266899,970,8.723,896,8.058,34908,10548,24360,3.952,13.079,30141,11260,18881,4.219,11.293,4767,1.786,22.586,650,651,4257
1992,3399,15097,15611,389016,386229,1650,10.466,1959,12.426,55992,15055,40937,3.898,14.497,50484,15945,34539,4.128,13.071,5508,1.426,26.142,1571,1572,11077
1992,4231,22309,27439,302903,306079,2455,8.877,2890,10.450,43644,13885,29759,4.536,14.259,50042,17983,32059,5.875,16.349,-6398,-2.090,28.518,1724,1790,9046
1992,4232,8998,10242,119455,121201,1248,12.176,1263,12.323,20082,6335,13747,5.227,16.569,23621,9016,14605,7.439,19.489,-3539,-2.920,33.138,838,873,5823
1992,4233,8089,10769,130359,131678,1059,9.761,1220,11.245,19886,5730,14156,4.352,15.102,22557,9047,13510,6.871,17.130,-2671,-2.028,30.204,798,819,5286
1992,4234,26261,34932,597417,604942,4674,13.469,4216,12.149,103722,36749,66973,6.075,17.146,118554,44216,74338,7.309,19.598,-14832,-2.452,34.292,2138,2291,14403
1992,4235,6874,9288,129547,132154,724,7.736,865,9.243,15986,5004,10982,3.786,12.096,21117,6862,14255,5.192,15.979,-5131,-3.883,24.193,485,504,2689
1992,4236,17941,26408,334574,342179,2673,10.112,2725,10.309,54084,18261,35823,5.337,15.806,68987,23725,45262,6.934,20.161,-14903,-4.355,31.612,1445,1494,9119
1992,4237,11338,16058,174789,175264,1276,7.972,1174,7.334,23242,7181,16061,4.097,13.261,24067,6770,17297,3.863,13.732,-825,-0.471,26.522,692,738,3585
1992,4238,47520,61693,638065,646785,5104,8.202,6176,9.925,82712,25331,57381,3.916,12.788,100437,34402,66035,5.319,15.529,-17725,-2.740,25.576,3447,3770,18096
1992,4239,25249,27257,272651,272911,3762,13.888,3426,12.647,49312,17002,32310,6.230,18.069,49777,18447,31330,6.759,18.239,-465,-0.170,36.138,2548,2574,11888
1992,4241,9758,12804,197821,195314,1104,8.579,1234,9.589,40409,6319,34090,3.235,20.689,35631,18851,16780,9.652,18.243,4778,2.446,36.486,663,693,3573
1992,4242,3477,4625,135290,133075,738,16.175,613,13.436,32016,12785,19231,9.607,24.059,27531,13828,13703,10.391,20.688,4485,3.370,41.377,335,342,2672
1992,4243,12528,13609,165109,159897,2191,16.262,1920,14.250,38648,13396,25252,8.378,24.171,28504,11345,17159,7.095,17.827,10144,6.344,35.653,1435,1459,7390
1992,4244,27558,33806,697546,699204,3667,10.825,3803,11.227,105668,29568,76100,4.229,15.113,108194,38834,69360,5.554,15.474,-2526,-0.361,30.225,2544,2568,16811
1992,4245,6282,9143,80327,80921,536,5.728,966,10.323,12519,3230,9289,3.992,15.471,13710,5362,8348,6.626,16.942,-1191,-1.472,30.941,493,521,3027
1992,4246,8483,12414,139370,139321,1321,10.727,1122,9.111,25228,9905,15323,7.110,18.108,25050,10090,14960,7.242,17.980,178,0.128,35.960,531,549,3094
1992,4247,8710,11772,132034,134420,769,6.401,1251,10.414,21832,6402,15430,4.763,16.242,26304,8759,17545,6.516,19.569,-4472,-3.327,32.483,561,578,3610
1992,4248,3435,4428,133572,132723,275,6.156,354,7.924,13437,3556,9881,2.679,10.124,11799,3944,7855,2.972,8.890,1638,1.234,17.780,213,214,1841
1992,4249,21722,26611,317309,313774,3193,11.942,3447,12.892,60296,23674,36622,7.545,19.216,54047,22309,31738,7.110,17.225,6249,1.992,34.450,2355,2387,11607
1992,4251,32028,34430,290311,294286,3808,11.099,3569,10.402,48693,16369,32324,5.562,16.546,56661,22610,34051,7.683,19.254,-7968,-2.708,33.092,2201,2229,10675
1992,4411,37355,39476,906641,910150,4104,10.334,4580,11.532,115079,42018,73061,4.617,12.644,122004,54078,67926,5.942,13.405,-6925,-0.761,25.288,3536,3577,42788
1992,4412,10353,11006,75592,75658,1028,9.261,1216,10.955,14457,4425,10032,5.849,19.108,14517,5953,8564,7.868,19.188,-60,-0.079,38.217,894,916,4468
1992,4413,39360,62434,463004,465552,4122,6.511,5869,9.271,69768,22023,47745,4.731,14.986,74286,28619,45667,6.147,15.957,-4518,-0.970,29.972,3188,3481,15890
1992,4421,21161,27764,227560,229481,2947,10.522,3435,12.264,39624,14938,24686,6.509,17.267,43566,17141,26425,7.469,18.985,-3942,-1.718,34.534,2092,2241,9796
1992,4422,23346,30711,189081,189512,3581,11.690,3425,11.181,36317,15369,20948,8.110,19.163,37374,11735,25639,6.192,19.721,-1057,-0.558,38.327,2119,2258,7477
1992,4431,25342,36338,267743,263018,5268,14.552,4993,13.793,64736,32546,32190,12.374,24.613,55644,24750,30894,9.410,21.156,9092,3.457,42.312,2861,3073,12839
1992,4441,51987,68655,753553,752649,4741,6.832,6210,8.949,114572,39762,74810,5.283,15.223,114078,41577,72501,5.524,15.157,494,0.066,30.314,3886,4016,19964
1992,4442,15850,19382,150052,150318,1525,7.827,1727,8.864,24676,6432,18244,4.279,16.416,25183,7654,17529,5.092,16.753,-507,-0.337,32.832,1125,1150,4436
1992,4451,60529,90674,2421764,2434300,9332,10.229,10439,11.443,281712,127231,154481,5.227,11.573,306626,97807,208819,4.018,12.596,-24914,-1.023,23.145,6706,6927,43862
1992,4452,17605,21293,130611,132764,3020,13.975,3654,16.909,29041,13410,15631,10.101,21.874,33228,16166,17062,12.177,25.028,-4187,-3.154,43.748,2365,2447,10366
1992,4453,24489,28818,133576,136907,2655,9.056,3652,12.457,22914,8014,14900,5.854,16.737,29510,13173,16337,9.622,21.555,-6596,-4.818,33.474,2480,2548,8275
1992,4461,45289,76000,746833,748115,7117,9.353,7306,9.601,114239,50896,63343,6.803,15.270,116259,46977,69282,6.279,15.540,-2020,-0.270,30.541,4118,4281,21183
1992,4471,75729,128510,899485,917558,11360,8.715,15052,11.547,160737,68544,92193,7.470,17.518,196721,80612,116109,8.785,21.440,-35984,-3.922,35.036,8190,8717,43517
1992,4481,47937,101671,982086,988215,11668,11.333,14238,13.829,178911,85325,93586,8.634,18.104,191173,74695,116478,7.559,19.345,-12262,-1.241,36.209,7216,8207,31982
1992,4482,8757,34492,183283,189093,2985,8.515,4116,11.741,34672,16219,18453,8.577,18.336,45831,18026,27805,9.533,24.237,-11159,-5.901,36.672,1274,1537,5782
1992,4483,18915,28265,162865,164454,3059,10.745,3467,12.178,30272,13047,17225,7.934,18.408,33341,13744,19597,8.357,20.274,-3069,-1.866,36.815,1878,2068,6971
1992,4511,31611,42940,328092,325896,5404,12.513,5898,13.657,65932,27872,38060,8.552,20.231,61460,25896,35564,7.946,18.859,4472,1.372,37.718,3860,4109,13832
1992,4512,8728,14451,106070,105132,1738,12.109,1541,10.737,22041,8023,14018,7.631,20.965,20064,6376,13688,6.065,19.085,1977,1.881,38.169,1041,1065,4015
1992,4521,165,10147,1577620,1593618,418,4.115,441,4.341,135056,62831,72225,3.943,8.475,169748,38971,130777,2.445,10.652,-34692,-2.177,16.950,16,23,2611
1992,4529,10774,24281,489887,491436,2817,11.551,3029,12.421,68506,34089,34417,6.937,13.940,71766,32506,39260,6.614,14.603,-3260,-0.663,27.880,1381,1465,6952
1992,4531,23440,24826,122611,126149,2668,10.580,3450,13.681,21232,8036,13196,6.370,16.831,28324,10606,17718,8.408,22.453,-7092,-5.622,33.662,2662,2700,7994
1992,4532,30222,38892,254854,256176,5375,13.766,5681,14.550,56881,25220,31661,9.845,22.204,59387,28304,31083,11.049,23.182,-2506,-0.978,44.408,3811,3985,14163
1992,4533,11289,14362,78141,74360,3215,23.364,2012,14.622,24663,14922,9741,20.067,33.167,16543,7666,8877,10.309,22.247,8120,10.920,44.494,1299,1310,3701
1992,4539,24576,28553,145686,145960,4637,16.167,4894,17.063,36798,16886,19912,11.569,25.211,37470,16701,20769,11.442,25.672,-672,-0.460,50.422,3463,3589,11873
1992,4541,6134,6975,130393,128553,850,11.788,1322,18.333,26801,7406,19395,5.761,20.848,22764,7844,14920,6.102,17.708,4037,3.140,35.416,631,640,3163
1992,4542,4257,5325,69514,67711,764,14.391,732,13.788,13321,7395,5926,10.921,19.673,9811,3421,6390,5.052,14.490,3510,5.184,28.979,483,485,2139
1992,4543,16711,23113,209934,217166,2088,9.020,2159,9.327,36361,12138,24223,5.589,16.743,50737,14823,35914,6.826,23.363,-14376,-6.620,33.487,1377,1416,8615
1992,4811,507,2825,436177,451155,225,8.284,7,0.258,32469,3794,28675,0.841,7.197,64323,29,64294,0.006,14.257,-31854,-7.061,14.394,5,5,23
1992,4812,1223,1408,20664,19841,229,17.643,9,0.693,5303,1489,3814,7.505,26.727,3828,34,3794,0.171,19.293,1475,7.434,38.587,6,6,22
1992,4831,386,693,39682,39829,82,11.971,66,9.635,7047,1884,5163,4.730,17.693,7289,695,6594,1.745,18.301,-242,-0.608,35.387,38,38,507
1992,4832,279,306,12008,12057,39,12.642,44,14.263,1851,437,1414,3.625,15.353,1876,1240,636,10.285,15.560,-25,-0.207,30.705,26,26,340
1992,4841,22651,29262,613228,601784,4611,15.945,3922,13.563,112305,37145,75160,6.172,18.662,88541,35249,53292,5.857,14.713,23764,3.949,29.426,2897,2944,17840
1992,4842,46342,50651,511818,515083,7584,14.970,7604,15.010,102346,34057,68289,6.612,19.870,108853,44004,64849,8.543,21.133,-6507,-1.263,39.740,5680,5724,29377
1992,4851,398,475,24313,22901,96,22.352,5,1.164,4633,3130,1503,13.668,20.231,1733,18,1715,0.079,7.568,2900,12.663,15.135,5,5,18
1992,4852,307,570,19513,18455,129,25.519,0,0.000,4406,924,3482,5.007,23.874,2271,0,2271,0.000,12.306,2135,11.569,24.611,0,0,0
1992,4853,5153,5242,47975,46430,864,17.838,67,1.383,10005,4617,5388,9.944,21.549,7004,176,6828,0.379,15.085,3001,6.463,30.170,55,55,134
1992,4854,3190,4085,129863,124734,369,9.439,18,0.460,24273,7950,16323,6.374,19.460,13993,73,13920,0.059,11.218,10280,8.242,22.437,15,15,69
1992,4855,1089,1203,24399,23330,154,13.592,14,1.236,5079,1501,3578,6.434,21.771,2925,39,2886,0.167,12.538,2154,9.233,25.076,8,8,11
1992,4859,1135,1219,24043,22710,199,17.657,15,1.331,5271,1699,3572,7.481,23.210,2523,423,2100,1.863,11.110,2748,12.100,22.219,9,9,410
1992,4861,44,382,9315,9264,59,16.738,0,0.000,1093,612,481,6.607,11.799,1031,0,1031,0.000,11.130,62,0.669,22.259,0,0,0
1992,4862,150,1309,42484,41871,184,15.113,(D),(D),7267,4991,2276,11.920,17.356,5899,(D),5886,(D),14.089,1368,3.267,28.177,0,0,0
1992,4869,56,385,6357,6360,60,16.878,(D),(D),980,473,507,7.438,15.410,1068,(D),1067,(D),16.794,-88,-1.384,30.820,(D),(D),(D)
1992,4871,311,351,6595,6198,68,20.763,21,6.412,1544,317,1227,5.115,24.911,713,114,599,1.839,11.504,831,13.408,23.007,13,13,71
1992,4872,1077,1109,11394,11075,213,20.056,119,11.205,2942,1320,1622,11.919,26.564,2299,812,1487,7.332,20.758,643,5.806,41.517,89,89,585
1992,4879,134,142,1112,1067,23,17.490,(D),(D),297,51,246,4.780,27.835,209,(D),207,(D),19.588,88,8.247,39.175,(D),(D),(D)
1992,4881,2271,2903,76848,74437,434,16.098,20,0.742,15210,5107,10103,6.861,20.434,10457,108,10349,0.145,14.048,4753,6.385,28.096,13,13,40
1992,4882,399,633,14521,14048,102,16.626,63,10.269,2825,909,1916,6.471,20.110,1872,685,1187,4.876,13.326,953,6.784,26.652,32,32,191
1992,4883,1957,2511,85432,84259,278,11.043,291,11.559,18059,5384,12675,6.390,21.433,15901,4475,11426,5.311,18.872,2158,2.561,37.743,175,180,1941
1992,4884,4109,4290,27415,27571,748,18.160,406,9.857,6429,3335,3094,12.096,23.318,6817,1974,4843,7.160,24.726,-388,-1.407,46.637,308,312,1250
1992,4885,8422,11225,106047,106091,1851,17.004,1172,10.767,21507,8554,12953,8.063,20.272,21590,9135,12455,8.611,20.350,-83,-0.078,40.544,789,813,4830
1992,4889,778,827,8871,8665,147,17.993,127,15.545,2388,1045,1343,12.061,27.561,2000,837,1163,9.660,23.083,388,4.478,46.165,107,107,641
1992,4921,1338,4162,363331,365383,580,14.577,214,5.378,27102,7137,19965,1.953,7.417,32273,1829,30444,0.501,8.833,-5171,-1.415,14.835,181,181,1224
1992,4922,3490,3827,54044,53640,691,18.191,634,16.691,13394,5949,7445,11.091,24.970,12380,4574,7806,8.527,23.080,1014,1.890,46.160,521,525,3574
1992,4931,6370,10515,440950,437641,980,9.341,933,8.893,79130,33919,45211,7.750,18.081,72427,16885,55542,3.858,16.549,6703,1.532,33.099,335,344,3534
1992,5111,14838,17537,678999,737516,1927,11.030,1794,10.269,60922,20670,40252,2.803,8.260,180517,21096,159421,2.860,24.476,-119595,-16.216,16.521,1371,1377,10008
1992,5112,5192,6269,125119,121199,1082,17.855,664,10.957,30990,10365,20625,8.552,25.570,23355,11132,12223,9.185,19.270,7635,6.300,38.540,430,432,3782
1992,5121,9735,14528,226500,235940,2350,16.306,2118,14.696,54343,27135,27208,11.501,23.033,72763,44418,28345,18.826,30.840,-18420,-7.807,46.065,1114,1207,18454
1992,5122,1445,1483,11385,11957,245,16.150,313,20.633,2179,841,1338,7.034,18.224,3312,1579,1733,13.206,27.700,-1133,-9.476,36.449,254,254,1420
1992,5151,5901,7856,224020,220904,845,11.347,27,0.363,30030,13954,16076,6.317,13.594,23515,410,23105,0.186,10.645,6515,2.949,21.290,14,14,47
1992,5152,198,324,16229,14713,40,13.093,3,0.982,4679,962,3717,6.539,31.803,1676,4,1672,0.027,11.392,3003,20.411,22.783,(D),(D),(D)
1992,5171,3966,24846,975943,958543,2544,10.776,68,0.288,129879,53286,76593,5.559,13.550,95301,481,94820,0.050,9.942,34578,3.607,19.885,46,46,213
1992,5172,1241,2800,59812,53757,711,28.879,35,1.422,19391,7645,11746,14.222,36.072,7091,112,6979,0.208,13.191,12300,22.881,26.382,27,27,89
1992,5174,190,252,4985,4650,75,34.562,5,2.304,1217,845,372,18.172,26.172,562,8,554,0.172,12.086,655,14.086,24.172,(D),(D),(D)
1992,5179,1124,1935,30637,30183,436,24.042,193,10.642,6896,3234,3662,10.715,22.847,5854,1613,4241,5.344,19.395,1042,3.452,38.790,148,149,941
1992,5182,5060,7349,268289,274207,1062,14.349,1166,15.755,55972,20564,35408,7.499,20.412,66760,28037,38723,10.225,24.347,-10788,-3.934,40.825,526,536,17234
1992,5191,2419,2840,34286,34776,239,8.460,209,7.398,3891,1082,2809,3.111,11.189,4804,1436,3368,4.129,13.814,-913,-2.625,22.378,142,142,732
1992,5211,14,44,24095,24068,(D),(D),(D),(D),623,(D),622,(D),2.588,576,(D),524,(D),2.393,47,0.195,4.786,0,0,0
1992,5221,23058,101285,2037135,2039678,6373,6.492,130,0.132,305786,89531,216255,4.389,14.992,312409,1065,311344,0.052,15.317,-6623,-0.325,29.984,119,119,940
1992,5222,12326,33355,426754,402366,4207,13.345,545,1.729,97957,34571,63386,8.592,24.345,49006,3074,45932,0.764,12.179,48951,12.166,24.359,301,302,1360
1992,5223,7592,9760,77784,70387,2159,24.642,162,1.849,24427,10058,14369,14.290,34.704,9617,776,8841,1.102,13.663,14810,21.041,27.326,136,136,561
1992,5231,6363,18831,319363,306820,2919,16.751,109,0.626,53195,17836,35359,5.813,17.338,27017,448,26569,0.146,8.805,26178,8.532,17.611,92,92,298
1992,5232,21,35,6418,6369,(D),(D),(D),(D),789,(D),782,(D),12.388,689,(D),680,(D),10.818,100,1.570,21.636,(D),(D),(D)
1992,5239,18114,19603,220454,209445,4056,22.833,377,2.122,52343,18478,33865,8.822,24.991,30227,2646,27581,1.263,14.432,22116,10.559,28.864,256,256,1191
1992,5241,3692,37092,1523700,1497507,3463,9.783,77,0.218,192601,66502,126099,4.441,12.861,140144,921,139223,0.062,9.358,52457,3.503,18.717,68,68,779
1992,5242,109821,120435,992372,946128,13016,11.355,1400,1.221,230214,72012,158202,7.611,24.332,137656,8872,128784,0.938,14.549,92558,9.783,29.099,976,976,5628
1992,5250,2482,2626,54875,51051,298,11.982,20,0.804,13636,2964,10672,5.806,26.711,5673,102,5571,0.200,11.113,7963,15.598,22.225,6,6,36
1992,5311,87213,94776,485976,469655,10768,11.908,2066,2.285,97586,43406,54180,9.242,20.778,64627,6276,58351,1.336,13.761,32959,7.018,27.521,1667,1671,4672
1992,5312,41256,46891,223812,215486,7472,16.986,1667,3.790,56239,23603,32636,10.953,26.099,40218,5042,35176,2.340,18.664,16021,7.435,37.328,1242,1242,4062
1992,5313,28492,31591,359925,345147,4994,16.879,986,3.333,84202,34927,49275,10.119,24.396,54716,3754,50962,1.088,15.853,29486,8.543,31.706,823,823,3348
1992,5321,4813,9620,128084,129786,1053,10.812,1291,13.256,21273,8341,12932,6.427,16.391,24487,8864,15623,6.830,18.867,-3214,-2.476,32.782,650,680,4276
1992,5322,21402,30019,203382,209861,5060,17.022,4476,15.057,52210,27351,24859,13.033,24.878,64420,21745,42675,10.362,30.697,-12210,-5.818,49.757,3056,3308,15257
1992,5323,3765,5826,37652,38900,542,9.175,705,11.934,6716,2313,4403,5.946,17.265,9052,3732,5320,9.594,23.270,-2336,-6.005,34.530,369,418,1905
1992,5324,7235,9753,106171,106090,1123,11.400,1319,13.390,22082,7206,14876,6.792,20.815,21825,7283,14542,6.865,20.572,257,0.242,41.145,793,851,3828
1992,5331,1317,1462,22067,20531,268,19.978,27,2.013,5542,1620,3922,7.891,26.993,2516,108,2408,0.526,12.255,3026,14.739,24.509,18,18,76
1992,5411,139571,145834,985435,977809,14283,9.890,11461,7.936,137948,44585,93363,4.560,14.108,122588,36897,85691,3.773,12.537,15360,1.571,25.074,8300,8362,26713
1992,5412,75310,79475,697050,700621,9888,12.623,7605,9.708,131452,46011,85441,6.567,18.762,136728,73079,63649,10.431,19.515,-5276,-0.753,37.524,5342,5392,59114
1992,5413,64025,72306,946585,947416,9174,12.791,8002,11.157,162157,51922,110235,5.480,17.116,163356,45592,117764,4.812,17.242,-1199,-0.127,34.231,5240,5309,22491
1992,5414,16967,17167,91562,93051,3129,18.284,3022,17.659,22109,10360,11749,11.134,23.760,25231,11804,13427,12.686,27.115,-3122,-3.355,47.520,2327,2332,8733
1992,5415,26830,30877,438664,426322,6873,22.860,5249,17.459,103744,39751,63993,9.324,24.335,79006,32331,46675,7.584,18.532,24738,5.803,37.064,3536,3576,16101
1992,5416,41593,44257,353000,347484,9944,23.221,7076,16.524,99655,41045,58610,11.812,28.679,88852,39769,49083,11.445,25.570,10803,3.109,51.140,5204,5230,28307
1992,5417,6680,8668,452325,448703,1338,15.815,923,10.910,66256,22550,43706,5.026,14.766,58546,16163,42383,3.602,13.048,7710,1.718,26.096,520,526,3383
1992,5418,27410,31257,352587,367613,4521,14.359,4980,15.816,69829,27362,42467,7.443,18.995,98121,59623,38498,16.219,26.691,-28292,-7.696,37.991,3825,3853,49487
1992,5419,34931,39600,323817,317610,4061,10.412,2864,7.343,64523,21205,43318,6.676,20.315,51549,16238,35311,5.113,16.230,12974,4.085,32.461,1729,1743,6834
1992,5511,28338,53264,3191270,3191839,4892,9.200,4708,8.854,563373,151543,411830,4.748,17.650,563139,124687,438452,3.906,17.643,234,0.007,35.286,442,465,5804
1992,5611,12862,14318,280091,270434,3074,22.418,1863,13.586,79559,39858,39701,14.739,29.419,59444,23376,36068,8.644,21.981,20115,7.438,43.962,1366,1379,15329
1992,5612,480,855,76271,75944,116,13.318,148,16.992,9919,3573,6346,4.705,13.061,9151,3870,5281,5.096,12.050,768,1.011,24.099,29,34,637
1992,5613,19163,27322,1661113,1590875,4436,16.263,4344,15.926,546973,186394,360579,11.716,34.382,403489,144784,258705,9.101,25.363,143484,9.019,50.725,2825,2911,86901
1992,5614,23647,27071,356716,354559,4361,16.272,3821,14.257,80787,31564,49223,8.902,22.785,75727,27537,48190,7.767,21.358,5060,1.427,42.716,2821,2845,15596
1992,5615,24251,30959,236229,236987,3866,12.474,3935,12.696,44937,18235,26702,7.695,18.962,46406,19236,27170,8.117,19.582,-1469,-0.620,37.924,2664,2723,13217
1992,5616,13253,16937,532404,540567,2426,14.445,2142,12.754,91103,32767,58336,6.062,16.853,108392,32640,75752,6.038,20.052,-17289,-3.198,33.706,1548,1568,18673
1992,5617,89934,94418,1116913,1102216,16687,18.249,10731,11.736,247270,86366,160904,7.836,22.434,217819,70917,146902,6.434,19.762,29451,2.672,39.524,8404,8420,42070
1992,5619,15755,17362,253064,245678,3078,17.881,2781,16.156,70012,30985,39027,12.612,28.497,55598,19879,35719,8.091,22.630,14414,5.867,45.261,2062,2070,12155
1992,5621,4032,4472,71656,71293,325,7.201,407,9.018,10514,3078,7436,4.317,14.748,9626,3746,5880,5.254,13.502,888,1.246,27.004,323,325,2174
1992,5622,1560,2354,67290,64850,356,16.278,22,1.006,13952,6505,7447,10.031,21.514,8962,315,8647,0.486,13.820,4990,7.695,27.639,6,6,16
1992,5629,4926,5266,64470,64483,696,13.303,628,12.003,14495,3980,10515,6.172,22.479,14509,3930,10579,6.095,22.501,-14,-0.022,44.958,451,455,2351
1992,6111,14141,16065,525468,511972,832,5.315,12,0.077,53737,11419,42318,2.230,10.496,26764,65,26699,0.013,5.228,26973,5.268,10.455,7,7,48
1992,6112,613,932,70950,68305,83,9.315,(D),(D),10043,2177,7866,3.187,14.703,4670,(D),4669,(D),6.837,5373,7.866,13.674,0,0,0
1992,6113,2071,2456,1098063,1081742,89,3.685,8,0.331,76755,1979,74776,0.183,7.095,43749,30,43719,0.003,4.044,33006,3.051,8.089,4,4,4
1992,6114,3243,3713,48246,47299,649,18.103,393,10.962,10183,2956,7227,6.250,21.529,8227,3049,5178,6.446,17.394,1956,4.135,34.787,255,261,2004
1992,6115,4598,5473,63936,63755,649,11.980,538,9.931,12794,3803,8991,5.965,20.067,12416,3580,8836,5.615,19.475,378,0.593,38.949,313,344,2247
1992,6116,14493,15442,115866,112137,2694,17.954,1820,12.129,29385,11283,18102,10.062,26.205,22148,9286,12862,8.281,19.751,7237,6.454,39.502,1387,1392,7139
1992,6117,2292,2377,18836,17918,509,22.174,346,15.073,5032,1848,3184,10.314,28.084,3055,1281,1774,7.149,17.050,1977,11.034,34.101,246,248,987
1992,6211,181686,193970,1506858,1465260,14045,7.259,13098,6.769,258565,80341,178224,5.483,17.646,175410,60818,114592,4.151,11.971,83155,5.675,23.943,9940,10100,41295
1992,6212,101284,104214,561657,552848,5139,4.945,4546,4.375,80753,18565,62188,3.358,14.607,63180,16707,46473,3.022,11.428,17573,3.179,22.856,3256,3311,12077
1992,6213,64804,68628,290793,279957,8253,12.289,5311,7.908,69052,28007,41045,10.004,24.665,47197,17381,29816,6.208,16.859,21855,7.807,33.717,3813,3887,12218
1992,6214,8410,13870,263465,253804,1777,13.186,990,7.346,50790,15646,35144,6.165,20.012,31381,11155,20226,4.395,12.364,19409,7.647,24.729,449,459,4451
1992,6215,5595,7810,129643,128782,1192,15.571,883,11.534,25405,9249,16156,7.182,19.727,23784,8336,15448,6.473,18.468,1621,1.259,36.937,622,627,4868
1992,6216,5589,9382,516934,483484,1592,17.800,716,8.005,127700,33682,94018,6.967,26.412,60611,16202,44409,3.351,12.536,67089,13.876,25.073,385,395,6885
1992,6219,5738,7369,141331,133853,1097,15.609,415,5.905,32926,10891,22035,8.137,24.599,18116,5931,12185,4.431,13.534,14810,11.064,27.069,271,272,3138
1992,6221,3141,4729,4176310,4057543,236,5.013,194,4.121,440041,162105,277936,3.995,10.845,202898,55438,147460,1.366,5.001,237143,5.844,10.001,103,104,35238
1992,6222,579,994,322920,340254,82,8.367,54,5.510,36535,17827,18708,5.239,10.738,70113,7683,62430,2.258,20.606,-33578,-9.869,21.475,23,23,3734
1992,6223,232,347,132600,126410,47,14.114,19,5.706,21212,10613,10599,8.396,16.780,8882,2274,6608,1.799,7.026,12330,9.754,14.053,13,13,1893
1992,6231,7333,12894,1244521,1209268,982,7.770,470,3.719,152791,65307,87484,5.401,12.635,82943,28332,54611,2.343,6.859,69848,5.776,13.718,295,307,17194
1992,6232,6561,13355,282586,273712,1679,13.062,678,5.274,52475,20270,32205,7.406,19.172,34714,11674,23040,4.265,12.683,17761,6.489,25.365,474,500,8413
1992,6233,11074,13499,403176,398314,1745,13.087,1415,10.612,61746,24792,36954,6.224,15.502,52254,27026,25228,6.785,13.119,9492,2.383,26.238,878,895,16269
1992,6239,3965,5431,133796,130706,638,12.096,325,6.162,22523,8394,14129,6.422,17.232,16354,6424,9930,4.915,12.512,6169,4.720,25.024,182,183,3026
1992,6241,20843,28443,421339,409601,3116,11.203,1859,6.684,73245,19368,53877,4.729,17.882,50129,13090,37039,3.196,12.238,23116,5.644,24.477,1096,1108,6308
1992,6242,5701,6794,73510,70886,618,9.222,433,6.461,13987,3357,10630,4.736,19.732,8878,2317,6561,3.269,12.524,5109,7.207,25.049,265,265,1057
1992,6243,5221,8195,297905,293639,771,9.558,514,6.372,47676,8098,39578,2.758,16.236,38827,5558,33269,1.893,13.223,8849,3.014,26.445,228,241,2597
1992,6244,38585,47168,463730,452874,6010,13.025,3960,8.582,87779,34967,52812,7.721,19.383,65831,22512,43319,4.971,14.536,21948,4.846,29.073,2916,2989,16274
1992,7111,6298,6364,90197,88299,1150,18.510,848,13.649,23078,7062,16016,7.998,26.136,19100,5066,14034,5.737,21.631,3978,4.505,43.262,589,590,3122
1992,7112,2679,2802,79805,76647,515,18.512,475,17.074,18625,5250,13375,6.850,24.300,12614,4686,7928,6.114,16.457,6011,7.842,32.915,348,350,3131
1992,7113,2569,2678,44751,44197,464,17.616,376,14.275,10768,3743,7025,8.469,24.364,9478,2644,6834,5.982,21.445,1290,2.919,42.890,272,272,1691
1992,7114,1472,1499,12916,13365,257,17.185,250,16.717,3195,1310,1885,9.802,23.907,4056,1848,2208,13.828,30.349,-861,-6.442,47.813,180,181,1396
1992,7115,6675,6720,37855,45567,1288,18.702,1622,23.552,14424,4688,9736,10.288,31.654,29140,22389,6751,49.134,63.950,-14716,-32.295,63.309,1171,1172,4526
1992,7121,3019,3315,66757,65533,258,7.890,168,5.138,8906,1569,7337,2.394,13.590,6398,973,5425,1.485,9.763,2508,3.827,19.526,98,98,293
1992,7131,1599,2498,93194,92403,307,12.402,262,10.584,15339,3304,12035,3.576,16.600,13693,6661,7032,7.209,14.819,1646,1.781,29.638,165,169,1172
1992,7132,953,1081,40682,34929,218,21.134,119,11.537,15312,6432,8880,18.415,43.838,3679,1788,1891,5.119,10.533,11633,33.305,21.066,79,80,1007
1992,7139,39086,42204,681021,667923,5250,12.537,4596,10.975,129815,48309,81506,7.233,19.436,103772,37934,65838,5.679,15.537,26043,3.899,31.073,3429,3471,28633
1992,7211,29533,36350,1421530,1433884,4028,11.075,4067,11.182,207670,97445,110225,6.796,14.483,232547,108081,124466,7.538,16.218,-24877,-1.735,28.966,2490,2551,58511
1992,7212,4332,4646,29998,29391,523,11.362,437,9.494,6938,1998,4940,6.798,23.606,5745,1766,3979,6.009,19.547,1193,4.059,39.094,229,230,918
1992,7213,3221,3313,15718,16053,281,8.397,348,10.399,2513,903,1610,5.625,15.655,3159,1619,1540,10.086,19.679,-646,-4.024,31.310,252,252,1168
1992,7223,17582,32904,560478,564597,6418,19.586,6145,18.753,145724,60145,85579,10.653,25.810,154319,88740,65579,15.717,27.333,-8595,-1.522,51.621,2508,2529,23033
1992,7224,48847,49392,306483,305786,6969,13.949,8103,16.219,81469,43524,37945,14.234,26.643,80065,41400,38665,13.539,26.183,1404,0.459,52.367,6342,6358,32204
1992,7225,227984,311337,5798684,5722366,45069,14.612,39252,12.726,1168144,604232,563912,10.559,20.414,1019022,425652,593370,7.438,17.808,149122,2.606,35.615,27385,28284,269991
1992,8111,122093,132384,664832,668820,16901,12.815,15899,12.055,131288,59958,71330,8.965,19.630,139345,55301,84044,8.268,20.834,-8057,-1.205,39.260,11667,11770,41152
1992,8112,12672,15613,138069,137645,2270,14.718,1890,12.254,28833,13489,15344,9.800,20.947,28197,10575,17622,7.683,20.485,636,0.462,40.971,1185,1197,4513
1992,8113,20984,22263,164906,166938,2485,11.145,2552,11.446,28838,10202,18636,6.111,17.275,32634,10523,22111,6.304,19.549,-3796,-2.274,34.549,1856,1861,7349
1992,8114,26998,28884,175015,176437,4183,14.512,4065,14.102,30951,12065,18886,6.838,17.542,33635,13381,20254,7.584,19.064,-2684,-1.521,35.085,3063,3073,8703
1992,8121,75718,87722,461885,462808,11691,13.326,11714,13.352,95267,47174,48093,10.193,20.585,97478,42514,54964,9.186,21.062,-2211,-0.478,41.169,9017,9176,32257
1992,8122,16504,20302,129181,127892,1154,5.654,1371,6.717,21439,5100,16339,3.988,16.763,18841,5858,12983,4.580,14.732,2598,2.031,29.464,890,904,4383
1992,8123,34157,41149,370650,375141,4944,11.974,5226,12.657,60538,23213,37325,6.188,16.137,69102,28065,41037,7.481,18.420,-8564,-2.283,32.275,3529,3702,17426
1992,8129,13187,22326,157759,158195,3426,15.372,3348,15.022,34441,15592,18849,9.856,21.771,35239,14811,20428,9.362,22.276,-798,-0.504,43.542,1329,1369,7367
1992,8131,137856,137951,1195714,1166013,7319,5.434,780,0.579,150763,20663,130100,1.772,12.930,91982,1758,90224,0.151,7.889,58781,5.041,15.777,204,204,442
1992,8132,10390,12164,146406,141414,1161,9.836,439,3.719,25747,6523,19224,4.613,18.207,15654,2153,13501,1.522,11.070,10093,7.137,22.139,255,256,1081
1992,8133,9511,11172,120689,120741,1040,9.425,764,6.924,21774,5024,16750,4.161,18.034,22417,4169,18248,3.453,18.566,-643,-0.533,36.067,418,422,2280
1992,8134,31596,33341,313447,313406,2165,6.542,1674,5.058,45404,8596,36808,2.743,14.487,44420,6572,37848,2.097,14.173,984,0.314,28.347,1161,1162,4468
1992,8139,62764,64981,522461,513374,4070,6.376,1781,2.790,78629,17800,60829,3.467,15.316,60619,7266,53353,1.415,11.808,18010,3.508,23.616,1229,1231,5143
1993,2111,6901,8093,100543,109691,766,9.396,884,10.844,16503,6847,9656,6.242,15.045,34936,5911,29025,5.389,31.850,-18433,-16.805,30.090,565,566,1954
1993,2121,1436,1958,105566,110404,278,13.641,438,21.492,15266,6757,8509,6.120,13.827,24988,12406,12582,11.237,22.633,-9722,-8.806,27.655,308,313,5375
1993,2122,366,535,45961,46314,74,13.297,117,21.024,4349,1750,2599,3.779,9.390,5044,1555,3489,3.358,10.891,-695,-1.501,18.781,55,57,254
1993,2123,3370,4989,95244,96630,307,6.091,410,8.134,11263,2580,8683,2.670,11.656,14200,3623,10577,3.749,14.695,-2937,-3.039,23.312,222,231,1464
1993,2131,7460,8441,138402,139905,1207,14.152,1383,16.215,37403,13693,23710,9.787,26.735,40358,15099,25259,10.792,28.847,-2955,-2.112,53.469,922,925,6131
1993,2211,1513,6929,618213,625374,339,4.931,232,3.374,46459,12354,34105,1.975,7.429,61175,6974,54201,1.115,9.782,-14716,-2.353,14.858,48,52,716
1993,2212,614,2774,109097,108640,216,7.859,165,6.003,8909,3509,5400,3.230,8.200,7956,1783,6173,1.641,7.323,953,0.877,14.647,34,34,112
1993,2213,3972,4355,31775,31316,351,8.201,201,4.696,3921,1247,2674,3.982,12.521,2986,934,2052,2.983,9.535,935,2.986,19.070,139,139,526
1993,2361,113197,113606,571911,558487,22398,19.893,20373,18.094,185880,73119,112761,13.092,33.283,158868,67906,90962,12.159,28.446,27012,4.837,56.892,14395,14398,49967
1993,2362,35238,35868,574747,577362,4752,13.306,4443,12.441,124895,28924,95971,5.010,21.632,129804,29212,100592,5.060,22.482,-4909,-0.850,43.264,3280,3280,21457
1993,2371,13966,14264,304464,305392,1301,9.121,1301,9.121,61637,10521,51116,3.445,20.183,63771,11344,52427,3.715,20.882,-2134,-0.699,40.366,968,969,8140
1993,2372,6829,7026,54310,55354,1608,23.047,1510,21.643,14102,6302,7800,11.385,25.476,16029,7498,8531,13.546,28.958,-1927,-3.481,50.953,1215,1215,4599
1993,2373,9458,9847,221057,223977,949,9.658,908,9.240,43134,6855,36279,3.061,19.258,49382,8874,40508,3.962,22.048,-6248,-2.790,38.516,648,649,5356
1993,2379,4870,4951,62548,64186,692,13.925,729,14.669,15579,4261,11318,6.639,24.272,18919,4439,14480,6.916,29.476,-3340,-5.204,48.544,550,551,2565
1993,2381,77347,77758,657876,648317,12211,15.911,10182,13.268,191105,55941,135164,8.629,29.477,172070,54336,117734,8.381,26.541,19035,2.936,53.082,7590,7593,42652
1993,2382,121115,123053,1167912,1158482,14663,11.997,13010,10.644,238806,54940,183866,4.742,20.614,219908,58221,161687,5.026,18.982,18898,1.631,37.965,9776,9783,45400
1993,2383,81530,81973,583147,581741,14879,18.371,12917,15.948,164098,53244,110854,9.153,28.208,161371,54893,106478,9.436,27.739,2727,0.469,55.479,9487,9492,42427
1993,2389,40184,40417,334356,333581,5581,13.861,5278,13.108,84186,21930,62256,6.574,25.237,82705,24194,58511,7.253,24.793,1481,0.444,49.586,3924,3927,18996
1993,3111,1395,2043,53362,52824,155,7.733,78,3.891,6463,2502,3961,4.736,12.235,5335,708,4627,1.340,10.100,1128,2.135,20.199,44,44,294
1993,3112,464,811,64387,65090,49,6.053,46,5.683,3864,1013,2851,1.556,5.936,5124,2292,2832,3.521,7.872,-1260,-1.936,11.873,22,23,233
1993,3113,1523,1735,85586,85324,165,9.549,151,8.738,9301,920,8381,1.078,10.901,8540,1567,6973,1.837,10.009,761,0.892,20.018,108,113,820
1993,3114,1249,1696,178704,177364,140,8.316,115,6.831,20748,3851,16897,2.171,11.698,18091,5898,12193,3.325,10.200,2657,1.498,20.400,79,79,1796
1993,3115,1271,1846,131911,132561,68,3.636,116,6.203,10064,1491,8573,1.125,7.592,11234,2422,8812,1.827,8.475,-1170,-0.883,15.184,78,80,1191
1993,3116,3575,4173,406832,398844,298,7.208,221,5.345,41408,10732,30676,2.691,10.382,25365,9712,15653,2.435,6.360,16043,4.022,12.719,162,165,3213
1993,3117,638,750,44952,45979,56,7.277,95,12.346,7372,1912,5460,4.158,16.033,9393,2685,6708,5.840,20.429,-2021,-4.395,32.067,66,66,2114
1993,3118,9221,10317,307948,306087,1205,11.692,1183,11.479,36698,12840,23858,4.195,11.989,32717,11574,21143,3.781,10.689,3981,1.301,21.378,817,855,5554
1993,3119,2195,2567,132804,131365,235,9.210,204,7.995,16449,6363,10086,4.844,12.522,13769,4496,9273,3.423,10.482,2680,2.040,20.963,156,156,1945
1993,3121,1671,2102,131776,131896,149,7.099,143,6.813,13295,2432,10863,1.844,10.080,13364,2680,10684,2.032,10.132,-69,-0.052,20.160,99,99,975
1993,3122,69,103,35372,36296,6,5.607,14,13.084,1461,342,1119,0.942,4.025,3221,487,2734,1.342,8.874,-1760,-4.849,8.051,6,6,105
1993,3131,358,597,90887,92178,42,7.029,43,7.197,6791,1396,5395,1.514,7.367,9451,3147,6304,3.414,10.253,-2660,-2.886,14.735,20,20,314
1993,3132,1600,1945,239269,240453,180,9.278,170,8.763,18099,5795,12304,2.410,7.527,20442,5620,14822,2.337,8.501,-2343,-0.974,15.054,133,136,2940
1993,3133,2093,2308,107286,106159,289,12.945,138,6.181,13147,3805,9342,3.584,12.384,10854,2432,8422,2.291,10.224,2293,2.160,20.449,98,100,1297
1993,3141,2943,3225,121503,121029,301,9.230,373,11.438,14063,3975,10088,3.284,11.620,13189,4995,8194,4.127,10.897,874,0.722,21.795,291,291,1883
1993,3149,3964,4075,112382,111687,505,12.463,459,11.328,18798,6186,12612,5.539,16.831,17379,6748,10631,6.042,15.560,1419,1.271,31.121,362,363,4365
1993,3151,1119,1251,118573,118337,135,10.830,126,10.108,12953,3282,9671,2.773,10.946,12480,3001,9479,2.536,10.546,473,0.400,21.092,98,98,1628
1993,3152,10997,12109,666418,676598,2219,18.224,2354,19.332,104369,41608,62761,6.150,15.426,124021,57732,66289,8.533,18.330,-19652,-2.905,30.851,1975,1990,41843
1993,3159,1796,1890,65996,65623,242,12.760,255,13.446,9505,2450,7055,3.733,14.484,8837,3160,5677,4.815,13.466,668,1.018,26.933,217,218,2319
1993,3161,306,340,17313,17214,31,9.199,25,7.418,2347,412,1935,2.393,13.634,2194,410,1784,2.382,12.745,153,0.889,25.491,19,19,149
1993,3162,335,437,66084,64247,46,10.648,36,8.333,11208,6451,4757,10.041,17.445,7503,2365,5138,3.681,11.678,3705,5.767,23.357,21,21,538
1993,3169,1058,1103,33148,32186,123,11.192,115,10.464,6379,2089,4290,6.491,19.819,4436,1497,2939,4.651,13.783,1943,6.037,27.565,92,92,822
1993,3211,4344,4837,129726,128890,457,9.446,459,9.487,15574,4128,11446,3.203,12.083,13870,4916,8954,3.814,10.761,1704,1.322,21.522,336,337,2241
1993,3212,1307,1602,96012,94180,120,7.531,103,6.464,10606,1852,8754,1.966,11.261,6949,2420,4529,2.570,7.378,3657,3.883,14.757,70,70,838
1993,3219,9108,9781,268401,261410,1074,11.028,990,10.165,45343,11644,33699,4.454,17.346,31302,10700,20602,4.093,11.974,14041,5.371,23.949,777,785,7386
1993,3221,219,526,186655,188378,24,4.585,19,3.629,7802,3899,3903,2.070,4.142,11097,4951,6146,2.628,5.891,-3295,-1.749,8.283,3,3,18
1993,3222,3531,5161,402820,399762,280,5.427,277,5.369,36116,11208,24908,2.804,9.034,30371,11073,19298,2.770,7.597,5745,1.437,15.195,172,176,3479
1993,3231,41652,43646,813841,815091,3562,8.121,3994,9.106,92997,25023,67974,3.070,11.409,95737,31430,64307,3.856,11.746,-2740,-0.336,22.819,3288,3299,19248
1993,3241,1129,2080,141909,145624,152,7.364,120,5.814,8130,2058,6072,1.413,5.583,15496,3160,12336,2.170,10.641,-7366,-5.058,11.166,58,59,646
1993,3251,1152,2347,217063,224569,189,8.106,158,6.777,11317,3660,7657,1.630,5.039,26145,13848,12297,6.166,11.642,-14828,-6.603,10.079,50,54,919
1993,3252,356,644,132256,137053,54,8.491,38,5.975,8834,2419,6415,1.765,6.446,17870,10928,6942,7.974,13.039,-9036,-6.593,12.891,7,8,272
1993,3253,638,855,39925,40828,55,6.421,58,6.772,2791,380,2411,0.931,6.836,4592,1178,3414,2.885,11.247,-1801,-4.411,13.672,26,28,210
1993,3254,1133,1429,191380,190745,122,8.689,72,5.128,18786,5035,13751,2.640,9.849,17706,3088,14618,1.619,9.283,1080,0.566,18.565,45,45,553
1993,3255,1572,2029,72727,73422,108,5.277,143,6.988,7062,2246,4816,3.059,9.618,8480,2829,5651,3.853,11.550,-1418,-1.931,19.237,82,82,462
1993,3256,2051,2290,125478,123365,199,8.759,163,7.174,14498,2545,11953,2.063,11.752,10418,3637,6781,2.948,8.445,4080,3.307,16.890,118,118,1055
1993,3259,2265,2947,131519,131115,217,7.402,186,6.345,12794,3294,9500,2.512,9.758,11768,2855,8913,2.177,8.975,1026,0.783,17.951,130,132,1005
1993,3261,10209,12309,699384,684905,918,7.491,811,6.617,92873,22290,70583,3.254,13.560,63966,20245,43721,2.956,9.339,28907,4.221,18.679,563,568,7348
1993,3262,2222,2733,189943,187081,196,7.190,182,6.676,17041,3944,13097,2.108,9.109,11301,2481,8820,1.326,6.041,5740,3.068,12.081,134,134,1226
1993,3271,1467,1751,75100,74338,167,9.625,135,7.781,8756,1695,7061,2.280,11.779,7295,1610,5685,2.166,9.813,1461,1.965,19.627,99,100,566
1993,3272,1722,1978,132439,132155,206,10.502,173,8.820,10069,2328,7741,1.762,7.619,9291,2405,6886,1.820,7.030,778,0.589,14.061,124,124,535
1993,3273,5951,8708,163179,163381,494,5.632,622,7.091,22036,4970,17066,3.042,13.487,22581,6004,16577,3.675,13.821,-545,-0.334,26.975,355,361,2983
1993,3274,244,346,16969,16829,26,7.536,24,6.957,1093,232,861,1.379,6.495,797,246,551,1.462,4.736,296,1.759,9.472,19,19,138
1993,3279,1929,2220,67801,67735,180,8.077,197,8.840,6849,2128,4721,3.142,10.111,6688,1969,4719,2.907,9.874,161,0.238,19.748,139,140,1157
1993,3311,235,293,130382,132376,28,9.573,27,9.231,5098,2584,2514,1.952,3.851,9280,870,8410,0.657,7.010,-4182,-3.159,7.702,21,21,223
1993,3312,534,730,64828,64972,45,6.156,47,6.430,5392,1248,4144,1.921,8.299,5824,1807,4017,2.781,8.964,-432,-0.665,16.598,29,29,489
1993,3313,382,539,91857,92651,23,4.201,40,7.306,6029,1356,4673,1.464,6.507,7646,4078,3568,4.401,8.253,-1617,-1.745,13.015,11,11,251
1993,3314,758,916,77051,77344,55,5.959,69,7.476,5674,1183,4491,1.530,7.336,6236,1796,4440,2.322,8.063,-562,-0.727,14.672,47,47,970
1993,3315,2380,2638,192907,192372,133,5.021,155,5.851,17776,3024,14752,1.572,9.240,16791,2685,14106,1.396,8.728,985,0.512,17.457,110,110,1349
1993,3321,3129,3319,130589,129622,159,4.751,214,6.395,14616,3482,11134,2.686,11.276,12763,4596,8167,3.546,9.846,1853,1.430,19.693,159,159,1429
1993,3322,1336,1468,74160,74268,91,6.226,78,5.337,5178,860,4318,1.158,6.972,5439,869,4570,1.170,7.323,-261,-0.351,13.944,62,62,487
1993,3323,10347,11095,311593,311458,816,7.342,853,7.675,42843,9486,33357,3.046,13.756,42522,13083,29439,4.201,13.653,321,0.103,27.305,660,666,6524
1993,3324,1500,1823,104252,106269,91,4.939,130,7.056,9551,2078,7473,1.955,8.988,13651,3286,10365,3.092,12.846,-4100,-3.858,17.975,83,84,1025
1993,3325,898,985,65461,65950,60,6.051,73,7.363,5266,1059,4207,1.606,7.985,6199,2627,3572,3.983,9.400,-933,-1.415,15.970,53,53,686
1993,3326,1539,1716,65412,63797,113,6.647,81,4.765,7971,1977,5994,3.099,12.494,4766,1281,3485,2.008,7.471,3205,5.024,14.941,55,60,901
1993,3327,22205,22529,332224,329276,2069,9.269,1653,7.406,46527,11810,34717,3.587,14.130,40676,12354,28322,3.752,12.353,5851,1.777,24.706,1224,1228,6715
1993,3328,5330,5722,129117,127758,356,6.220,359,6.272,16772,2998,13774,2.347,13.128,14132,3679,10453,2.880,11.062,2640,2.066,22.123,271,273,2187
1993,3329,5737,6223,307558,312030,514,8.266,504,8.106,27489,5358,22131,1.717,8.810,36468,13032,23436,4.177,11.687,-8979,-2.878,17.619,356,357,3058
1993,3331,2735,2978,189525,189872,205,6.863,223,7.466,19377,6248,13129,3.291,10.205,20405,5531,14874,2.913,10.747,-1028,-0.541,20.411,150,150,1355
1993,3332,4042,4280,151499,153868,301,7.033,301,7.033,15935,3553,12382,2.309,10.356,20405,5806,14599,3.773,13.261,-4470,-2.905,20.713,211,214,1626
1993,3333,2418,2546,136961,138726,206,8.090,207,8.129,12479,1571,10908,1.132,8.995,15877,4296,11581,3.097,11.445,-3398,-2.449,17.991,155,157,2028
1993,3334,1550,1794,148492,147779,134,7.492,123,6.877,15755,3204,12551,2.168,10.661,14503,4492,10011,3.040,9.814,1252,0.847,19.628,79,81,924
1993,3335,9317,9642,206061,205053,610,6.340,569,5.914,25556,6101,19455,2.975,12.463,23469,8828,14641,4.305,11.445,2087,1.018,22.891,429,429,3255
1993,3336,764,916,119349,119100,52,5.686,49,5.358,9833,2620,7213,2.200,8.256,9300,3121,6179,2.620,7.809,533,0.448,15.617,33,34,758
1993,3339,5478,6085,299506,298669,458,7.576,379,6.269,30774,8112,22662,2.716,10.304,29076,8203,20873,2.747,9.735,1698,0.569,19.470,257,260,3039
1993,3341,1689,1784,188698,192214,249,14.004,237,13.330,19845,4556,15289,2.370,10.324,26583,7272,19311,3.783,13.830,-6738,-3.505,20.649,174,175,2350
1993,3342,1768,1958,217967,217948,171,8.751,163,8.342,24985,8362,16623,3.837,11.464,25209,8229,16980,3.776,11.567,-224,-0.103,22.927,97,98,1401
1993,3343,401,436,34359,33325,48,11.215,32,7.477,3691,1126,2565,3.379,11.076,1642,372,1270,1.116,4.927,2049,6.149,9.854,22,22,232
1993,3344,5037,5598,476513,476722,571,10.266,499,8.972,52554,11902,40652,2.497,11.024,52339,16341,35998,3.428,10.979,215,0.045,21.958,360,361,4950
1993,3345,4545,5156,547471,564116,352,6.824,356,6.902,37433,12704,24729,2.252,6.636,69814,9544,60270,1.692,12.376,-32381,-5.740,13.271,229,232,3046
1993,3346,737,788,44515,43057,120,15.574,85,11.032,7977,1854,6123,4.306,18.527,5138,1524,3614,3.540,11.933,2839,6.594,23.866,57,57,414
1993,3351,1104,1217,70644,70220,71,5.721,119,9.589,7563,1835,5728,2.613,10.771,6675,2304,4371,3.281,9.506,888,1.265,19.012,88,89,1544
1993,3352,334,405,99384,99094,25,6.112,33,8.068,8347,677,7670,0.683,8.423,7455,1151,6304,1.162,7.523,892,0.900,15.046,21,22,365
1993,3353,2184,2616,207417,205395,183,7.003,177,6.774,24691,11045,13646,5.377,12.021,20173,5098,15075,2.482,9.822,4518,2.200,19.643,110,110,1209
1993,3359,1836,2198,178441,175472,147,6.696,142,6.468,21235,6549,14686,3.732,12.102,14958,3831,11127,2.183,8.524,6277,3.577,17.049,99,99,761
1993,3361,251,309,213211,210297,48,16.080,27,9.045,31531,13099,18432,6.229,14.994,26629,18069,8560,8.592,12.663,4902,2.331,25.325,21,21,217
1993,3362,1724,1886,108757,102767,176,9.261,205,10.787,20899,4202,16697,4.089,20.336,9019,4588,4431,4.464,8.776,11880,11.560,17.552,133,135,1765
1993,3363,4290,5186,664948,650715,421,8.183,338,6.570,73330,16594,56736,2.550,11.269,45491,14656,30835,2.252,6.991,27839,4.278,13.982,235,236,4674
1993,3364,1428,1754,589904,630735,120,6.753,166,9.342,23313,10633,12680,1.686,3.696,104497,16102,88395,2.553,16.567,-81184,-12.871,7.392,118,120,1433
1993,3365,172,220,26864,25552,11,4.966,14,6.321,4622,702,3920,2.747,18.089,1973,178,1795,0.697,7.722,2649,10.367,15.443,7,7,127
1993,3366,1358,1458,139236,143591,170,11.863,120,8.374,11817,3058,8759,2.130,8.230,20618,2861,17757,1.992,14.359,-8801,-6.129,16.459,79,79,955
1993,3369,487,500,31219,31539,76,15.606,50,10.267,4217,581,3636,1.842,13.371,4645,2651,1994,8.405,14.728,-428,-1.357,26.741,38,38,425
1993,3371,13119,13648,361600,354189,1719,12.611,1685,12.362,55188,16027,39161,4.525,15.582,39923,16096,23827,4.544,11.272,15265,4.310,22.543,1272,1288,10748
1993,3372,3192,3380,146173,145571,352,10.529,278,8.316,18396,3971,14425,2.728,12.637,17194,5172,12022,3.553,11.811,1202,0.826,23.623,208,211,2829
1993,3379,1092,1228,39906,39854,107,8.760,94,7.695,5139,724,4415,1.817,12.895,5090,1398,3692,3.508,12.772,49,0.123,25.544,74,74,570
1993,3391,10709,11288,279856,274931,977,8.709,838,7.470,36947,10219,26728,3.717,13.439,26664,9036,17628,3.287,9.698,10283,3.740,19.397,628,629,3144
1993,3399,15502,16024,400496,394855,1964,12.402,1589,10.034,59195,17119,42076,4.336,14.992,47915,12532,35383,3.174,12.135,11280,2.857,24.270,1251,1256,7283
1993,4231,21982,26904,301239,301655,2239,8.244,2747,10.115,41084,11839,29245,3.925,13.620,42256,16053,26203,5.322,14.008,-1172,-0.389,27.239,1815,1937,9223
1993,4232,9028,10220,122265,120697,1148,11.216,1179,11.519,21565,5580,15985,4.623,17.867,18355,6220,12135,5.153,15.208,3210,2.660,30.415,850,867,3899
1993,4233,8219,10997,135177,132714,1168,10.697,1012,9.268,21433,6229,15204,4.694,16.150,16591,6251,10340,4.710,12.501,4842,3.648,25.003,733,739,4137
1993,4234,27085,35467,599826,596723,4483,12.744,3906,11.103,99021,30754,68267,5.154,16.594,92815,34764,58051,5.826,15.554,6206,1.040,31.108,2335,2405,15615
1993,4235,6835,9201,127896,127910,729,7.893,798,8.641,16544,4161,12383,3.253,12.934,16479,5642,10837,4.411,12.883,65,0.051,25.767,491,501,2807
1993,4236,18198,27226,343302,338562,3276,12.220,2443,9.112,64106,20748,43358,6.128,18.935,54348,18214,36134,5.380,16.053,9758,2.882,32.105,1478,1548,8557
1993,4237,11362,16130,178195,176212,1181,7.337,1114,6.921,24419,6571,17848,3.729,13.858,20347,5477,14870,3.108,11.547,4072,2.311,23.094,727,746,3453
1993,4238,47582,61664,643280,639977,5178,8.393,5244,8.500,90767,27220,63547,4.253,14.183,84440,29829,54611,4.661,13.194,6327,0.989,26.388,3358,3461,15678
1993,4239,25763,27843,281183,276968,3774,13.700,3183,11.555,51790,16186,35604,5.844,18.699,43360,16156,27204,5.833,15.655,8430,3.044,31.310,2467,2484,10856
1993,4241,9842,12774,195455,196195,1063,8.314,1085,8.487,22610,5627,16983,2.868,11.524,23916,7821,16095,3.986,12.190,-1306,-0.666,23.049,682,712,4092
1993,4242,3627,4800,147279,141149,704,14.971,509,10.824,30659,13311,17348,9.430,21.721,18539,5113,13426,3.622,13.134,12120,8.587,26.269,337,339,2421
1993,4243,12928,13995,165835,164621,2247,16.280,1861,13.484,33272,12728,20544,7.732,20.211,30651,11225,19426,6.819,18.619,2621,1.592,37.238,1483,1497,8417
1993,4244,27750,33864,705094,700751,3571,10.550,3541,10.461,101071,29804,71267,4.253,14.423,92224,31055,61169,4.432,13.161,8847,1.263,26.321,2670,2720,17320
1993,4245,6235,9049,79767,80396,510,5.579,696,7.613,11365,2921,8444,3.633,14.136,12667,3902,8765,4.854,15.756,-1302,-1.619,28.273,444,456,2635
1993,4246,8679,12514,142472,141120,1302,10.447,1200,9.629,24068,8158,15910,5.781,17.055,21241,9211,12030,6.527,15.052,2827,2.003,30.103,576,585,3008
1993,4247,8527,11639,128565,129772,747,6.384,872,7.452,19786,5966,13820,4.597,15.247,22114,6388,15726,4.922,17.041,-2328,-1.794,30.494,531,540,3849
1993,4248,3412,4398,135772,134567,235,5.328,260,5.895,12423,2594,9829,1.928,9.232,10126,3064,7062,2.277,7.525,2297,1.707,15.050,180,182,1583
1993,4249,22333,26965,321166,319645,3276,12.193,3082,11.471,53249,16813,36436,5.260,16.659,49996,18571,31425,5.810,15.641,3253,1.018,31.282,2106,2145,10674
1993,4251,32789,35161,293971,292151,3789,10.887,3074,8.832,50398,15447,34951,5.287,17.251,46676,16382,30294,5.607,15.977,3722,1.274,31.953,2046,2059,10125
1993,4411,37909,40217,941539,924091,4340,10.893,3591,9.013,124957,39980,84977,4.326,13.522,90025,35285,54740,3.818,9.742,34932,3.780,19.484,2899,2917,29348
1993,4412,10374,11042,76949,76249,1022,9.278,968,8.788,13822,4298,9524,5.637,18.128,12372,4761,7611,6.244,16.226,1450,1.902,32.452,739,750,3519
1993,4413,39077,61713,461843,462324,3983,6.418,4680,7.541,65734,20733,45001,4.485,14.218,67056,22508,44548,4.868,14.504,-1322,-0.286,28.436,2839,3088,13363
1993,4421,21283,27717,236670,232599,2684,9.648,2887,10.378,43441,14194,29247,6.102,18.676,35304,14455,20849,6.215,15.178,8137,3.498,30.356,1858,2000,9073
1993,4422,23462,30986,200430,194878,3204,10.376,2991,9.686,42836,15500,27336,7.954,21.981,31924,10459,21465,5.367,16.382,10912,5.599,32.763,2018,2105,7031
1993,4431,26082,37234,281699,274485,5179,14.075,4301,11.689,63304,29423,33881,10.719,23.063,48981,20005,28976,7.288,17.845,14323,5.218,35.689,2800,2929,12726
1993,4441,51657,68482,774367,763624,4830,7.035,5186,7.553,118250,44678,73572,5.851,15.485,97743,30545,67198,4.000,12.800,20507,2.685,25.600,3626,3763,17181
1993,4442,16071,19618,149746,149704,1569,8.025,1435,7.340,23485,6680,16805,4.462,15.688,23414,6447,16967,4.306,15.640,71,0.047,31.280,999,1011,3778
1993,4451,61353,91297,2463400,2442791,9825,10.797,9225,10.138,309323,145647,163676,5.962,12.663,269158,91867,177291,3.761,11.018,40165,1.644,22.037,5986,6154,39252
1993,4452,17501,21672,131070,130973,3196,14.871,2836,13.196,29471,13646,15825,10.419,22.502,29399,12499,16900,9.543,22.447,72,0.055,44.893,2022,2086,8698
1993,4453,24286,28531,138612,138329,2573,8.975,2849,9.938,26195,12088,14107,8.739,18.937,25560,8677,16883,6.273,18.478,635,0.459,36.956,2038,2064,6063
1993,4461,45104,75946,749858,748055,6480,8.530,6518,8.580,105434,45213,60221,6.044,14.094,103308,40332,62976,5.392,13.810,2126,0.284,27.620,3777,4021,19851
1993,4471,74334,124995,881539,889964,10168,8.028,13492,10.652,158758,58076,100682,6.526,17.839,176298,81237,95061,9.128,19.810,-17540,-1.971,35.677,7240,7625,38417
1993,4481,46660,98963,1007401,994499,10506,10.476,13154,13.116,209751,78200,131551,7.863,21.091,184270,74449,109821,7.486,18.529,25481,2.562,37.058,6481,7150,28426
1993,4482,8486,33590,181521,182635,2770,8.141,3643,10.706,35647,13741,21906,7.524,19.518,36847,15253,21594,8.352,20.175,-1200,-0.657,39.036,1028,1163,4262
1993,4483,19084,27843,160653,161543,2691,9.602,3053,10.894,29389,10683,18706,6.613,18.193,31556,12573,18983,7.783,19.534,-2167,-1.341,36.385,1589,1705,5541
1993,4511,31795,42945,336593,332227,5236,12.192,5239,12.199,68052,29219,38833,8.795,20.484,59026,25325,33701,7.623,17.767,9026,2.717,35.534,3440,3611,12629
1993,4512,8974,14777,110758,108494,1709,11.696,1378,9.431,25306,10521,14785,9.697,23.325,20709,6307,14402,5.813,19.088,4597,4.237,38.175,844,876,3840
1993,4521,159,10078,1635696,1594776,590,5.943,288,2.901,190632,84077,106555,5.272,11.954,110717,25802,84915,1.618,6.942,79915,5.011,13.885,4,6,566
1993,4529,10639,24762,552094,531741,2461,9.968,2313,9.369,100347,46817,53530,8.804,18.871,61276,20162,41114,3.792,11.524,39071,7.348,23.047,1239,1332,6703
1993,4531,23314,24637,120114,121474,2620,10.587,2843,11.488,20968,7832,13136,6.447,17.261,23735,8301,15434,6.834,19.539,-2767,-2.278,34.523,2267,2296,6552
1993,4532,30613,39375,266819,260795,5348,13.662,4886,12.482,62546,30620,31926,11.741,23.983,50662,19765,30897,7.579,19.426,11884,4.557,38.852,3466,3590,13010
1993,4533,11816,14903,85656,81896,2231,15.242,1699,11.608,18884,6927,11957,8.458,23.059,11362,4829,6533,5.897,13.874,7522,9.185,27.748,1351,1359,3580
1993,4539,25335,29296,154274,150100,4759,16.447,4037,13.952,40122,18509,21613,12.331,26.730,31615,13814,17801,9.203,21.063,8507,5.668,42.125,2934,3080,10539
1993,4541,6229,6904,132601,130799,925,13.358,966,13.950,24191,5740,18451,4.388,18.495,20682,7394,13288,5.653,15.812,3509,2.683,31.624,642,651,3840
1993,4542,4392,5404,69253,69341,804,14.978,732,13.636,12717,6502,6215,9.377,18.340,12610,6064,6546,8.745,18.185,107,0.154,36.371,420,423,2219
1993,4543,16957,23490,212425,211431,2337,10.029,1964,8.428,36032,11629,24403,5.500,17.042,33740,9920,23820,4.692,15.958,2292,1.084,31.916,1311,1329,6196
1993,4811,559,2825,438191,435307,299,11.161,7,0.261,37794,6426,31368,1.476,8.682,31827,568,31259,0.130,7.311,5967,1.371,14.623,(D),(D),(D)
1993,4812,1209,1389,20854,20052,174,12.509,178,12.797,4910,1099,3811,5.481,24.486,3109,1180,1929,5.885,15.505,1801,8.982,31.009,121,124,632
1993,4831,410,723,37413,38330,95,13.428,64,9.046,6120,1717,4403,4.480,15.967,7675,1625,6050,4.240,20.024,-1555,-4.057,31.934,35,35,612
1993,4832,284,311,11071,11552,48,15.534,44,14.239,1268,427,841,3.696,10.976,2241,982,1259,8.501,19.399,-973,-8.423,21.953,28,28,435
1993,4841,23816,30439,628638,620925,5055,16.922,3922,13.129,100778,30930,69848,4.981,16.230,85839,31340,54499,5.047,13.824,14939,2.406,27.649,2926,2968,19422
1993,4842,47290,51508,521821,517866,7949,15.540,7237,14.148,107581,34943,72638,6.747,20.774,99893,40649,59244,7.849,19.289,7688,1.485,38.579,5521,5576,28979
1993,4851,395,483,25936,25208,65,13.528,60,12.487,4831,2579,2252,10.231,19.165,3357,957,2400,3.796,13.317,1474,5.847,26.634,49,49,485
1993,4852,299,570,19654,19599,43,7.537,44,7.713,2834,404,2430,2.061,14.460,2697,829,1868,4.230,13.761,137,0.699,27.522,30,31,357
1993,4853,5320,5407,49206,48616,930,17.450,775,14.542,11271,4594,6677,9.450,23.184,10034,4647,5387,9.559,20.640,1237,2.544,41.279,652,653,3653
1993,4854,3231,4126,131930,130835,351,8.552,308,7.504,19067,7430,11637,5.679,14.573,17031,6716,10315,5.133,13.017,2036,1.556,26.034,204,219,3224
1993,4855,1106,1220,25319,24936,124,10.210,113,9.304,4178,904,3274,3.625,16.755,3324,936,2388,3.754,13.330,854,3.425,26.660,87,87,782
1993,4859,1315,1402,26304,25197,282,21.519,99,7.554,5889,2270,3619,9.009,23.372,3715,1399,2316,5.552,14.744,2174,8.628,29.488,71,71,802
1993,4861,48,368,8603,8969,35,9.272,54,14.305,1133,218,915,2.431,12.632,1922,412,1510,4.594,21.429,-789,-8.797,25.265,0,0,0
1993,4862,151,1314,40083,41197,88,6.705,85,6.476,3206,1569,1637,3.809,7.782,5494,957,4537,2.323,13.336,-2288,-5.554,15.564,17,19,149
1993,4869,59,366,5791,6063,44,11.828,56,15.054,959,596,363,9.831,15.819,1422,763,659,12.586,23.456,-463,-7.637,31.637,5,8,137
1993,4871,342,379,7223,6992,68,18.579,42,11.475,1553,516,1037,7.380,22.213,1059,239,820,3.418,15.147,494,7.066,30.294,31,31,206
1993,4872,1134,1163,12043,11771,179,15.633,143,12.489,3083,863,2220,7.332,26.191,2593,814,1779,6.915,22.029,490,4.163,44.057,105,105,579
1993,4879,121,129,992,1051,11,8.118,24,17.712,152,26,126,2.475,14.469,268,87,181,8.282,25.512,-116,-11.042,28.939,19,19,63
1993,4881,2402,3034,84272,81067,465,15.633,346,11.632,16686,5377,11309,6.633,20.583,10626,3069,7557,3.786,13.108,6060,7.475,26.215,217,219,1064
1993,4882,434,673,15595,15107,97,14.843,58,8.875,3697,1417,2280,9.380,24.473,2698,1614,1084,10.684,17.860,999,6.613,35.720,26,27,560
1993,4883,1975,2542,81793,83601,268,10.595,243,9.607,14723,3250,11473,3.888,17.611,17926,3900,14026,4.665,21.442,-3203,-3.831,35.222,167,168,1461
1993,4884,4230,4412,28926,28183,675,15.505,558,12.817,6731,2699,4032,9.577,23.884,5288,2285,3003,8.108,18.763,1443,5.120,37.527,425,435,1689
1993,4885,8906,11700,109273,108058,1658,14.445,1214,10.577,20560,7344,13216,6.796,19.027,18107,6287,11820,5.818,16.757,2453,2.270,33.514,799,832,3869
1993,4889,811,864,9179,9019,131,15.394,105,12.338,2341,958,1383,10.623,25.958,2013,452,1561,5.012,22.321,328,3.637,44.642,82,83,365
1993,4921,1475,4252,382294,373088,494,11.768,386,9.195,39768,4250,35518,1.139,10.659,19811,5356,14455,1.436,5.310,19957,5.349,10.620,146,147,3068
1993,4922,3713,4060,58826,56326,703,17.845,462,11.727,14436,4297,10139,7.629,25.630,9527,4266,5261,7.574,16.914,4909,8.715,33.828,390,391,3141
1993,4931,6400,10435,421261,431450,870,8.285,1001,9.533,64435,16074,48361,3.726,14.935,85476,24044,61432,5.573,19.811,-21041,-4.877,29.869,324,332,3301
1993,5111,14985,17776,678395,677533,1958,11.089,1721,9.747,71492,29001,42491,4.280,10.552,70077,27520,42557,4.062,10.343,1415,0.209,20.686,1318,1324,11456
1993,5112,5584,6717,138898,132184,1155,17.814,688,10.612,30487,9067,21420,6.859,23.064,17205,6286,10919,4.755,13.016,13282,10.048,26.032,428,430,3555
1993,5121,9991,14553,246539,245044,2044,14.056,2022,13.905,53684,14181,39503,5.787,21.908,51402,21442,29960,8.750,20.977,2282,0.931,41.953,1108,1138,10920
1993,5122,1542,1577,11944,11692,318,20.757,228,14.883,3073,1291,1782,11.042,26.284,2541,1298,1243,11.102,21.734,532,4.550,43.467,160,160,780
1993,5151,6072,7990,226085,225329,827,10.427,709,8.940,31441,13008,18433,5.773,13.953,29963,12408,17555,5.507,13.297,1478,0.656,26.595,476,501,5408
1993,5152,205,343,15371,15787,56,16.817,36,10.811,2879,909,1970,5.758,18.237,3721,2712,1009,17.179,23.571,-842,-5.334,36.474,15,15,167
1993,5171,4147,24501,952302,963521,2553,10.351,2880,11.677,136010,48614,87396,5.045,14.116,157125,50312,106813,5.222,16.307,-21115,-2.191,28.232,367,382,3277
1993,5172,1466,3186,71075,65869,697,23.245,322,10.739,21247,8741,12506,13.270,32.257,11124,4927,6197,7.480,16.888,10123,15.368,33.776,159,171,2098
1993,5174,232,290,6915,6834,52,18.807,25,9.042,1180,355,825,5.195,17.267,1003,270,733,3.951,14.677,177,2.590,29.353,14,14,69
1993,5179,1289,1996,28510,29970,477,24.275,415,21.120,6624,2720,3904,9.076,22.102,9510,3190,6320,10.644,31.732,-2886,-9.630,44.205,135,135,848
1993,5182,5059,7200,277024,272916,858,11.791,1011,13.894,53232,15221,38011,5.577,19.505,44907,15346,29561,5.623,16.455,8325,3.050,32.909,513,519,5415
1993,5191,2540,2943,38147,36328,315,10.819,252,8.655,7985,5216,2769,14.358,21.980,4082,1606,2476,4.421,11.237,3903,10.744,22.473,137,206,1229
1993,5211,17,47,23943,24020,4,8.696,(D),(D),442,22,420,0.092,1.840,613,(D),545,(D),2.552,-171,-0.712,3.680,(D),(D),(D)
1993,5221,22229,96482,1917576,1972351,5005,5.067,9598,9.717,285714,83145,202569,4.216,14.486,400302,187372,212930,9.500,20.296,-114588,-5.810,28.972,768,1160,14604
1993,5222,13448,34583,452976,439534,5082,14.932,3983,11.703,113595,37535,76060,8.540,25.844,86359,40481,45878,9.210,19.648,27236,6.197,39.296,1106,1247,9082
1993,5223,8031,10470,91423,85142,2015,19.917,1309,12.939,27966,10598,17368,12.448,32.846,15054,6451,8603,7.577,17.681,12912,15.165,35.362,860,906,3850
1993,5231,6913,19244,326036,321082,3208,16.833,2836,14.881,63058,23792,39266,7.410,19.639,54401,22827,31574,7.109,16.943,8657,2.696,33.886,639,661,4060
1993,5232,37,51,6437,6458,7,14.583,(D),(D),267,41,226,0.635,4.135,313,(D),312,(D),4.847,-46,-0.712,8.269,(D),(D),(D)
1993,5239,19252,20837,201569,202006,3622,17.546,3233,15.662,49386,18894,30492,9.353,24.448,50269,21648,28621,10.717,24.885,-883,-0.437,48.896,2343,2353,10335
1993,5241,3943,36261,1515490,1527619,3198,8.703,4171,11.350,203727,55909,147818,3.660,13.336,228910,80606,148304,5.277,14.985,-25183,-1.649,26.672,170,227,3532
1993,5242,110678,121078,950341,963893,13233,10.986,11977,9.944,195638,67925,127713,7.047,20.297,222298,107045,115253,11.105,23.063,-26660,-2.766,40.593,8612,8730,81468
1993,5250,2431,2612,53079,51553,295,11.447,225,8.731,13922,5762,8160,11.177,27.005,10791,2622,8169,5.086,20.932,3131,6.073,41.864,136,137,969
1993,5311,88567,95981,496885,493141,11245,11.779,10220,10.705,100700,43413,57287,8.803,20.420,92720,40350,52370,8.182,18.802,7980,1.618,37.604,7787,7874,28853
1993,5312,42390,48021,226582,225907,7720,16.253,6673,14.049,53912,23786,30126,10.529,23.865,53059,21770,31289,9.637,23.487,853,0.378,46.974,4615,4723,13583
1993,5313,30416,33670,370759,365444,4947,15.146,2932,8.977,79749,30098,49651,8.236,21.822,69127,20008,49119,5.475,18.916,10622,2.907,37.832,2012,2045,11724
1993,5321,4778,9447,134840,131484,867,9.090,1049,10.998,26984,5262,21722,4.002,20.523,20196,7883,12313,5.995,15.360,6788,5.163,30.720,567,613,3804
1993,5322,21351,30118,213807,208613,4100,13.629,4030,13.396,54539,21007,33532,10.070,26.144,44569,20245,24324,9.705,21.364,9970,4.779,42.729,2812,2909,12821
1993,5323,3768,5933,38247,37951,578,9.824,479,8.141,7353,2529,4824,6.664,19.375,6721,2977,3744,7.844,17.710,632,1.665,35.420,281,288,1797
1993,5324,7305,9824,105323,106723,1127,11.445,1173,11.912,21968,5972,15996,5.596,20.584,24730,9931,14799,9.305,23.172,-2762,-2.588,41.168,721,732,3814
1993,5331,1421,1565,18917,19960,285,18.781,190,12.521,4613,1486,3127,7.445,23.111,6647,3862,2785,19.349,33.302,-2034,-10.190,46.222,132,132,1352
1993,5411,143647,150096,1001301,993154,15355,10.378,11070,7.482,135335,45645,89690,4.596,13.627,119025,31867,87158,3.209,11.985,16310,1.642,23.969,8200,8266,23310
1993,5412,77396,81686,761808,770689,9755,12.105,7559,9.380,128248,43092,85156,5.591,16.641,150298,33191,117107,4.307,19.502,-22050,-2.861,33.281,5458,5511,22239
1993,5413,65936,74210,946066,943690,9794,13.414,7404,10.140,157335,45893,111442,4.863,16.672,152902,39559,113343,4.192,16.203,4433,0.470,32.405,5003,5059,20928
1993,5414,17771,17975,95577,93806,3397,19.279,2688,15.255,24979,11154,13825,11.890,26.628,21584,9414,12170,10.036,23.009,3395,3.619,46.018,2083,2087,7440
1993,5415,29689,33881,472748,458184,7825,24.172,4807,14.849,114897,44729,70168,9.762,25.077,86102,29042,57060,6.339,18.792,28795,6.285,37.584,3137,3171,13551
1993,5416,43114,45776,386910,369290,9187,20.539,7096,15.864,111623,43760,67863,11.850,30.226,75999,31841,44158,8.622,20.580,35624,9.647,41.160,5332,5357,22010
1993,5417,7061,8954,450161,454789,1228,13.924,959,10.874,57498,15358,42140,3.377,12.643,68043,19009,49034,4.180,14.961,-10545,-2.319,25.286,512,520,3156
1993,5418,28336,30958,369328,361767,4775,15.351,5068,16.293,88083,36078,52005,9.973,24.348,71698,25100,46598,6.938,19.819,16385,4.529,39.638,2890,4252,19565
1993,5419,35771,40714,342482,331312,4248,10.691,2289,5.761,67042,18989,48053,5.731,20.235,44783,9817,34966,2.963,13.517,22259,6.718,27.034,1490,1668,5823
1993,5511,28213,51178,3137460,3166005,4540,8.700,6554,12.559,531591,137584,394007,4.346,16.791,590489,164135,426354,5.184,18.651,-58898,-1.860,33.581,860,905,12059
1993,5611,14444,15699,301237,292019,3315,21.962,2105,13.946,76798,36213,40585,12.401,26.299,58180,24754,33426,8.477,19.923,18618,6.376,39.847,1455,1494,14554
1993,5612,551,954,73983,71005,178,19.550,91,9.995,13944,6354,7590,8.949,19.638,7908,2944,4964,4.146,11.137,6036,8.501,22.275,33,33,615
1993,5613,19541,27762,1869521,1762488,4572,16.606,4114,14.942,637088,186853,450235,10.602,36.147,419956,157019,262937,8.909,23.827,217132,12.320,47.655,2461,2588,89211
1993,5614,24339,27782,385977,371498,4342,15.824,3655,13.321,97114,37193,59921,10.012,26.141,67313,25559,41754,6.880,18.119,29801,8.022,36.239,2783,2830,16254
1993,5615,24637,31288,245192,240899,3894,12.512,3562,11.445,49478,18342,31136,7.614,20.539,41258,16702,24556,6.933,17.127,8220,3.412,34.253,2258,2460,10249
1993,5616,13713,17332,552564,542949,2483,14.463,2154,12.547,110580,34127,76453,6.285,20.367,91227,35602,55625,6.557,16.802,19353,3.564,33.604,1429,1454,16788
1993,5617,94474,98795,1166197,1133184,17336,18.307,9141,9.653,277644,83078,194566,7.331,24.501,212298,57851,154447,5.105,18.735,65346,5.767,37.469,7203,7230,38553
1993,5619,16631,18210,277296,265294,3526,19.846,2640,14.859,73616,22191,51425,8.365,27.749,50370,18293,32077,6.895,18.986,23246,8.762,37.973,2146,2156,13245
1993,5621,4534,4988,77446,74096,639,13.498,131,2.767,12935,3815,9120,5.149,17.457,6246,1325,4921,1.788,8.430,6689,9.028,16.859,79,79,799
1993,5622,1629,2457,82464,79847,312,12.919,228,9.441,15444,5358,10086,6.710,19.342,10342,3888,6454,4.869,12.952,5102,6.390,25.905,135,137,1326
1993,5629,5023,5382,68578,66765,765,14.409,619,11.659,17720,5073,12647,7.598,26.541,14090,4913,9177,7.359,21.104,3630,5.437,42.208,458,460,2389
1993,6111,14215,16123,547986,532664,705,4.470,0,0.000,59876,11196,48680,2.102,11.241,29148,0,29148,0.000,5.472,30728,5.769,10.944,0,0,0
1993,6112,608,894,72322,70802,50,5.754,0,0.000,8384,2155,6229,3.044,11.841,5197,0,5197,0.000,7.340,3187,4.501,14.680,0,0,0
1993,6113,2073,2486,1131608,1111029,111,4.565,(D),(D),90750,14838,75912,1.336,8.168,49235,(D),49219,(D),4.431,41515,3.737,8.863,0,0,0
1993,6114,3526,3948,48370,48063,756,19.749,516,13.480,10586,3281,7305,6.826,22.025,9993,4168,5825,8.672,20.791,593,1.234,41.583,337,363,2970
1993,6115,4706,5553,62256,62545,627,11.392,529,9.611,11048,3174,7874,5.075,17.664,11710,4712,6998,7.534,18.723,-662,-1.058,35.328,352,352,2392
1993,6116,15498,16532,128133,122161,3007,18.797,1938,12.114,34098,14522,19576,11.888,27.912,22138,9029,13109,7.391,18.122,11960,9.790,36.244,1431,1455,6750
1993,6117,2486,2569,20202,19619,517,20.864,335,13.519,4435,1647,2788,8.395,22.606,3394,1864,1530,9.501,17.300,1041,5.306,34.600,246,246,1587
1993,6211,180950,193785,1556820,1530949,13273,6.847,13394,6.910,252941,78928,174013,5.155,16.522,201999,63889,138110,4.173,13.194,50942,3.327,26.389,10718,10971,47187
1993,6212,102180,105140,575375,568374,4875,4.657,3952,3.775,77179,18530,58649,3.260,13.579,63110,13670,49440,2.405,11.104,14069,2.475,22.207,3123,3167,10824
1993,6213,67533,71380,310639,300881,8191,11.701,5436,7.765,67121,26778,40343,8.900,22.308,47861,16537,31324,5.496,15.907,19260,6.401,31.814,4033,4130,12551
1993,6214,8674,14354,288737,277180,1689,11.967,1209,8.566,59025,19407,39618,7.002,21.295,35862,12753,23109,4.601,12.938,23163,8.357,25.876,599,632,6465
1993,6215,5500,7876,138347,134430,1125,14.346,1057,13.479,30811,11518,19293,8.568,22.920,22857,10400,12457,7.736,17.003,7954,5.917,34.006,699,713,4675
1993,6216,6124,10665,591258,555978,2310,23.046,1027,10.246,159346,57170,102176,10.283,28.661,89550,37314,52236,6.711,16.107,69796,12.554,32.214,502,518,11732
1993,6219,5726,7407,158227,150798,860,11.641,821,11.113,38706,15477,23229,10.263,25.667,23795,9415,14380,6.243,15.779,14911,9.888,31.559,546,567,5792
1993,6221,3096,4656,4192333,4185144,137,2.919,212,4.517,256634,46600,210034,1.113,6.132,246698,105937,140761,2.531,5.895,9936,0.237,11.789,55,55,18149
1993,6222,587,985,307808,314304,81,8.228,80,8.126,21277,6690,14587,2.129,6.770,34159,18701,15458,5.950,10.868,-12882,-4.099,13.539,24,24,6127
1993,6223,233,353,134198,132777,22,6.304,14,4.011,9658,1051,8607,0.792,7.274,7013,2098,4915,1.580,5.282,2645,1.992,10.564,5,6,441
1993,6231,7448,13105,1298525,1271139,794,6.110,573,4.410,144614,53306,91308,4.194,11.377,89977,34869,55108,2.743,7.078,54637,4.298,14.157,256,272,12602
1993,6232,6938,14484,302949,292129,1635,11.747,503,3.614,58704,20761,37943,7.107,20.095,36973,8875,28098,3.038,12.656,21731,7.439,25.313,237,238,4296
1993,6233,11275,13576,400692,401291,1657,12.249,1560,11.532,57099,19254,37845,4.798,14.229,58140,32520,25620,8.104,14.488,-1041,-0.259,28.458,899,914,17304
1993,6239,4002,5549,140946,137022,514,9.371,386,7.037,22681,6732,15949,4.913,16.553,15147,4286,10861,3.128,11.054,7534,5.498,22.109,203,205,1951
1993,6241,22125,30102,453122,436586,3490,11.922,1831,6.255,85083,25676,59407,5.881,19.488,52123,11580,40543,2.652,11.939,32960,7.549,23.878,1004,1022,6093
1993,6242,6054,7220,74149,73578,827,11.797,408,5.820,13706,4881,8825,6.634,18.628,12415,2596,9819,3.528,16.873,1291,1.755,33.747,219,224,1052
1993,6243,5351,8282,298415,298033,736,8.934,649,7.878,47357,6839,40518,2.295,15.890,46849,6552,40297,2.198,15.719,508,0.170,31.439,247,264,2173
1993,6244,40186,49022,499903,481991,6272,13.043,4403,9.156,98971,35823,63148,7.432,20.534,63241,25188,38053,5.226,13.121,35730,7.413,26.242,3236,3301,18037
1993,7111,6446,6513,94266,92276,1122,17.424,975,15.141,23484,6794,16690,7.363,25.450,19648,5291,14357,5.734,21.293,3836,4.157,42.585,696,696,3313
1993,7112,2734,2867,79358,80134,485,17.053,439,15.436,15764,4900,10864,6.115,19.672,16959,4100,12859,5.116,21.163,-1195,-1.491,39.344,349,350,2982
1993,7113,2610,2721,51919,48345,422,15.650,373,13.833,15223,4895,10328,10.125,31.489,8166,2388,5778,4.940,16.891,7057,14.597,33.783,286,287,1701
1993,7114,1556,1594,12764,12591,291,18.823,195,12.613,3557,1628,1929,12.930,28.250,3221,1176,2045,9.340,25.582,336,2.669,51.164,142,142,773
1993,7115,6678,6712,34639,36562,1294,19.266,1303,19.400,12215,4535,7680,12.404,33.409,16088,8952,7136,24.484,44.002,-3873,-10.593,66.818,850,851,6701
1993,7121,3196,3496,71960,69350,349,10.245,170,4.990,11128,1839,9289,2.652,16.046,5802,835,4967,1.204,8.366,5326,7.680,16.733,105,105,407
1993,7131,1605,2512,93980,93633,276,11.042,251,10.042,10362,3017,7345,3.222,11.067,9472,1270,8202,1.356,10.116,890,0.951,20.232,170,171,806
1993,7132,1119,1278,51708,44696,289,24.492,93,7.881,18158,11548,6610,25.837,40.626,4125,694,3431,1.553,9.229,14033,31.397,18.458,61,61,431
1993,7139,40417,43579,710096,696270,5454,12.701,4176,9.725,130651,48147,82504,6.915,18.764,102949,33593,69356,4.825,14.786,27702,3.979,29.572,3142,3199,23932
1993,7211,30115,36711,1416167,1414967,3919,10.730,3542,9.698,200025,86646,113379,6.124,14.136,196467,87479,108988,6.182,13.885,3558,0.251,27.770,2263,2334,44012
1993,7212,4444,4764,31207,30545,524,11.148,397,8.446,6965,2043,4922,6.689,22.803,5606,1493,4113,4.888,18.354,1359,4.449,36.707,260,260,850
1993,7213,3168,3258,15559,15722,234,7.129,283,8.621,2450,639,1811,4.064,15.584,2802,874,1928,5.559,17.823,-352,-2.239,31.168,196,199,604
1993,7223,16721,31089,554918,557502,5723,17.893,7513,23.490,141808,73138,68670,13.119,25.436,146716,80784,65932,14.490,26.317,-4908,-0.880,50.873,3087,3149,27752
1993,7224,49765,50301,317745,312417,7425,14.892,6543,13.123,85075,46357,38718,14.838,27.231,74811,32872,41939,10.522,23.946,10264,3.285,47.892,5376,5391,27459
1993,7225,235614,319319,5909078,5853956,43581,13.820,35631,11.299,1137964,562534,575430,9.609,19.439,1026152,391182,634970,6.682,17.529,111812,1.910,35.058,25327,26303,243575
1993,8111,124778,134991,685756,675589,16837,12.590,14322,10.709,138838,57564,81274,8.521,20.551,118289,47227,71062,6.990,17.509,20549,3.042,35.018,10668,10799,36121
1993,8112,12965,15743,134587,136545,1972,12.570,1863,11.875,21951,7691,14260,5.633,16.076,25925,10381,15544,7.603,18.986,-3974,-2.910,32.152,1181,1191,4613
1993,8113,21219,22458,165809,165115,2387,10.636,2358,10.506,29855,9241,20614,5.597,18.081,28626,9160,19466,5.548,17.337,1229,0.744,34.674,1738,1746,6426
1993,8114,26976,28790,172895,174322,3827,13.257,3982,13.794,30177,12149,18028,6.969,17.311,32935,11044,21891,6.335,18.893,-2758,-1.582,34.622,3061,3088,8324
1993,8121,76147,87664,460950,461226,11006,12.554,11020,12.570,97972,43604,54368,9.454,21.242,99464,40907,58557,8.869,21.565,-1492,-0.323,42.483,8286,8454,27180
1993,8122,16529,20129,128329,128771,1136,5.619,1311,6.485,19899,4702,15197,3.651,15.453,20843,7464,13379,5.796,16.186,-944,-0.733,30.906,712,786,3427
1993,8123,34549,41459,383666,377878,4479,10.843,4180,10.119,63712,20775,42937,5.498,16.860,52372,19710,32662,5.216,13.860,11340,3.001,27.719,3078,3184,13763
1993,8129,13693,22915,162960,159645,3432,15.334,2365,10.567,36501,14750,21751,9.239,22.864,29589,13576,16013,8.504,18.534,6912,4.330,37.069,1023,1147,5915
1993,8131,140201,140308,1240756,1211291,7414,5.426,55,0.040,148640,20276,128364,1.674,12.271,89849,116,89733,0.010,7.418,58791,4.854,14.835,6,6,9
1993,8132,10369,12124,149603,146304,961,8.006,719,5.990,25585,4377,21208,2.992,17.488,19202,3445,15757,2.355,13.125,6383,4.363,26.249,422,423,1706
1993,8133,9681,11337,122932,121546,961,8.542,788,7.004,19931,3740,16191,3.077,16.398,17097,4261,12836,3.506,14.066,2834,2.332,28.133,459,469,2262
1993,8134,31386,33133,317314,314475,1698,5.111,1876,5.647,42817,7776,35041,2.473,13.615,37145,7186,29959,2.285,11.812,5672,1.804,23.624,1319,1321,4845
1993,8139,62869,65028,510090,508076,4070,6.345,2312,3.604,70256,16326,53930,3.213,13.828,66544,9257,57287,1.822,13.097,3712,0.731,26.195,1583,1605,6197
1994,2111,6736,8022,100655,100801,800,9.911,899,11.138,18134,7481,10653,7.422,17.990,18675,6977,11698,6.922,18.527,-541,-0.537,35.980,605,613,2502
1994,2121,1356,1872,102203,104282,274,14.263,372,19.365,17021,8114,8907,7.781,16.322,21066,9668,11398,9.271,20.201,-4045,-3.879,32.644,240,243,4029
1994,2122,357,515,42893,44063,66,12.632,81,15.502,3205,725,2480,1.645,7.274,5569,1202,4367,2.728,12.639,-2364,-5.365,14.547,43,43,151
1994,2123,3325,4974,96388,96314,326,6.523,373,7.464,12140,2930,9210,3.042,12.605,12091,3725,8366,3.868,12.554,49,0.051,25.108,231,234,1686
1994,2131,7414,8425,151285,146214,1069,12.618,1163,13.728,38754,11317,27437,7.740,26.505,28384,10270,18114,7.024,19.413,10370,7.092,38.825,800,804,5625
1994,2211,1526,7046,601936,611296,310,4.432,206,2.945,30685,10456,20229,1.710,5.020,49396,5830,43566,0.954,8.081,-18711,-3.061,10.039,51,53,448
1994,2212,587,2739,106884,107593,168,6.117,183,6.663,8628,3810,4818,3.541,8.019,9915,1739,8176,1.616,9.215,-1287,-1.196,16.038,47,60,472
1994,2213,3948,4341,31969,31621,343,8.002,234,5.459,3564,1307,2257,4.133,11.271,2911,872,2039,2.758,9.206,653,2.065,18.412,172,172,546
1994,2361,117454,117943,601095,585506,24104,20.872,19185,16.613,190586,79338,111248,13.550,32.551,159351,64476,94875,11.012,27.216,31235,5.335,54.432,13710,13715,48768
1994,2362,35667,36293,596889,585910,4858,13.518,4148,11.542,139816,27329,112487,4.664,23.863,117936,26246,91690,4.480,20.129,21880,3.734,40.257,3062,3063,19589
1994,2371,14077,14384,310318,307592,1394,9.745,1235,8.634,63628,11253,52375,3.658,20.686,58897,10340,48557,3.362,19.148,4731,1.538,38.296,948,948,7295
1994,2372,7469,7671,57752,56173,1950,26.518,1315,17.883,17695,8677,9018,15.447,31.501,14610,6580,8030,11.714,26.009,3085,5.492,52.018,983,989,4574
1994,2373,9627,10044,223271,222678,1012,10.160,845,8.484,44727,7835,36892,3.519,20.086,43503,8545,34958,3.837,19.536,1224,0.550,39.073,610,612,5804
1994,2379,4820,4899,60643,61329,661,13.445,696,14.156,14864,3785,11079,6.172,24.237,16185,3528,12657,5.753,26.391,-1321,-2.154,48.473,542,542,2392
1994,2381,80040,80440,684836,673591,12389,15.635,9982,12.598,197962,56555,141407,8.396,29.389,175260,54476,120784,8.087,26.019,22702,3.370,52.038,7502,7507,43815
1994,2382,125122,127047,1247958,1209859,15677,12.525,11912,9.517,270758,61422,209336,5.077,22.379,194457,55141,139316,4.558,16.073,76301,6.307,32.145,8991,8994,41025
1994,2383,84531,84988,618927,600902,15559,18.629,12623,15.114,182162,57930,124232,9.641,30.315,146409,52049,94360,8.662,24.365,35753,5.950,48.730,9443,9448,42078
1994,2389,41881,42113,341820,337858,6307,15.246,4816,11.642,89245,24423,64822,7.229,26.415,81258,24702,56556,7.311,24.051,7987,2.364,48.102,3592,3592,17776
1994,3111,1360,1995,53475,53138,124,6.214,125,6.264,5830,1534,4296,2.887,10.972,5161,1947,3214,3.664,9.713,669,1.259,19.425,65,65,825
1994,3112,463,815,63370,64185,47,5.767,47,5.767,4290,2052,2238,3.197,6.684,6029,1100,4929,1.714,9.393,-1739,-2.709,13.368,28,28,379
1994,3113,1531,1739,84800,85274,169,9.727,166,9.554,7444,1587,5857,1.861,8.730,8327,1575,6752,1.847,9.765,-883,-1.035,17.459,121,124,707
1994,3114,1257,1699,177297,178770,113,6.639,119,6.992,17678,3218,14460,1.800,9.889,20605,5504,15101,3.079,11.526,-2927,-1.637,19.777,78,78,1494
1994,3115,1277,1847,134663,133720,123,6.647,130,7.025,12344,4216,8128,3.153,9.231,10682,2982,7700,2.230,7.988,1662,1.243,15.977,79,79,720
1994,3116,3520,4123,419158,414526,306,7.485,236,5.773,37496,7678,29818,1.852,9.046,28053,8851,19202,2.135,6.767,9443,2.278,13.535,165,166,3900
1994,3117,635,745,45212,45421,72,9.549,90,11.936,7501,2602,4899,5.729,16.515,7765,1950,5815,4.293,17.096,-264,-0.581,33.029,63,65,1310
1994,3118,9332,10399,311541,309487,1245,11.988,1217,11.719,37749,12966,24783,4.190,12.197,33613,12117,21496,3.915,10.861,4136,1.336,21.722,896,920,6682
1994,3119,2230,2603,135717,135565,249,9.606,227,8.758,17195,6089,11106,4.492,12.684,17219,6934,10285,5.115,12.702,-24,-0.018,25.368,159,159,2406
1994,3121,1694,2110,127033,128970,179,8.530,156,7.434,10953,2871,8082,2.226,8.493,14702,3732,10970,2.894,11.400,-3749,-2.907,16.985,106,106,1213
1994,3122,75,109,33290,34573,11,10.329,6,5.634,1611,135,1476,0.390,4.660,4200,272,3928,0.787,12.148,-2589,-7.489,9.319,3,3,8
1994,3131,371,612,92020,91727,46,7.591,34,5.611,8215,2717,5498,2.962,8.956,7663,3250,4413,3.543,8.354,552,0.602,16.708,15,15,856
1994,3132,1650,1994,239835,241036,169,8.535,141,7.121,17900,3367,14533,1.397,7.426,20335,5229,15106,2.169,8.436,-2435,-1.010,14.853,107,108,1747
1994,3133,2417,2636,113807,112655,485,19.458,198,7.944,14974,4836,10138,4.293,13.292,12671,4663,8008,4.139,11.248,2303,2.044,22.495,138,143,2805
1994,3141,2877,3155,126434,124248,309,9.658,398,12.439,15408,2902,12506,2.336,12.401,11002,4331,6671,3.486,8.855,4406,3.546,17.710,305,314,1969
1994,3149,4111,4228,115968,114479,577,13.894,427,10.282,21424,7774,13650,6.791,18.714,18341,6979,11362,6.096,16.021,3083,2.693,32.043,341,341,4284
1994,3151,1125,1264,118533,119428,152,12.102,136,10.828,14783,4536,10247,3.798,12.378,16325,4388,11937,3.674,13.669,-1542,-1.291,24.756,116,117,2592
1994,3152,10990,12052,627764,649118,2281,18.844,2386,19.712,95209,41343,53866,6.369,14.667,138180,61063,77117,9.407,21.287,-42971,-6.620,29.335,2027,2042,43248
1994,3159,1837,1942,62362,64527,271,14.107,229,11.921,7591,2926,4665,4.535,11.764,11972,4103,7869,6.359,18.554,-4381,-6.789,23.528,191,191,2820
1994,3161,320,353,16787,16822,33,9.483,23,6.609,1586,697,889,4.143,9.428,1656,672,984,3.995,9.844,-70,-0.416,18.856,15,15,111
1994,3162,332,416,59897,63436,33,7.701,58,13.536,5151,1042,4109,1.643,8.120,12096,7132,4964,11.243,19.068,-6945,-10.948,16.240,30,30,2217
1994,3169,997,1039,31806,32469,92,8.598,154,14.393,4588,541,4047,1.666,14.131,5926,2858,3068,8.802,18.252,-1338,-4.121,28.261,119,119,1121
1994,3211,4362,4873,136667,134327,433,8.909,408,8.394,17304,4674,12630,3.480,12.882,12650,3513,9137,2.615,9.417,4654,3.465,18.835,339,339,2288
1994,3212,1334,1638,103183,99948,123,7.581,92,5.670,12468,2381,10087,2.382,12.474,5942,1850,4092,1.851,5.945,6526,6.529,11.890,60,69,1267
1994,3219,9298,10003,286933,278554,1122,11.323,934,9.426,47413,13344,34069,4.790,17.021,30386,11324,19062,4.065,10.908,17027,6.113,21.817,732,733,7472
1994,3221,228,545,184010,185590,25,4.613,19,3.506,5857,2022,3835,1.090,3.156,9120,2382,6738,1.283,4.914,-3263,-1.758,6.312,8,8,213
1994,3222,3567,5209,401778,403511,291,5.599,268,5.156,32383,8522,23861,2.112,8.025,35736,14430,21306,3.576,8.856,-3353,-0.831,16.051,169,174,3331
1994,3231,41083,43056,821521,820529,3353,7.731,3978,9.173,98169,28123,70046,3.427,11.964,95507,34997,60510,4.265,11.640,2662,0.324,23.279,3276,3289,21258
1994,3241,1101,2027,139983,140630,115,5.640,139,6.817,7936,2261,5675,1.608,5.643,9404,2690,6714,1.913,6.687,-1468,-1.044,11.286,61,62,896
1994,3251,1167,2364,207379,212436,145,6.162,123,5.227,12645,6201,6444,2.919,5.952,22459,9396,13063,4.423,10.572,-9814,-4.620,11.905,46,47,886
1994,3252,373,654,135689,134245,51,7.870,39,6.019,19099,14942,4157,11.130,14.227,16264,9179,7085,6.837,12.115,2835,2.112,24.230,19,19,135
1994,3253,639,887,38453,39007,75,8.532,59,6.712,2686,893,1793,2.289,6.886,3783,784,2999,2.010,9.698,-1097,-2.812,13.772,41,41,347
1994,3254,1143,1434,194797,192202,130,9.226,80,5.678,20112,4094,16018,2.130,10.464,15087,4146,10941,2.157,7.850,5025,2.614,15.699,43,43,735
1994,3255,1560,2021,72704,72711,115,5.666,132,6.504,6030,857,5173,1.179,8.293,6099,1743,4356,2.397,8.388,-69,-0.095,16.586,90,92,550
1994,3256,2062,2290,123283,125013,194,8.498,180,7.884,11373,3233,8140,2.586,9.097,14824,5025,9799,4.020,11.858,-3451,-2.761,18.195,128,129,1519
1994,3259,2253,2957,130717,131151,189,6.406,176,5.965,10841,2877,7964,2.194,8.266,11710,2799,8911,2.134,8.929,-869,-0.663,16.532,129,131,1322
1994,3261,10408,12613,735908,720562,1023,8.183,799,6.391,99259,24285,74974,3.370,13.775,68458,25199,43259,3.497,9.501,30801,4.275,19.001,566,571,10020
1994,3262,2235,2750,193909,192153,192,6.995,182,6.630,16777,4217,12560,2.195,8.731,13157,3984,9173,2.073,6.847,3620,1.884,13.694,131,131,1587
1994,3271,1498,1769,77381,76781,193,10.953,179,10.159,8201,1790,6411,2.331,10.681,6946,2214,4732,2.884,9.047,1255,1.635,18.093,131,132,1241
1994,3272,1723,1984,133719,133710,189,9.545,181,9.141,10552,2414,8138,1.805,7.892,10457,4183,6274,3.128,7.821,95,0.071,15.641,134,134,1080
1994,3273,5883,8751,169535,166537,515,5.888,505,5.774,27414,6347,21067,3.811,16.461,21255,5565,15690,3.342,12.763,6159,3.698,25.526,278,289,2512
1994,3274,248,347,16970,17032,22,6.331,23,6.619,1035,105,930,0.616,6.077,1153,209,944,1.227,6.770,-118,-0.693,12.154,15,15,98
1994,3279,1967,2282,70479,69282,208,9.220,156,6.915,8589,3088,5501,4.457,12.397,6222,1913,4309,2.761,8.981,2367,3.416,17.962,113,114,1300
1994,3311,266,332,133533,132299,52,16.587,15,4.785,9070,5523,3547,4.175,6.856,6579,64,6515,0.048,4.973,2491,1.883,9.946,10,10,50
1994,3312,536,732,68344,67744,37,5.034,43,5.850,5609,1443,4166,2.130,8.280,4533,976,3557,1.441,6.691,1076,1.588,13.383,26,26,200
1994,3313,376,543,88428,89942,31,5.725,28,5.171,4507,774,3733,0.861,5.011,7675,1484,6191,1.650,8.533,-3168,-3.522,10.022,13,13,254
1994,3314,738,902,77270,76965,61,6.707,76,8.356,6253,1715,4538,2.228,8.125,5644,1584,4060,2.058,7.333,609,0.791,14.667,51,51,447
1994,3315,2412,2677,204680,198898,160,5.994,145,5.432,24642,6980,17662,3.509,12.389,13323,3945,9378,1.983,6.698,11319,5.691,13.397,102,102,1682
1994,3321,3118,3318,136674,134776,165,4.951,194,5.821,16420,3123,13297,2.317,12.183,12483,3426,9057,2.542,9.262,3937,2.921,18.524,141,141,1313
1994,3322,1363,1497,76448,75559,107,7.205,83,5.589,6997,1742,5255,2.305,9.260,5211,1236,3975,1.636,6.897,1786,2.364,13.793,54,54,568
1994,3323,10408,11170,326856,320905,823,7.368,822,7.359,47379,9371,38008,2.920,14.764,35571,10956,24615,3.414,11.085,11808,3.680,22.169,621,629,6997
1994,3324,1529,1860,106815,106241,131,7.085,109,5.895,11909,3702,8207,3.485,11.209,10849,2347,8502,2.209,10.212,1060,0.998,20.423,64,64,700
1994,3325,915,999,66569,66007,61,6.131,53,5.327,6087,1245,4842,1.886,9.222,5065,1787,3278,2.707,7.673,1022,1.548,15.347,33,35,404
1994,3326,1556,1736,68002,66600,112,6.483,95,5.499,7893,1315,6578,1.974,11.851,5065,1493,3572,2.242,7.605,2828,4.246,15.210,74,74,514
1994,3327,22437,22781,348613,340855,1840,8.123,1584,6.992,50778,11771,39007,3.453,14.897,35454,11183,24271,3.281,10.402,15324,4.496,20.803,1270,1272,8270
1994,3328,5400,5820,136702,133049,403,6.962,340,5.874,19247,4814,14433,3.618,14.466,12050,3206,8844,2.410,9.057,7197,5.409,18.114,272,274,2363
1994,3329,5773,6265,302712,303459,472,7.542,458,7.319,28317,5747,22570,1.894,9.331,29765,7497,22268,2.471,9.809,-1448,-0.477,18.663,327,328,3115
1994,3331,2784,3036,195600,193707,246,8.136,221,7.309,21860,3491,18369,1.802,11.285,18534,8643,9891,4.462,9.568,3326,1.717,19.136,153,154,1796
1994,3332,4046,4291,158839,156613,302,7.025,318,7.397,19897,4919,14978,3.141,12.705,15543,6024,9519,3.846,9.924,4354,2.780,19.849,239,240,3330
1994,3333,2421,2558,132894,135028,192,7.509,190,7.431,12930,2940,9990,2.177,9.576,16718,1558,15160,1.154,12.381,-3788,-2.805,19.152,143,143,924
1994,3334,1567,1818,156314,153102,134,7.383,128,7.052,18451,3200,15251,2.090,12.051,12108,3141,8967,2.052,7.908,6343,4.143,15.817,92,93,1322
1994,3335,9426,9751,214716,210771,649,6.681,576,5.929,27227,7046,20181,3.343,12.918,19436,6220,13216,2.951,9.221,7791,3.696,18.443,444,444,3178
1994,3336,761,913,119726,119884,43,4.694,49,5.349,9531,1492,8039,1.245,7.950,9539,895,8644,0.747,7.957,-8,-0.007,15.900,35,35,314
1994,3339,5545,6166,308543,304976,457,7.442,406,6.612,34481,7656,26825,2.510,11.306,27104,9441,17663,3.096,8.887,7377,2.419,17.775,279,279,2702
1994,3341,1677,1769,187515,188346,265,15.121,232,13.238,24846,5822,19024,3.091,13.192,27001,9217,17784,4.894,14.336,-2155,-1.144,26.383,178,180,3407
1994,3342,1781,1990,213058,214764,176,8.905,149,7.539,22431,3122,19309,1.454,10.444,25579,10254,15325,4.775,11.910,-3148,-1.466,20.889,113,113,1421
1994,3343,431,464,34706,34710,65,14.381,41,9.071,3581,767,2814,2.210,10.317,3528,1216,2312,3.503,10.164,53,0.153,20.329,29,30,667
1994,3344,5147,5699,485286,482479,596,10.546,501,8.865,61124,17582,43542,3.644,12.669,55882,17729,38153,3.675,11.582,5242,1.086,23.165,353,354,5045
1994,3345,4596,5206,515500,533335,357,6.854,362,6.950,37256,11213,26043,2.102,6.985,72210,20542,51668,3.852,13.539,-34954,-6.554,13.971,216,216,2842
1994,3346,748,800,45622,45109,122,15.522,94,11.959,6119,2177,3942,4.826,13.565,5079,1893,3186,4.197,11.260,1040,2.306,22.519,65,65,615
1994,3351,1146,1264,72955,72125,121,9.707,86,6.899,7321,1660,5661,2.302,10.150,5711,1596,4115,2.213,7.918,1610,2.232,15.836,61,61,866
1994,3352,329,400,104093,102134,25,6.196,32,7.931,10165,868,9297,0.850,9.953,6401,1595,4806,1.562,6.267,3764,3.685,12.535,23,23,1465
1994,3353,2217,2639,204614,206176,191,7.268,169,6.431,19144,3819,15325,1.852,9.285,22030,11320,10710,5.490,10.685,-2886,-1.400,18.571,102,103,772
1994,3359,1846,2207,184559,181926,143,6.481,142,6.436,23097,6374,16723,3.504,12.696,17457,7909,9548,4.347,9.596,5640,3.100,19.191,89,89,1521
1994,3361,269,328,222200,217734,49,15.313,33,10.313,22267,4246,18021,1.950,10.227,13822,2555,11267,1.173,6.348,8445,3.879,12.696,26,26,316
1994,3362,1734,1900,119860,114864,186,9.795,184,9.689,21098,3244,17854,2.824,18.368,11416,5860,5556,5.102,9.939,9682,8.429,19.878,143,147,3754
1994,3363,4371,5298,706526,686905,433,8.243,343,6.530,84218,17282,66936,2.516,12.261,46309,18618,27691,2.710,6.742,37909,5.519,13.483,250,250,3990
1994,3364,1366,1678,529451,567661,114,6.702,160,9.406,31731,16561,15170,2.917,5.590,107692,22682,85010,3.996,18.971,-75961,-13.381,11.180,97,97,895
1994,3365,175,225,29171,28072,14,6.306,8,3.604,4071,1521,2550,5.418,14.502,1900,615,1285,2.191,6.768,2171,7.734,13.537,5,5,70
1994,3366,1382,1483,137876,138874,160,10.836,147,9.956,13136,2318,10818,1.669,9.459,15514,2900,12614,2.088,11.171,-2378,-1.712,18.918,110,110,2101
1994,3369,507,523,30873,31134,77,14.966,60,11.662,3447,799,2648,2.566,11.071,4025,492,3533,1.580,12.928,-578,-1.856,22.143,49,49,407
1994,3371,13161,13689,373738,367777,1697,12.399,1692,12.363,53329,16345,36984,4.444,14.500,41659,15066,26593,4.097,11.327,11670,3.173,22.655,1317,1320,10117
1994,3372,3276,3472,161489,154782,335,9.747,265,7.710,27276,10232,17044,6.611,17.622,14230,4195,10035,2.710,9.194,13046,8.429,18.387,205,206,2924
1994,3379,1068,1202,40392,40178,93,7.661,117,9.638,4881,1264,3617,3.146,12.149,4398,1439,2959,3.582,10.946,483,1.202,21.893,91,92,853
1994,3391,10758,11333,277700,278775,923,8.162,875,7.737,28645,7719,20926,2.769,10.275,31108,8476,22632,3.040,11.159,-2463,-0.884,20.551,644,646,3800
1994,3399,15794,16334,405402,403916,1955,12.085,1640,10.138,55861,15626,40235,3.869,13.830,52627,21026,31601,5.206,13.029,3234,0.801,26.058,1293,1298,10703
1994,4231,21816,26707,312186,307894,2229,8.305,2491,9.282,46210,12730,33480,4.135,15.008,37665,15079,22586,4.897,12.233,8545,2.775,24.466,1729,1804,8684
1994,4232,9056,10228,126686,125432,1124,10.972,1156,11.285,21000,5127,15873,4.087,16.742,18568,7087,11481,5.650,14.803,2432,1.939,29.607,867,884,4703
1994,4233,8374,11230,143580,140458,1110,9.952,957,8.580,22668,5809,16859,4.136,16.139,16392,5732,10660,4.081,11.670,6276,4.468,23.341,688,707,4000
1994,4234,28157,36396,595033,599678,4907,13.604,4254,11.794,100246,29634,70612,4.942,16.717,109412,39678,69734,6.617,18.245,-9166,-1.528,33.433,2666,2841,18044
1994,4235,6930,9300,135230,132738,784,8.451,737,7.945,18174,4572,13602,3.444,13.692,13085,4124,8961,3.107,9.858,5089,3.834,19.716,467,491,2215
1994,4236,18664,27927,359504,352892,3055,11.057,2462,8.910,63560,20841,42719,5.906,18.011,50155,16583,33572,4.699,14.213,13405,3.799,28.425,1424,1489,7411
1994,4237,11415,16411,186503,183305,1262,7.736,1065,6.529,25703,7078,18625,3.861,14.022,19262,6214,13048,3.390,10.508,6441,3.514,21.016,746,775,4486
1994,4238,47810,61971,658343,652463,5094,8.227,4985,8.051,90055,25533,64522,3.913,13.802,78153,27422,50731,4.203,11.978,11902,1.824,23.956,3199,3319,15862
1994,4239,26406,28483,292581,288595,3856,13.662,3337,11.823,56135,18203,37932,6.307,19.451,47893,19682,28211,6.820,16.595,8242,2.856,33.190,2569,2611,12356
1994,4241,9941,12947,203235,199759,1175,9.114,1066,8.268,26794,6627,20167,3.317,13.413,19736,6711,13025,3.360,9.880,7058,3.533,19.760,700,722,3664
1994,4242,3885,5101,144292,146354,794,15.963,540,10.856,21021,6817,14204,4.658,14.363,25314,6587,18727,4.501,17.296,-4293,-2.933,28.726,370,374,3325
1994,4243,12920,14013,167915,167617,2017,14.391,2023,14.434,32513,11060,21453,6.598,19.397,31755,11488,20267,6.854,18.945,758,0.452,37.890,1624,1638,8104
1994,4244,27903,33963,726757,718702,3683,10.834,3744,11.014,104247,30752,73495,4.279,14.505,87795,36296,51499,5.050,12.216,16452,2.289,24.432,2707,2729,17841
1994,4245,6025,8884,78373,79448,515,5.725,738,8.204,10180,2756,7424,3.469,12.813,12320,4168,8152,5.246,15.507,-2140,-2.694,25.627,444,498,2792
1994,4246,8854,12740,145126,144506,1247,9.855,1073,8.480,23413,7450,15963,5.156,16.202,22197,8018,14179,5.549,15.361,1216,0.841,30.721,594,604,3632
1994,4247,8299,11497,130036,129581,716,6.181,888,7.666,19052,5814,13238,4.487,14.703,18151,5828,12323,4.498,14.008,901,0.695,28.015,499,516,2828
1994,4248,3398,4385,140563,139206,222,5.032,276,6.256,14995,3537,11458,2.541,10.772,12036,4518,7518,3.246,8.646,2959,2.126,17.292,181,199,2362
1994,4249,22596,27275,333584,329241,3331,12.269,3079,11.341,55022,16730,38292,5.081,16.712,46253,17298,28955,5.254,14.048,8769,2.663,28.097,2284,2308,11003
1994,4251,33532,35872,300717,298998,3792,10.664,3164,8.898,49627,16288,33339,5.448,16.598,46431,17482,28949,5.847,15.529,3196,1.069,31.058,2154,2179,10118
1994,4411,38863,41316,1010509,980253,4361,10.672,3459,8.464,136952,38635,98317,3.941,13.971,76600,29817,46783,3.042,7.814,60352,6.157,15.629,2726,2755,22946
1994,4412,10616,11320,83384,80561,1110,9.897,902,8.042,15972,4713,11259,5.850,19.826,10297,3510,6787,4.357,12.782,5675,7.044,25.563,673,678,2640
1994,4413,38849,62157,485713,475121,4674,7.532,4474,7.210,78718,28423,50295,5.982,16.568,57030,21562,35468,4.538,12.003,21688,4.565,24.007,2849,3049,12783
1994,4421,21364,27994,246606,242286,2942,10.533,2818,10.089,43195,16696,26499,6.891,17.828,34936,13823,21113,5.705,14.419,8259,3.409,28.839,1916,2060,8730
1994,4422,23732,31800,210636,205967,3710,11.802,2979,9.477,42907,18379,24528,8.923,20.832,33641,10978,22663,5.330,16.333,9266,4.499,32.666,2054,2133,6991
1994,4431,27243,39035,314464,298906,5803,15.185,4165,10.899,78932,39338,39594,13.161,26.407,47145,20077,27068,6.717,15.773,31787,10.634,31.545,2906,2991,13074
1994,4441,51866,68961,814414,799150,5368,7.794,5199,7.548,135907,56980,78927,7.130,17.006,105071,43732,61339,5.472,13.148,30836,3.859,26.296,3530,3689,19983
1994,4442,16279,19870,155382,153631,1601,8.090,1441,7.281,24649,6868,17781,4.470,16.044,21092,6256,14836,4.072,13.729,3557,2.315,27.458,1062,1079,4250
1994,4451,61633,91497,2534033,2503021,9223,10.084,9148,10.002,321895,147974,173921,5.912,12.860,260818,95809,165009,3.828,10.420,61077,2.440,20.840,6221,6349,40503
1994,4452,17442,21898,132775,131849,3010,13.790,2870,13.148,29616,13887,15729,10.533,22.462,27836,11657,16179,8.841,21.112,1780,1.350,42.224,2125,2160,8548
1994,4453,23841,27997,135677,136049,2348,8.311,2858,10.116,23617,8030,15587,5.902,17.359,24592,9376,15216,6.892,18.076,-975,-0.717,34.719,2125,2152,6424
1994,4461,44886,76974,770767,761774,6961,9.090,6168,8.055,118078,47464,70614,6.231,15.500,99549,41195,58354,5.408,13.068,18529,2.432,26.136,3696,4079,21937
1994,4471,73081,123378,904106,895386,9896,7.960,11770,9.468,169709,59588,110121,6.655,18.954,150359,63202,87157,7.059,16.793,19350,2.161,33.585,7087,7385,35414
1994,4481,45364,99566,1013318,1013616,11960,12.032,11634,11.704,181658,95170,86488,9.389,17.922,183075,58843,124232,5.805,18.062,-1417,-0.140,35.844,6558,7212,27239
1994,4482,8125,32478,179276,180125,2717,8.225,3827,11.585,35169,16469,18700,9.143,19.525,36153,15699,20454,8.716,20.071,-984,-0.546,39.050,1041,1351,4798
1994,4483,18975,27573,154183,157645,2605,9.395,2912,10.503,26259,11617,14642,7.369,16.657,33809,11523,22286,7.309,21.446,-7550,-4.789,33.314,1743,1901,6305
1994,4511,32026,43033,343989,341740,5292,12.302,5261,12.230,65984,31884,34100,9.330,19.308,61515,24783,36732,7.252,18.001,4469,1.308,36.001,3474,3672,13888
1994,4512,9078,14690,113371,112469,1561,10.575,1704,11.544,22927,8392,14535,7.462,20.385,21322,8884,12438,7.899,18.958,1605,1.427,37.916,951,985,3614
1994,4521,143,10058,1668233,1642798,452,4.543,233,2.342,172084,66879,105205,4.071,10.475,124857,24883,99974,1.515,7.600,47227,2.875,15.201,4,6,233
1994,4529,10625,25038,580623,575983,2689,10.747,2657,10.619,96793,52663,44130,9.143,16.805,87624,33125,54499,5.751,15.213,9169,1.592,30.426,1282,1389,5676
1994,4531,23094,24443,120178,120397,2550,10.384,2779,11.316,21718,7912,13806,6.572,18.039,22295,7801,14494,6.479,18.518,-577,-0.479,36.077,2230,2265,6303
1994,4532,30255,39900,284513,277429,4838,12.124,4849,12.151,60763,25622,35141,9.236,21.902,46527,18129,28398,6.535,16.771,14236,5.131,33.542,3708,3821,13152
1994,4533,12146,15286,90186,88094,2198,14.563,1812,12.006,17506,7318,10188,8.307,19.872,13258,4671,8587,5.302,15.050,4248,4.822,30.100,1421,1432,3303
1994,4539,26427,30803,169428,162434,5204,17.277,3839,12.745,46378,23097,23281,14.219,28.552,32160,13362,18798,8.226,19.799,14218,8.753,39.598,2856,2953,10076
1994,4541,5494,6151,145113,139466,946,14.506,1687,25.868,33849,10438,23411,7.484,24.270,22263,10043,12220,7.201,15.963,11586,8.307,31.926,1427,1433,6849
1994,4542,4607,5471,69803,71351,745,13.641,726,13.293,9525,2631,6894,3.687,13.349,12791,6788,6003,9.514,17.927,-3266,-4.577,26.699,415,416,1851
1994,4543,17407,24008,219540,215668,2809,11.875,2102,8.886,40122,16389,23733,7.599,18.604,32206,12313,19893,5.709,14.933,7916,3.670,29.866,1328,1347,7472
1994,4811,619,3056,445402,440406,438,15.417,8,0.282,29266,6584,22682,1.495,6.645,19293,103,19190,0.023,4.381,9973,2.265,8.761,6,6,96
1994,4812,1248,1440,24187,22640,200,14.184,140,9.929,5924,1246,4678,5.504,26.167,2830,934,1896,4.126,12.500,3094,13.666,25.001,104,104,662
1994,4831,434,750,36635,36904,95,13.067,49,6.740,5276,1284,3992,3.479,14.297,6075,1317,4758,3.569,16.462,-799,-2.165,28.593,31,31,225
1994,4832,305,339,12149,11809,62,19.018,36,11.043,2239,968,1271,8.197,18.960,1543,307,1236,2.600,13.066,696,5.894,26.133,25,25,137
1994,4841,25346,32377,679785,654788,5862,18.643,3995,12.705,130100,40387,89713,6.168,19.869,79638,32317,47321,4.935,12.162,50462,7.707,24.325,2967,3020,17405
1994,4842,47850,52029,521522,521737,7957,15.361,7499,14.477,103941,33699,70242,6.459,19.922,103924,45554,58370,8.731,19.919,17,0.003,39.838,5839,5928,29373
1994,4851,397,478,27184,26838,65,13.570,67,13.987,3761,998,2763,3.719,14.014,3052,1517,1535,5.652,11.372,709,2.642,22.744,49,49,488
1994,4852,292,505,20048,19694,83,15.514,143,26.729,4464,520,3944,2.640,22.667,3730,3000,730,15.233,18.940,734,3.727,37.880,22,22,64
1994,4853,5434,5539,52274,50750,968,17.667,848,15.477,12412,4856,7556,9.569,24.457,9448,4115,5333,8.108,18.617,2964,5.840,37.234,719,722,3557
1994,4854,3256,4226,138509,135306,394,9.424,304,7.271,19069,8361,10708,6.179,14.093,13094,4840,8254,3.577,9.677,5975,4.416,19.355,233,244,3324
1994,4855,1142,1260,26671,26107,167,13.451,130,10.471,5242,1535,3707,5.880,20.079,4144,1580,2564,6.052,15.873,1098,4.206,31.746,99,102,1221
1994,4859,1524,1624,30152,28380,358,23.615,142,9.367,6676,2607,4069,9.186,23.524,3099,1092,2007,3.848,10.920,3577,12.604,21.840,110,110,788
1994,4861,47,370,9491,9601,34,9.264,28,7.629,1323,748,575,7.791,13.781,1540,116,1424,1.208,16.041,-217,-2.260,27.561,4,4,11
1994,4862,152,1452,38691,39324,171,12.119,89,6.308,3952,1555,2397,3.954,10.050,5196,1292,3904,3.286,13.213,-1244,-3.163,20.100,10,10,49
1994,4869,59,424,6311,6186,92,23.145,39,9.811,1768,1591,177,25.721,28.583,1501,799,702,12.917,24.266,267,4.317,48.533,3,3,18
1994,4871,337,377,7425,7339,54,14.248,58,15.303,1588,602,986,8.203,21.638,1421,487,934,6.636,19.362,167,2.276,38.725,46,47,440
1994,4872,1174,1206,11945,11984,192,16.244,144,12.183,3181,1015,2166,8.470,26.544,3237,1013,2224,8.453,27.011,-56,-0.467,53.087,108,108,822
1994,4879,128,132,1207,1093,25,19.531,17,13.281,399,175,224,16.018,36.522,171,40,131,3.661,15.652,228,20.870,31.304,13,13,25
1994,4881,2558,3198,89287,87079,502,16.085,348,11.150,19292,6942,12350,7.972,22.155,14757,3765,10992,4.324,16.947,4535,5.208,33.893,228,230,1176
1994,4882,429,658,15363,15099,83,12.720,72,11.034,3058,910,2148,6.027,20.254,2547,1222,1325,8.094,16.869,511,3.384,33.738,45,51,579
1994,4883,2024,2585,81959,81836,276,10.754,239,9.312,14132,3542,10590,4.328,17.269,13705,3655,10050,4.466,16.747,427,0.522,33.494,167,168,2233
1994,4884,4402,4572,30939,29743,761,16.983,579,12.921,7515,3179,4336,10.688,25.267,5087,2354,2733,7.915,17.103,2428,8.163,34.207,456,462,1909
1994,4885,9294,12279,114768,112070,1819,15.143,1286,10.706,23579,9046,14533,8.072,21.040,18279,6967,11312,6.217,16.310,5300,4.729,32.621,887,945,4615
1994,4889,792,848,9664,9457,117,13.708,128,14.997,2127,825,1302,8.724,22.492,1744,861,883,9.105,18.442,383,4.050,36.885,105,105,726
1994,4921,1544,4339,384827,383382,446,10.416,332,7.753,27502,4643,22859,1.211,7.174,25990,3038,22952,0.792,6.779,1512,0.394,13.558,204,207,1527
1994,4922,3877,4270,63638,61344,728,17.429,542,12.976,13891,4488,9403,7.316,22.644,9516,3697,5819,6.027,15.513,4375,7.132,31.025,441,448,2833
1994,4931,6525,10664,434845,429704,1112,10.512,940,8.886,77274,31033,46241,7.222,17.983,66786,22730,44056,5.290,15.542,10488,2.441,31.085,332,343,3774
1994,5111,15422,18221,683089,682863,2142,11.886,1742,9.667,66904,23757,43147,3.479,9.798,65767,24107,41660,3.530,9.631,1137,0.167,19.262,1340,1352,9047
1994,5112,5794,7028,150063,144994,1166,16.979,845,12.304,32490,8343,24147,5.754,22.408,22043,10398,11645,7.171,15.203,10447,7.205,30.406,543,552,4633
1994,5121,10493,14961,218777,226377,2196,14.834,1882,12.713,47962,15705,32257,6.938,21.187,63894,22585,41309,9.977,28.225,-15932,-7.038,42.374,1059,1121,15469
1994,5122,1707,1743,12402,12182,353,21.169,202,12.114,3152,1312,1840,10.770,25.874,2719,1037,1682,8.513,22.320,433,3.554,44.640,159,159,618
1994,5151,6246,8168,246022,236769,939,11.613,774,9.573,46779,14069,32710,5.942,19.757,28948,12165,16783,5.138,12.226,17831,7.531,24.453,539,573,6662
1994,5152,219,375,16421,15911,60,16.575,34,9.392,2547,792,1755,4.978,16.008,1436,360,1076,2.263,9.025,1111,6.983,18.051,16,16,109
1994,5171,4417,25287,938908,946609,3038,12.199,2270,9.115,135107,52185,82922,5.513,14.273,151879,47652,104227,5.034,16.045,-16772,-1.772,28.545,462,501,5155
1994,5172,1675,3555,86412,78774,876,26.013,501,14.878,31170,12316,18854,15.635,39.569,16294,10456,5838,13.273,20.684,14876,18.884,41.369,193,208,1376
1994,5174,244,311,6281,6660,63,21.176,36,12.101,2015,1026,989,15.407,30.258,2574,1916,658,28.771,38.652,-559,-8.394,60.515,20,20,127
1994,5179,1524,2243,33547,31286,619,29.150,380,17.895,11085,4285,6800,13.696,35.431,6665,3024,3641,9.666,21.303,4420,14.128,42.607,166,167,959
1994,5182,5001,7142,285747,283380,876,12.199,954,13.285,49968,19418,30550,6.852,17.633,45689,18280,27409,6.451,16.123,4279,1.510,32.246,543,546,4016
1994,5191,2562,3001,40930,39528,261,8.791,197,6.635,6007,1775,4232,4.490,15.197,3284,1092,2192,2.763,8.308,2723,6.889,16.616,143,143,704
1994,5211,15,45,22982,23796,(D),(D),(D),(D),339,(D),293,(D),1.425,1928,(D),1925,(D),8.102,-1589,-6.678,2.849,(D),(D),(D)
1994,5221,21386,98096,1960288,1937995,7920,8.143,6242,6.418,356467,181595,174872,9.370,18.394,309003,112008,196995,5.780,15.944,47464,2.449,31.889,733,1084,15802
1994,5222,15047,37228,490966,472305,6799,18.907,4263,11.855,127114,53662,73452,11.362,26.914,90569,44370,46199,9.394,19.176,36545,7.738,38.352,1149,1220,5981
1994,5223,8929,11700,111332,101165,2445,22.040,1232,11.106,36496,13095,23401,12.944,36.076,15975,6831,9144,6.752,15.791,20521,20.285,31.582,843,893,3923
1994,5231,7771,22650,382769,354909,6151,29.358,2755,13.149,95884,39343,56541,11.085,27.017,39177,19949,19228,5.621,11.039,56707,15.978,22.077,662,673,3577
1994,5232,34,48,6439,6438,8,16.495,9,18.557,300,140,160,2.175,4.660,298,50,248,0.777,4.629,2,0.031,9.258,5,5,12
1994,5239,18872,20705,182101,185926,3865,18.899,3357,16.415,46825,20847,25978,11.213,25.185,54315,38413,15902,20.660,29.213,-7490,-4.028,50.370,2543,2558,29528
1994,5241,4134,36964,1506352,1511346,4462,12.190,3741,10.220,222083,83440,138643,5.521,14.694,228934,81671,147263,5.404,15.148,-6851,-0.453,29.389,254,285,5680
1994,5242,109350,120076,786251,869788,12187,10.092,13549,11.220,139275,46769,92506,5.377,16.013,305487,212625,92862,24.446,35.122,-166212,-19.109,32.025,10439,10593,190830
1994,5250,2653,2901,61255,60232,367,13.037,195,6.927,14778,7363,7415,12.225,24.535,12535,2359,10176,3.917,20.811,2243,3.724,41.623,109,111,634
1994,5311,87852,95287,487590,490614,10079,10.554,10506,11.001,90212,39630,50582,8.078,18.388,96731,44583,52148,9.087,19.716,-6519,-1.329,36.775,8086,8214,30182
1994,5312,44371,50093,229393,226571,8018,16.305,6182,12.571,53257,22647,30610,9.996,23.506,47815,20155,27660,8.896,21.104,5442,2.402,42.208,4378,4526,13607
1994,5313,32990,36788,389296,380522,6282,17.762,3440,9.727,84470,40107,44363,10.540,22.198,67515,23077,44438,6.065,17.743,16955,4.456,35.486,2417,2503,14626
1994,5321,4853,9817,133819,134847,1520,15.737,1204,12.465,25434,11417,14017,8.467,18.861,28482,7300,21182,5.414,21.122,-3048,-2.260,37.723,507,551,2807
1994,5322,20847,30274,230531,222175,4121,13.636,4017,13.292,57371,22351,35020,10.060,25.822,41513,17452,24061,7.855,18.685,15858,7.138,37.370,2952,3108,12008
1994,5323,3815,6123,40777,39836,622,10.313,439,7.278,7716,2522,5194,6.331,19.370,5793,2107,3686,5.289,14.542,1923,4.827,29.085,274,298,1316
1994,5324,7312,9903,110125,108944,1170,11.845,1120,11.338,22484,7840,14644,7.196,20.638,19995,8562,11433,7.859,18.353,2489,2.285,36.707,703,735,4310
1994,5331,1553,1694,19175,18957,340,20.789,223,13.635,4589,2446,2143,12.903,24.207,4137,2078,2059,10.962,21.823,452,2.384,43.646,144,148,678
1994,5411,147224,153983,1015255,1010903,15497,10.186,11815,7.766,132161,45113,87048,4.463,13.074,123536,35240,88296,3.486,12.220,8625,0.853,24.441,8740,8840,26602
1994,5412,79088,83515,748498,733046,9656,11.685,7902,9.562,148336,65266,83070,8.903,20.236,116044,36676,79368,5.003,15.830,32292,4.405,31.661,5687,5744,23863
1994,5413,68305,76840,971236,961524,10276,13.656,7097,9.431,166218,44254,121964,4.602,17.287,147841,39794,108047,4.139,15.376,18377,1.911,30.751,4869,4954,20660
1994,5414,18532,18742,97703,96631,3466,18.883,2693,14.671,24899,11565,13334,11.968,25.767,22671,10827,11844,11.204,23.461,2228,2.306,46.923,2078,2081,7505
1994,5415,33052,37458,497505,482733,8902,24.995,5216,14.646,120697,43255,77442,8.960,25.003,91158,37677,53481,7.805,18.884,29539,6.119,37.768,3460,3507,19673
1994,5416,45448,48223,437448,422405,9921,21.159,7249,15.461,112910,39143,73767,9.267,26.730,82122,34252,47870,8.109,19.442,30788,7.289,38.883,5450,5499,25405
1994,5417,7482,9381,450555,451984,1366,14.862,987,10.738,48607,11214,37393,2.481,10.754,50748,15583,35165,3.448,11.228,-2141,-0.474,21.508,568,579,2969
1994,5418,29328,32072,376968,373565,4846,15.376,3735,11.851,69481,25253,44228,6.760,18.599,62965,24247,38718,6.491,16.855,6516,1.744,33.710,2910,2940,13988
1994,5419,36772,42170,362303,351662,4378,10.642,2312,5.620,69531,25321,44210,7.200,19.772,48148,10513,37635,2.990,13.692,21383,6.081,27.383,1603,1631,7279
1994,5511,28406,51174,3136996,3148617,4871,9.511,4953,9.671,476745,149824,326921,4.758,15.141,500428,146420,354008,4.650,15.894,-23683,-0.752,30.283,965,1022,13837
1994,5611,15802,17243,321303,311211,3618,21.866,2224,13.441,85522,38010,47512,12.214,27.480,65432,31454,33978,10.107,21.025,20090,6.455,42.050,1684,1700,22449
1994,5612,609,1047,72379,73491,206,20.610,111,11.106,12771,4641,8130,6.315,17.378,15224,3922,11302,5.337,20.716,-2453,-3.338,34.756,31,37,479
1994,5613,20105,29331,2193298,2034846,5089,17.801,3602,12.600,732140,201977,530163,9.926,35.980,416979,136474,280505,6.707,20.492,315161,15.488,40.984,2438,2583,101866
1994,5614,25084,28651,410950,399397,4441,15.746,3548,12.580,95135,34227,60908,8.570,23.820,72248,24560,47688,6.149,18.089,22887,5.730,36.179,2810,2834,14631
1994,5615,25164,31790,259833,253073,3761,11.918,3296,10.444,51749,17157,34592,6.779,20.448,38155,17802,20353,7.034,15.077,13594,5.372,30.153,2172,2240,8583
1994,5616,14087,17377,566781,560072,2549,14.873,2071,12.084,95835,29380,66455,5.246,17.111,82334,29803,52531,5.321,14.701,13501,2.411,29.401,1541,1572,18532
1994,5617,98183,102790,1184762,1166692,18014,18.254,9806,9.937,268989,98336,170653,8.429,23.056,233025,66654,166371,5.713,19.973,35964,3.083,39.946,8020,8068,43181
1994,5619,17963,19677,294749,288000,3819,20.067,2527,13.278,75818,27450,48368,9.531,26.326,61937,29876,32061,10.374,21.506,13881,4.820,43.012,1962,1971,16575
1994,5621,5061,5575,86284,81878,796,15.056,220,4.161,15708,5174,10534,6.319,19.185,6894,1781,5113,2.175,8.420,8814,10.765,16.840,158,158,1225
1994,5622,1685,2591,85177,84464,330,12.964,239,9.389,13042,3810,9232,4.511,15.441,11516,3949,7567,4.675,13.634,1526,1.807,27.269,142,145,1633
1994,5629,5042,5453,81199,78222,743,13.720,668,12.335,20422,4699,15723,6.007,26.108,14588,5218,9370,6.671,18.650,5834,7.458,37.299,505,507,4146
1994,6111,14430,16483,563448,547823,784,4.870,12,0.075,59420,9796,49624,1.788,10.847,28441,78,28363,0.014,5.192,30979,5.655,10.383,(D),(D),(D)
1994,6112,592,862,73931,72430,33,3.901,(D),(D),7708,493,7215,0.681,10.642,4799,(D),4797,(D),6.626,2909,4.016,13.251,0,0,0
1994,6113,2087,2519,1164441,1153664,108,4.377,5,0.203,71712,3023,68689,0.262,6.216,49986,13,49973,0.001,4.333,21726,1.883,8.666,(D),(D),(D)
1994,6114,3849,4251,49326,48812,911,22.266,592,14.469,11142,4172,6970,8.547,22.826,10134,5194,4940,10.641,20.761,1008,2.065,41.523,418,451,3436
1994,6115,4894,5729,61886,62210,714,12.653,542,9.605,10455,3387,7068,5.445,16.806,11220,4070,7150,6.542,18.036,-765,-1.230,33.612,355,371,2125
1994,6116,16617,17639,135776,131968,3204,18.751,2100,12.290,32569,13820,18749,10.472,24.680,24924,8657,16267,6.560,18.886,7645,5.793,37.773,1604,1672,7102
1994,6117,2780,2875,23088,22370,655,23.984,367,13.438,5045,2556,2489,11.426,22.553,3672,1053,2619,4.707,16.415,1373,6.138,32.830,283,286,801
1994,6211,178265,192110,1569794,1559977,12922,6.692,14870,7.701,230738,74878,155860,4.800,14.791,210779,79074,131705,5.069,13.512,19959,1.279,27.023,11927,12173,56283
1994,6212,103006,106061,590896,583535,4959,4.694,4138,3.917,79073,19377,59696,3.321,13.551,64365,15770,48595,2.702,11.030,14708,2.521,22.060,3241,3297,12638
1994,6213,69440,73396,318884,315274,8164,11.276,6172,8.525,66555,26153,40402,8.295,21.110,59586,23670,35916,7.508,18.900,6969,2.210,37.800,4630,4788,15515
1994,6214,8751,15049,315978,302568,1816,12.335,1162,7.893,61410,25694,35716,8.492,20.296,34096,10717,23379,3.542,11.269,27314,9.027,22.538,713,766,6971
1994,6215,5418,8555,150772,145817,1689,20.527,1035,12.579,33492,17584,15908,12.059,22.969,23130,11555,11575,7.924,15.862,10362,7.106,31.725,652,689,5063
1994,6216,6818,12127,681687,637441,2503,21.913,1094,9.578,173391,67394,105997,10.573,27.201,86511,26038,60473,4.085,13.572,86880,13.629,27.143,536,583,10620
1994,6219,5608,7403,165398,162833,800,10.798,811,10.947,29946,9833,20113,6.039,18.391,24993,9799,15194,6.018,15.349,4953,3.042,30.698,568,593,6092
1994,6221,2996,4679,4188898,4185173,193,4.148,141,3.030,194496,53821,140675,1.286,4.647,182968,56456,126512,1.349,4.372,11528,0.275,8.744,88,90,34955
1994,6222,614,956,302062,303266,57,5.950,61,6.367,13028,4864,8164,1.604,4.296,15475,5748,9727,1.895,5.103,-2447,-0.807,8.592,8,9,873
1994,6223,252,371,136246,135579,34,9.405,15,4.149,7302,1586,5716,1.170,5.386,5969,617,5352,0.455,4.403,1333,0.983,8.805,4,4,213
1994,6231,7556,13469,1346955,1325054,839,6.298,543,4.076,145805,60647,85158,4.577,11.004,101619,36016,65603,2.718,7.669,44186,3.335,15.338,275,292,17722
1994,6232,7223,15857,322032,312652,1884,12.408,537,3.537,54679,22409,32270,7.167,17.489,36416,9281,27135,2.968,11.647,18263,5.841,23.295,310,327,5470
1994,6233,11472,13745,388939,395637,1814,13.256,1693,12.372,53906,20240,33666,5.116,13.625,67240,41224,26016,10.420,16.995,-13334,-3.370,27.250,1056,1121,20956
1994,6239,4031,5754,147611,144720,548,9.685,356,6.292,20227,5704,14523,3.941,13.977,14522,4971,9551,3.435,10.035,5705,3.942,20.069,234,240,2736
1994,6241,23350,32108,490203,475076,3677,11.782,1878,6.018,81371,26653,54718,5.610,17.128,51306,11074,40232,2.331,10.800,30065,6.328,21.599,1224,1248,6197
1994,6242,6339,7698,80287,77704,812,10.824,420,5.599,13990,4749,9241,6.112,18.004,8799,2086,6713,2.685,11.324,5191,6.681,22.648,302,303,1394
1994,6243,5427,8478,310606,307531,658,7.804,566,6.713,45939,7032,38907,2.287,14.938,39779,5642,34137,1.835,12.935,6160,2.003,25.870,302,315,2746
1994,6244,41862,51362,536499,519606,6537,13.009,4309,8.575,99689,37886,61803,7.291,19.186,65958,23135,42823,4.452,12.694,33731,6.492,25.388,3302,3392,17572
1994,7111,6651,6718,100781,97920,1231,18.613,1022,15.453,24992,7920,17072,8.088,25.523,19162,6019,13143,6.147,19.569,5830,5.954,39.138,758,759,4445
1994,7112,2833,2956,78776,79501,546,18.705,472,16.170,12831,3807,9024,4.789,16.139,14334,5193,9141,6.532,18.030,-1503,-1.891,32.279,339,347,2906
1994,7113,2706,2816,52796,52681,465,16.796,370,13.365,11809,4383,7426,8.320,22.416,11585,2618,8967,4.970,21.991,224,0.425,43.982,278,278,1944
1994,7114,1688,1727,12758,12791,309,18.564,184,11.054,2982,1232,1750,9.632,23.314,3049,1517,1532,11.860,23.838,-67,-0.524,46.628,141,141,1378
1994,7115,6832,6861,33110,33694,1329,19.569,1190,17.522,10985,4423,6562,13.127,32.603,12164,6283,5881,18.648,36.102,-1179,-3.499,65.205,777,780,3877
1994,7121,3392,3711,74212,73547,354,9.805,153,4.238,8084,1303,6781,1.772,10.992,6855,961,5894,1.307,9.321,1229,1.671,18.641,96,96,484
1994,7131,1634,2622,101503,96630,346,13.463,242,9.416,17109,4756,12353,4.922,17.706,7833,2293,5540,2.373,8.106,9276,9.600,16.212,179,186,1883
1994,7132,1259,1475,77890,64955,317,22.979,126,9.134,31808,15002,16806,23.096,48.970,5465,1716,3749,2.642,8.414,26343,40.556,16.827,87,87,693
1994,7139,41654,44957,736281,724875,5656,12.770,4326,9.767,132991,52863,80128,7.293,18.347,109723,36387,73336,5.020,15.137,23268,3.210,30.274,3375,3467,28886
1994,7211,30790,37607,1479880,1456145,4264,11.453,3509,9.425,238332,111335,126997,7.646,16.367,188657,83475,105182,5.733,12.956,49675,3.411,25.912,2444,2503,52296
1994,7212,4580,4958,32028,31881,568,11.675,382,7.852,6458,2234,4224,7.007,20.257,6256,1448,4808,4.542,19.623,202,0.634,39.246,255,255,1009
1994,7213,3144,3238,15506,15494,244,7.512,264,8.128,2370,917,1453,5.919,15.297,2356,717,1639,4.628,15.206,14,0.090,30.413,191,191,554
1994,7223,15343,28439,533238,544898,3656,12.282,6310,21.199,110541,54288,56253,9.963,20.287,136467,70730,65737,12.980,25.045,-25926,-4.758,40.573,3146,3203,28346
1994,7224,49669,50179,321854,320519,7044,14.002,7299,14.509,84518,45467,39051,14.185,26.369,81895,36886,45009,11.508,25.551,2623,0.818,51.102,5999,6024,31347
1994,7225,241761,328419,6173039,6050961,46174,14.241,37811,11.662,1235897,676067,559830,11.173,20.425,991103,401019,590084,6.627,16.379,244794,4.046,32.759,27847,28978,272880
1994,8111,127785,138342,724510,706760,17111,12.508,14034,10.259,149349,59095,90254,8.361,21.132,113567,45752,67815,6.473,16.069,35782,5.063,32.137,10772,10928,36298
1994,8112,13198,15856,131179,132496,1978,12.514,1879,11.888,24268,9687,14581,7.311,18.316,26869,9975,16894,7.529,20.279,-2601,-1.963,36.632,1249,1307,4240
1994,8113,21305,22531,173254,170477,2384,10.614,2244,9.991,31531,8827,22704,5.178,18.496,25949,9615,16334,5.640,15.221,5582,3.274,30.443,1698,1698,6564
1994,8114,26391,28092,167790,170366,3458,12.174,4082,14.371,28787,9006,19781,5.286,16.897,34102,14125,19977,8.291,20.017,-5315,-3.120,33.794,3188,3218,9688
1994,8121,75797,86790,450597,456989,11001,12.602,12018,13.767,87449,44005,43444,9.629,19.136,100276,44330,55946,9.700,21.943,-12827,-2.807,38.272,8847,9156,31272
1994,8122,16516,20725,138352,133744,1659,8.108,1130,5.523,28255,12553,15702,9.386,21.126,18744,5564,13180,4.160,14.015,9511,7.111,28.030,695,739,3378
1994,8123,34725,41698,378074,380538,4523,10.864,4392,10.549,57149,21244,35905,5.583,15.018,61546,21866,39680,5.746,16.173,-4397,-1.155,30.036,3222,3400,16464
1994,8129,14143,22970,167555,164943,3103,13.649,2630,11.569,36551,14985,21566,9.085,22.160,30856,13116,17740,7.952,18.707,5695,3.453,37.414,1092,1143,6187
1994,8131,143233,143347,1270769,1249392,7804,5.591,268,0.192,152839,23812,129027,1.906,12.233,110704,1093,109611,0.087,8.861,42135,3.372,17.721,55,55,114
1994,8132,10909,12688,154128,152503,984,7.847,687,5.479,20098,3823,16275,2.507,13.179,16721,3742,12979,2.454,10.964,3377,2.214,21.929,469,470,2243
1994,8133,9852,11549,126958,125423,917,8.007,725,6.330,19248,4407,14841,3.514,15.347,16114,3064,13050,2.443,12.848,3134,2.499,25.696,461,462,1769
1994,8134,31243,33065,319871,319706,1680,5.072,1790,5.405,38811,6958,31853,2.176,12.140,38303,6853,31450,2.144,11.981,508,0.159,23.961,1303,1305,4836
1994,8139,64217,66355,509509,507021,4844,7.435,2441,3.747,73841,21266,52575,4.194,14.564,68492,11293,57199,2.227,13.509,5349,1.055,27.017,1742,1760,8422
1995,2111,6488,7693,100071,99801,607,7.728,931,11.852,17088,7266,9822,7.280,17.122,16113,5446,10667,5.457,16.145,975,0.977,32.290,626,635,2235
1995,2121,1248,1737,95929,99051,238,13.182,375,20.770,15260,5072,10188,5.121,15.406,21709,9667,12042,9.760,21.917,-6449,-6.511,30.812,253,254,4245
1995,2122,337,493,43295,42942,48,9.533,69,13.704,4012,585,3427,1.362,9.343,3320,471,2849,1.097,7.731,692,1.611,15.463,47,47,331
1995,2123,3344,5038,99545,98967,370,7.393,304,6.074,14145,3890,10255,3.931,14.293,12884,2166,10718,2.189,13.019,1261,1.274,26.037,176,176,1254
1995,2131,7380,8372,150354,150515,1047,12.469,1096,13.053,32765,8092,24673,5.376,21.769,33531,13456,20075,8.940,22.278,-766,-0.509,43.537,739,743,5374
1995,2211,1546,7301,582176,592618,476,6.637,217,3.026,30134,9288,20846,1.567,5.085,51294,3581,47713,0.604,8.655,-21160,-3.571,10.170,39,40,526
1995,2212,592,2732,105873,106365,159,5.811,167,6.104,7880,3571,4309,3.357,7.408,8936,1573,7363,1.479,8.401,-1056,-0.993,14.817,29,30,221
1995,2213,4060,4465,33016,32630,349,7.929,222,5.044,3797,1289,2508,3.950,11.637,3056,1121,1935,3.436,9.366,741,2.271,18.732,168,168,512
1995,2361,122247,122838,641085,621023,24304,20.182,19478,16.174,194387,79341,115046,12.776,31.301,154363,63729,90634,10.262,24.856,40024,6.445,49.713,14128,14129,48864
1995,2362,37191,37854,638365,616426,5521,14.894,3952,10.661,149323,34854,114469,5.654,24.224,105251,28977,76274,4.701,17.074,44072,7.150,34.149,2978,2988,22143
1995,2371,14367,14674,330448,320382,1455,10.020,1148,7.906,68375,11599,56776,3.620,21.342,47956,10338,37618,3.227,14.968,20419,6.373,29.937,859,865,7412
1995,2372,8060,8254,63030,60579,1859,23.303,1306,16.371,18124,7356,10768,12.143,29.918,13291,5797,7494,9.569,21.940,4833,7.978,43.880,992,996,4420
1995,2373,9789,10195,233716,228400,999,9.875,842,8.323,46232,7316,38916,3.203,20.242,35468,7854,27614,3.439,15.529,10764,4.713,31.058,629,635,5555
1995,2379,4798,4879,60739,60450,676,13.870,666,13.664,14090,3574,10516,5.912,23.309,13455,3894,9561,6.442,22.258,635,1.050,44.516,516,516,2987
1995,2381,83475,83865,734348,710206,13390,16.307,9880,12.033,203142,59012,144130,8.309,28.603,154646,47940,106706,6.750,21.775,48496,6.828,43.550,7578,7581,38610
1995,2382,130163,132164,1350846,1298867,16870,13.015,11772,9.082,298438,73134,225304,5.631,22.977,193680,54706,138974,4.212,14.911,104758,8.065,29.823,8935,8959,41784
1995,2383,88140,88648,663207,641108,16491,19.002,12770,14.714,187701,60858,126843,9.493,29.278,143563,51564,91999,8.043,22.393,44138,6.885,44.786,9796,9799,41584
1995,2389,43999,44250,359886,350641,6875,15.925,4718,10.929,91372,27928,63444,7.965,26.059,73384,23848,49536,6.801,20.929,17988,5.130,41.857,3588,3588,18204
1995,3111,1324,1963,51481,51816,122,6.269,88,4.522,4483,1334,3149,2.575,8.652,5197,1353,3844,2.611,10.030,-714,-1.378,17.304,67,67,367
1995,3112,457,817,63907,63721,57,7.028,45,5.549,4674,902,3772,1.416,7.335,4435,1477,2958,2.318,6.960,239,0.375,13.920,22,22,177
1995,3113,1496,1683,84408,84524,138,8.091,183,10.730,8951,2626,6325,3.107,10.590,8870,2615,6255,3.094,10.494,81,0.096,20.988,118,122,817
1995,3114,1261,1691,179555,178784,108,6.374,115,6.787,17823,2363,15460,1.322,9.969,16110,3115,12995,1.742,9.011,1713,0.958,18.022,77,79,983
1995,3115,1260,1788,133886,134181,85,4.696,129,7.127,10664,2363,8301,1.761,7.948,11506,4737,6769,3.530,8.575,-842,-0.628,15.895,70,73,912
1995,3116,3502,4116,440404,430181,303,7.464,190,4.680,39352,4952,34400,1.151,9.148,18666,4272,14394,0.993,4.339,20686,4.809,8.678,144,144,2219
1995,3117,648,762,43273,44258,77,10.246,56,7.452,6244,1795,4449,4.056,14.108,8302,2225,6077,5.027,18.758,-2058,-4.650,28.216,38,38,538
1995,3118,9442,10407,315534,313183,1268,12.191,1256,12.076,38978,11066,27912,3.533,12.446,34321,13607,20714,4.345,10.959,4657,1.487,21.918,901,915,7052
1995,3119,2226,2603,135962,135671,222,8.534,219,8.418,14547,3288,11259,2.424,10.722,14003,4558,9445,3.360,10.321,544,0.401,20.643,159,161,2190
1995,3121,1769,2170,130230,128161,218,10.230,140,6.570,14421,2305,12116,1.799,11.252,10308,3631,6677,2.833,8.043,4113,3.209,16.086,97,97,846
1995,3122,69,100,28986,31104,4,3.828,13,12.440,854,100,754,0.322,2.746,5079,617,4462,1.984,16.329,-4225,-13.583,5.491,9,9,31
1995,3131,377,620,89631,90882,41,6.661,32,5.199,5624,1108,4516,1.219,6.188,8057,1788,6269,1.967,8.865,-2433,-2.677,12.377,20,20,195
1995,3132,1676,2026,238237,238136,177,8.808,144,7.166,17936,4011,13925,1.684,7.532,17448,4993,12455,2.097,7.327,488,0.205,14.654,114,114,2527
1995,3133,2648,2866,116187,115232,454,16.446,243,8.803,13770,3539,10231,3.071,11.950,11929,4365,7564,3.788,10.352,1841,1.598,20.704,197,199,2023
1995,3141,2900,3191,128355,127313,350,11.043,307,9.686,14973,3908,11065,3.070,11.761,12622,3840,8782,3.016,9.914,2351,1.847,19.828,256,256,3002
1995,3149,4222,4350,121410,118403,561,13.078,440,10.258,22404,6712,15692,5.669,18.922,16406,7379,9027,6.232,13.856,5998,5.066,27.712,358,358,4261
1995,3151,1119,1249,117937,118453,128,10.167,148,11.755,13310,1997,11313,1.686,11.237,14117,5275,8842,4.453,11.918,-807,-0.681,22.473,123,123,2177
1995,3152,10966,11953,610797,618304,2137,17.818,2218,18.493,98607,39311,59296,6.358,15.948,112726,51180,61546,8.277,18.231,-14119,-2.284,31.896,1867,1874,34617
1995,3159,1866,1975,62628,62498,244,12.465,209,10.677,8550,2128,6422,3.405,13.680,8273,2211,6062,3.538,13.237,277,0.443,26.474,179,179,1684
1995,3161,310,338,16642,16625,21,6.087,35,10.145,2127,639,1488,3.844,12.794,2093,996,1097,5.991,12.589,34,0.205,25.179,23,23,306
1995,3162,334,415,56510,58204,33,7.971,31,7.488,4651,794,3857,1.364,7.991,8104,2079,6025,3.572,13.924,-3453,-5.933,15.982,19,20,549
1995,3169,1013,1053,31801,31824,109,10.406,98,9.356,4164,868,3296,2.728,13.085,4290,1077,3213,3.384,13.481,-126,-0.396,26.169,77,77,618
1995,3211,4334,4850,136718,136437,436,8.993,432,8.911,15600,4462,11138,3.270,11.434,15018,5339,9679,3.913,11.007,582,0.427,22.015,339,341,2337
1995,3212,1379,1694,107517,105406,149,8.949,91,5.465,12056,3540,8516,3.358,11.438,7807,3090,4717,2.932,7.407,4249,4.031,14.813,64,65,1124
1995,3219,9441,10145,309167,297273,1151,11.465,940,9.363,51401,14360,37041,4.831,17.291,27758,10983,16775,3.695,9.338,23643,7.953,18.675,748,752,7234
1995,3221,228,550,183184,183268,31,5.709,17,3.131,7961,4711,3250,2.571,4.344,8061,1778,6283,0.970,4.398,-100,-0.055,8.688,7,7,210
1995,3222,3572,5250,411341,406802,292,5.586,246,4.706,35773,7681,28092,1.888,8.794,26722,6453,20269,1.586,6.569,9051,2.225,13.138,171,171,2429
1995,3231,40425,42345,839676,828209,3161,7.413,3754,8.804,102318,27625,74693,3.336,12.354,79584,29233,50351,3.530,9.609,22734,2.745,19.218,3174,3184,20170
1995,3241,1082,2013,135057,137785,92,4.566,96,4.764,6806,1119,5687,0.812,4.940,12259,4460,7799,3.237,8.897,-5453,-3.958,9.879,39,39,355
1995,3251,1180,2377,207426,207606,133,5.608,122,5.144,13608,3777,9831,1.819,6.555,13638,3594,10044,1.731,6.569,-30,-0.014,13.109,53,53,914
1995,3252,391,672,133666,134480,47,7.100,27,4.079,6550,1595,4955,1.186,4.871,8040,2046,5994,1.521,5.979,-1490,-1.108,9.741,18,18,218
1995,3253,644,898,37910,38188,68,7.632,54,6.061,2789,703,2086,1.841,7.303,3404,920,2484,2.409,8.914,-615,-1.610,14.607,35,35,289
1995,3254,1140,1425,192199,193068,124,8.816,87,6.186,14064,3228,10836,1.672,7.284,16175,2548,13627,1.320,8.378,-2111,-1.093,14.569,55,55,737
1995,3255,1585,2047,74156,73394,122,6.000,95,4.672,7090,1046,6044,1.425,9.660,5553,1611,3942,2.195,7.566,1537,2.094,15.132,66,66,455
1995,3256,2047,2271,123179,122895,173,7.614,175,7.702,11656,3046,8610,2.479,9.485,10965,2763,8202,2.248,8.922,691,0.562,17.845,119,119,936
1995,3259,2233,2933,134139,131934,207,7.053,211,7.189,16376,5567,10809,4.220,12.412,11627,2763,8864,2.094,8.813,4749,3.600,17.626,135,135,1279
1995,3261,10605,12886,771248,752726,1051,8.239,791,6.201,102442,20491,81951,2.722,13.609,65582,22888,42694,3.041,8.713,36860,4.897,17.425,530,535,8732
1995,3262,2266,2796,200037,197133,202,7.290,152,5.485,16801,3591,13210,1.822,8.523,10947,2654,8293,1.346,5.553,5854,2.970,11.106,107,107,1063
1995,3271,1531,1807,81570,79586,205,11.462,168,9.393,10024,2314,7710,2.908,12.595,6149,2207,3942,2.773,7.726,3875,4.869,15.453,129,130,958
1995,3272,1727,1992,137515,135683,187,9.423,172,8.667,12770,2846,9924,2.098,9.412,8941,2479,6462,1.827,6.590,3829,2.822,13.179,131,132,1006
1995,3273,5771,8745,175578,172226,533,6.099,521,5.962,26520,5689,20831,3.303,15.398,19809,5016,14793,2.912,11.502,6711,3.897,23.003,325,329,2623
1995,3274,251,356,17652,17146,38,10.873,25,7.153,1900,963,937,5.616,11.081,881,278,603,1.621,5.138,1019,5.943,10.276,18,18,241
1995,3279,1967,2290,72608,71484,193,8.459,176,7.714,9019,1850,7169,2.588,12.617,6619,3065,3554,4.288,9.259,2400,3.357,18.519,131,131,865
1995,3311,243,310,131713,131811,30,9.631,33,10.594,5088,758,4330,0.575,3.860,5148,2255,2893,1.711,3.906,-60,-0.046,7.720,24,24,423
1995,3312,538,734,70572,69327,47,6.434,40,5.476,5895,906,4989,1.307,8.503,3476,1545,1931,2.229,5.014,2419,3.489,10.028,24,24,719
1995,3313,367,533,89084,88599,22,4.101,29,5.405,7082,1153,5929,1.301,7.993,6254,2492,3762,2.813,7.059,828,0.935,14.118,22,22,335
1995,3314,745,921,80826,78598,83,9.136,58,6.384,8859,1891,6968,2.406,11.271,4313,1087,3226,1.383,5.487,4546,5.784,10.975,40,41,499
1995,3315,2403,2675,218123,211179,155,5.806,144,5.394,26169,3280,22889,1.553,12.392,12326,5770,6556,2.732,5.837,13843,6.555,11.674,108,108,1712
1995,3321,3094,3296,142697,139150,170,5.153,176,5.335,18157,3473,14684,2.496,13.049,11032,3883,7149,2.791,7.928,7125,5.120,15.856,134,134,1846
1995,3322,1370,1504,80093,78136,86,5.724,83,5.524,8297,1089,7208,1.394,10.619,4488,1654,2834,2.117,5.744,3809,4.875,11.488,57,57,339
1995,3323,10480,11261,348068,337012,867,7.739,751,6.704,53536,10496,43040,3.114,15.886,31327,8649,22678,2.566,9.296,22209,6.590,18.591,601,607,5474
1995,3324,1522,1854,109297,107770,96,5.168,103,5.545,12527,2637,9890,2.447,11.624,9499,3252,6247,3.018,8.814,3028,2.810,17.628,67,67,1035
1995,3325,919,1009,71183,69132,69,6.869,60,5.973,7876,2904,4972,4.201,11.393,3925,1198,2727,1.733,5.678,3951,5.715,11.355,46,46,805
1995,3326,1560,1741,73248,70408,129,7.433,118,6.799,9514,1392,8122,1.977,13.513,3800,1071,2729,1.521,5.397,5714,8.116,10.794,92,93,800
1995,3327,22998,23355,380384,363862,2044,8.867,1438,6.238,60449,10501,49948,2.886,16.613,27341,9239,18102,2.539,7.514,33108,9.099,15.028,1146,1147,5895
1995,3328,5443,5865,144615,140329,419,7.184,353,6.053,21067,4910,16157,3.499,15.013,12494,4866,7628,3.468,8.903,8573,6.109,17.807,254,254,2748
1995,3329,5725,6215,308998,304188,451,7.262,441,7.101,34528,6953,27575,2.286,11.351,25030,7328,17702,2.409,8.228,9498,3.122,16.457,346,347,3492
1995,3331,2782,3041,202370,198259,224,7.398,198,6.539,20682,3860,16822,1.947,10.432,12715,2726,9989,1.375,6.413,7967,4.018,12.827,141,141,1088
1995,3332,4048,4297,173384,166319,280,6.528,265,6.178,25611,3311,22300,1.991,15.399,11527,3278,8249,1.971,6.931,14084,8.468,13.861,193,194,1680
1995,3333,2420,2550,125836,123278,223,8.761,214,8.407,15579,5061,10518,4.105,12.637,10499,4295,6204,3.484,8.517,5080,4.121,17.033,160,161,1593
1995,3334,1570,1825,165804,160634,114,6.269,101,5.554,20146,2666,17480,1.660,12.542,9602,3608,5994,2.246,5.978,10544,6.564,11.955,74,74,879
1995,3335,9587,9931,231430,222343,720,7.321,528,5.369,32886,6783,26103,3.051,14.791,14732,4888,9844,2.198,6.626,18154,8.165,13.252,405,405,2761
1995,3336,744,902,119976,119586,44,4.867,48,5.310,10121,1677,8444,1.402,8.463,9107,1317,7790,1.101,7.615,1014,0.848,15.231,31,31,272
1995,3339,5649,6285,325480,316358,493,7.921,371,5.961,40315,7560,32755,2.390,12.743,22313,8544,13769,2.701,7.053,18002,5.690,14.106,276,276,2330
1995,3341,1632,1722,198578,192289,211,12.235,216,12.525,32357,6083,26274,3.163,16.827,19573,5199,14374,2.704,10.179,12784,6.648,20.358,167,167,2282
1995,3342,1815,2143,249896,231086,324,15.713,162,7.856,56858,32152,24706,13.913,24.605,18450,5612,12838,2.429,7.984,38408,16.621,15.968,110,110,1455
1995,3343,451,483,39286,37064,56,11.802,39,8.219,6915,1864,5051,5.029,18.657,2391,1051,1340,2.836,6.451,4524,12.206,12.902,32,32,452
1995,3344,5211,5792,526563,505792,610,10.659,472,8.247,82686,23749,58937,4.695,16.348,40742,13215,27527,2.613,8.055,41944,8.293,16.110,342,343,4881
1995,3345,4597,5201,490969,501299,391,7.530,374,7.203,37892,9000,28892,1.795,7.559,58362,13642,44720,2.721,11.642,-20470,-4.083,15.118,240,240,3566
1995,3346,774,833,53074,49324,129,15.828,93,11.411,10749,3237,7512,6.563,21.793,3049,1098,1951,2.226,6.182,7700,15.611,12.363,73,73,714
1995,3351,1165,1282,76300,74513,123,9.693,97,7.644,8629,1471,7158,1.974,11.581,4936,1591,3345,2.135,6.624,3693,4.956,13.249,72,73,686
1995,3352,342,412,107542,105701,46,11.358,32,7.901,8962,1777,7185,1.681,8.479,5167,625,4542,0.591,4.888,3795,3.590,9.777,23,23,246
1995,3353,2245,2664,206673,204883,205,7.739,175,6.606,21352,4057,17295,1.980,10.422,17728,6634,11094,3.238,8.653,3624,1.769,17.306,114,114,1104
1995,3359,1797,2173,194304,188896,122,5.592,139,6.372,25370,6433,18937,3.406,13.431,14642,3120,11522,1.652,7.751,10728,5.679,15.503,92,93,1091
1995,3361,277,338,228805,225605,39,11.694,30,8.996,22895,6163,16732,2.732,10.148,16663,9470,7193,4.198,7.386,6232,2.762,14.772,22,23,204
1995,3362,1760,1931,137998,128767,193,10.089,157,8.207,25683,7323,18360,5.687,19.945,7569,1407,6162,1.093,5.878,18114,14.067,11.756,129,129,1051
1995,3363,4407,5390,745208,724362,426,7.981,321,6.014,88444,15605,72839,2.154,12.210,47692,10272,37420,1.418,6.584,40752,5.626,13.168,229,229,3970
1995,3364,1343,1629,478032,503284,112,6.806,145,8.812,14592,2360,12232,0.469,2.899,64138,11411,52727,2.267,12.744,-49546,-9.845,5.799,78,79,1242
1995,3365,173,230,30800,29866,22,9.756,13,5.765,5000,1544,3456,5.170,16.742,3129,1273,1856,4.262,10.477,1871,6.265,20.954,10,10,253
1995,3366,1392,1493,143784,145553,143,9.613,132,8.874,16384,3266,13118,2.244,11.256,19396,9698,9698,6.663,13.326,-3012,-2.069,22.513,104,104,2856
1995,3369,534,553,32152,31434,83,15.456,51,9.497,5401,1583,3818,5.036,17.182,3984,411,3573,1.308,12.674,1417,4.508,25.349,39,39,345
1995,3371,13216,13739,384478,379842,1672,12.199,1607,11.724,49660,12809,36851,3.372,13.074,40241,13946,26295,3.672,10.594,9419,2.480,21.188,1252,1258,10960
1995,3372,3357,3567,160941,157600,315,8.932,234,6.635,19960,3985,15975,2.529,12.665,13166,3514,9652,2.230,8.354,6794,4.311,16.708,184,185,2297
1995,3379,1055,1185,41123,40418,85,7.155,91,7.660,5481,1385,4096,3.427,13.561,4154,1476,2678,3.652,10.278,1327,3.283,20.555,68,68,687
1995,3391,10796,11365,274072,275487,964,8.501,915,8.068,32625,9532,23093,3.460,11.843,35358,15208,20150,5.520,12.835,-2733,-0.992,23.685,671,673,4853
1995,3399,16019,16574,424810,414318,1886,11.486,1577,9.604,64524,19656,44868,4.744,15.574,43142,13648,29494,3.294,10.413,21382,5.161,20.826,1281,1287,9158
1995,4231,21742,26715,326242,319283,2385,8.932,2359,8.835,50619,15583,35036,4.881,15.854,36903,14874,22029,4.659,11.558,13716,4.296,23.116,1652,1725,8763
1995,4232,9183,10369,133266,130352,1165,11.314,1021,9.916,22115,5198,16917,3.988,16.966,16373,5924,10449,4.545,12.561,5742,4.405,25.121,788,795,4498
1995,4233,8615,11594,154280,149071,1236,10.804,929,8.120,25227,7166,18061,4.807,16.923,14963,4984,9979,3.343,10.038,10264,6.885,20.075,666,685,3205
1995,4234,28961,37296,609556,602010,4949,13.426,4078,11.063,105766,33412,72354,5.550,17.569,91026,33056,57970,5.491,15.120,14740,2.448,30.241,2719,2875,19329
1995,4235,7150,9538,143903,139820,820,8.684,630,6.672,20409,5230,15179,3.741,14.597,12423,4078,8345,2.917,8.885,7986,5.712,17.770,379,388,2328
1995,4236,19050,29134,406983,382899,3675,12.881,2469,8.654,96540,45344,51196,11.842,25.213,47310,18217,29093,4.758,12.356,49230,12.857,24.711,1423,1490,8899
1995,4237,11486,16640,193488,190212,1185,7.169,962,5.820,24696,5011,19685,2.634,12.983,18062,5583,12479,2.935,9.496,6634,3.488,18.991,672,696,3389
1995,4238,48372,62700,690980,674713,5164,8.281,4481,7.186,101145,26343,74802,3.904,14.991,68894,25258,43636,3.744,10.211,32251,4.780,20.422,2989,3130,15128
1995,4239,27133,29335,314620,303568,3945,13.658,3045,10.542,61394,18857,42537,6.212,20.224,39100,14378,24722,4.736,12.880,22294,7.344,25.760,2432,2446,10628
1995,4241,9955,12997,202841,203177,1150,8.874,1074,8.288,26904,7244,19660,3.565,13.242,27716,9288,18428,4.571,13.641,-812,-0.400,26.483,682,701,4645
1995,4242,4106,5481,150581,147031,909,17.178,530,10.016,27351,12462,14889,8.476,18.602,20306,7275,13031,4.948,13.811,7045,4.792,27.621,380,385,2629
1995,4243,13255,14369,174210,170631,2275,16.028,1924,13.556,34811,10849,23962,6.358,20.401,27770,10519,17251,6.165,16.275,7041,4.126,32.550,1584,1605,8279
1995,4244,27967,33933,741215,734521,3591,10.575,3640,10.719,104672,28774,75898,3.917,14.250,90656,35334,55322,4.810,12.342,14016,1.908,24.684,2682,2754,20334
1995,4245,5786,8641,77164,77736,432,4.932,669,7.637,9687,2391,7296,3.076,12.461,10881,3955,6926,5.088,13.997,-1194,-1.536,24.923,420,443,2670
1995,4246,9092,12940,152650,148723,1218,9.485,1020,7.943,25096,8309,16787,5.587,16.874,16999,5803,11196,3.902,11.430,8097,5.444,22.860,573,580,2370
1995,4247,8175,11434,133801,131879,661,5.768,714,6.230,19555,7215,12340,5.471,14.828,16008,4626,11382,3.508,12.138,3547,2.690,24.277,431,457,2518
1995,4248,3376,4351,141589,141138,214,4.896,254,5.811,13069,3000,10069,2.126,9.260,12041,4062,7979,2.878,8.531,1028,0.728,17.063,177,201,2656
1995,4249,23118,27859,350371,341423,3573,12.956,3013,10.925,62241,20003,42238,5.859,18.230,44558,15631,28927,4.578,13.051,17683,5.179,26.101,2239,2285,10510
1995,4251,34615,37104,316139,308007,4216,11.564,2925,8.023,57326,18806,38520,6.106,18.612,40848,14797,26051,4.804,13.262,16478,5.350,26.524,2077,2090,9602
1995,4411,39854,42578,1061714,1036855,4375,10.415,3232,7.694,127649,37772,89877,3.643,12.311,78034,25864,52170,2.494,7.526,49615,4.785,15.052,2572,2595,20716
1995,4412,10837,11606,91376,87381,1128,9.837,849,7.404,17120,4633,12487,5.302,19.592,9166,3257,5909,3.727,10.490,7954,9.103,20.979,691,700,2695
1995,4413,38528,62783,505278,495000,4902,7.855,4141,6.636,78277,31187,47090,6.300,15.814,58589,19622,38967,3.964,11.836,19688,3.977,23.672,2743,2909,12061
1995,4421,21472,28268,256784,251740,2950,10.486,2679,9.523,44600,17165,27435,6.819,17.717,34592,13882,20710,5.514,13.741,10008,3.976,27.482,1849,1960,8868
1995,4422,24036,32310,219520,215015,3682,11.498,3106,9.700,44557,19123,25434,8.894,20.723,35229,13013,22216,6.052,16.384,9328,4.338,32.769,2009,2247,8040
1995,4431,28539,41033,357430,335391,6151,15.365,4148,10.362,92632,45098,47534,13.446,27.619,49099,19566,29533,5.834,14.639,43533,12.980,29.279,2841,3026,12781
1995,4441,52067,70061,867975,840816,5848,8.412,4768,6.858,147225,67321,79904,8.007,17.510,93255,34455,58800,4.098,11.091,53970,6.419,22.182,3323,3461,15916
1995,4442,16441,20087,161701,158528,1574,7.880,1351,6.763,25665,7286,18379,4.596,16.190,19227,5517,13710,3.480,12.128,6438,4.061,24.257,986,1010,3771
1995,4451,62103,91617,2593637,2562787,9229,10.083,9056,9.894,341457,144653,196804,5.644,13.324,276656,103762,172894,4.049,10.795,64801,2.529,21.590,6042,6162,34480
1995,4452,17351,21736,135656,134376,2781,12.751,2929,13.430,29006,12446,16560,9.262,21.586,26510,11840,14670,8.811,19.728,2496,1.857,39.457,2090,2130,7833
1995,4453,23632,27712,135332,136235,2411,8.659,2675,9.607,21364,7688,13676,5.643,15.682,23113,8675,14438,6.368,16.966,-1749,-1.284,31.363,2039,2073,6385
1995,4461,44371,77864,797019,782765,7553,9.755,6680,8.627,135963,58875,77088,7.521,17.370,106781,47103,59678,6.018,13.642,29182,3.728,27.283,3883,4150,20959
1995,4471,71748,121874,907316,905279,9041,7.377,10395,8.482,155742,56417,99325,6.232,17.204,151955,61815,90140,6.828,16.785,3787,0.418,33.571,6605,6992,36092
1995,4481,43746,94312,962877,988244,10308,10.636,15508,16.002,168744,83165,85579,8.415,17.075,215633,120582,95051,12.202,21.820,-46889,-4.745,34.150,6361,7368,29961
1995,4482,7828,31803,188119,186069,3191,9.933,3837,11.944,41378,19683,21695,10.578,22.238,37650,16452,21198,8.842,20.234,3728,2.004,40.469,971,1073,4238
1995,4483,19015,28436,158489,156261,3426,12.235,2559,9.138,29373,13124,16249,8.399,18.797,24797,8973,15824,5.742,15.869,4576,2.928,31.738,1636,1708,5095
1995,4511,32242,43266,369505,356930,5288,12.251,5083,11.776,79319,32664,46655,9.151,22.223,53103,24677,28426,6.914,14.878,26216,7.345,29.755,3485,3633,13068
1995,4512,9096,14760,121920,117507,1811,12.291,1759,11.938,28831,16279,12552,13.854,24.536,19894,6798,13096,5.785,16.930,8937,7.606,33.860,1005,1049,3855
1995,4521,122,10163,1750656,1706276,451,4.479,265,2.632,180094,78138,101956,4.579,10.555,92409,24503,67906,1.436,5.416,87685,5.139,10.832,(D),(D),(D)
1995,4529,10599,24656,630673,608866,2776,11.150,3258,13.086,113069,63335,49734,10.402,18.570,69643,32006,37637,5.257,11.438,43426,7.132,22.876,1247,1579,7316
1995,4531,23146,24497,123786,122352,2558,10.450,2523,10.307,23067,7920,15147,6.473,18.853,20308,7064,13244,5.774,16.598,2759,2.255,33.196,2012,2045,5735
1995,4532,30192,40178,298279,291181,5083,12.700,4777,11.935,62744,30027,32717,10.312,21.548,48898,19218,29680,6.600,16.793,13846,4.755,33.586,3522,3678,13236
1995,4533,12518,15708,92983,91639,2278,14.700,1856,11.977,16832,7519,9313,8.205,18.368,14136,5715,8421,6.236,15.426,2696,2.942,30.851,1508,1536,4342
1995,4539,27414,32333,184926,177797,5374,17.000,3933,12.441,48187,22390,25797,12.593,27.102,33875,14315,19560,8.051,19.053,14312,8.050,38.105,3055,3171,11068
1995,4541,5867,6516,151501,149015,1107,17.485,737,11.641,27758,10195,17563,6.842,18.628,22601,9394,13207,6.304,15.167,5157,3.461,30.334,527,531,3933
1995,4542,4752,5554,71317,70312,685,12.411,616,11.160,9198,2933,6265,4.171,13.082,7123,2853,4270,4.058,10.131,2075,2.951,20.261,418,422,1690
1995,4543,18052,24471,225952,222365,2638,10.888,2153,8.886,39239,12203,27036,5.488,17.646,31691,14258,17433,6.412,14.252,7548,3.394,28.504,1274,1288,6172
1995,4811,648,3146,446578,442724,376,12.696,7,0.236,36312,7002,29310,1.582,8.202,28750,12,28738,0.003,6.494,7562,1.708,12.988,5,5,8
1995,4812,1302,1472,24407,24204,212,14.651,162,11.196,5436,1334,4102,5.512,22.460,5262,623,4639,2.574,21.741,174,0.719,43.481,114,114,353
1995,4831,454,772,37664,37023,90,11.866,63,8.306,5981,2047,3934,5.529,16.155,4469,1045,3424,2.823,12.071,1512,4.084,24.142,32,35,524
1995,4832,312,352,12422,12344,46,13.276,35,10.101,1800,408,1392,3.305,14.582,1612,169,1443,1.369,13.059,188,1.523,26.118,24,24,88
1995,4841,27865,35298,748715,714131,6841,20.205,3962,11.702,149919,51479,98440,7.209,20.993,81221,29027,52194,4.065,11.373,68698,9.620,22.747,2958,3023,16944
1995,4842,49025,53103,529590,525390,8389,15.950,7374,14.020,104621,34836,69785,6.631,19.913,96569,40420,56149,7.693,18.380,8052,1.533,36.761,5799,5843,26967
1995,4851,409,493,27753,27538,64,13.142,52,10.678,3767,1183,2584,4.296,13.680,3308,1840,1468,6.682,12.013,459,1.667,24.025,38,40,978
1995,4852,275,483,19363,19666,28,5.662,51,10.313,1839,546,1293,2.776,9.351,2475,334,2141,1.698,12.585,-636,-3.234,18.703,30,30,192
1995,4853,5503,5592,53637,52837,1001,18.010,933,16.787,12348,4743,7605,8.977,23.370,10753,5376,5377,10.175,20.351,1595,3.019,40.703,803,813,4670
1995,4854,3257,4251,143073,140685,354,8.352,329,7.762,21716,5382,16334,3.826,15.436,16519,8186,8333,5.819,11.742,5197,3.694,23.484,256,266,4127
1995,4855,1164,1280,28006,27355,139,10.923,124,9.745,4820,1279,3541,4.676,17.621,3541,1096,2445,4.007,12.945,1279,4.676,25.890,91,91,827
1995,4859,1677,1794,34472,32334,366,21.397,199,11.634,9175,3879,5296,11.997,28.376,4922,2092,2830,6.470,15.222,4253,13.153,30.445,162,162,1348
1995,4861,48,394,8790,9148,53,13.874,29,7.592,1310,732,578,8.002,14.320,2052,326,1726,3.564,22.431,-742,-8.111,28.640,(D),(D),(D)
1995,4862,152,1436,36431,37553,58,4.012,77,5.327,1965,360,1605,0.959,5.233,4169,533,3636,1.419,11.102,-2204,-5.869,10.465,9,10,149
1995,4869,64,573,6542,6277,170,34.240,17,3.424,1392,1134,258,18.067,22.178,898,114,784,1.816,14.307,494,7.871,28.615,3,3,8
1995,4871,331,369,7585,7383,51,13.747,55,14.825,1311,236,1075,3.197,17.758,906,394,512,5.337,12.272,405,5.486,24.545,37,37,235
1995,4872,1195,1229,12664,12320,180,14.778,158,12.972,2644,777,1867,6.307,21.462,1988,810,1178,6.575,16.137,656,5.325,32.274,117,117,513
1995,4879,136,140,1348,1279,27,19.780,20,14.652,329,103,226,8.056,25.733,184,49,135,3.833,14.392,145,11.341,28.784,16,16,40
1995,4881,2624,3392,95667,91836,571,17.364,364,11.069,19669,8133,11536,8.856,21.418,12029,4912,7117,5.349,13.098,7640,8.319,26.197,253,256,2033
1995,4882,446,709,17493,16431,105,15.373,53,7.760,4458,2103,2355,12.799,27.132,2289,620,1669,3.773,13.931,2169,13.201,27.862,33,34,217
1995,4883,2020,2583,82455,82179,247,9.570,243,9.415,13276,3245,10031,3.949,16.155,12603,3173,9430,3.861,15.336,673,0.819,30.672,174,177,2258
1995,4884,4595,4758,33378,32094,756,16.211,567,12.158,7761,3438,4323,10.712,24.182,5155,2524,2631,7.864,16.062,2606,8.120,32.124,445,446,1891
1995,4885,9711,12902,125903,120312,1756,13.930,1163,9.226,26788,9606,17182,7.984,22.266,15610,6182,9428,5.138,12.975,11178,9.291,25.949,871,906,4266
1995,4889,807,853,10291,10164,130,15.258,128,15.023,2055,711,1344,6.996,20.219,1815,852,963,8.383,17.858,240,2.361,35.716,93,104,633
1995,4921,1645,4630,427621,406419,720,16.129,388,8.692,59007,8978,50029,2.209,14.519,16728,6596,10132,1.623,4.116,42279,10.403,8.232,207,222,1810
1995,4922,4059,4454,64718,64257,824,18.893,639,14.651,13555,4499,9056,7.002,21.095,12616,6505,6111,10.123,19.634,939,1.461,39.268,524,544,5066
1995,4931,6588,10889,460414,447484,1041,9.658,820,7.608,80312,23951,56361,5.352,17.947,54428,14764,39664,3.299,12.163,25884,5.784,24.326,324,328,3708
1995,5111,15732,18519,688432,684551,2109,11.499,1753,9.558,68776,21134,47642,3.087,10.047,60453,24385,36068,3.562,8.831,8323,1.216,17.662,1323,1333,10127
1995,5112,6214,7674,169872,159285,1554,21.176,883,12.032,50640,25284,25356,15.873,31.792,29154,9781,19373,6.141,18.303,21486,13.489,36.606,541,552,5988
1995,5121,10995,15352,241332,229716,2202,14.522,1824,12.029,61490,31252,30238,13.605,26.768,39645,13440,26205,5.851,17.258,21845,9.510,34.517,1146,1193,8527
1995,5122,1888,1926,14358,13518,403,21.855,239,12.961,3958,1989,1969,14.714,29.281,2324,1096,1228,8.108,17.193,1634,12.088,34.385,183,183,660
1995,5151,6355,8307,244002,245082,987,11.983,846,10.271,37225,14334,22891,5.849,15.189,38736,13507,25229,5.511,15.805,-1511,-0.617,30.378,602,659,8908
1995,5152,227,410,18621,17500,71,18.112,35,8.929,3261,1082,2179,6.183,18.635,1030,454,576,2.594,5.886,2231,12.749,11.772,21,24,363
1995,5171,4724,25452,950280,945158,2462,9.701,2316,9.126,145985,49925,96060,5.282,15.446,136453,30963,105490,3.276,14.437,9532,1.009,28.874,509,534,5787
1995,5172,1905,3929,93744,88966,1099,29.416,713,19.085,30537,12109,18428,13.611,34.325,21082,14969,6113,16.826,23.697,9455,10.628,47.394,242,261,3012
1995,5174,287,399,8641,7701,109,30.320,30,8.345,3295,2171,1124,28.193,42.789,1458,530,928,6.883,18.934,1837,23.856,37.868,16,17,95
1995,5179,1953,2639,38500,36086,793,32.361,416,16.976,12108,6155,5953,17.057,33.554,7303,2544,4759,7.050,20.238,4805,13.316,40.476,176,186,1103
1995,5182,5011,7834,322980,307536,1551,20.739,840,11.232,66156,27578,38578,8.967,21.512,36038,11052,24986,3.594,11.718,30118,9.793,23.437,467,474,4911
1995,5191,2619,3078,37796,39341,255,8.380,185,6.080,5133,1768,3365,4.494,13.047,8440,4643,3797,11.802,21.453,-3307,-8.406,26.095,141,142,823
1995,5211,14,49,22604,22796,(D),(D),3,6.316,548,(D),464,(D),2.404,948,81,867,0.355,4.159,-400,-1.755,4.808,3,3,81
1995,5221,20655,98876,1952353,1956488,6580,6.683,5749,5.839,244254,88751,155503,4.536,12.484,250423,79636,170787,4.070,12.800,-6169,-0.315,24.969,720,1482,22536
1995,5222,15315,39391,470775,480344,6722,17.549,4548,11.873,95793,49405,46388,10.285,19.943,115282,39161,76121,8.153,24.000,-19489,-4.057,39.885,1835,1956,14449
1995,5223,8465,11520,99642,105167,2138,18.426,2304,19.857,26249,14828,11421,14.099,24.959,36752,16727,20025,15.905,34.946,-10503,-9.987,49.919,1562,1636,11251
1995,5231,8248,24324,382096,381207,4118,17.554,2388,10.179,63899,26539,37360,6.962,16.762,61769,15871,45898,4.163,16.204,2130,0.559,32.407,784,825,5510
1995,5232,32,51,6636,6548,8,16.162,5,10.101,451,21,430,0.321,6.888,245,233,12,3.558,3.742,206,3.146,7.483,5,5,233
1995,5239,19300,21153,183744,182918,3451,16.500,2976,14.229,41443,18425,23018,10.073,22.657,39484,19161,20323,10.475,21.586,1959,1.071,43.171,2104,2123,11305
1995,5241,4272,37998,1475336,1488877,4061,10.834,3035,8.097,164304,56169,108135,3.773,11.035,190309,45031,145278,3.024,12.782,-26005,-1.747,22.071,290,324,5579
1995,5242,109279,120354,731155,759400,11800,9.815,11541,9.600,117135,43649,73486,5.748,15.425,174841,102656,72185,13.518,23.024,-57706,-7.599,30.849,8665,8806,86009
1995,5250,2779,3184,64778,62653,482,15.793,218,7.143,14198,6494,7704,10.365,22.662,9899,2379,7520,3.797,15.800,4299,6.862,31.600,125,125,669
1995,5311,88479,96026,489817,487774,10730,11.218,9979,10.433,90310,41171,49139,8.441,18.515,86607,39791,46816,8.158,17.756,3703,0.759,35.511,7832,7963,29341
1995,5312,45282,50996,235801,232855,7609,15.053,6716,13.286,54046,23390,30656,10.045,23.210,47884,21009,26875,9.022,20.564,6162,2.646,41.128,4768,4844,14421
1995,5313,33510,39158,394229,391792,6820,17.955,4473,11.776,86110,46263,39847,11.808,21.978,80184,23181,57003,5.917,20.466,5926,1.513,40.932,3246,3323,16699
1995,5321,4864,9894,137192,135389,1129,11.462,1041,10.569,22135,5383,16752,3.976,16.349,18892,9197,9695,6.793,13.954,3243,2.395,27.908,548,580,2445
1995,5322,20567,30809,250697,240746,4413,14.455,3854,12.624,64124,22985,41139,9.547,26.636,45054,18610,26444,7.730,18.714,19070,7.921,37.429,2782,3026,13389
1995,5323,3840,6188,42647,41695,489,7.936,437,7.092,7593,2526,5067,6.058,18.211,5548,2409,3139,5.778,13.306,2045,4.905,26.613,295,319,1500
1995,5324,7414,10055,115430,112306,1184,11.863,1035,10.370,23492,7460,16032,6.643,20.918,17074,6884,10190,6.130,15.203,6418,5.715,30.406,670,702,4309
1995,5331,1670,1823,21560,20029,343,19.572,202,11.526,6724,3554,3170,17.745,33.572,3612,1589,2023,7.934,18.034,3112,15.538,36.069,140,140,785
1995,5411,150221,156992,1005777,1010541,15412,9.913,12385,7.966,123836,43069,80767,4.262,12.254,133266,38173,95093,3.777,13.188,-9430,-0.933,24.509,9218,9317,28197
1995,5412,80891,85546,783697,763047,10030,11.869,7949,9.406,136977,55257,81720,7.242,17.951,96801,31001,65800,4.063,12.686,40176,5.265,25.372,5810,5861,22512
1995,5413,71743,80774,1010513,990148,11378,14.492,6858,8.735,182971,57593,125378,5.817,18.479,141663,40704,100959,4.111,14.307,41308,4.172,28.615,4726,4806,20625
1995,5414,19736,19945,106485,102427,3778,19.484,2668,13.760,27461,11775,15686,11.496,26.810,19152,9107,10045,8.891,18.698,8309,8.112,37.396,2095,2099,7488
1995,5415,38111,43110,567506,532697,11074,27.472,5474,13.580,159823,65673,94150,12.328,30.003,89755,34543,55212,6.485,16.849,70068,13.153,33.698,3649,3708,16184
1995,5416,48121,51060,469564,452485,10631,21.551,7172,14.539,118235,45109,73126,9.969,26.130,84062,31681,52381,7.002,18.578,34173,7.552,37.156,5494,5560,23333
1995,5417,7943,10010,464792,457693,1550,15.982,927,9.558,72475,36474,36001,7.969,15.835,57528,17630,39898,3.852,12.569,14947,3.266,25.138,557,560,3644
1995,5418,30484,33366,397162,387685,5037,15.390,3764,11.500,76554,24219,52335,6.247,19.746,57649,20955,36694,5.405,14.870,18905,4.876,29.740,2939,2989,14643
1995,5419,37883,43492,385512,371515,4385,10.320,2381,5.604,79224,24861,54363,6.692,21.325,50961,13860,37101,3.731,13.717,28263,7.608,27.434,1557,1581,6650
1995,5511,28556,51726,3207995,3171350,5025,9.771,4433,8.619,528494,175024,353470,5.519,16.665,454966,123514,331452,3.895,14.346,73528,2.319,28.692,1010,1046,12767
1995,5611,17135,18616,341127,332421,3744,20.884,2368,13.208,90978,36898,54080,11.100,27.368,73125,39581,33544,11.907,21.998,17853,5.371,43.995,1828,1845,23287
1995,5612,699,1249,75210,73583,273,23.729,76,6.606,15199,7009,8190,9.525,20.656,12007,3842,8165,5.221,16.318,3192,4.338,32.635,30,31,469
1995,5613,21351,32158,2523706,2372117,6145,20.010,3248,10.577,809761,304716,505045,12.846,34.137,505751,139499,366252,5.881,21.321,304010,12.816,42.641,2208,2286,94461
1995,5614,25636,29485,456130,432819,4598,15.833,3709,12.772,113234,43282,69952,10.000,26.162,66807,23835,42972,5.507,15.435,46427,10.727,30.871,2899,2935,17323
1995,5615,25880,32500,272302,267356,3883,12.080,3170,9.862,49179,18952,30227,7.089,18.395,39712,14653,25059,5.481,14.854,9467,3.541,29.707,2147,2431,11068
1995,5616,14548,17928,601896,584241,2631,14.913,2059,11.671,120438,36485,83953,6.245,20.614,84422,27341,57081,4.680,14.450,36016,6.165,28.900,1516,1531,14973
1995,5617,103821,108563,1243619,1207232,19586,18.903,9686,9.348,273786,93255,180531,7.725,22.679,201392,62333,139059,5.163,16.682,72394,5.997,33.364,7896,7919,44266
1995,5619,19346,21125,313479,303997,3991,19.531,2610,12.773,79774,26398,53376,8.684,26.242,60875,21908,38967,7.207,20.025,18899,6.217,40.050,2063,2087,13302
1995,5621,5487,6056,94862,89726,843,14.532,333,5.740,17723,5169,12554,5.761,19.752,7430,1983,5447,2.210,8.281,10293,11.472,16.562,247,248,1404
1995,5622,1752,2714,91404,89438,341,12.781,249,9.333,14744,4353,10391,4.867,16.485,10797,3434,7363,3.840,12.072,3947,4.413,24.144,150,160,1475
1995,5629,5115,5555,83844,82445,738,13.411,634,11.521,16733,5236,11497,6.351,20.296,13827,3927,9900,4.763,16.771,2906,3.525,33.543,491,492,2568
1995,6111,14668,16849,589365,573083,805,4.893,13,0.079,59076,9816,49260,1.713,10.308,26542,43,26499,0.008,4.631,32534,5.677,9.263,3,3,4
1995,6112,582,849,73738,73788,41,4.949,0,0.000,5154,727,4427,0.985,6.985,5358,0,5358,0.000,7.261,-204,-0.276,13.970,0,0,0
1995,6113,2111,2550,1178491,1168786,120,4.817,(D),(D),68862,2064,66798,0.177,5.892,49710,(D),49708,(D),4.253,19152,1.639,8.506,0,0,0
1995,6114,4206,4628,51369,50421,961,21.603,602,13.533,12283,4997,7286,9.911,24.361,10326,4914,5412,9.746,20.480,1957,3.881,40.960,431,476,3647
1995,6115,5089,5932,64392,63172,717,12.302,510,8.750,11840,4538,7302,7.184,18.743,9444,2950,6494,4.670,14.950,2396,3.793,29.900,341,361,2219
1995,6116,17799,18913,146435,141095,3383,18.516,2099,11.488,36829,17330,19499,12.283,26.102,25988,9834,16154,6.970,18.419,10841,7.683,36.838,1644,1663,7924
1995,6117,2868,2994,25592,24349,571,19.452,454,15.466,5886,2690,3196,11.048,24.174,3427,1506,1921,6.185,14.075,2459,10.099,28.150,357,357,960
1995,6211,173670,189165,1611154,1594650,13722,7.199,16616,8.717,266994,98222,168772,6.159,16.743,233760,95957,137803,6.017,14.659,33234,2.084,29.318,13324,13685,71725
1995,6212,104036,107236,613581,602230,5069,4.753,3893,3.650,83034,20641,62393,3.427,13.788,60157,15229,44928,2.529,9.989,22877,3.799,19.978,3195,3246,12973
1995,6213,71421,75722,346266,332601,8577,11.503,6262,8.398,80983,35529,45454,10.682,24.348,53831,20570,33261,6.185,16.185,27152,8.164,32.370,4780,4897,16570
1995,6214,8884,15864,346330,329938,1991,12.894,1146,7.422,70968,30073,40895,9.115,21.509,37881,11898,25983,3.606,11.481,33087,10.028,22.962,709,781,7253
1995,6215,5327,8356,145070,147358,1242,14.697,1431,16.934,28981,12783,16198,8.675,19.667,32109,22901,9208,15.541,21.790,-3128,-2.123,39.334,669,710,7685
1995,6216,7737,13723,748962,712707,2815,21.772,1228,9.498,179368,67085,112283,9.413,25.167,107575,33473,74102,4.697,15.094,71793,10.073,30.188,617,649,11953
1995,6219,5449,7388,171862,168672,752,10.161,778,10.512,32286,9654,22632,5.724,19.141,25783,12573,13210,7.454,15.286,6503,3.855,30.572,556,580,9111
1995,6221,2904,4621,4125696,4146141,146,3.147,182,3.923,196954,55383,141571,1.336,4.750,238728,75130,163598,1.812,5.758,-41774,-1.008,9.501,72,74,34855
1995,6222,601,958,298796,300583,84,8.782,81,8.468,14293,5341,8952,1.777,4.755,17696,8005,9691,2.663,5.887,-3403,-1.132,9.510,29,31,3415
1995,6223,269,393,139490,138048,35,9.162,13,3.403,8811,1952,6859,1.414,6.383,5730,1623,4107,1.176,4.151,3081,2.232,8.301,5,6,894
1995,6231,7711,13919,1418913,1382196,1000,7.312,515,3.766,165110,66599,98511,4.818,11.945,91595,32707,58888,2.366,6.627,73515,5.319,13.254,293,317,19747
1995,6232,7532,17211,339983,330693,1865,11.275,526,3.180,55086,20127,34959,6.086,16.658,36583,8156,28427,2.466,11.063,18503,5.595,22.125,345,355,6159
1995,6233,11815,14164,385510,385948,1932,13.850,1503,10.775,52605,20101,32504,5.208,13.630,53783,30783,23000,7.976,13.935,-1178,-0.305,27.260,1011,1081,21281
1995,6239,4060,5970,156671,152100,538,9.171,331,5.642,21143,6200,14943,4.076,13.901,11962,4254,7708,2.797,7.865,9181,6.036,15.729,206,215,2686
1995,6241,24695,34033,531223,510700,3839,11.611,1901,5.749,90358,28272,62086,5.536,17.693,49400,10617,38783,2.079,9.673,40958,8.020,19.346,1291,1312,6647
1995,6242,6526,7973,82396,81082,732,9.352,440,5.622,13009,4362,8647,5.380,16.044,10350,2204,8146,2.718,12.765,2659,3.279,25.530,316,323,1507
1995,6243,5476,8572,319693,315482,583,6.833,502,5.884,45069,7663,37406,2.429,14.286,36832,4524,32308,1.434,11.675,8237,2.611,23.350,282,301,2446
1995,6244,43555,53525,567600,552068,6728,12.829,4562,8.699,101105,40062,61043,7.257,18.314,70019,24018,46001,4.351,12.683,31086,5.631,25.366,3576,3635,18758
1995,7111,6945,7011,101805,101602,1271,18.514,979,14.261,22616,9025,13591,8.883,22.260,22203,6075,16128,5.979,21.853,413,0.406,43.706,707,710,4711
1995,7112,2896,3020,79187,79193,501,16.770,436,14.594,13278,3698,9580,4.670,16.767,13369,2670,10699,3.372,16.882,-91,-0.115,33.533,347,351,2114
1995,7113,2784,2906,52762,52656,452,15.790,365,12.751,11765,3850,7915,7.312,22.343,11602,2382,9220,4.524,22.034,163,0.310,44.067,278,278,1751
1995,7114,1811,1855,12709,12565,330,18.400,207,11.542,3178,1721,1457,13.697,25.292,2863,1462,1401,11.635,22.786,315,2.507,45.571,153,153,899
1995,7115,7252,7279,35430,34147,1494,21.129,1078,15.245,11538,5178,6360,15.164,33.789,8906,3855,5051,11.289,26.081,2632,7.708,52.163,690,690,2567
1995,7121,3589,3913,77342,75956,374,9.809,174,4.563,8603,1769,6834,2.329,11.326,5831,859,4972,1.131,7.677,2772,3.650,15.354,112,112,582
1995,7131,1661,2815,114341,108148,475,17.515,269,9.919,24046,11864,12182,10.970,22.234,11144,4738,6406,4.381,10.304,12902,11.930,20.609,193,196,1791
1995,7132,1385,1648,92597,81543,294,18.864,115,7.379,30487,10180,20307,12.484,37.388,8710,1540,7170,1.889,10.682,21777,26.706,21.363,91,91,1420
1995,7139,42754,46140,773111,754316,5554,12.195,4363,9.580,141523,56776,84747,7.527,18.762,103959,35723,68236,4.736,13.782,37564,4.980,27.564,3419,3484,27008
1995,7211,31449,38319,1482518,1475693,4318,11.375,3602,9.489,215380,98206,117174,6.655,14.595,202354,94478,107876,6.402,13.712,13026,0.883,27.425,2375,2442,49645
1995,7212,4702,5093,33055,32645,559,11.134,414,8.246,6280,1823,4457,5.584,19.238,5450,1417,4033,4.341,16.695,830,2.543,33.390,269,273,810
1995,7213,3054,3147,15373,15386,237,7.449,306,9.618,2720,871,1849,5.661,17.678,2729,1282,1447,8.332,17.737,-9,-0.058,35.357,223,223,910
1995,7223,14250,27616,524336,528712,4420,15.778,5214,18.613,116232,58723,57509,11.107,21.984,125734,70068,55666,13.253,23.781,-9502,-1.797,43.968,2924,3005,27057
1995,7224,49664,50197,329511,325233,7089,14.126,7063,14.074,85556,43596,41960,13.405,26.306,76942,37019,39923,11.382,23.658,8614,2.649,47.315,5848,5861,31353
1995,7225,248604,339927,6461138,6315614,49247,14.736,37795,11.309,1355750,729924,625826,11.557,21.467,1066899,427598,639301,6.770,16.893,288851,4.574,33.786,28017,29137,282847
1995,8111,131461,142235,767913,746546,17960,12.797,14177,10.102,156089,64966,91123,8.702,20.908,113501,47765,65736,6.398,15.203,42588,5.705,30.407,10834,11044,36779
1995,8112,13491,16097,140365,140963,2058,12.872,1840,11.509,31423,13493,17930,9.572,22.292,32575,8334,24241,5.912,23.109,-1152,-0.817,44.583,1230,1278,5411
1995,8113,21707,23001,185320,179282,2675,11.762,2159,9.493,36427,11463,24964,6.394,20.318,24436,8900,15536,4.964,13.630,11991,6.688,27.260,1649,1656,5980
1995,8114,26315,27988,166219,167072,3741,13.353,3798,13.556,30241,10896,19345,6.522,18.101,31345,11562,19783,6.920,18.761,-1104,-0.661,36.201,2997,3019,8623
1995,8121,76343,87243,459180,455092,11055,12.704,10606,12.188,90000,40825,49175,8.971,19.776,81987,35536,46451,7.809,18.015,8013,1.761,36.031,8380,8684,28735
1995,8122,16486,21264,148213,143459,1616,7.692,1104,5.255,27063,11561,15502,8.059,18.865,17042,5541,11501,3.862,11.879,10021,6.985,23.759,731,778,4090
1995,8123,34785,41601,386128,382029,4309,10.349,4384,10.529,58115,21256,36859,5.564,15.212,50174,21044,29130,5.508,13.134,7941,2.079,26.267,3286,3452,15922
1995,8129,14803,23767,172745,169734,3362,14.517,2146,9.266,39679,16956,22723,9.990,23.377,32854,11088,21766,6.533,19.356,6825,4.021,38.712,1093,1190,5926
1995,8131,146949,147067,1321795,1289044,8626,6.040,137,0.096,156877,24175,132702,1.875,12.170,91369,307,91062,0.024,7.088,65508,5.082,14.176,15,15,46
1995,8132,11107,12887,158131,154316,930,7.275,723,5.656,22675,5049,17626,3.272,14.694,15116,3451,11665,2.236,9.795,7559,4.898,19.591,501,508,2174
1995,8133,10129,11872,135397,131197,1028,8.781,697,5.954,21930,4304,17626,3.281,16.715,13755,3265,10490,2.489,10.484,8175,6.231,20.969,422,430,2021
1995,8134,31276,33152,326364,329054,1640,4.944,1674,5.047,40720,8032,32688,2.441,12.375,45531,5774,39757,1.755,13.837,-4811,-1.462,24.750,1200,1202,3981
1995,8139,63823,65951,502561,499250,4056,6.213,2719,4.165,65315,15998,49317,3.204,13.083,58792,10438,48354,2.091,11.776,6523,1.307,23.552,1990,2000,7069
1996,2111,6325,7510,92701,95556,662,8.693,873,11.463,13075,4767,8308,4.989,13.683,19118,7718,11400,8.077,20.007,-6043,-6.324,27.366,574,580,2282
1996,2121,1109,1539,85341,89659,186,11.408,369,22.631,11014,3857,7157,4.302,12.284,19502,8256,11246,9.208,21.751,-8488,-9.467,24.569,249,251,4541
1996,2122,344,491,42474,42619,62,12.627,62,12.627,4265,322,3943,0.756,10.007,4345,1840,2505,4.317,10.195,-80,-0.188,20.015,35,35,1263
1996,2123,3311,5045,97495,98351,335,6.640,336,6.659,11464,2532,8932,2.574,11.656,13062,4492,8570,4.567,13.281,-1598,-1.625,23.313,211,212,1401
1996,2131,7009,8096,153084,150752,961,11.797,1061,13.025,35520,7949,27571,5.273,23.562,30984,12366,18618,8.203,20.553,4536,3.009,41.106,757,779,7846
1996,2211,1576,7697,553810,568771,685,9.129,298,3.971,38225,21652,16573,3.807,6.721,68172,8212,59960,1.444,11.986,-29947,-5.265,13.441,52,52,606
1996,2212,606,2729,103833,105879,206,7.533,217,7.936,8931,3000,5931,2.833,8.435,13053,3554,9499,3.357,12.328,-4122,-3.893,16.870,37,44,440
1996,2213,4091,4532,34189,33657,319,7.090,253,5.623,4032,1534,2498,4.558,11.980,2966,1210,1756,3.595,8.813,1066,3.167,17.625,176,178,744
1996,2361,124222,124863,642880,639641,22425,18.102,20466,16.520,175981,71265,104716,11.141,27.512,169162,67259,101903,10.515,26.446,6819,1.066,52.893,14863,14864,52461
1996,2362,37858,38544,650724,639978,5206,13.661,4334,11.373,142970,33241,109729,5.194,22.340,121145,28012,93133,4.377,18.930,21825,3.410,37.859,3214,3215,20982
1996,2371,14662,14969,328062,327383,1455,9.816,1163,7.846,63018,14947,48071,4.566,19.249,63401,10809,52592,3.302,19.366,-383,-0.117,38.498,866,868,6997
1996,2372,8538,8721,63584,63340,1838,21.639,1384,16.294,16270,7181,9089,11.337,25.687,15695,6202,9493,9.792,24.779,575,0.908,49.558,1051,1059,4256
1996,2373,9806,10227,233241,229855,921,9.040,842,8.265,44329,7723,36606,3.360,19.286,37513,7284,30229,3.169,16.320,6816,2.965,32.641,614,615,5341
1996,2379,4719,4788,59422,58992,626,12.988,690,14.315,13344,3854,9490,6.533,22.620,12579,3514,9065,5.957,21.323,765,1.297,42.647,518,519,2693
1996,2381,84757,85169,764534,747860,11829,13.994,10548,12.479,193629,53818,139811,7.196,25.891,160324,49389,110935,6.604,21.438,33305,4.453,42.875,8063,8065,39822
1996,2382,133809,135714,1399770,1371402,16071,11.992,12675,9.458,277126,65842,211284,4.801,20.207,221082,65299,155783,4.761,16.121,56044,4.087,32.242,9595,9600,45356
1996,2383,89859,90338,678954,670882,15056,16.807,13548,15.123,172651,54632,118019,8.143,25.735,156298,54383,101915,8.106,23.297,16353,2.438,46.595,10339,10352,43262
1996,2389,45261,45522,370416,365835,6386,14.201,5277,11.735,84845,24585,60260,6.720,23.192,75519,23480,52039,6.418,20.643,9326,2.549,41.286,3969,3971,18788
1996,3111,1259,1888,49338,49677,101,5.352,99,5.246,5275,2090,3185,4.207,10.619,5955,1476,4479,2.971,11.988,-680,-1.369,21.237,64,64,355
1996,3112,473,833,62464,63892,55,6.655,42,5.082,3938,1245,2693,1.949,6.164,6742,1322,5420,2.069,10.552,-2804,-4.389,12.327,27,27,194
1996,3113,1458,1634,82395,83671,150,9.066,191,11.544,7622,1653,5969,1.976,9.110,10094,2076,8018,2.481,12.064,-2472,-2.954,18.219,137,139,1043
1996,3114,1245,1665,174844,175947,110,6.577,125,7.474,16860,5977,10883,3.397,9.582,18979,4109,14870,2.335,10.787,-2119,-1.204,19.165,88,89,1900
1996,3115,1222,1734,130882,130813,94,5.379,121,6.924,11934,2359,9575,1.803,9.123,11865,4613,7252,3.526,9.070,69,0.053,18.140,71,73,1693
1996,3116,3445,4063,458564,448654,291,7.245,198,4.930,47574,8236,39338,1.836,10.604,27239,5963,21276,1.329,6.071,20335,4.532,12.143,140,140,2379
1996,3117,626,735,41714,42259,66,8.824,92,12.299,5549,1404,4145,3.322,13.131,6697,2040,4657,4.827,15.848,-1148,-2.717,26.262,65,65,1375
1996,3118,9376,10212,313955,312616,1211,11.786,1336,13.003,45088,11559,33529,3.698,14.423,42837,17770,25067,5.684,13.703,2251,0.720,27.406,930,943,7927
1996,3119,2194,2579,134362,135543,195,7.520,223,8.600,14035,3609,10426,2.663,10.355,16306,5961,10345,4.398,12.030,-2271,-1.675,20.709,169,170,2798
1996,3121,1841,2263,132988,131985,236,10.643,145,6.539,13943,2835,11108,2.148,10.564,11859,3651,8208,2.766,8.985,2084,1.579,17.970,104,105,1711
1996,3122,67,98,28723,28483,6,6.218,3,3.109,2270,126,2144,0.442,7.970,1704,841,863,2.953,5.983,566,1.987,11.965,(D),(D),(D)
1996,3131,357,592,80663,85164,29,4.813,50,8.299,3410,509,2901,0.598,4.004,12373,3468,8905,4.072,14.529,-8963,-10.524,8.008,32,32,575
1996,3132,1681,2043,222440,230840,177,8.640,188,9.177,13655,5715,7940,2.476,5.915,30423,7104,23319,3.077,13.179,-16768,-7.264,11.831,141,141,2461
1996,3133,2656,2872,108044,111866,369,12.891,350,12.227,9093,3114,5979,2.784,8.129,16872,4651,12221,4.158,15.082,-7779,-6.954,16.257,290,290,2246
1996,3141,2797,3058,117965,121614,271,8.676,402,12.870,9709,2438,7271,2.005,7.983,17017,5095,11922,4.190,13.993,-7308,-6.009,15.967,311,337,3298
1996,3149,4260,4388,113301,116044,571,13.104,510,11.704,16729,6397,10332,5.513,14.416,22416,7998,14418,6.892,19.317,-5687,-4.901,28.832,427,429,5938
1996,3151,1074,1190,109617,114682,110,9.046,162,13.322,9778,3551,6227,3.096,8.526,20017,7025,12992,6.126,17.454,-10239,-8.928,17.052,122,123,2816
1996,3152,10695,11599,546522,575323,2028,17.210,2398,20.350,79631,36051,43580,6.266,13.841,136438,59196,77242,10.289,23.715,-56807,-9.874,27.682,2034,2057,36615
1996,3159,1813,1927,56522,59840,228,11.698,272,13.956,6347,2256,4091,3.770,10.607,12946,4644,8302,7.761,21.635,-6599,-11.028,21.213,215,216,3089
1996,3161,303,330,15068,15489,33,9.985,34,10.287,1328,507,821,3.273,8.574,2132,602,1530,3.887,13.765,-804,-5.191,17.148,27,27,311
1996,3162,309,380,45990,50329,29,7.389,54,13.758,2083,291,1792,0.578,4.139,10818,3358,7460,6.672,21.495,-8735,-17.356,8.278,38,38,688
1996,3169,989,1024,29765,30901,91,8.788,114,11.009,2775,530,2245,1.715,8.980,5119,1794,3325,5.806,16.566,-2344,-7.586,17.961,87,87,902
1996,3211,4170,4663,125053,129033,320,6.745,483,10.180,10882,2867,8015,2.222,8.434,18819,5779,13040,4.479,14.585,-7937,-6.151,16.867,393,394,3424
1996,3212,1385,1736,111737,110188,115,6.659,97,5.617,11577,3395,8182,3.081,10.507,8486,1643,6843,1.491,7.701,3091,2.805,15.403,70,70,1078
1996,3219,9380,10114,305886,305703,989,9.771,1004,9.919,39603,10296,29307,3.368,12.955,39094,10972,28122,3.589,12.788,509,0.167,25.576,800,803,7042
1996,3221,220,534,178137,181242,9,1.659,26,4.793,5043,469,4574,0.259,2.782,10967,4784,6183,2.640,6.051,-5924,-3.269,5.565,9,9,145
1996,3222,3555,5235,395731,400815,281,5.387,243,4.659,26810,7500,19310,1.871,6.689,37021,10238,26783,2.554,9.236,-10211,-2.548,13.378,155,158,3627
1996,3231,39742,41688,823042,827683,2928,6.961,3683,8.755,83205,21853,61352,2.640,10.053,92590,30788,61802,3.720,11.187,-9385,-1.134,20.106,3044,3049,18950
1996,3241,1086,2036,128762,131785,109,5.375,93,4.586,6643,1378,5265,1.046,5.041,12560,3560,9000,2.701,9.531,-5917,-4.490,10.082,51,52,2141
1996,3251,1145,2323,211788,212895,135,5.796,147,6.312,14630,3772,10858,1.772,6.872,16841,6046,10795,2.840,7.910,-2211,-1.039,13.744,72,72,860
1996,3252,407,710,118132,120109,48,6.852,29,4.140,5119,1301,3818,1.083,4.262,9112,1155,7957,0.962,7.586,-3993,-3.324,8.524,19,19,773
1996,3253,626,885,38846,39335,54,6.074,62,6.974,2383,495,1888,1.258,6.058,3309,650,2659,1.652,8.412,-926,-2.354,12.116,41,42,393
1996,3254,1193,1480,199002,198151,142,9.770,89,6.123,17097,3563,13534,1.798,8.628,15570,3700,11870,1.867,7.858,1527,0.771,15.715,48,48,663
1996,3255,1571,2040,72768,72595,142,6.978,132,6.486,7255,1944,5311,2.678,9.994,6778,2479,4299,3.415,9.337,477,0.657,18.673,85,85,876
1996,3256,2019,2236,122236,122366,155,6.895,179,7.963,12292,2495,9797,2.039,10.045,12600,4355,8245,3.559,10.297,-308,-0.252,20.091,122,123,1932
1996,3259,2236,2937,125800,127916,198,6.751,190,6.478,9122,1832,7290,1.432,7.131,13345,2427,10918,1.897,10.433,-4223,-3.301,14.263,120,120,999
1996,3261,10614,12976,767779,770282,957,7.412,827,6.405,82725,21413,61312,2.780,10.740,87828,20198,67630,2.622,11.402,-5103,-0.662,21.479,599,610,10577
1996,3262,2134,2650,197968,198027,220,8.379,171,6.513,15995,5521,10474,2.788,8.077,16204,4518,11686,2.282,8.183,-209,-0.106,16.154,119,124,2329
1996,3271,1541,1812,77365,79158,172,9.524,160,8.859,6628,1703,4925,2.151,8.373,10249,2212,8037,2.794,12.948,-3621,-4.574,16.746,117,117,754
1996,3272,1759,2027,135759,137073,202,10.060,164,8.167,10453,3162,7291,2.307,7.626,12968,4988,7980,3.639,9.461,-2515,-1.835,15.252,119,119,1473
1996,3273,5686,8795,180576,178328,607,6.924,550,6.274,25492,7523,17969,4.219,14.295,20978,5761,15217,3.231,11.764,4514,2.531,23.527,307,334,3074
1996,3274,253,366,18519,18203,30,8.219,28,7.671,1718,492,1226,2.703,9.438,1086,470,616,2.582,5.966,632,3.472,11.932,17,17,151
1996,3279,2003,2340,70636,70721,210,9.065,163,7.036,7737,3026,4711,4.279,10.940,7926,2020,5906,2.856,11.207,-189,-0.267,21.880,126,128,950
1996,3311,227,296,129982,130873,21,7.059,24,8.067,4340,2138,2202,1.634,3.316,6180,383,5797,0.293,4.722,-1840,-1.406,6.632,21,21,288
1996,3312,526,718,67228,67419,41,5.734,35,4.895,4148,970,3178,1.439,6.153,4540,1085,3455,1.609,6.734,-392,-0.581,12.305,26,26,582
1996,3313,357,525,84294,86585,25,4.771,23,4.389,5936,2649,3287,3.059,6.856,10537,6543,3994,7.557,12.170,-4601,-5.314,13.711,10,10,242
1996,3314,736,915,79837,79246,52,5.655,61,6.634,6022,1107,4915,1.397,7.599,4826,1439,3387,1.816,6.090,1196,1.509,12.180,39,39,505
1996,3315,2372,2646,215117,215275,138,5.210,143,5.399,19876,5760,14116,2.676,9.233,20218,5844,14374,2.715,9.392,-342,-0.159,18.466,101,102,2532
1996,3321,3090,3295,142066,141453,171,5.198,161,4.894,13779,2356,11423,1.666,9.741,12742,3361,9381,2.376,9.008,1037,0.733,18.016,124,124,1996
1996,3322,1384,1522,76737,77542,86,5.665,78,5.138,4595,736,3859,0.949,5.926,6287,1176,5111,1.517,8.108,-1692,-2.182,11.852,57,57,488
1996,3323,10493,11268,345844,342988,815,7.254,750,6.675,42692,9230,33462,2.691,12.447,36878,11574,25304,3.374,10.752,5814,1.695,21.504,570,578,6184
1996,3324,1520,1844,104892,104955,110,6.003,87,4.748,10341,2186,8155,2.083,9.853,10457,2949,7508,2.810,9.963,-116,-0.111,19.706,55,55,1121
1996,3325,906,1001,65939,68250,58,5.788,60,5.988,3702,805,2897,1.179,5.424,8515,2279,6236,3.339,12.476,-4813,-7.052,10.848,48,48,378
1996,3326,1541,1725,69595,70007,130,7.567,116,6.752,6904,2246,4658,3.208,9.862,7932,2092,5840,2.988,11.330,-1028,-1.468,19.724,86,87,1195
1996,3327,23718,24084,389812,382492,2071,8.720,1405,5.916,51987,12056,39931,3.152,13.592,37206,10206,27000,2.668,9.727,14781,3.864,19.455,1121,1124,6910
1996,3328,5502,5929,142633,142285,393,6.666,327,5.546,17373,4580,12793,3.219,12.210,16822,5333,11489,3.748,11.823,551,0.387,23.646,254,254,3139
1996,3329,5707,6209,312153,311982,427,6.897,391,6.316,28443,6446,21997,2.066,9.117,28373,6441,21932,2.065,9.094,70,0.022,18.189,294,296,3259
1996,3331,2745,3010,197145,197879,210,6.964,221,7.329,15393,2795,12598,1.412,7.779,16839,3532,13307,1.785,8.510,-1446,-0.731,15.558,170,170,1607
1996,3332,4088,4354,178857,174553,328,7.588,265,6.131,23067,3496,19571,2.003,13.215,14479,4616,9863,2.644,8.295,8588,4.920,16.590,200,203,2136
1996,3333,2364,2489,130081,125436,193,7.737,204,8.178,21539,10121,11418,8.069,17.171,12559,3768,8791,3.004,10.012,8980,7.159,20.025,151,153,1533
1996,3334,1539,1808,168828,167511,96,5.283,114,6.274,13937,1417,12520,0.846,8.320,11263,2847,8416,1.700,6.724,2674,1.596,13.447,86,86,2192
1996,3335,9645,9998,236525,232441,656,6.602,532,5.354,26362,5453,20909,2.346,11.341,18129,4633,13496,1.993,7.799,8233,3.542,15.599,422,423,3342
1996,3336,750,901,113257,115291,45,5.006,41,4.561,7355,1902,5453,1.650,6.380,11317,1307,10010,1.134,9.816,-3962,-3.437,12.759,26,26,188
1996,3339,5701,6343,334207,331485,446,7.065,386,6.114,32687,6549,26138,1.976,9.861,27288,9264,18024,2.795,8.232,5399,1.629,16.464,272,272,3393
1996,3341,1579,1678,195230,196967,200,11.969,186,11.131,22987,3577,19410,1.816,11.671,26588,8062,18526,4.093,13.499,-3601,-1.828,23.341,135,136,1719
1996,3342,1767,1974,232376,237852,163,8.189,196,9.847,29809,5582,24227,2.347,12.533,41528,25893,15635,10.886,17.460,-11719,-4.927,25.065,126,126,2949
1996,3343,497,533,35044,36646,83,16.179,43,8.382,4393,1272,3121,3.471,11.988,7514,3468,4046,9.464,20.504,-3121,-8.517,23.975,32,32,315
1996,3344,5188,5783,544981,535499,495,8.571,479,8.294,74259,11700,62559,2.185,13.867,55371,25473,29898,4.757,10.340,18888,3.527,20.680,353,353,4236
1996,3345,4515,5101,486877,494669,334,6.513,389,7.585,39274,10715,28559,2.166,7.939,54639,21549,33090,4.356,11.046,-15365,-3.106,15.879,271,272,4250
1996,3346,709,770,47736,49304,125,16.534,97,12.831,6896,2040,4856,4.138,13.987,9883,6003,3880,12.175,20.045,-2987,-6.058,27.973,70,71,589
1996,3351,1123,1232,71529,73254,85,6.822,113,9.069,5580,1415,4165,1.932,7.617,9067,2525,6542,3.447,12.377,-3487,-4.760,15.235,86,88,707
1996,3352,331,404,106428,108378,29,7.099,38,9.302,5603,2243,3360,2.070,5.170,9378,2152,7226,1.986,8.653,-3775,-3.483,10.340,30,30,816
1996,3353,2210,2647,203249,204780,163,6.172,151,5.718,16295,2334,13961,1.140,7.957,18918,4369,14549,2.134,9.238,-2623,-1.281,15.915,97,98,1629
1996,3359,1819,2194,188143,189984,159,7.290,133,6.098,16267,3218,13049,1.694,8.562,19899,5327,14572,2.804,10.474,-3632,-1.912,17.125,77,80,1294
1996,3361,277,341,214220,221221,39,11.556,32,9.481,10171,1169,9002,0.528,4.598,24712,288,24424,0.130,11.171,-14541,-6.573,9.195,26,26,266
1996,3362,1720,1908,124115,129314,200,10.482,200,10.482,13913,4134,9779,3.197,10.759,24080,8848,15232,6.842,18.621,-10167,-7.862,21.518,158,160,4649
1996,3363,4404,5460,729525,737952,420,7.734,361,6.648,63919,22999,40920,3.117,8.662,81556,24322,57234,3.296,11.052,-17637,-2.390,17.323,245,246,4736
1996,3364,1342,1632,446965,452871,128,7.894,107,6.599,30060,11585,18475,2.558,6.638,41926,13248,28678,2.925,9.258,-11866,-2.620,13.275,68,68,769
1996,3365,179,240,31080,31158,21,8.898,13,5.508,2632,939,1693,3.014,8.447,2803,766,2037,2.458,8.996,-171,-0.549,16.895,7,7,108
1996,3366,1407,1528,136907,139061,173,11.506,124,8.247,12249,1671,10578,1.202,8.808,16350,3070,13280,2.208,11.757,-4101,-2.949,17.617,84,84,2035
1996,3369,562,592,33898,33339,101,17.766,54,9.499,5766,2643,3123,7.928,17.295,4697,2355,2342,7.064,14.089,1069,3.207,28.178,42,42,482
1996,3371,13312,13814,376576,381641,1493,10.746,1652,11.890,39195,11525,27670,3.020,10.270,49604,17144,32460,4.492,12.998,-10409,-2.727,20.540,1253,1264,10655
1996,3372,3419,3621,154325,156758,361,10.047,305,8.489,14872,4410,10462,2.813,9.487,19974,5634,14340,3.594,12.742,-5102,-3.255,18.974,233,235,3868
1996,3379,1033,1157,41287,41247,82,7.003,110,9.394,4605,979,3626,2.374,11.165,4537,1398,3139,3.389,11.000,68,0.165,21.999,87,88,879
1996,3391,10856,11432,272135,270599,984,8.649,874,7.682,30921,10151,20770,3.751,11.427,28105,9088,19017,3.358,10.386,2816,1.041,20.772,665,666,4817
1996,3399,16233,16797,415197,415920,1811,10.830,1660,9.927,52715,13254,39461,3.187,12.674,54115,15060,39055,3.621,13.011,-1400,-0.337,25.349,1351,1357,10961
1996,4231,21359,26732,321855,322475,2817,10.572,2644,9.923,44458,14707,29751,4.561,13.787,45853,18298,27555,5.674,14.219,-1395,-0.433,27.573,1785,1844,9118
1996,4232,9266,10467,131224,131080,1248,11.995,1123,10.793,20280,6709,13571,5.118,15.472,20002,6386,13616,4.872,15.259,278,0.212,30.519,836,854,4507
1996,4233,9920,13163,173387,173397,1251,9.568,1075,8.222,24193,7391,16802,4.262,13.952,24290,7313,16977,4.217,14.008,-97,-0.056,27.905,731,755,4435
1996,4234,28930,37301,612871,607619,5063,13.662,4578,12.353,110522,39140,71382,6.442,18.189,100033,39102,60931,6.435,16.463,10489,1.726,32.926,2947,3088,22295
1996,4235,7418,9824,146522,144476,878,9.060,612,6.315,18406,5559,12847,3.848,12.740,14367,3858,10509,2.670,9.944,4039,2.796,19.888,412,421,2180
1996,4236,19113,29095,403636,402661,3441,11.886,3151,10.884,73314,26179,47135,6.502,18.207,72730,34497,38233,8.567,18.062,584,0.145,36.125,1472,1515,8723
1996,4237,11662,16953,195597,194350,1274,7.568,1038,6.166,24042,6848,17194,3.524,12.370,21419,5377,16042,2.767,11.021,2623,1.350,22.042,679,708,3239
1996,4238,49352,64081,708450,697996,5398,8.477,4592,7.211,99823,31584,68239,4.525,14.301,78813,28094,50719,4.025,11.291,21010,3.010,22.583,3015,3163,16953
1996,4239,28068,30328,315670,312838,4010,13.382,3286,10.966,54789,18324,36465,5.857,17.514,49230,18878,30352,6.034,15.737,5559,1.777,31.473,2648,2689,14421
1996,4241,9580,12526,205446,202008,1126,8.978,1157,9.225,29748,7720,22028,3.822,14.726,22583,8750,13833,4.332,11.179,7165,3.547,22.359,664,680,4482
1996,4242,4385,5650,153335,151758,809,14.474,688,12.309,26641,7868,18773,5.185,17.555,23444,9992,13452,6.584,15.448,3197,2.107,30.897,412,454,4101
1996,4243,13366,14448,169502,171593,2129,14.740,2121,14.684,31831,12834,18997,7.479,18.550,35995,13381,22614,7.798,20.977,-4164,-2.427,37.101,1697,1724,10092
1996,4244,27857,33585,726173,730782,3549,10.501,3970,11.747,99416,25432,73984,3.480,13.604,108136,41434,66702,5.670,14.797,-8720,-1.193,27.208,2905,2962,22720
1996,4245,5523,8466,74237,75831,468,5.470,649,7.585,8398,2210,6188,2.914,11.075,11490,3714,7776,4.898,15.152,-3092,-4.077,22.149,409,428,2406
1996,4246,9503,13485,159069,155661,1327,9.978,955,7.181,27717,7495,20222,4.815,17.806,20721,6131,14590,3.939,13.312,6996,4.494,26.623,561,582,2360
1996,4247,7458,10678,126101,126990,715,6.643,885,8.223,18433,5065,13368,3.989,14.515,20194,5142,15052,4.049,15.902,-1761,-1.387,29.031,426,438,2301
1996,4248,3277,4251,138288,138470,218,5.097,270,6.313,12770,2821,9949,2.037,9.222,13163,4697,8466,3.392,9.506,-393,-0.284,18.444,198,199,2800
1996,4249,23391,28189,346544,344715,3765,13.456,3348,11.965,59174,19824,39350,5.751,17.166,55663,21932,33731,6.362,16.148,3511,1.019,32.295,2451,2503,13938
1996,4251,34989,37486,306044,307965,4153,11.206,3305,8.917,47548,15697,31851,5.097,15.439,51472,18856,32616,6.123,16.714,-3924,-1.274,30.879,2215,2226,10692
1996,4411,40741,43470,1076123,1059018,4698,10.954,3538,8.249,130621,43971,86650,4.152,12.334,97101,33334,63767,3.148,9.169,33520,3.165,18.338,2752,2790,26281
1996,4412,11057,11869,94757,92359,1165,9.939,870,7.422,16438,5698,10740,6.169,17.798,11639,3855,7784,4.174,12.602,4799,5.196,25.204,679,691,2953
1996,4413,37135,63305,535215,519635,5819,9.281,4607,7.348,104759,59371,45388,11.426,20.160,76642,26337,50305,5.068,14.749,28117,5.411,29.498,2797,2895,13269
1996,4421,21277,28195,252932,253700,2872,10.195,2821,10.014,39059,17312,21747,6.824,15.396,41136,14729,26407,5.806,16.214,-2077,-0.819,30.791,1969,2156,10169
1996,4422,24246,32854,227676,222813,3661,11.235,3123,9.584,44318,19490,24828,8.747,19.890,34308,12066,22242,5.415,15.398,10010,4.493,30.795,2078,2224,7402
1996,4431,29045,41413,375134,365094,6062,14.750,5431,13.215,89477,45977,43500,12.593,24.508,69240,29900,39340,8.190,18.965,20237,5.543,37.930,3328,3507,16389
1996,4441,45946,64214,843154,829776,5324,8.289,5353,8.334,136777,52349,84428,6.309,16.484,111694,43264,68430,5.214,13.461,25083,3.023,26.921,3447,3574,19203
1996,4442,16461,20252,161847,161037,1570,7.777,1444,7.152,23758,7188,16570,4.464,14.753,22140,5746,16394,3.568,13.748,1618,1.005,27.497,1030,1042,3976
1996,4451,61837,91098,2627710,2603691,9134,10.021,9235,10.132,319225,136902,182323,5.258,12.260,268142,104383,163759,4.009,10.299,51083,1.962,20.597,6393,6532,43178
1996,4452,17033,21637,138521,135804,2894,13.387,2856,13.211,32382,12473,19909,9.185,23.845,27199,12714,14485,9.362,20.028,5183,3.817,40.056,2147,2162,9053
1996,4453,23375,26995,133461,133830,2387,8.749,2961,10.853,21546,7758,13788,5.797,16.100,22456,9095,13361,6.796,16.780,-910,-0.680,32.199,1984,2019,6135
1996,4461,43170,77591,785102,786199,6868,8.868,6580,8.496,122486,52708,69778,6.704,15.580,125784,46618,79166,5.930,15.999,-3298,-0.419,31.159,4066,4271,22724
1996,4471,69851,120366,904845,903860,9580,7.924,10634,8.796,159902,61053,98849,6.755,17.691,157969,62106,95863,6.871,17.477,1933,0.214,34.954,6659,7046,37034
1996,4481,41373,91834,902063,931286,9958,10.736,11795,12.717,155315,75512,79803,8.108,16.677,213511,65695,147816,7.054,22.926,-58196,-6.249,33.355,6252,7260,29164
1996,4482,7337,30472,184489,186120,1862,6.001,2973,9.582,35356,12611,22745,6.776,18.996,38823,12505,26318,6.719,20.859,-3467,-1.863,37.993,914,1027,3344
1996,4483,18796,28302,150978,153635,2777,9.827,2688,9.513,24905,10392,14513,6.764,16.210,30795,11576,19219,7.535,20.044,-5890,-3.834,32.421,1678,1839,7855
1996,4511,31974,43679,381401,373866,5517,12.728,4847,11.183,74988,36123,38865,9.662,20.057,60093,23789,36304,6.363,16.073,14895,3.984,32.147,3485,3669,14062
1996,4512,8938,14635,126469,123589,1526,10.393,1622,11.047,27331,11608,15723,9.392,22.114,20830,7294,13536,5.902,16.854,6501,5.260,33.709,1047,1065,3756
1996,4521,105,10182,1775896,1760963,403,3.966,363,3.572,192568,67184,125384,3.815,10.935,167945,39998,127947,2.271,9.537,24623,1.398,19.074,3,3,260
1996,4529,10428,25046,648335,641322,2764,11.129,2346,9.446,91281,44642,46639,6.961,14.233,77449,22724,54725,3.543,12.076,13832,2.157,24.153,1299,1376,6907
1996,4531,22740,24073,122019,121755,2388,9.871,2628,10.863,20723,7323,13400,6.015,17.020,20223,7657,12566,6.289,16.610,500,0.411,33.219,2135,2166,6199
1996,4532,29586,39581,296969,293321,5078,12.906,4606,11.707,60410,29538,30872,10.070,20.595,54168,22804,31364,7.774,18.467,6242,2.128,36.934,3489,3617,13234
1996,4533,12563,15843,92749,91297,2356,15.088,1901,12.174,18792,8159,10633,8.937,20.583,16026,5670,10356,6.211,17.554,2766,3.030,35.108,1442,1454,3492
1996,4539,28600,33876,198046,191685,5562,16.786,4081,12.316,49505,24556,24949,12.811,25.826,36649,15219,21430,7.940,19.119,12856,6.707,38.239,3201,3276,11587
1996,4541,6974,7654,166408,162889,1227,16.592,709,9.588,30868,12915,17953,7.929,18.950,24175,6793,17382,4.170,14.841,6693,4.109,29.683,529,530,2791
1996,4542,4928,5720,70265,70440,804,14.277,627,11.134,9331,3722,5609,5.284,13.247,9806,3600,6206,5.111,13.921,-475,-0.674,26.493,477,477,2120
1996,4543,18536,24776,219216,220798,2751,11.221,2232,9.104,36774,12553,24221,5.685,16.655,39256,17954,21302,8.131,17.779,-2482,-1.124,33.310,1387,1415,7120
1996,4811,649,3104,464747,446571,316,10.706,11,0.373,51794,17200,34594,3.852,11.598,16846,53,16793,0.012,3.772,34948,7.826,7.545,6,6,17
1996,4812,1386,1560,26187,25027,236,15.629,136,9.007,6080,1718,4362,6.865,24.294,3490,913,2577,3.648,13.945,2590,10.349,27.890,101,108,790
1996,4831,473,806,41088,39671,92,11.551,73,9.165,8769,2836,5933,7.149,22.105,6253,1306,4947,3.292,15.762,2516,6.342,31.525,35,40,863
1996,4832,339,375,12537,12498,55,15.007,38,10.368,2036,774,1262,6.193,16.291,1891,522,1369,4.177,15.130,145,1.160,30.261,25,25,120
1996,4841,29428,37154,778775,767625,6443,17.775,4632,12.778,119477,40033,79444,5.215,15.565,97361,28978,68383,3.775,12.683,22116,2.881,25.367,3383,3440,19433
1996,4842,48821,52585,517774,520689,7902,15.005,8056,15.298,94754,33042,61712,6.346,18.198,100876,43083,57793,8.274,19.374,-6122,-1.176,36.396,6217,6268,29805
1996,4851,445,545,29266,28754,90,17.192,47,8.978,3968,2599,1369,9.039,13.800,3000,751,2249,2.612,10.433,968,3.366,20.867,40,40,635
1996,4852,248,420,17887,18439,33,7.458,78,17.627,1576,312,1264,1.692,8.547,2677,637,2040,3.455,14.518,-1101,-5.971,17.094,28,33,164
1996,4853,5434,5517,55420,54612,915,16.460,999,17.971,11797,5059,6738,9.264,21.601,10246,5112,5134,9.361,18.761,1551,2.840,37.523,862,863,4400
1996,4854,3220,4254,144936,142870,341,8.037,319,7.518,17843,7067,10776,4.946,12.489,13677,6758,6919,4.730,9.573,4166,2.916,19.146,265,272,3518
1996,4855,1220,1338,28784,28287,188,14.324,137,10.438,5199,1113,4086,3.935,18.380,4257,1534,2723,5.423,15.050,942,3.330,30.099,104,104,1175
1996,4859,1834,1965,36832,35241,393,20.966,212,11.310,8407,3738,4669,10.607,23.856,5259,2516,2743,7.140,14.923,3148,8.933,29.846,157,157,1047
1996,4861,49,377,7862,8325,38,9.819,58,14.987,977,433,544,5.201,11.736,1897,392,1505,4.709,22.787,-920,-11.051,23.471,(D),(D),(D)
1996,4862,151,1359,35370,36343,97,6.931,178,12.719,3548,1405,2143,3.866,9.763,5447,1698,3749,4.672,14.988,-1899,-5.225,19.525,16,16,72
1996,4869,59,539,6301,6417,35,6.306,67,12.072,759,225,534,3.507,11.829,971,440,531,6.857,15.133,-212,-3.304,23.658,6,6,37
1996,4871,332,368,7690,7654,53,14.461,50,13.643,958,242,716,3.162,12.517,854,306,548,3.998,11.158,104,1.359,22.317,40,40,273
1996,4872,1212,1249,12213,12154,196,15.954,155,12.617,2488,795,1693,6.541,20.471,2363,818,1545,6.731,19.443,125,1.029,38.886,122,122,640
1996,4879,136,139,1411,1351,26,18.978,22,16.058,319,87,232,6.442,23.621,195,123,72,9.108,14.439,124,9.182,28.878,17,17,115
1996,4881,2754,3604,101262,98903,571,16.342,351,10.046,20815,7909,12906,7.997,21.046,15877,3940,11937,3.984,16.053,4938,4.993,32.106,232,239,1484
1996,4882,446,723,18033,17886,79,10.965,74,10.271,3447,1671,1776,9.343,19.272,3126,1031,2095,5.764,17.477,321,1.795,34.955,45,46,619
1996,4883,2030,2601,80261,81289,251,9.641,256,9.833,11143,2020,9123,2.485,13.708,13462,3226,10236,3.969,16.561,-2319,-2.853,27.416,169,173,1181
1996,4884,4844,5038,36665,35038,853,17.412,575,11.737,8740,3699,5041,10.557,24.945,5492,2602,2890,7.426,15.675,3248,9.270,31.349,483,485,2316
1996,4885,10250,13581,129898,127074,1822,13.712,1236,9.302,23994,8465,15529,6.661,18.882,18209,6786,11423,5.340,14.329,5785,4.552,28.659,892,935,4825
1996,4889,844,886,10814,10647,131,14.886,119,13.523,2253,672,1581,6.312,21.161,1889,717,1172,6.734,17.742,364,3.419,35.484,94,98,645
1996,4921,1725,4814,462232,444627,631,13.454,383,8.166,76849,7162,69687,1.611,17.284,40753,29735,11018,6.688,9.166,36096,8.118,18.331,214,225,2108
1996,4922,4253,4664,69892,67860,802,17.467,657,14.309,16668,8141,8527,11.997,24.563,12575,4778,7797,7.041,18.531,4093,6.032,37.062,557,566,3811
1996,4931,6713,11293,472137,466174,1245,11.213,866,7.799,81487,29374,52113,6.301,17.480,68929,22563,46366,4.840,14.786,12558,2.694,29.572,318,324,3473
1996,5111,15921,18738,672181,675741,1977,10.599,1807,9.687,58768,16784,41984,2.484,8.697,66751,18459,48292,2.732,9.878,-7983,-1.181,17.394,1437,1451,10800
1996,5112,6744,8441,184148,173866,1682,20.978,836,10.427,45571,15810,29761,9.093,26.210,25053,9096,15957,5.232,14.409,20518,11.801,28.819,518,542,5028
1996,5121,11445,15736,243384,242457,2349,15.145,1898,12.237,56468,17289,39179,7.131,23.290,53307,28771,24536,11.866,21.986,3161,1.304,43.972,1178,1204,6702
1996,5122,2112,2179,19065,18523,460,22.153,255,12.280,4070,1710,2360,9.232,21.973,3036,1196,1840,6.457,16.391,1034,5.582,32.782,194,194,895
1996,5151,6285,8295,235308,238587,917,11.082,877,10.598,31391,13103,18288,5.492,13.157,37672,12397,25275,5.196,15.790,-6281,-2.633,26.314,672,720,8716
1996,5152,232,448,22088,20485,112,25.956,79,18.308,7545,4862,2683,23.734,36.832,4321,1942,2379,9.480,21.093,3224,15.738,42.187,27,28,276
1996,5171,4843,25241,960771,957263,3423,13.511,3611,14.253,192480,82043,110437,8.571,20.107,186616,71855,114761,7.506,19.495,5864,0.613,38.990,732,794,7826
1996,5172,2201,4821,122166,108012,1488,33.872,632,14.387,46372,25940,20432,24.016,42.932,17791,11275,6516,10.439,16.471,28581,26.461,32.943,290,345,4431
1996,5174,347,457,9551,9207,93,21.330,51,11.697,3775,1256,2519,13.642,41.001,3099,1970,1129,21.397,33.659,676,7.342,67.318,22,22,655
1996,5179,2901,3429,45593,42714,1346,43.973,610,19.928,17393,8318,9075,19.474,40.720,11499,5358,6141,12.544,26.921,5894,13.799,53.842,254,259,1710
1996,5182,4952,8319,336089,328786,1572,19.594,980,12.215,59152,24944,34208,7.587,17.991,44121,11258,32863,3.424,13.419,15031,4.572,26.839,466,475,3169
1996,5191,2845,3467,46546,45319,334,9.850,182,5.367,7102,1899,5203,4.190,15.671,4735,944,3791,2.083,10.448,2367,5.223,20.896,139,139,513
1996,5211,16,47,22738,22711,(D),(D),(D),(D),582,(D),549,(D),2.563,565,(D),475,(D),2.488,17,0.075,4.976,0,0,0
1996,5221,19861,99703,1911395,1930184,6723,6.778,5699,5.745,242463,91516,150947,4.741,12.562,279180,84850,194330,4.396,14.464,-36717,-1.902,25.123,603,1184,16221
1996,5222,16106,41500,493841,481307,6538,16.195,4281,10.604,120237,49958,70279,10.380,24.981,95138,42161,52977,8.760,19.767,25099,5.215,39.533,1462,1604,11650
1996,5223,9084,12350,126263,112381,2648,22.258,1742,14.642,47531,26134,21397,23.255,42.295,20456,10509,9947,9.351,18.202,27075,24.092,36.405,998,1068,4409
1996,5231,8944,25316,406209,393424,3260,13.132,2276,9.169,69746,19412,50334,4.934,17.728,44125,18062,26063,4.591,11.216,25621,6.512,22.431,790,803,4793
1996,5232,29,46,6418,6516,7,14.433,12,24.742,118,27,91,0.414,1.811,313,91,222,1.397,4.804,-195,-2.993,3.622,6,6,70
1996,5239,20048,22060,195559,188314,3833,17.828,2712,12.614,49767,19917,29850,10.577,26.428,35499,14998,20501,7.964,18.851,14268,7.577,37.702,1934,1940,8335
1996,5241,4456,38014,1501684,1485831,4076,10.732,4006,10.548,204709,79330,125379,5.339,13.777,172866,50083,122783,3.371,11.634,31843,2.143,23.269,289,350,5314
1996,5242,109930,121162,740756,733655,11973,9.923,10963,9.086,128178,45974,82204,6.266,17.471,112812,47457,65355,6.469,15.377,15366,2.094,30.753,7877,8070,31495
1996,5250,2954,3400,73663,69337,427,12.979,207,6.292,16912,4981,11931,7.184,24.391,7988,1263,6725,1.822,11.521,8924,12.870,23.041,115,116,700
1996,5311,88644,96703,487899,487542,10696,11.100,10007,10.385,89038,39935,49103,8.191,18.263,88014,38671,49343,7.932,18.053,1024,0.210,36.105,7914,8012,29490
1996,5312,45659,51259,230681,231842,7374,14.441,6985,13.679,47478,20850,26628,8.993,20.479,49876,22238,27638,9.592,21.513,-2398,-1.034,40.957,4888,5102,15801
1996,5313,34959,40892,398607,394426,5779,14.400,4259,10.612,77990,33698,44292,8.544,19.773,69528,20991,48537,5.322,17.628,8462,2.145,35.255,2851,2917,14539
1996,5321,4789,9680,146984,142149,898,9.168,1127,11.506,28477,6452,22025,4.539,20.033,18244,6770,11474,4.763,12.834,10233,7.199,25.669,572,598,3817
1996,5322,19354,30270,214063,231259,4069,13.369,4403,14.466,46218,20141,26077,8.709,19.985,78288,24849,53439,10.745,33.853,-32070,-13.868,39.971,3089,3491,17698
1996,5323,3813,6189,41760,41976,476,7.708,449,7.271,6595,2122,4473,5.055,15.711,7099,2415,4684,5.753,16.912,-504,-1.201,31.423,285,305,1422
1996,5324,7515,10277,119337,117053,1329,13.090,1080,10.638,23862,8090,15772,6.911,20.386,19282,7066,12216,6.037,16.473,4580,3.913,32.946,641,663,3329
1996,5331,1424,1532,16556,16381,284,18.454,298,19.363,4834,1426,3408,8.705,29.511,4456,2881,1575,17.588,27.203,378,2.308,54.406,194,212,1234
1996,5411,152150,159065,993060,993486,15258,9.671,12667,8.029,123970,44181,79789,4.447,12.478,124326,36520,87806,3.676,12.514,-356,-0.036,24.957,9675,9749,28608
1996,5412,82720,87635,887987,876207,9787,11.268,8234,9.480,141723,48718,93005,5.560,16.175,117492,34024,83468,3.883,13.409,24231,2.765,26.818,5993,6090,23479
1996,5413,74441,83626,1034752,1017596,11051,13.526,7207,8.821,178427,52337,126090,5.143,17.534,144772,47910,96862,4.708,14.227,33655,3.307,28.454,4931,5016,22468
1996,5414,19507,19698,101457,99736,3620,18.703,2935,15.164,24264,10806,13458,10.835,24.328,20903,10505,10398,10.533,20.958,3361,3.370,41.917,2264,2267,8180
1996,5415,44025,49623,639475,600173,12869,27.745,6390,13.776,188236,80889,107347,13.478,31.364,109612,45014,64598,7.500,18.263,78624,13.100,36.527,4309,4380,22345
1996,5416,52558,55753,508110,493080,11649,21.681,7601,14.147,127464,50100,77364,10.161,25.851,97726,34401,63325,6.977,19.820,29738,6.031,39.639,5759,5803,25262
1996,5417,8445,10623,471126,466165,1560,15.063,1027,9.916,78669,24652,54017,5.288,16.876,70473,27285,43188,5.853,15.118,8196,1.758,30.235,607,624,4664
1996,5418,31153,34177,413702,404298,5096,15.141,4058,12.057,81037,28565,52472,7.065,20.044,62282,21810,40472,5.395,15.405,18755,4.639,30.810,3258,3283,14920
1996,5419,38410,44287,381828,378643,4303,9.938,2328,5.377,64786,19168,45618,5.062,17.110,58290,19475,38815,5.143,15.394,6496,1.716,30.789,1644,1669,8438
1996,5511,28235,51664,3183720,3188999,4851,9.410,4622,8.966,508205,150407,357798,4.716,15.936,519257,154447,364810,4.843,16.283,-11052,-0.347,31.872,1023,1075,16028
1996,5611,15711,16705,277185,270618,3687,22.649,2835,17.415,78633,39499,39134,14.596,29.057,65686,33372,32314,12.332,24.273,12947,4.784,48.545,1978,2005,23189
1996,5612,866,1647,79554,78137,314,20.429,94,6.116,19875,10633,9242,13.608,25.436,16431,8701,7730,11.136,21.028,3444,4.408,42.057,30,32,457
1996,5613,22321,34615,2709117,2599079,6321,18.957,3780,11.336,847152,262639,584513,10.105,32.594,631195,182170,449025,7.009,24.285,215957,8.309,48.571,2333,2447,107402
1996,5614,24669,28679,490487,465842,4478,15.793,3828,13.501,120750,51619,69131,11.081,25.921,71959,24194,47765,5.194,15.447,48791,10.474,30.894,2981,3029,15652
1996,5615,25675,32795,275940,271834,4325,13.314,3705,11.405,52297,24365,27932,8.963,19.239,44558,16681,27877,6.136,16.392,7739,2.847,32.783,2493,2577,10895
1996,5616,15128,19088,619412,611806,2851,15.155,2300,12.226,123881,37284,86597,6.094,20.248,109656,45079,64577,7.368,17.923,14225,2.325,35.847,1615,1646,21571
1996,5617,107552,112364,1270172,1242227,18955,17.540,10358,9.585,260862,82541,178321,6.645,21.000,204769,60427,144342,4.864,16.484,56093,4.516,32.968,8559,8591,45604
1996,5619,17451,19295,295403,289261,3775,19.996,2942,15.584,73080,27598,45482,9.541,25.264,60804,24421,36383,8.443,21.020,12276,4.244,42.041,2199,2234,15200
1996,5621,5620,6279,99400,96251,770,12.582,452,7.386,15784,5665,10119,5.886,16.399,9521,2731,6790,2.837,9.892,6263,6.507,19.784,351,351,2034
1996,5622,1729,2638,85142,87920,280,10.475,350,13.094,12067,2637,9430,2.999,13.725,17194,6059,11135,6.892,19.557,-5127,-5.831,27.450,191,204,2596
1996,5629,5269,5727,85820,85343,726,12.809,608,10.727,21523,9464,12059,11.089,25.220,21331,10274,11057,12.039,24.995,192,0.225,49.989,465,467,2538
1996,6111,14885,17083,598861,588299,857,5.143,19,0.114,53174,11979,41195,2.036,9.039,31937,88,31849,0.015,5.429,21237,3.610,10.857,4,4,25
1996,6112,573,827,71533,70825,50,6.231,(D),(D),6101,984,5117,1.389,8.614,4557,(D),4556,(D),6.434,1544,2.180,12.868,(D),(D),(D)
1996,6113,2118,2572,1141690,1137501,126,5.020,(D),(D),62440,3350,59090,0.295,5.489,54203,(D),54195,(D),4.765,8237,0.724,9.530,0,0,0
1996,6114,4647,5099,54743,53181,1056,21.540,663,13.524,12965,5506,7459,10.353,24.379,9900,4949,4951,9.306,18.616,3065,5.763,37.232,499,512,3662
1996,6115,5289,6153,66722,65361,821,13.604,585,9.693,12928,4550,8378,6.961,19.780,10313,4253,6060,6.507,15.779,2615,4.001,31.557,398,415,2082
1996,6116,18548,19744,145317,142124,3325,17.246,2397,12.433,32506,14099,18407,9.920,22.872,26211,10901,15310,7.670,18.442,6295,4.429,36.885,1936,1952,8829
1996,6117,2989,3132,26814,26308,595,19.293,499,16.180,5756,2251,3505,8.556,21.879,4710,1692,3018,6.432,17.903,1046,3.976,35.807,404,404,1329
1996,6211,167424,184833,1619491,1611376,13601,7.289,17118,9.174,262594,96901,165693,6.014,16.296,245919,108647,137272,6.742,15.261,16675,1.035,30.523,13684,14074,78854
1996,6212,104346,107708,625855,617301,5016,4.678,4069,3.794,81420,21224,60196,3.438,13.190,64120,16705,47415,2.706,10.387,17300,2.803,20.774,3311,3347,14170
1996,6213,72558,77144,357564,351756,8537,11.180,6963,9.119,73414,29802,43612,8.472,20.871,61666,23691,37975,6.735,17.531,11748,3.340,35.062,5327,5465,18287
1996,6214,8988,16884,371114,359799,2372,14.495,1333,8.146,73060,32298,40762,8.977,20.306,49878,18328,31550,5.094,13.863,23182,6.443,27.726,765,845,10312
1996,6215,5218,7670,141325,142431,976,12.195,1642,20.517,22496,9305,13191,6.533,15.794,24803,14507,10296,10.185,17.414,-2307,-1.620,31.589,631,661,5817
1996,6216,8718,14987,783737,763339,3045,21.192,1808,12.583,188580,77390,111190,10.138,24.705,149420,60339,89081,7.905,19.575,39160,5.130,39.149,654,745,20165
1996,6219,5282,7306,182077,179024,706,9.546,886,11.979,36642,8898,27744,4.970,20.468,30074,12935,17139,7.225,16.799,6568,3.669,33.598,570,602,8145
1996,6221,2726,4503,4049159,4051076,128,2.840,135,2.996,224529,71182,153347,1.757,5.542,225200,56051,169149,1.384,5.559,-671,-0.017,11.085,68,68,25202
1996,6222,551,840,275883,287080,30,3.429,100,11.429,12234,5519,6715,1.922,4.262,34132,11489,22643,4.002,11.889,-21898,-7.628,8.523,28,32,6639
1996,6223,230,365,133076,134492,21,5.730,24,6.548,7466,3560,3906,2.647,5.551,10169,2154,8015,1.602,7.561,-2703,-2.010,11.103,12,12,815
1996,6231,7787,14225,1444443,1428901,880,6.256,565,4.016,143052,54002,89050,3.779,10.011,111316,32342,78974,2.263,7.790,31736,2.221,15.581,310,321,17099
1996,6232,7679,18486,351165,343965,1903,10.671,599,3.359,54652,20176,34476,5.866,15.889,40385,10269,30116,2.985,11.741,14267,4.148,23.482,374,391,5847
1996,6233,12033,14336,378798,381364,2053,14.427,1841,12.937,56533,22998,33535,6.030,14.824,61836,36041,25795,9.451,16.214,-5303,-1.391,29.648,1181,1245,22333
1996,6239,4060,6166,160701,158642,585,9.643,386,6.363,19659,6591,13068,4.155,12.392,15688,4733,10955,2.983,9.889,3971,2.503,19.778,244,258,2871
1996,6241,25785,35820,540969,532446,4031,11.544,2231,6.389,79854,27074,52780,5.085,14.998,63039,12686,50353,2.383,11.840,16815,3.158,23.679,1449,1490,7787
1996,6242,6688,8251,82396,81715,754,9.291,482,5.940,12112,4438,7674,5.431,14.822,10695,2789,7906,3.413,13.088,1417,1.734,26.176,338,340,1793
1996,6243,5513,8676,311712,314001,685,7.956,552,6.412,40272,8256,32016,2.629,12.825,44652,7714,36938,2.457,14.220,-4380,-1.395,25.651,258,314,3833
1996,6244,44740,55241,585338,575370,6763,12.443,4989,9.179,95997,40838,55159,7.098,16.684,76346,27010,49336,4.694,13.269,19651,3.415,26.538,3969,4039,20932
1996,7111,7121,7202,97968,98738,1204,17.002,963,13.599,21656,7365,14291,7.459,21.933,23239,5502,17737,5.572,23.536,-1583,-1.603,43.866,699,700,4129
1996,7112,2986,3105,81399,78695,571,18.691,471,15.417,19523,6995,12528,8.889,24.808,14017,5109,8908,6.492,17.812,5506,6.997,35.624,368,374,3593
1996,7113,2912,3048,58462,55109,502,16.925,338,11.396,14939,5060,9879,9.182,27.108,8133,2411,5722,4.375,14.758,6806,12.350,29.516,255,257,2096
1996,7114,1897,1945,11453,11366,379,20.344,215,11.541,3097,1834,1263,16.137,27.249,2943,1509,1434,13.277,25.894,154,1.355,51.788,168,168,1069
1996,7115,7450,7472,38009,35139,1509,20.738,1118,15.365,15972,4842,11130,13.780,45.454,10300,3973,6327,11.307,29.312,5672,16.142,58.624,724,726,2374
1996,7121,3715,4047,77169,76819,331,8.319,195,4.901,7406,1119,6287,1.457,9.641,6867,672,6195,0.875,8.939,539,0.702,17.879,134,134,561
1996,7131,1739,2939,131684,126609,321,10.915,325,11.051,26588,11797,14791,9.318,21.000,16216,2565,13651,2.026,12.808,10372,8.192,25.616,243,247,1697
1996,7132,1429,1737,121509,111412,303,18.231,153,9.206,30356,13637,16719,12.240,27.247,10592,1133,9459,1.017,9.507,19764,17.740,19.014,112,112,880
1996,7139,43217,46684,762660,760102,5456,11.790,4639,10.025,124781,48466,76315,6.376,16.416,119283,40923,78360,5.384,15.693,5498,0.723,31.386,3637,3679,31969
1996,7211,32068,39319,1514866,1499145,4541,11.702,3512,9.050,245546,142766,102780,9.523,16.379,213891,101264,112627,6.755,14.268,31655,2.112,28.535,2444,2510,61757
1996,7212,4862,5316,35343,34381,582,11.081,454,8.644,7387,2741,4646,7.973,21.486,5499,1608,3891,4.677,15.995,1888,5.491,31.989,313,314,1232
1996,7213,2974,3071,15834,15651,217,6.989,285,9.179,2755,1014,1741,6.479,17.603,2346,981,1365,6.268,14.989,409,2.613,29.979,219,219,810
1996,7223,12809,27337,500832,510740,4517,16.462,4720,17.202,93134,49119,44015,9.617,18.235,113455,56721,56734,11.106,22.214,-20321,-3.979,36.470,2876,2937,25276
1996,7224,48833,49368,327912,328068,6697,13.467,7419,14.919,79011,40384,38627,12.310,24.084,79764,38994,40770,11.886,24.313,-753,-0.230,48.167,6264,6278,32657
1996,7225,254515,348875,6632647,6534044,49225,14.306,39657,11.525,1313134,723945,589189,11.080,20.097,1113937,442593,671344,6.774,17.048,199197,3.049,34.096,29007,30021,283636
1996,8111,134242,146021,802020,783436,18331,12.727,14350,9.963,160088,68661,91427,8.764,20.434,122670,50751,71919,6.478,15.658,37418,4.776,31.316,11094,11298,40550
1996,8112,13873,16502,147149,143539,2285,13.982,1966,12.030,32145,11728,20417,8.171,22.395,24873,10051,14822,7.002,17.328,7272,5.066,34.657,1281,1362,5571
1996,8113,21874,23195,189202,186217,2562,11.133,2199,9.555,34336,11162,23174,5.994,18.439,28268,9781,18487,5.252,15.180,6068,3.259,30.360,1654,1659,6398
1996,8114,26291,27977,160121,162851,3615,12.915,3642,13.012,26302,9942,16360,6.105,16.151,31486,12248,19238,7.521,19.334,-5184,-3.183,32.302,2955,2964,9210
1996,8121,76027,86824,457136,455601,11258,12.971,11199,12.903,91345,44963,46382,9.869,20.049,87484,37026,50458,8.127,19.202,3861,0.847,38.404,8879,9078,29382
1996,8122,16144,21124,147848,146965,1328,6.294,1277,6.053,24038,9424,14614,6.412,16.356,21991,7348,14643,5.000,14.963,2047,1.393,29.927,799,850,4171
1996,8123,34574,41231,384835,383407,4309,10.425,4513,10.919,57094,22817,34277,5.951,14.891,54348,21453,32895,5.595,14.175,2746,0.716,28.350,3380,3524,16352
1996,8129,15061,24072,184776,177727,3410,14.441,2493,10.558,46288,19136,27152,10.767,26.044,32741,13701,19040,7.709,18.422,13547,7.622,36.844,1204,1292,7449
1996,8131,150703,150822,1372117,1340209,8626,5.883,236,0.161,164537,24611,139926,1.836,12.277,100507,513,99994,0.038,7.499,64030,4.778,14.999,43,43,86
1996,8132,11731,13568,161959,161049,1005,7.489,707,5.269,20278,4318,15960,2.681,12.591,18452,2955,15497,1.835,11.457,1826,1.134,22.915,495,507,2142
1996,8133,10506,12331,143436,143651,989,8.117,697,5.720,18431,5052,13379,3.517,12.830,18731,3751,14980,2.611,13.039,-300,-0.209,25.661,464,479,2518
1996,8134,30811,32684,321639,320240,1489,4.536,1775,5.407,37283,6287,30996,1.963,11.642,34482,6167,28315,1.926,10.768,2801,0.875,21.535,1321,1322,4500
1996,8139,63977,66094,500830,498045,3993,6.099,2735,4.178,64745,15157,49588,3.043,13.000,58923,11552,47371,2.319,11.831,5822,1.169,23.662,2032,2036,7657
1997,2111,6198,7340,98571,95241,726,9.804,856,11.560,27534,7985,19549,8.384,28.910,20728,7034,13694,7.385,21.764,6806,7.146,43.527,532,537,2360
1997,2121,968,1373,85004,85383,179,12.583,278,19.543,13778,6232,7546,7.299,16.137,14334,6154,8180,7.208,16.788,-556,-0.651,32.273,169,174,3147
1997,2122,332,465,42608,42259,71,15.187,76,16.257,4712,881,3831,2.085,11.150,3958,1192,2766,2.821,9.366,754,1.784,18.732,47,49,559
1997,2123,3269,5007,98346,97943,363,7.269,337,6.748,14342,4229,10113,4.318,14.643,13559,3430,10129,3.502,13.844,783,0.799,27.688,184,189,1427
1997,2131,7008,8118,156738,155253,1103,13.600,1088,13.415,40939,16636,24303,10.715,26.369,37463,21466,15997,13.826,24.130,3476,2.239,48.261,688,692,6608
1997,2211,1547,7709,552930,561043,464,6.029,438,5.691,38464,13759,24705,2.452,6.856,54377,7045,47332,1.256,9.692,-15913,-2.836,13.712,69,69,780
1997,2212,580,2633,100303,99867,179,6.756,212,8.002,12631,3688,8943,3.693,12.648,11534,3422,8112,3.427,11.549,1097,1.098,23.099,58,61,924
1997,2213,4086,4545,33780,33582,282,6.216,265,5.842,4238,1318,2920,3.925,12.620,3876,1697,2179,5.053,11.542,362,1.078,23.084,185,186,754
1997,2361,125888,126502,639577,625561,23334,18.700,19897,15.945,183938,73969,109969,11.824,29.404,155799,68419,87380,10.937,24.905,28139,4.498,49.811,14481,14485,52326
1997,2362,40157,40875,698780,684884,5270,13.051,4280,10.599,149217,30747,118470,4.489,21.787,120991,32330,88661,4.721,17.666,28226,4.121,35.332,3125,3127,22234
1997,2371,15634,15916,360706,348574,1401,8.871,1155,7.313,81989,14016,67973,4.021,23.521,57291,10988,46303,3.152,16.436,24698,7.085,32.872,823,825,6048
1997,2372,8494,8639,51604,51188,1842,21.749,1503,17.746,15357,7013,8344,13.700,30.001,14773,7574,7199,14.796,28.860,584,1.141,57.721,1154,1155,4484
1997,2373,10638,10998,257628,251296,977,8.920,888,8.107,52503,8236,44267,3.277,20.893,40050,8557,31493,3.405,15.937,12453,4.956,31.875,595,596,5211
1997,2379,4781,4856,64885,65137,604,12.348,675,13.799,14998,2712,12286,4.164,23.025,15474,4413,11061,6.775,23.756,-476,-0.731,46.051,528,528,2646
1997,2381,88380,88792,838460,807235,12827,14.667,10157,11.614,224694,59605,165089,7.384,27.835,161926,51058,110868,6.325,20.059,62768,7.776,40.119,7783,7810,40836
1997,2382,138244,140231,1511687,1465467,16045,11.575,12811,9.242,307973,73556,234417,5.019,21.015,216833,63495,153338,4.333,14.796,91140,6.219,29.592,9848,9860,49844
1997,2383,91848,92333,709913,687647,15364,16.838,13195,14.461,189269,55261,134008,8.036,27.524,144740,53231,91509,7.741,21.049,44529,6.476,42.097,10195,10202,42505
1997,2389,46553,46810,377760,370573,6598,14.285,5354,11.592,96065,30459,65606,8.219,25.923,82453,36004,46449,9.716,22.250,13612,3.673,44.500,4052,4053,21780
1997,3111,1123,1752,48839,49105,117,6.670,121,6.899,5062,1695,3367,3.452,10.309,5644,1550,4094,3.157,11.494,-582,-1.185,20.617,67,69,652
1997,3112,505,863,63842,63352,52,6.061,42,4.895,4595,1457,3138,2.300,7.253,3421,576,2845,0.909,5.400,1174,1.853,10.800,27,27,214
1997,3113,1421,1601,83818,82918,163,10.219,151,9.467,9176,1622,7554,1.956,11.066,7263,1984,5279,2.393,8.759,1913,2.307,17.519,108,111,1333
1997,3114,1292,1682,169407,171820,114,6.764,121,7.179,16397,3479,12918,2.025,9.543,21204,8686,12518,5.055,12.341,-4807,-2.798,19.086,63,67,1332
1997,3115,1191,1706,130647,131053,100,5.816,127,7.386,13008,3354,9654,2.559,9.926,13863,5097,8766,3.889,10.578,-855,-0.652,19.852,72,75,1297
1997,3116,3526,4130,452289,455452,286,6.971,231,5.631,36011,7512,28499,1.649,7.907,42692,15427,27265,3.387,9.374,-6681,-1.467,15.813,160,163,7913
1997,3117,642,748,41531,42446,81,10.778,88,11.710,6397,858,5539,2.021,15.071,8223,2871,5352,6.764,19.373,-1826,-4.302,30.142,59,63,1078
1997,3118,9239,10059,306544,309769,1275,12.658,1303,12.936,37299,11039,26260,3.564,12.041,43583,14529,29054,4.690,14.070,-6284,-2.029,24.082,1031,1043,6850
1997,3119,2193,2555,143112,141533,228,8.884,251,9.780,19168,3046,16122,2.152,13.543,16026,6196,9830,4.378,11.323,3142,2.220,22.646,174,174,2350
1997,3121,1922,2351,137543,136832,266,11.533,177,7.674,12715,2946,9769,2.153,9.292,11492,3001,8491,2.193,8.399,1223,0.894,16.797,126,129,1908
1997,3122,71,103,30516,29669,15,15.306,5,5.102,3015,559,2456,1.884,10.162,1401,21,1380,0.071,4.722,1614,5.440,9.444,5,5,21
1997,3131,336,567,81184,82699,42,7.330,54,9.424,7218,1983,5235,2.398,8.728,10331,3973,6358,4.804,12.492,-3113,-3.764,17.456,26,29,1606
1997,3132,1673,1999,215432,216290,156,7.729,195,9.661,19659,5157,14502,2.384,9.089,21507,9164,12343,4.237,9.944,-1848,-0.854,18.178,133,133,1979
1997,3133,2361,2541,105018,105268,274,10.555,384,14.792,12687,3792,8895,3.602,12.052,13302,4481,8821,4.257,12.636,-615,-0.584,24.104,314,315,2680
1997,3141,2824,3070,127026,126103,255,8.177,352,11.287,14299,3404,10895,2.699,11.339,12253,3866,8387,3.066,9.717,2046,1.622,19.433,278,280,2795
1997,3149,4396,4522,111456,111543,532,11.797,507,11.243,17184,5681,11503,5.093,15.406,17553,7306,10247,6.550,15.737,-369,-0.331,30.812,392,392,4892
1997,3151,1088,1190,102828,105401,99,8.165,144,11.876,10034,2042,7992,1.937,9.520,15066,4258,10808,4.040,14.294,-5032,-4.774,19.040,113,114,1915
1997,3152,10375,11186,519689,536718,1953,17.157,2347,20.618,85977,33746,52231,6.287,16.019,120028,61813,58215,11.517,22.363,-34051,-6.344,32.038,2013,2028,41094
1997,3159,2019,2129,58033,58247,283,13.346,266,12.544,9177,4214,4963,7.235,15.755,9552,3322,6230,5.703,16.399,-375,-0.644,31.511,218,219,1975
1997,3161,306,335,16253,15937,27,7.965,35,10.324,2303,718,1585,4.505,14.451,1707,360,1347,2.259,10.711,596,3.740,21.422,31,31,184
1997,3162,319,382,44067,44952,30,7.802,35,9.103,4346,1359,2987,3.023,9.668,5885,2952,2933,6.567,13.092,-1539,-3.424,19.336,23,23,705
1997,3169,966,996,29194,29375,90,8.960,107,10.652,3529,837,2692,2.849,12.014,3898,1238,2660,4.214,13.270,-369,-1.256,24.027,89,89,609
1997,3211,4103,4570,129895,129053,318,6.882,419,9.068,15032,3054,11978,2.366,11.648,13280,4525,8755,3.506,10.290,1752,1.358,20.581,340,341,2299
1997,3212,1406,1769,111892,111100,127,7.232,101,5.752,12014,2812,9202,2.531,10.814,10368,2945,7423,2.651,9.332,1646,1.482,18.664,70,72,1328
1997,3219,8993,9716,316304,309396,983,10.136,948,9.775,45964,9652,36312,3.120,14.856,32010,10198,21812,3.296,10.346,13954,4.510,20.692,739,740,6558
1997,3221,210,513,173691,175210,16,3.092,25,4.831,6885,3124,3761,1.783,3.930,9716,3720,5996,2.123,5.545,-2831,-1.616,7.859,9,9,75
1997,3222,3481,5159,399190,397985,274,5.282,330,6.362,41013,16451,24562,4.134,10.305,38952,19321,19631,4.855,9.787,2061,0.518,19.575,179,181,3600
1997,3231,38425,40293,823855,828073,2668,6.531,3779,9.251,92769,23594,69175,2.849,11.203,101441,39898,61543,4.818,12.250,-8672,-1.047,22.406,3069,3076,21077
1997,3241,1100,2067,128182,129072,118,5.685,135,6.504,10530,5309,5221,4.113,8.158,12229,3980,8249,3.084,9.475,-1699,-1.316,16.317,60,63,737
1997,3251,1086,2268,207414,210782,164,7.229,165,7.274,11131,3550,7581,1.684,5.281,17901,4173,13728,1.980,8.493,-6770,-3.212,10.562,59,70,1222
1997,3252,434,744,119936,119437,47,6.279,56,7.482,8012,2650,5362,2.219,6.708,7060,2476,4584,2.073,5.911,952,0.797,11.822,31,31,566
1997,3253,645,858,36136,35951,50,5.780,64,7.399,3271,461,2810,1.282,9.099,2851,920,1931,2.559,7.930,420,1.168,15.861,30,31,375
1997,3254,1289,1609,204083,202216,138,8.628,119,7.440,26086,3287,22799,1.625,12.900,21156,4632,16524,2.291,10.462,4930,2.438,20.924,68,70,1162
1997,3255,1621,2077,73817,73694,131,6.281,148,7.097,8673,2057,6616,2.791,11.769,8409,3072,5337,4.169,11.411,264,0.358,22.822,92,93,1191
1997,3256,2073,2275,122886,124071,188,8.240,201,8.810,13225,2504,10721,2.018,10.659,15420,7680,7740,6.190,12.428,-2195,-1.769,21.319,134,134,1421
1997,3259,2122,2775,125007,124225,199,7.154,212,7.622,11836,2106,9730,1.695,9.528,10269,2590,7679,2.085,8.266,1567,1.261,16.533,128,128,846
1997,3261,10669,13060,795812,784956,937,7.194,866,6.649,100824,25079,75745,3.195,12.845,79243,26540,52703,3.381,10.095,21581,2.749,20.190,586,592,12814
1997,3262,2088,2607,196176,196517,175,6.669,209,7.965,16871,4077,12794,2.075,8.585,17295,5829,11466,2.966,8.801,-424,-0.216,17.170,142,153,3114
1997,3271,1542,1791,80640,79261,130,7.188,165,9.124,9295,1299,7996,1.639,11.727,6552,1598,4954,2.016,8.266,2743,3.461,16.533,117,117,712
1997,3272,1812,2079,131718,132088,203,9.871,158,7.683,12253,3703,8550,2.803,9.276,12604,3002,9602,2.273,9.542,-351,-0.266,18.553,117,117,656
1997,3273,5535,8735,186235,183327,550,6.300,539,6.174,27629,6304,21325,3.439,15.071,22114,6683,15431,3.645,12.063,5515,3.008,24.125,322,327,3445
1997,3274,234,358,19348,19218,21,5.817,27,7.479,1726,290,1436,1.509,8.981,1472,294,1178,1.530,7.659,254,1.322,15.319,20,20,206
1997,3279,1973,2346,73080,72335,194,8.308,172,7.366,9179,2623,6556,3.626,12.690,7502,2552,4950,3.528,10.371,1677,2.318,20.742,125,126,1464
1997,3311,183,254,127591,129244,27,10.526,32,12.476,6035,3457,2578,2.675,4.669,9086,1305,7781,1.010,7.030,-3051,-2.361,9.339,24,24,1208
1997,3312,483,671,64778,65137,30,4.444,38,5.630,4167,397,3770,0.609,6.397,4893,1311,3582,2.013,7.512,-726,-1.115,12.795,32,32,890
1997,3313,354,533,86422,86642,37,7.028,24,4.558,6690,2308,4382,2.664,7.721,7188,1641,5547,1.894,8.296,-498,-0.575,15.443,8,8,80
1997,3314,677,857,80535,79431,55,6.448,47,5.510,7260,1793,5467,2.257,9.140,5080,1477,3603,1.859,6.396,2180,2.745,12.791,29,30,335
1997,3315,2356,2647,218699,217545,126,4.733,156,5.860,19504,4148,15356,1.907,8.966,17210,3912,13298,1.798,7.911,2294,1.054,15.822,110,110,1601
1997,3321,2753,2965,140545,139389,135,4.507,196,6.543,15204,3614,11590,2.593,10.908,12799,5877,6922,4.216,9.182,2405,1.725,18.364,148,149,3071
1997,3322,1472,1612,78377,78112,103,6.440,78,4.877,5840,642,5198,0.822,7.476,5218,1069,4149,1.369,6.680,622,0.796,13.360,58,58,362
1997,3323,10880,11678,365002,357582,811,6.963,750,6.439,50279,10810,39469,3.023,14.061,35450,10728,24722,3.000,9.914,14829,4.147,19.828,540,541,5422
1997,3324,1433,1761,105398,105383,84,4.742,105,5.927,10429,1763,8666,1.673,9.896,10415,2705,7710,2.567,9.883,14,0.013,19.766,59,59,1030
1997,3325,798,883,66798,65598,53,5.952,68,7.636,7310,880,6430,1.342,11.144,4886,1059,3827,1.614,7.448,2424,3.695,14.897,44,49,693
1997,3326,1592,1765,68047,67980,117,6.646,108,6.135,6066,872,5194,1.283,8.923,5981,1881,4100,2.767,8.798,85,0.125,17.596,68,68,494
1997,3327,24864,25255,411330,403364,2127,8.509,1610,6.441,54341,12134,42207,3.008,13.472,38561,11502,27059,2.852,9.560,15780,3.912,19.120,1273,1273,8310
1997,3328,5581,6055,150325,146723,428,7.106,365,6.060,21152,4659,16493,3.175,14.416,13970,3292,10678,2.244,9.521,7182,4.895,19.043,275,277,2124
1997,3329,5448,5950,305359,303304,515,8.721,425,7.197,29729,6720,23009,2.216,9.802,25664,7915,17749,2.610,8.461,4065,1.340,16.923,311,311,3281
1997,3331,2644,2921,209608,204907,216,7.371,235,8.019,25369,7381,17988,3.602,12.381,15567,3600,11967,1.757,7.597,9802,4.784,15.194,182,182,1841
1997,3332,4076,4333,179156,180315,383,8.896,328,7.618,20769,3868,16901,2.145,11.518,23020,5035,17985,2.792,12.767,-2251,-1.248,23.036,224,225,2115
1997,3333,2345,2479,132171,130695,221,8.962,195,7.908,14995,3372,11623,2.580,11.473,12168,3173,8995,2.428,9.310,2827,2.163,18.620,140,140,1318
1997,3334,1470,1755,171988,170854,126,7.163,134,7.618,16390,4462,11928,2.612,9.593,14263,4937,9326,2.890,8.348,2127,1.245,16.696,97,97,1492
1997,3335,9498,9854,240024,238163,552,5.603,549,5.572,25946,6339,19607,2.662,10.894,22067,6834,15233,2.869,9.266,3879,1.629,18.531,430,430,3590
1997,3336,737,895,111690,110909,45,5.045,39,4.372,9164,2766,6398,2.494,8.263,7294,977,6317,0.881,6.577,1870,1.686,13.153,28,29,347
1997,3339,5990,6630,352267,349600,452,6.848,393,5.954,39542,11383,28159,3.256,11.311,33731,11768,21963,3.366,9.648,5811,1.662,19.297,287,290,5211
1997,3341,1615,1712,221070,215687,211,12.379,196,11.499,28356,4845,23511,2.246,13.147,17614,6431,11183,2.982,8.166,10742,4.980,16.333,143,144,2351
1997,3342,1819,2017,245157,239975,146,7.201,167,8.237,32172,4141,28031,1.726,13.406,21905,4683,17222,1.951,9.128,10267,4.278,18.256,98,98,1399
1997,3343,492,525,32051,31672,65,12.334,69,13.093,4468,1360,3108,4.294,14.107,3725,1046,2679,3.303,11.761,743,2.346,23.522,46,46,323
1997,3344,5087,5700,550395,545576,512,9.005,484,8.512,63943,17407,46536,3.191,11.720,54904,15255,39649,2.796,10.063,9039,1.657,20.127,338,339,5941
1997,3345,4523,5124,477184,480344,360,7.031,352,6.875,49741,16240,33501,3.381,10.355,56327,23583,32744,4.910,11.726,-6586,-1.371,20.711,236,236,2529
1997,3346,760,828,48493,47320,100,12.180,86,10.475,7531,1222,6309,2.582,15.915,5203,1161,4042,2.454,10.995,2328,4.920,21.991,71,71,458
1997,3351,1131,1243,74439,73737,81,6.444,109,8.671,7601,2223,5378,3.015,10.308,6201,1528,4673,2.072,8.410,1400,1.899,16.819,79,79,900
1997,3352,234,302,98445,100810,18,5.788,36,11.576,6303,1284,5019,1.274,6.252,11172,4450,6722,4.414,11.082,-4869,-4.830,12.505,28,28,580
1997,3353,2389,2801,207747,207250,169,6.050,154,5.513,17854,4828,13026,2.330,8.615,16748,6571,10177,3.171,8.081,1106,0.534,16.162,87,88,952
1997,3359,1747,2112,190465,188211,156,7.365,168,7.932,18483,2697,15786,1.433,9.820,14171,5280,8891,2.805,7.529,4312,2.291,15.059,94,94,1818
1997,3361,266,330,224714,217834,53,16.258,45,13.804,22859,4558,18301,2.092,10.494,9323,3302,6021,1.516,4.280,13536,6.214,8.560,26,26,294
1997,3362,1786,1966,121008,123190,166,8.416,179,9.075,11889,2143,9746,1.740,9.651,16184,4662,11522,3.784,13.137,-4295,-3.486,19.302,124,124,3536
1997,3363,4607,5664,783107,769486,445,7.871,424,7.500,88248,24342,63906,3.163,11.468,60320,22304,38016,2.899,7.839,27928,3.629,15.678,252,256,3230
1997,3364,1377,1657,450685,438845,118,7.102,127,7.644,54616,6451,48165,1.470,12.445,29516,17924,11592,4.084,6.726,25100,5.720,13.452,67,67,964
1997,3365,164,221,28598,29763,11,4.846,23,10.132,2383,453,1930,1.522,8.007,4498,1274,3224,4.281,15.113,-2115,-7.106,16.013,11,11,147
1997,3366,1472,1575,137377,137644,176,11.264,151,9.664,15507,4918,10589,3.573,11.266,15948,3940,12008,2.862,11.586,-441,-0.320,22.532,81,82,1275
1997,3369,608,631,35081,34567,77,12.116,86,13.533,3958,501,3457,1.449,11.450,3037,726,2311,2.100,8.786,921,2.664,17.572,58,58,346
1997,3371,13058,13553,375152,374542,1516,11.170,1554,11.450,45363,12156,33207,3.246,12.112,44085,17345,26740,4.631,11.770,1278,0.341,23.541,1180,1182,9339
1997,3372,4051,4265,177144,173361,379,8.971,298,7.054,23224,4512,18712,2.603,13.396,15588,5452,10136,3.145,8.992,7636,4.405,17.983,220,223,2574
1997,3379,997,1118,41546,41326,71,6.264,102,8.999,4615,748,3867,1.810,11.167,4155,1593,2562,3.855,10.054,460,1.113,20.109,84,84,1038
1997,3391,11090,11640,275196,273182,945,8.115,956,8.209,36238,11773,24465,4.310,13.265,31929,12469,19460,4.564,11.688,4309,1.577,23.376,721,733,6484
1997,3399,16497,17075,427157,426117,1788,10.478,1766,10.349,55397,14883,40514,3.493,13.000,53064,17286,35778,4.057,12.453,2333,0.548,24.906,1439,1447,11103
1997,4231,19602,23708,296234,293658,2306,9.508,3397,14.006,50783,14569,36214,4.961,17.293,45383,20215,25168,6.884,15.454,5400,1.839,30.909,1937,2053,10847
1997,4232,9504,10675,134875,132676,1238,11.661,1122,10.568,22654,5829,16825,4.393,17.075,18481,6845,11636,5.159,13.929,4173,3.145,27.859,796,816,4019
1997,4233,8211,11051,138896,136764,1283,11.610,1282,11.601,26057,8770,17287,6.413,19.053,21667,10421,11246,7.620,15.843,4390,3.210,31.685,875,903,6214
1997,4234,28638,36448,634960,620778,4471,12.200,4869,13.286,138426,41130,97296,6.626,22.299,109993,48047,61946,7.740,17.719,28433,4.580,35.437,2930,3117,21627
1997,4235,7910,10431,159554,155563,846,8.152,740,7.130,24344,6786,17558,4.362,15.649,16410,4873,11537,3.133,10.549,7934,5.100,21.098,438,449,3068
1997,4236,19524,28500,396727,390247,3070,10.785,2999,10.536,75886,21758,54128,5.575,19.446,62613,27866,34747,7.141,16.044,13273,3.401,32.089,1655,1746,12279
1997,4237,11321,16026,184467,181881,1273,7.953,1233,7.703,28246,8512,19734,4.680,15.530,22916,7680,15236,4.223,12.599,5330,2.930,25.199,725,760,4680
1997,4238,49664,64619,716571,710099,5207,8.069,5030,7.795,103450,27403,76047,3.859,14.568,90540,30319,60221,4.270,12.750,12910,1.818,25.501,3074,3165,16640
1997,4239,27937,30232,313146,311600,4009,13.320,3738,12.420,59056,21782,37274,6.990,18.953,56308,21483,34825,6.894,18.071,2748,0.882,36.141,2879,2909,13220
1997,4241,9848,12760,205003,204800,1069,8.340,1185,9.245,26448,6468,19980,3.158,12.914,26099,10889,15210,5.317,12.744,349,0.170,25.487,701,713,5259
1997,4242,4836,6244,164469,161684,1058,17.371,751,12.331,32852,9816,23036,6.071,20.319,27721,13631,14090,8.431,17.145,5131,3.173,34.290,470,477,4337
1997,4243,13714,14764,177190,176340,2164,14.679,2121,14.387,34368,9225,25143,5.231,19.490,32566,13598,18968,7.711,18.468,1802,1.022,36.936,1681,1687,9300
1997,4244,27883,33554,746163,738461,3614,10.712,3982,11.803,122166,33585,88581,4.548,16.543,106746,43857,62889,5.939,14.455,15420,2.088,28.910,2842,2883,23328
1997,4245,5281,8169,70648,71566,488,5.868,784,9.426,10356,2716,7640,3.795,14.471,12089,4573,7516,6.390,16.892,-1733,-2.422,28.941,437,469,2607
1997,4246,9730,13653,159062,158816,1288,9.457,1221,8.965,27637,9176,18461,5.778,17.402,27529,9756,17773,6.143,17.334,108,0.068,34.668,581,622,4112
1997,4247,7404,10422,126000,127337,568,5.341,994,9.346,19171,3818,15353,2.998,15.055,21689,8881,12808,6.974,17.033,-2518,-1.977,30.111,415,456,2927
1997,4248,3192,4111,138325,137718,252,6.045,368,8.827,15861,4360,11501,3.166,11.517,14714,5803,8911,4.214,10.684,1147,0.833,21.368,223,240,3147
1997,4249,22034,26306,335457,333075,3760,14.212,4060,15.346,65802,23252,42550,6.981,19.756,61166,25059,36107,7.524,18.364,4636,1.392,36.728,2835,2877,13752
1997,4251,33751,36123,288875,286231,4061,11.314,3602,10.035,53347,16679,36668,5.827,18.638,48330,22432,25898,7.837,16.885,5017,1.753,33.770,2348,2366,10936
1997,4411,41961,44768,1118638,1102585,4646,10.439,4120,9.257,145170,46803,98367,4.245,13.166,112739,43369,69370,3.933,10.225,32431,2.941,20.450,3107,3138,29308
1997,4412,11514,12356,101773,99892,1214,9.879,1079,8.781,18078,5607,12471,5.613,18.098,14186,5416,8770,5.422,14.201,3892,3.896,28.403,808,830,3836
1997,4413,35378,58672,511569,509669,4864,8.297,4761,8.122,74797,29605,45192,5.809,14.676,71387,24306,47081,4.769,14.007,3410,0.669,28.013,2832,3029,12905
1997,4421,19809,27501,252828,253007,3267,11.922,3071,11.207,44981,18567,26414,7.339,17.779,45542,16330,29212,6.454,18.000,-561,-0.222,35.557,2003,2191,9590
1997,4422,23975,32395,232250,229248,3558,11.002,3446,10.656,46024,17911,28113,7.813,20.076,40355,14537,25818,6.341,17.603,5669,2.473,35.206,2055,2209,7638
1997,4431,31828,48759,427593,424692,6395,13.218,5636,11.650,92232,42323,49909,9.966,21.717,86797,33887,52910,7.979,20.438,5435,1.280,40.875,3350,3509,16300
1997,4441,49776,71171,984953,957146,5245,7.396,4739,6.682,156069,69604,86465,7.272,16.306,102147,39681,62466,4.146,10.672,53922,5.634,21.344,2956,3130,17530
1997,4442,16490,20556,172767,170887,1551,7.549,1532,7.456,28003,7459,20544,4.365,16.387,24378,6761,17617,3.956,14.266,3625,2.121,28.531,1074,1090,3990
1997,4451,60016,88264,2613030,2612494,9960,11.269,10195,11.535,363690,184985,178705,7.081,13.921,363603,114067,249536,4.366,13.918,87,0.003,27.836,6865,7034,42233
1997,4452,15944,19757,124312,126892,2562,12.665,3506,17.332,26806,11627,15179,9.163,21.125,31437,16392,15045,12.918,24.775,-4631,-3.650,42.250,2124,2177,9147
1997,4453,23076,26550,127614,128643,2279,8.488,2880,10.726,21551,7333,14218,5.700,16.753,23600,10008,13592,7.780,18.345,-2049,-1.593,33.505,2090,2154,6877
1997,4461,41279,78281,892935,836506,8358,10.771,6994,9.013,224213,68143,156070,8.146,26.804,112961,48021,64940,5.741,13.504,111252,13.300,27.008,4062,4493,26166
1997,4471,65689,118055,906073,908523,10079,8.494,11278,9.505,164464,64812,99652,7.134,18.102,167732,63805,103927,7.023,18.462,-3268,-0.360,36.205,7066,7527,39553
1997,4481,39801,87466,886592,897736,10166,11.325,14771,16.455,168566,76049,92517,8.471,18.777,187791,84473,103318,9.410,20.918,-19225,-2.141,37.554,5697,6942,26859
1997,4482,7022,28602,181225,183062,2383,8.057,4333,14.650,38811,16465,22346,8.994,21.201,41834,19900,21934,10.871,22.852,-3023,-1.651,42.402,896,1074,5227
1997,4483,18680,28376,162671,156930,2960,10.443,2899,10.227,38363,11438,26925,7.289,24.446,26516,9745,16771,6.210,16.897,11847,7.549,33.793,1681,1796,4936
1997,4511,30852,41914,359609,369147,4704,11.058,5957,14.003,64466,26231,38235,7.106,17.464,83042,32392,50650,8.775,22.496,-18576,-5.032,34.927,3636,4034,17072
1997,4512,8035,13707,129378,126326,1378,9.960,1636,11.824,27061,10523,16538,8.330,21.422,20602,8395,12207,6.646,16.309,6459,5.113,32.617,1045,1085,4972
1997,4521,90,10202,1813909,1794124,308,3.019,306,3.000,216504,53226,163278,2.967,12.067,180906,32712,148194,1.823,10.083,35598,1.984,20.166,5,8,968
1997,4529,9039,23574,693673,665803,2953,12.445,3260,13.739,139036,39266,99770,5.898,20.882,84625,39011,45614,5.859,12.710,54411,8.172,25.420,1440,1811,11052
1997,4531,22428,23637,121819,122258,2366,9.894,2921,12.214,22569,7206,15363,5.894,18.460,23312,9216,14096,7.538,19.068,-743,-0.608,36.920,2268,2299,6939
1997,4532,29699,40783,312361,304175,5576,13.763,5040,12.440,70900,31526,39374,10.364,23.309,55172,21666,33506,7.123,18.138,15728,5.171,36.277,3441,3623,12630
1997,4533,12704,16053,95499,93202,2316,14.617,1899,11.985,18967,8128,10839,8.721,20.351,14334,5439,8895,5.836,15.380,4633,4.971,30.759,1495,1509,3582
1997,4539,29435,35840,219299,213095,6045,17.177,4750,13.497,56801,27281,29520,12.802,26.655,44250,17804,26446,8.355,20.765,12551,5.890,41.531,3528,3643,13687
1997,4541,7928,8691,198932,190841,1351,15.879,985,11.577,39940,14165,25775,7.422,20.928,23662,9432,14230,4.942,12.399,16278,8.530,24.798,678,691,4357
1997,4542,5168,5833,69332,69632,735,12.557,776,13.257,11143,5192,5951,7.456,16.003,11732,5703,6029,8.190,16.849,-589,-0.846,32.005,515,541,2477
1997,4543,19074,25114,217827,218286,2822,11.285,2606,10.421,38762,14068,24694,6.445,17.757,40232,14793,25439,6.777,18.431,-1470,-0.673,35.515,1715,1773,8867
1997,4811,607,2992,490395,480197,271,9.472,9,0.315,46103,6522,39581,1.358,9.601,25983,94,25889,0.020,5.411,20120,4.190,10.822,7,7,84
1997,4812,1471,1611,25450,25516,221,13.930,172,10.841,4800,1452,3348,5.691,18.812,5002,738,4264,2.892,19.603,-202,-0.792,37.623,105,108,519
1997,4831,763,1145,52750,51438,132,11.759,87,7.751,9194,3930,5264,7.640,17.874,6382,1823,4559,3.544,12.407,2812,5.467,24.814,34,34,963
1997,4832,486,533,18197,17338,51,9.733,33,6.298,3548,523,3025,3.017,20.464,1925,449,1476,2.590,11.103,1623,9.361,22.206,22,22,68
1997,4841,31623,39798,848454,833215,7105,18.248,5381,13.820,148551,48686,99865,5.843,17.829,118163,41508,76655,4.982,14.182,30388,3.647,28.363,3955,4015,23205
1997,4842,47574,50825,475928,477171,7671,14.988,8385,16.383,99187,36297,62890,7.607,20.786,101769,48049,53720,10.070,21.328,-2582,-0.541,41.573,6432,6502,30136
1997,4851,454,554,28869,28722,90,16.499,73,13.382,4565,1709,2856,5.950,15.894,4231,2003,2228,6.974,14.731,334,1.163,29.462,53,53,1008
1997,4852,188,338,16419,15899,26,7.439,49,14.020,2712,228,2484,1.434,17.058,1651,667,984,4.195,10.384,1061,6.673,20.769,17,17,244
1997,4853,5522,5596,58646,57285,966,17.340,916,16.442,14506,6112,8394,10.670,25.323,11945,6265,5680,10.937,20.852,2561,4.471,41.704,764,770,5075
1997,4854,3216,4241,148714,147104,397,9.324,431,10.122,27966,11484,16482,7.807,19.011,25023,10905,14118,7.413,17.010,2943,2.001,34.021,234,240,3162
1997,4855,1266,1382,29569,29081,148,10.787,128,9.329,5521,1315,4206,4.522,18.985,4545,1470,3075,5.055,15.629,976,3.356,31.258,94,95,999
1997,4859,2100,2274,44688,43460,376,17.029,244,11.051,9597,2994,6603,6.889,22.083,7202,2475,4727,5.695,16.572,2395,5.511,33.144,173,173,1120
1997,4861,45,363,7682,7814,16,4.233,46,12.169,955,314,641,4.018,12.222,1223,405,818,5.183,15.651,-268,-3.430,24.443,3,3,79
1997,4862,126,1434,34111,35392,164,11.685,103,7.339,4445,2112,2333,5.968,12.560,6972,1879,5093,5.309,19.700,-2527,-7.140,25.119,21,21,533
1997,4869,50,468,5695,5933,41,8.333,89,18.089,675,249,426,4.197,11.378,1124,831,293,14.008,18.946,-449,-7.568,22.756,5,5,36
1997,4871,325,362,8149,8068,54,14.897,55,15.172,1782,465,1317,5.764,22.089,1659,885,774,10.970,20.564,123,1.525,41.128,34,34,188
1997,4872,1134,1168,12885,12444,171,14.449,202,17.068,3549,1843,1706,14.811,28.521,2739,1131,1608,9.089,22.011,810,6.509,44.023,153,153,740
1997,4879,131,135,1577,1533,21,15.217,27,19.565,449,76,373,4.959,29.299,352,240,112,15.661,22.969,97,6.330,45.938,14,14,44
1997,4881,2967,3859,108101,106587,531,13.897,455,11.908,19901,6399,13502,6.004,18.671,17050,7478,9572,7.016,15.996,2851,2.675,31.993,287,289,3179
1997,4882,427,782,19170,18731,109,14.211,79,10.300,3625,1849,1776,9.872,19.353,2866,928,1938,4.954,15.301,759,4.052,30.602,38,38,412
1997,4883,1715,2204,72619,71190,221,9.917,270,12.116,14217,2198,12019,3.088,19.971,11395,3450,7945,4.846,16.006,2822,3.964,32.013,150,160,1619
1997,4884,5499,5728,44764,42416,953,17.083,654,11.724,11343,5938,5405,13.999,26.742,6711,2987,3724,7.042,15.822,4632,10.920,31.644,508,515,2284
1997,4885,10721,14245,138132,133270,2078,14.878,1521,10.890,31551,11477,20074,8.612,23.675,21908,9783,12125,7.341,16.439,9643,7.236,32.878,980,999,5274
1997,4889,733,791,19366,14774,157,20.026,143,18.240,11589,10848,741,73.426,78.442,2900,1509,1391,10.214,19.629,8689,58.813,39.258,109,114,1384
1997,4921,1747,5097,463325,461092,569,11.369,385,7.692,41730,7869,33861,1.707,9.050,36397,4523,31874,0.981,7.894,5333,1.157,15.787,276,279,3382
1997,4922,4389,4774,67331,68794,889,18.837,780,16.527,16270,6690,9580,9.725,23.650,19053,8105,10948,11.782,27.696,-2783,-4.045,47.301,592,613,5737
1997,4931,6405,11586,499677,487653,1543,13.618,1033,9.117,105700,39686,66014,8.138,21.675,81470,25304,56166,5.189,16.707,24230,4.969,33.413,395,415,5321
1997,5111,16009,19030,694896,692688,1984,10.440,1930,10.156,85347,24628,60719,3.555,12.321,80358,27831,52527,4.018,11.601,4989,0.720,23.202,1499,1504,9637
1997,5112,8437,10556,252013,235830,1839,18.163,977,9.649,72511,24479,48032,10.380,30.747,39950,16517,23433,7.004,16.940,32561,13.807,33.880,603,620,10338
1997,5121,11516,15810,250994,243650,2335,14.871,2118,13.489,65930,38051,27879,15.617,27.059,52129,18675,33454,7.665,21.395,13801,5.664,42.790,1276,1342,7439
1997,5122,2315,2425,19392,18721,437,18.560,296,12.572,3966,1637,2329,8.744,21.185,2651,965,1686,5.155,14.161,1315,7.024,28.321,218,218,720
1997,5151,5896,7990,242979,240252,972,11.947,1264,15.536,47528,18870,28658,7.854,19.783,41694,19779,21915,8.233,17.354,5834,2.428,34.709,863,906,12006
1997,5152,246,435,24340,23887,66,14.286,120,25.974,7633,1940,5693,8.122,31.955,6696,5724,972,23.963,28.032,937,3.923,56.064,37,40,369
1997,5171,4467,24485,976231,965525,2711,10.986,3094,12.538,182074,64828,117246,6.714,18.858,159156,57593,101563,5.965,16.484,22918,2.374,32.968,750,799,8888
1997,5172,2440,5615,127513,125453,1460,27.817,727,13.852,37231,17597,19634,14.027,29.677,32372,12308,20064,9.811,25.804,4859,3.873,51.608,377,389,4474
1997,5174,336,451,10593,10028,87,19.551,75,16.854,3776,1837,1939,18.320,37.656,2555,1776,779,17.711,25.480,1221,12.177,50.960,30,30,205
1997,5179,4005,4479,63807,52257,1747,44.318,673,17.073,32642,13827,18815,26.460,62.465,9806,5729,4077,10.963,18.765,22836,43.700,37.530,387,389,2558
1997,5182,4169,7399,305042,304428,1429,19.237,1488,20.031,64881,30322,34559,9.960,21.312,63483,23905,39578,7.852,20.853,1398,0.459,41.706,558,566,6138
1997,5191,2712,3327,47100,47294,261,7.840,265,7.960,8407,2829,5578,5.982,17.776,8430,1829,6601,3.867,17.825,-23,-0.049,35.552,190,194,807
1997,5211,12,42,22130,22401,0,0.000,(D),(D),171,0,171,0.000,0.763,729,(D),697,(D),3.254,-558,-2.491,1.527,0,0,0
1997,5221,19335,103003,1915683,1914950,12342,12.167,9210,9.080,384709,179456,205253,9.371,20.090,382561,184540,198021,9.637,19.978,2148,0.112,39.955,656,1146,16619
1997,5222,16891,42967,520545,508207,6869,16.298,5230,12.409,140947,67671,73276,13.316,27.734,114770,59763,55007,11.760,22.583,26177,5.151,45.167,1614,1793,11049
1997,5223,9934,14141,156116,146045,3554,26.783,1811,13.648,48693,20885,27808,14.300,33.341,27869,12174,15695,8.336,19.083,20824,14.259,38.165,1035,1089,6483
1997,5231,10592,27318,473239,442401,4600,17.215,3405,12.743,132692,34869,97823,7.882,29.994,67662,25276,42386,5.713,15.294,65030,14.699,30.589,857,883,6479
1997,5232,19,31,5937,5975,0,0.000,12,32.432,97,0,97,0.000,1.624,171,41,130,0.686,2.862,-74,-1.239,3.247,5,5,14
1997,5239,21291,23775,248444,239071,4652,20.278,2984,13.007,65192,22913,42279,9.584,27.269,46252,19568,26684,8.185,19.347,18940,7.922,38.693,2027,2035,10153
1997,5241,4419,36026,1537516,1535633,4361,11.769,6417,17.318,212953,74866,138087,4.875,13.867,208645,79207,129438,5.158,13.587,4308,0.281,27.174,379,404,5671
1997,5242,112369,123412,757849,749759,13342,10.887,11609,9.473,143356,57866,85490,7.718,19.120,127493,57193,70300,7.628,17.005,15863,2.116,34.009,7590,7729,29320
1997,5250,3159,3900,73119,66116,659,17.922,213,5.793,24438,14201,10237,21.479,36.963,11082,2536,8546,3.836,16.762,13356,20.201,33.523,124,124,1655
1997,5311,88436,97506,469315,470911,11076,11.345,11318,11.593,94355,41494,52861,8.811,20.037,97421,49961,47460,10.609,20.688,-3066,-0.651,40.073,8775,8855,35657
1997,5312,45679,51234,219592,218610,7976,15.710,7047,13.880,54183,23131,31052,10.581,24.785,52629,26645,25984,12.188,24.074,1554,0.711,48.149,4656,4817,17523
1997,5313,38462,44890,449648,441890,6038,13.693,4449,10.089,97945,35344,62601,7.998,22.165,82676,34216,48460,7.743,18.710,15269,3.455,37.419,2844,2910,17286
1997,5321,4535,9627,154410,149716,1086,11.327,1007,10.503,30341,6080,24261,4.061,20.266,20813,7926,12887,5.294,13.902,9528,6.364,27.803,547,593,3801
1997,5322,18098,31432,228251,218215,5512,17.926,4145,13.480,66211,36001,30210,16.498,30.342,46983,19638,27345,8.999,21.531,19228,8.811,43.061,2908,3145,14003
1997,5323,3540,6023,39115,39136,548,9.078,575,9.525,6468,2247,4221,5.742,16.527,6508,2937,3571,7.505,16.629,-40,-0.102,33.054,336,381,2034
1997,5324,7228,10355,131407,124940,1517,14.824,1274,12.449,32963,12119,20844,9.700,26.383,19854,8430,11424,6.747,15.891,13109,10.492,31.782,817,859,5336
1997,5331,1627,1749,18789,18831,284,16.560,216,12.595,5101,2112,2989,11.216,27.089,5242,2650,2592,14.073,27.838,-141,-0.749,54.178,153,153,2123
1997,5411,153895,161132,1018270,1008971,15756,9.822,14327,8.931,143352,46329,97023,4.592,14.208,124810,41317,83493,4.095,12.370,18542,1.838,24.740,10802,10919,31206
1997,5412,83620,88788,960624,929885,9844,11.150,8840,10.013,210538,84965,125573,9.137,22.641,148006,47614,100392,5.120,15.917,62532,6.725,31.833,6225,6299,32545
1997,5413,77733,86861,1065705,1047938,11380,13.361,8008,9.402,202149,57510,144639,5.488,19.290,165776,62328,103448,5.948,15.819,36373,3.471,31.639,5329,5434,26464
1997,5414,21733,21938,112368,109904,3810,17.738,2893,13.469,27061,11688,15373,10.635,24.623,22285,10154,12131,9.239,20.277,4776,4.346,40.554,2281,2284,7466
1997,5415,51044,57084,742390,684580,15348,28.793,7791,14.616,249982,84844,165138,12.394,36.516,133720,63962,69758,9.343,19.533,116262,16.983,39.066,5318,5383,33456
1997,5416,53294,56553,458571,444118,13573,25.111,8571,15.857,131966,61025,70941,13.741,29.714,103490,52724,50766,11.872,23.302,28476,6.412,46.605,6271,6339,36362
1997,5417,8706,10948,477424,479278,1647,15.344,1219,11.356,81900,25603,56297,5.342,17.088,84316,22264,62052,4.645,17.592,-2416,-0.504,34.176,684,695,5466
1997,5418,31211,34286,425321,416763,5036,14.808,4479,13.171,82861,29114,53747,6.986,19.882,66170,26228,39942,6.293,15.877,16691,4.005,31.754,3430,3514,20645
1997,5419,39073,44873,391997,382045,4048,9.159,2693,6.093,74296,22508,51788,5.891,19.447,54553,16895,37658,4.422,14.279,19743,5.168,28.558,1717,1786,8071
1997,5511,27804,50221,3177821,3189393,5062,9.941,6458,12.683,594592,171243,423349,5.369,18.643,613219,223181,390038,6.998,19.227,-18627,-0.584,37.286,1304,1406,24581
1997,5611,18666,20995,331332,317278,5010,25.198,2785,14.007,102753,51061,51692,16.093,32.386,75267,40298,34969,12.701,23.723,27486,8.663,47.446,2086,2117,28979
1997,5612,1147,2312,107108,101058,597,28.496,163,7.780,28517,13529,14988,13.387,28.219,16627,5212,11415,5.157,16.453,11890,11.766,32.906,49,52,703
1997,5613,23312,37028,3046787,2926162,7056,19.698,4641,12.956,988420,361398,627022,12.351,33.779,747109,227107,520002,7.761,25.532,241311,8.247,51.064,2548,2699,115494
1997,5614,24795,29329,576849,540269,4816,16.582,4246,14.619,172855,78326,94529,14.498,31.994,99739,43509,56230,8.053,18.461,73116,13.533,36.922,3117,3211,26106
1997,5615,25513,32553,284095,279225,3802,11.598,4259,12.992,61123,23421,37702,8.388,21.890,50960,23060,27900,8.259,18.251,10163,3.640,36.501,2609,2682,11700
1997,5616,15270,18994,642533,628497,2836,15.133,2329,12.428,131745,42550,89195,6.770,20.962,104686,35673,69013,5.676,16.657,27059,4.305,33.313,1660,1668,18895
1997,5617,110485,115598,1330161,1284819,19810,17.782,11428,10.258,317971,110479,207492,8.599,24.748,226620,75895,150725,5.907,17.638,91351,7.110,35.277,9228,9240,49386
1997,5619,20537,22460,332961,320874,4269,19.549,3023,13.843,84716,32454,52262,10.114,26.402,60333,26092,34241,8.132,18.803,24383,7.599,37.605,2295,2315,16664
1997,5621,6432,7458,139368,133620,849,11.625,539,7.381,27273,9554,17719,7.150,20.411,15916,3547,12369,2.655,11.911,11357,8.500,23.823,403,405,2664
1997,5622,1404,2138,56690,60818,296,13.628,364,16.759,12296,5911,6385,9.719,20.218,20692,7183,13509,11.811,34.023,-8396,-13.805,40.436,193,209,2983
1997,5629,5056,5577,84757,83707,795,14.379,699,12.642,21575,7743,13832,9.250,25.775,19373,7025,12348,8.392,23.144,2202,2.631,46.288,521,528,3746
1997,6111,15398,17601,636144,617496,868,5.055,11,0.064,66103,11098,55005,1.797,10.705,28724,62,28662,0.010,4.652,37379,6.053,9.303,(D),(D),(D)
1997,6112,562,828,73328,72239,40,4.947,(D),(D),7057,985,6072,1.364,9.769,5030,(D),4968,(D),6.963,2027,2.806,13.926,(D),(D),(D)
1997,6113,2255,2774,1180359,1164709,176,6.549,3,0.112,75607,2226,73381,0.191,6.491,43970,27,43943,0.002,3.775,31637,2.716,7.550,0,0,0
1997,6114,5040,5594,59291,56339,1085,20.149,667,12.386,17139,7238,9901,12.847,30.421,11224,5034,6190,8.935,19.922,5915,10.499,39.845,498,508,3910
1997,6115,5234,6148,66455,63721,820,13.553,625,10.330,15074,4838,10236,7.592,23.656,9672,3429,6243,5.381,15.179,5402,8.478,30.357,403,413,2150
1997,6116,19029,20315,154844,149795,3222,16.136,2528,12.660,38926,15532,23394,10.369,25.986,28549,10770,17779,7.190,19.059,10377,6.927,38.118,1982,1990,7682
1997,6117,2874,3092,28416,27423,580,19.114,465,15.324,6838,2048,4790,7.468,24.935,4791,2093,2698,7.632,17.471,2047,7.465,34.941,365,365,1785
1997,6211,160514,180268,1557019,1531474,16985,9.400,17838,9.872,321816,132476,189340,8.650,21.013,270087,117704,152383,7.686,17.636,51729,3.378,35.272,13353,13804,78056
1997,6212,104771,108286,645448,634738,5663,5.243,5124,4.744,93721,25448,68273,4.009,14.765,72625,22903,49722,3.608,11.442,21096,3.324,22.883,3870,3943,17533
1997,6213,75295,80893,402933,389417,9402,11.737,7824,9.767,99787,43203,56584,11.094,25.625,71784,33122,38662,8.506,18.434,28003,7.191,36.867,5694,5773,23789
1997,6214,9641,19985,496345,483584,3353,17.540,1615,8.448,105603,47157,58446,9.752,21.838,79269,26579,52690,5.496,16.392,26334,5.446,32.784,782,841,14021
1997,6215,5396,8989,144925,146908,2251,26.517,1251,14.737,34512,17142,17370,11.669,23.492,38556,19064,19492,12.977,26.245,-4044,-2.753,46.985,590,616,6655
1997,6216,10684,17832,907682,878279,3551,20.952,1784,10.526,228051,90023,138028,10.250,25.966,169107,59266,109841,6.748,19.254,58944,6.711,38.509,774,910,25958
1997,6219,3945,5865,164431,160411,741,12.261,1098,18.168,47834,23401,24433,14.588,29.820,39303,23855,15448,14.871,24.501,8531,5.318,49.003,546,600,9082
1997,6221,2594,4415,4082574,4079813,191,4.310,224,5.055,339702,106234,233468,2.604,8.326,333286,95404,237882,2.338,8.169,6416,0.157,16.338,105,115,49527
1997,6222,491,786,243549,257232,84,10.599,97,12.240,25101,11303,13798,4.394,9.758,53381,22256,31125,8.652,20.752,-28280,-10.994,19.516,38,43,9365
1997,6223,236,372,137744,139701,32,8.637,29,7.827,12451,4096,8355,2.932,8.913,16322,4597,11725,3.291,11.684,-3871,-2.771,17.825,7,7,1758
1997,6231,7758,14846,1524212,1489667,1387,9.584,640,4.422,201812,95707,106105,6.425,13.547,132390,38448,93942,2.581,8.887,69422,4.660,17.774,341,358,21217
1997,6232,7304,19428,349642,346144,1946,10.315,821,4.352,59040,21264,37776,6.143,17.057,52120,12310,39810,3.556,15.057,6920,1.999,30.115,505,513,7428
1997,6233,11748,14233,399723,402728,2246,15.948,1946,13.818,65713,25203,40510,6.258,16.317,71746,43921,27825,10.906,17.815,-6033,-1.498,32.634,1262,1287,25377
1997,6239,3389,5636,130839,129163,554,9.877,500,8.914,22371,7521,14850,5.823,17.320,19055,6656,12399,5.153,14.753,3316,2.567,29.505,284,291,4170
1997,6241,28616,40340,651833,632196,4293,10.856,2705,6.840,115590,28226,87364,4.465,18.284,76734,17927,58807,2.836,12.138,38856,6.146,24.275,1562,1595,9041
1997,6242,7700,9537,101686,99590,706,7.434,626,6.592,16295,3496,12799,3.510,16.362,12246,3758,8488,3.773,12.296,4049,4.066,24.593,376,381,2273
1997,6243,5225,7831,285018,283392,659,8.360,762,9.667,47365,7163,40202,2.528,16.714,44275,8084,36191,2.853,15.623,3090,1.090,31.246,295,334,3415
1997,6244,45785,56712,612868,603202,6682,11.891,5644,10.044,107976,40848,67128,6.772,17.900,88528,32269,56259,5.350,14.676,19448,3.224,29.353,4272,4365,23699
1997,7111,7332,7426,108254,105186,1178,16.003,1048,14.237,26768,8684,18084,8.256,25.448,20509,7083,13426,6.734,19.498,6259,5.950,38.996,753,756,4518
1997,7112,3000,3114,85610,84080,555,17.854,544,17.500,17173,5983,11190,7.116,20.425,14318,5138,9180,6.111,17.029,2855,3.396,34.058,392,395,3691
1997,7113,2987,3099,64310,61602,405,12.970,452,14.476,15218,3966,11252,6.438,24.704,10112,3635,6477,5.901,16.415,5106,8.289,32.830,351,351,2765
1997,7114,2141,2196,13714,12980,353,16.495,241,11.262,3788,1314,2474,10.124,29.184,2266,1138,1128,8.768,17.458,1522,11.726,34.917,176,176,842
1997,7115,7846,7864,32545,33044,1697,22.335,1165,15.333,12433,4866,7567,14.726,37.626,13542,4469,9073,13.524,40.982,-1109,-3.356,75.251,788,789,2901
1997,7121,4682,5049,89887,86635,366,7.355,220,4.421,12261,1669,10592,1.926,14.152,5635,939,4696,1.084,6.504,6626,7.648,13.009,140,140,604
1997,7131,1618,2759,129088,128571,284,10.192,339,12.166,19054,9672,9382,7.523,14.820,18844,5873,12971,4.568,14.656,210,0.163,29.313,229,231,4742
1997,7132,1588,1915,159379,152547,286,15.315,191,10.228,31480,10492,20988,6.878,20.636,17367,6562,10805,4.302,11.385,14113,9.252,22.769,113,118,5003
1997,7139,43781,47488,826463,816168,5309,11.215,5012,10.587,146863,53648,93215,6.573,17.994,126706,50795,75911,6.224,15.525,20157,2.470,31.049,3793,3831,33066
1997,7211,32639,41014,1574527,1553064,5619,13.946,4172,10.355,275406,139063,136343,8.954,17.733,233259,99225,134034,6.389,15.019,42147,2.714,30.039,2812,2878,57843
1997,7212,5022,5440,33951,34793,620,11.428,591,10.893,7077,2107,4970,6.056,20.340,8655,2973,5682,8.545,24.876,-1578,-4.535,40.681,328,328,1706
1997,7213,3151,3227,15820,16200,282,8.709,304,9.389,2542,954,1588,5.889,15.692,3284,1615,1669,9.969,20.272,-742,-4.580,31.384,198,200,790
1997,7223,9303,22513,452440,465994,3217,13.354,6372,26.450,105670,44358,61312,9.519,22.676,133442,76216,57226,16.356,28.636,-27772,-5.960,45.353,2950,3040,28580
1997,7224,47350,47816,316790,319682,5683,11.651,7608,15.597,74042,35559,38483,11.123,23.161,79482,39480,40002,12.350,24.863,-5440,-1.702,46.322,6370,6406,33328
1997,7225,260883,360589,6839596,6762873,53813,15.126,44142,12.408,1429370,795226,634144,11.759,21.136,1270458,508037,762421,7.512,18.786,158912,2.350,37.572,31589,32856,318321
1997,8111,137481,149761,827343,814773,18205,12.253,15826,10.652,166575,70529,96046,8.656,20.444,141240,58370,82870,7.164,17.335,25335,3.109,34.670,11827,12060,43750
1997,8112,13638,15993,135375,137997,2070,12.888,2206,13.735,30244,9273,20971,6.720,21.916,36012,20553,15459,14.894,26.096,-5768,-4.180,43.833,1270,1289,5065
1997,8113,20959,22498,188990,186614,2461,10.975,2312,10.311,33352,10103,23249,5.414,17.872,28582,10603,17979,5.682,15.316,4770,2.556,30.632,1717,1718,7446
1997,8114,24494,26022,145765,146103,3350,12.773,3762,14.343,24537,10061,14476,6.886,16.794,25302,11536,13766,7.896,17.318,-765,-0.524,33.589,2954,2975,8844
1997,8121,74672,85492,455983,455072,11516,13.413,12252,14.270,95397,44372,51025,9.751,20.963,94802,43218,51584,9.497,20.832,595,0.131,41.665,9295,9543,30387
1997,8122,15915,21409,156127,151934,1677,7.882,1411,6.632,30707,13557,17150,8.923,20.211,22013,7018,14995,4.619,14.489,8694,5.722,28.977,815,852,3996
1997,8123,34303,40848,387510,386155,4347,10.595,4708,11.475,65863,21759,44104,5.635,17.056,63089,27399,35690,7.095,16.338,2774,0.718,32.675,3393,3558,17483
1997,8129,15371,24368,197644,193270,3396,14.124,2750,11.437,44179,16958,27221,8.774,22.859,35654,14071,21583,7.280,18.448,8525,4.411,36.896,1266,1387,6359
1997,8131,154550,154675,1433982,1398360,8254,5.480,126,0.084,173104,23321,149783,1.668,12.379,101983,324,101659,0.023,7.293,71121,5.086,14.586,17,17,38
1997,8132,9401,10963,109781,110923,1030,9.471,855,7.862,16386,4121,12265,3.715,14.772,18509,6820,11689,6.148,16.686,-2123,-1.914,29.545,558,567,3810
1997,8133,7829,9384,82841,82482,890,9.559,743,7.980,13964,3246,10718,3.935,16.930,13246,3866,9380,4.687,16.059,718,0.870,32.119,462,465,2242
1997,8134,28006,29720,301379,298201,1414,4.724,1841,6.150,40098,7055,33043,2.366,13.447,33849,6656,27193,2.232,11.351,6249,2.096,22.702,1277,1280,4150
1997,8139,63045,64937,493668,489167,3420,5.291,2827,4.373,66684,13901,52783,2.842,13.632,57788,12779,45009,2.612,11.814,8896,1.819,23.627,2007,2015,9129
1998,2111,6089,7265,95253,97924,644,8.801,748,10.223,16532,5622,10910,5.741,16.883,21866,5128,16738,5.237,22.330,-5334,-5.447,33.765,463,469,1624
1998,2121,900,1308,80387,83212,161,11.939,242,17.946,11289,4645,6644,5.582,13.567,16970,6846,10124,8.227,20.394,-5681,-6.827,27.133,141,152,3409
1998,2122,315,433,39860,40482,44,9.843,72,16.107,2770,323,2447,0.798,6.843,3974,733,3241,1.811,9.817,-1204,-2.974,13.685,46,46,171
1998,2123,3259,5015,102050,100441,329,6.551,343,6.830,15783,2909,12874,2.896,15.714,12415,3614,8801,3.598,12.361,3368,3.353,24.721,180,182,1347
1998,2131,7054,8123,171433,164587,1046,12.864,1063,13.073,46564,13741,32823,8.349,28.292,32893,16440,16453,9.989,19.985,13671,8.306,39.970,676,712,8469
1998,2211,1561,8165,556243,553793,897,11.334,396,5.003,55693,29290,26403,5.289,10.057,50885,6457,44428,1.166,9.188,4808,0.868,18.377,69,74,926
1998,2212,570,2679,97583,100232,228,8.528,217,8.117,9610,2894,6716,2.887,9.588,15384,3239,12145,3.232,15.348,-5774,-5.761,19.176,42,44,473
1998,2213,4128,4596,34635,34271,277,6.053,238,5.200,4220,2021,2199,5.897,12.314,3458,1010,2448,2.947,10.090,762,2.223,20.181,167,168,672
1998,2361,128490,129053,666201,655780,22057,17.227,20022,15.638,182184,73544,108640,11.215,27.781,161432,67469,93963,10.288,24.617,20752,3.164,49.234,14155,14160,47725
1998,2362,40171,40947,735448,719299,4664,11.435,4343,10.648,156361,34386,121975,4.780,21.738,123912,28025,95887,3.896,17.227,32449,4.511,34.454,3111,3113,18404
1998,2371,15926,16251,379129,371603,1510,9.384,1191,7.401,76306,14296,62010,3.847,20.534,61211,12543,48668,3.375,16.472,15095,4.062,32.944,864,867,6959
1998,2372,8729,8895,55983,55087,1732,19.728,1501,17.097,16952,8187,8765,14.862,30.773,15067,5405,9662,9.812,27.352,1885,3.422,54.703,1093,1097,3518
1998,2373,10761,11165,266002,264526,941,8.463,848,7.627,48852,9713,39139,3.672,18.468,45808,8148,37660,3.080,17.317,3044,1.151,34.634,588,591,5198
1998,2379,4750,4835,66996,66767,569,11.730,601,12.389,15653,3779,11874,5.660,23.444,15383,4877,10506,7.305,23.040,270,0.404,46.080,466,466,2625
1998,2381,89701,90073,868222,854707,11864,13.277,10436,11.679,208664,55788,152876,6.527,24.414,181257,53405,127852,6.248,21.207,27407,3.207,42.414,7700,7700,39058
1998,2382,140048,142370,1594599,1558463,15601,11.043,13405,9.489,316009,81558,234451,5.233,20.277,243311,72364,170947,4.643,15.612,72698,4.665,31.224,10095,10104,55613
1998,2383,93543,94129,743202,726478,15053,16.157,13132,14.095,186213,56997,129216,7.846,25.632,152629,51333,101296,7.066,21.009,33584,4.623,42.019,9930,9941,39768
1998,2389,47826,48082,391652,385253,6652,14.013,5427,11.433,90862,27120,63742,7.040,23.585,77891,25725,52166,6.677,20.218,12971,3.367,40.436,3996,4000,18259
1998,3111,1062,1677,48956,48427,111,6.591,125,7.423,6349,2622,3727,5.414,13.111,5345,1434,3911,2.961,11.037,1004,2.073,22.075,74,74,411
1998,3112,502,860,63182,63763,46,5.336,50,5.800,4533,1316,3217,2.064,7.109,5619,1700,3919,2.666,8.812,-1086,-1.703,14.218,29,29,205
1998,3113,1450,1636,84324,84379,118,7.224,113,6.918,6854,1314,5540,1.557,8.123,6939,1131,5808,1.340,8.224,-85,-0.101,16.246,78,81,471
1998,3114,1320,1720,167347,168854,132,7.737,104,6.096,16514,5051,11463,2.991,9.780,19298,3407,15891,2.018,11.429,-2784,-1.649,19.560,72,72,806
1998,3115,1195,1715,130604,131617,87,5.058,97,5.640,11594,3421,8173,2.599,8.809,13516,5555,7961,4.221,10.269,-1922,-1.460,17.618,45,45,482
1998,3116,3455,4081,467103,461569,272,6.704,225,5.545,40191,11430,28761,2.476,8.707,29116,5323,23793,1.153,6.308,11075,2.399,12.616,165,166,2090
1998,3117,645,759,43825,42971,70,9.235,68,8.971,7685,1969,5716,4.582,17.884,6003,1209,4794,2.814,13.970,1682,3.914,27.940,45,45,733
1998,3118,9509,10343,303954,306346,1272,12.389,1120,10.909,36857,14530,22327,4.743,12.031,41379,12813,28566,4.183,13.507,-4522,-1.476,24.062,849,865,6661
1998,3119,2246,2603,142906,142998,224,8.642,202,7.793,15799,4463,11336,3.121,11.048,15919,4023,11896,2.813,11.132,-120,-0.084,22.097,149,152,2188
1998,3121,1922,2378,139805,139509,235,9.895,229,9.642,12968,3213,9755,2.303,9.295,12309,3017,9292,2.163,8.823,659,0.472,17.646,177,185,1579
1998,3122,81,111,30490,30583,18,16.981,8,7.547,1808,500,1308,1.635,5.912,2023,275,1748,0.899,6.615,-215,-0.703,11.824,5,5,143
1998,3131,334,572,82376,81865,44,7.719,40,7.018,7335,2564,4771,3.132,8.960,6138,2794,3344,3.413,7.498,1197,1.462,14.995,22,25,967
1998,3132,1660,1990,208007,210849,149,7.493,146,7.342,13930,3334,10596,1.581,6.607,19583,5863,13720,2.781,9.288,-5653,-2.681,13.213,100,100,1281
1998,3133,2189,2359,101593,103602,153,6.276,311,12.756,9621,2824,6797,2.726,9.287,13627,5394,8233,5.206,13.153,-4006,-3.867,18.573,239,244,2905
1998,3141,2778,3020,122135,124767,230,7.537,293,9.602,11200,2880,8320,2.308,8.977,16598,6570,10028,5.266,13.303,-5398,-4.326,17.953,220,225,2389
1998,3149,4355,4481,108936,110751,494,11.016,501,11.172,15069,4771,10298,4.308,13.606,18786,7348,11438,6.635,16.962,-3717,-3.356,27.212,392,393,4897
1998,3151,1071,1166,94385,98349,90,7.634,116,9.839,10502,4000,6502,4.067,10.678,18367,4823,13544,4.904,18.675,-7865,-7.997,21.357,87,90,3035
1998,3152,10171,10904,481693,502568,1578,14.272,1884,17.039,67473,22476,44997,4.472,13.426,109172,44655,64517,8.885,21.723,-41699,-8.297,26.851,1500,1511,28364
1998,3159,1966,2062,55870,57611,187,8.858,285,13.501,6354,1911,4443,3.317,11.029,9866,2969,6897,5.154,17.125,-3512,-6.096,22.058,210,215,1947
1998,3161,303,332,15716,15860,25,7.474,30,8.969,1183,113,1070,0.713,7.459,1475,386,1089,2.434,9.300,-292,-1.841,14.919,22,22,195
1998,3162,335,389,38046,41062,39,10.065,36,9.290,2181,699,1482,1.702,5.312,8401,4239,4162,10.324,20.460,-6220,-15.148,10.623,21,21,394
1998,3169,955,983,27221,28278,93,9.403,105,10.617,2648,675,1973,2.387,9.364,4726,1465,3261,5.181,16.713,-2078,-7.348,18.728,77,77,473
1998,3211,4072,4536,133397,132870,295,6.471,341,7.480,13929,3255,10674,2.450,10.483,12828,3567,9261,2.685,9.655,1101,0.829,19.309,253,253,2090
1998,3212,1438,1793,113396,113033,127,7.139,99,5.565,11971,3123,8848,2.763,10.591,11123,3999,7124,3.538,9.841,848,0.750,19.681,64,64,1169
1998,3219,9174,9918,330770,324828,1044,10.604,899,9.131,46828,12719,34109,3.916,14.416,35126,10739,24387,3.306,10.814,11702,3.603,21.627,684,685,6144
1998,3221,222,524,173514,174015,23,4.402,20,3.828,8781,5353,3428,3.076,5.046,9652,3131,6521,1.799,5.547,-871,-0.501,10.092,(D),(D),(D)
1998,3222,3510,5223,397960,399780,280,5.371,261,5.006,34749,9614,25135,2.405,8.692,37879,15387,22492,3.849,9.475,-3130,-0.783,17.384,150,152,2778
1998,3231,37703,39534,835693,834223,2457,6.152,3262,8.168,93627,20459,73168,2.452,11.223,90503,30734,59769,3.684,10.849,3124,0.374,21.698,2587,2598,19595
1998,3241,1117,2139,128599,129350,182,8.611,131,6.198,12684,3311,9373,2.560,9.806,13851,5889,7962,4.553,10.708,-1167,-0.902,19.612,54,56,537
1998,3251,1106,2349,214933,210396,200,8.649,127,5.492,21749,9344,12405,4.441,10.337,12857,2176,10681,1.034,6.111,8892,4.226,12.222,62,64,916
1998,3252,438,765,121842,120790,53,6.992,39,5.145,11237,7048,4189,5.835,9.303,9279,1407,7872,1.165,7.682,1958,1.621,15.364,21,21,848
1998,3253,660,884,37192,37137,71,8.036,70,7.923,3375,903,2472,2.432,9.088,3307,1032,2275,2.779,8.905,68,0.183,17.810,42,42,396
1998,3254,1360,1690,206825,205729,181,10.933,112,6.765,18432,3329,15103,1.618,8.959,16437,4383,12054,2.130,7.990,1995,0.970,15.979,67,67,938
1998,3255,1632,2080,75261,74817,131,6.301,129,6.205,7989,1933,6056,2.584,10.678,7097,2440,4657,3.261,9.486,892,1.192,18.972,74,74,601
1998,3256,2105,2317,125220,124205,190,8.250,162,7.034,14367,3962,10405,3.190,11.567,12210,3948,8262,3.179,9.831,2157,1.737,19.661,118,120,1853
1998,3259,2134,2793,125287,125924,201,7.202,197,7.058,10901,3143,7758,2.496,8.657,12220,3065,9155,2.434,9.704,-1319,-1.047,17.314,128,130,1184
1998,3261,10703,13163,815889,808222,914,6.956,868,6.606,103255,29729,73526,3.678,12.776,88248,32693,55555,4.045,10.919,15007,1.857,21.838,574,590,15707
1998,3262,2078,2602,199367,197903,166,6.374,171,6.566,16736,3462,13274,1.749,8.457,13690,4929,8761,2.491,6.918,3046,1.539,13.835,112,112,1372
1998,3271,1547,1802,78444,79919,145,8.035,150,8.313,7572,2918,4654,3.651,9.475,10397,2763,7634,3.457,13.009,-2825,-3.535,18.949,108,109,978
1998,3272,1838,2110,131337,131662,188,8.959,165,7.863,9596,2080,7516,1.580,7.288,10202,2512,7690,1.908,7.749,-606,-0.460,14.577,113,113,849
1998,3273,5525,8805,193669,189918,556,6.331,511,5.818,28431,7002,21429,3.687,14.970,21021,4844,16177,2.551,11.068,7410,3.902,22.137,252,259,2496
1998,3274,241,373,20004,19664,31,8.424,21,5.707,2023,795,1228,4.043,10.288,1383,258,1125,1.312,7.033,640,3.255,14.066,17,17,196
1998,3279,2003,2387,75500,74169,199,8.390,169,7.125,9170,2736,6434,3.689,12.364,6446,2273,4173,3.065,8.691,2724,3.673,17.382,131,131,1514
1998,3311,207,286,126429,127399,32,11.490,17,6.104,5869,1820,4049,1.429,4.607,7860,3358,4502,2.636,6.170,-1991,-1.563,9.214,9,9,127
1998,3312,500,697,65573,64889,45,6.536,28,4.067,5010,873,4137,1.345,7.721,3580,508,3072,0.783,5.517,1430,2.204,11.034,14,14,210
1998,3313,370,541,89419,87834,35,6.464,36,6.648,8032,3206,4826,3.650,9.145,5006,1140,3866,1.298,5.699,3026,3.445,11.399,22,22,276
1998,3314,707,888,83353,82771,63,7.175,43,4.897,6591,1607,4984,1.942,7.963,5311,725,4586,0.876,6.417,1280,1.546,12.833,25,25,131
1998,3315,2385,2702,231594,226645,145,5.392,119,4.425,24384,7934,16450,3.501,10.759,14359,3419,10940,1.509,6.335,10025,4.423,12.671,85,85,1183
1998,3321,2756,2964,147834,143972,152,5.123,158,5.325,18505,4135,14370,2.872,12.853,10662,3492,7170,2.425,7.406,7843,5.448,14.811,105,105,1484
1998,3322,1484,1633,82020,80577,96,5.915,76,4.683,7393,2796,4597,3.470,9.175,4588,934,3654,1.159,5.694,2805,3.481,11.388,60,60,528
1998,3323,11159,12011,391547,381022,923,7.777,637,5.367,53650,15176,38474,3.983,14.081,32824,8770,24054,2.302,8.615,20826,5.466,17.229,471,475,4778
1998,3324,1447,1786,106305,106496,114,6.406,101,5.676,10536,2710,7826,2.545,9.893,10876,2973,7903,2.792,10.213,-340,-0.319,19.787,71,72,1129
1998,3325,792,873,66875,66489,46,5.236,57,6.488,6408,1865,4543,2.805,9.638,5624,2162,3462,3.252,8.459,784,1.179,16.917,38,38,499
1998,3326,1615,1792,69084,68639,124,6.951,108,6.054,7315,1842,5473,2.684,10.657,6554,1945,4609,2.834,9.549,761,1.109,19.097,75,77,879
1998,3327,25638,26045,444625,429731,2207,8.586,1525,5.933,64736,13425,51311,3.124,15.064,34980,9951,25029,2.316,8.140,29756,6.924,16.280,1170,1172,6535
1998,3328,5604,6123,158883,155213,387,6.343,344,5.638,22912,4970,17942,3.202,14.762,15632,4764,10868,3.069,10.071,7280,4.690,20.143,264,264,3174
1998,3329,5663,6198,316704,313457,567,9.285,384,6.288,32291,9026,23265,2.880,10.302,25469,7350,18119,2.345,8.125,6822,2.176,16.250,274,275,2844
1998,3331,2687,2989,216024,213946,198,6.642,182,6.105,23497,5998,17499,2.804,10.983,19311,8481,10830,3.964,9.026,4186,1.957,18.052,130,130,2214
1998,3332,4140,4394,192628,188134,316,7.210,293,6.686,25086,6234,18852,3.314,13.334,16281,4693,11588,2.494,8.654,8805,4.680,17.308,208,208,1641
1998,3333,2323,2466,134279,134313,171,6.866,220,8.834,13517,3421,10096,2.547,10.064,13525,4358,9167,3.245,10.070,-8,-0.006,20.128,161,162,2108
1998,3334,1465,1774,170675,171354,119,6.727,109,6.162,15186,4295,10891,2.507,8.862,16395,3504,12891,2.045,9.568,-1209,-0.706,17.725,71,72,1391
1998,3335,9510,9883,247816,245144,526,5.318,543,5.490,26993,5850,21143,2.386,11.011,21591,5737,15854,2.340,8.807,5402,2.204,17.615,418,422,3649
1998,3336,751,905,110047,110649,43,4.759,40,4.427,7476,775,6701,0.700,6.757,8813,3328,5485,3.008,7.965,-1337,-1.208,13.513,21,21,115
1998,3339,6039,6689,364177,359442,410,6.130,409,6.115,38946,8985,29961,2.500,10.835,29520,9695,19825,2.697,8.213,9426,2.622,16.425,285,286,3810
1998,3341,1652,1742,225549,221257,226,13.094,194,11.240,33764,4885,28879,2.208,15.260,25579,11565,14014,5.227,11.561,8185,3.699,23.122,143,144,1266
1998,3342,1859,2065,251692,248540,189,9.220,159,7.756,35091,7428,27663,2.989,14.119,29074,10738,18336,4.320,11.698,6017,2.421,23.396,103,103,2398
1998,3343,483,522,32263,32386,54,10.276,61,11.608,4084,1347,2737,4.159,12.611,4233,1887,2346,5.827,13.071,-149,-0.460,25.221,41,41,602
1998,3344,5159,5820,580005,566669,530,9.181,436,7.552,82242,19295,62947,3.405,14.513,56211,14876,41335,2.625,9.920,26031,4.594,19.839,293,298,4701
1998,3345,4598,5236,499133,490901,358,6.857,328,6.282,52774,19436,33338,3.959,10.750,36006,9977,26029,2.032,7.335,16768,3.416,14.669,199,201,2196
1998,3346,760,830,48886,49229,102,12.349,94,11.380,6703,2388,4315,4.851,13.616,7275,2198,5077,4.465,14.778,-572,-1.162,27.232,66,66,841
1998,3351,1159,1272,74351,74361,101,7.987,86,6.801,7369,1456,5913,1.958,9.910,7347,3083,4264,4.146,9.880,22,0.030,19.760,58,58,490
1998,3352,236,307,100984,99939,26,8.428,29,9.400,9051,752,8299,0.752,9.057,6733,1516,5217,1.517,6.737,2318,2.319,13.474,13,13,113
1998,3353,2390,2823,208468,209095,172,6.113,153,5.438,21783,4994,16789,2.388,10.418,22606,8531,14075,4.080,10.811,-823,-0.394,20.836,91,91,802
1998,3359,1812,2185,197718,195377,184,8.501,143,6.607,19520,4772,14748,2.442,9.991,14841,3822,11019,1.956,7.596,4679,2.395,15.192,74,75,1112
1998,3361,281,345,224051,224762,35,10.309,24,7.069,13065,805,12260,0.358,5.813,14714,120,14594,0.053,6.546,-1649,-0.734,11.626,20,20,107
1998,3362,1822,2016,130044,125889,171,8.574,128,6.418,17619,4554,13065,3.617,13.996,9495,2694,6801,2.140,7.542,8124,6.453,15.085,103,103,1426
1998,3363,4599,5750,810012,802400,413,7.220,353,6.171,82706,28960,53746,3.609,10.307,67398,14711,52687,1.833,8.400,15308,1.908,16.799,231,235,5306
1998,3364,1406,1697,476138,463400,143,8.482,121,7.177,39993,7582,32411,1.636,8.630,14417,6127,8290,1.322,3.111,25576,5.519,6.222,81,83,1156
1998,3365,160,222,30590,29677,12,5.393,13,5.843,4352,393,3959,1.324,14.665,2498,265,2233,0.893,8.417,1854,6.247,16.835,9,9,195
1998,3366,1478,1577,140880,140490,165,10.381,190,11.953,14732,2718,12014,1.935,10.486,14214,5161,9053,3.674,10.117,518,0.369,20.235,123,124,1342
1998,3369,630,654,35922,35552,82,12.763,59,9.183,4615,2136,2479,6.008,12.981,3907,1603,2304,4.509,10.990,708,1.991,21.979,43,43,456
1998,3371,13169,13673,383230,379204,1570,11.535,1446,10.624,49875,12265,37610,3.234,13.153,41874,17321,24553,4.568,11.043,8001,2.110,22.085,1100,1110,9898
1998,3372,4061,4266,185452,182040,303,7.070,342,7.980,25470,5131,20339,2.819,13.991,18707,6206,12501,3.409,10.276,6763,3.715,20.553,252,253,3114
1998,3379,994,1111,44934,43650,73,6.532,86,7.696,5672,1155,4517,2.646,12.994,3125,774,2351,1.773,7.159,2547,5.835,14.318,68,69,569
1998,3391,10987,11594,284500,281819,881,7.579,940,8.087,37551,10915,26636,3.873,13.325,32563,13857,18706,4.917,11.555,4988,1.770,23.109,683,687,4106
1998,3399,16838,17397,437868,435803,1950,11.284,1719,9.947,59912,16981,42931,3.896,13.748,55551,20617,34934,4.731,12.747,4361,1.001,25.494,1349,1352,9555
1998,4231,19333,23425,304306,300486,2163,9.164,2518,10.668,47627,15606,32021,5.194,15.850,40033,16784,23249,5.586,13.323,7594,2.527,26.646,1731,1782,10179
1998,4232,9619,10771,138359,137048,1149,10.686,1112,10.342,22353,6212,16141,4.533,16.310,19618,7576,12042,5.528,14.315,2735,1.996,28.629,798,819,4483
1998,4233,8387,11253,142845,140949,1405,12.571,1252,11.202,25867,10024,15843,7.112,18.352,21858,8677,13181,6.156,15.508,4009,2.844,31.015,791,819,4756
1998,4234,28608,36431,665252,653591,4105,11.248,4235,11.604,130283,39890,90393,6.103,19.933,105446,40805,64641,6.243,16.133,24837,3.800,32.267,2761,2843,19244
1998,4235,7950,10501,164573,163094,727,6.918,743,7.070,21716,5321,16395,3.263,13.315,18549,6245,12304,3.829,11.373,3167,1.942,22.746,444,475,3484
1998,4236,19716,28935,435746,422576,3390,11.776,3095,10.751,90706,30331,60375,7.178,21.465,63786,23458,40328,5.551,15.095,26920,6.370,30.189,1579,1666,9698
1998,4237,11272,16308,192838,190330,1437,8.869,1226,7.567,29818,9456,20362,4.968,15.666,24749,8502,16247,4.467,13.003,5069,2.663,26.006,774,834,4964
1998,4238,49931,64948,755041,740241,4855,7.472,4918,7.569,114406,30986,83420,4.186,15.455,84844,31611,53233,4.270,11.462,29562,3.994,22.923,3043,3161,16939
1998,4239,28160,30480,317976,318132,3710,12.200,3570,11.740,55297,18777,36520,5.902,17.382,55805,21733,34072,6.831,17.541,-508,-0.160,34.764,2729,2750,13912
1998,4241,9822,12994,216814,212249,1249,9.678,1073,8.314,31928,12078,19850,5.690,15.043,22795,8427,14368,3.970,10.740,9133,4.303,21.480,671,681,3803
1998,4242,4952,6418,169047,166602,950,15.009,773,12.213,27279,9163,18116,5.500,16.374,22382,8699,13683,5.221,13.434,4897,2.939,26.869,527,532,5031
1998,4243,13859,14930,180490,179521,2038,13.704,1922,12.924,35330,10582,24748,5.895,19.680,33327,11403,21924,6.352,18.564,2003,1.116,37.129,1471,1494,7614
1998,4244,27529,33130,758687,757805,3048,9.122,3616,10.822,103878,27539,76339,3.634,13.708,101339,34025,67314,4.490,13.373,2539,0.335,26.745,2604,2684,17055
1998,4245,5216,8064,71994,71836,441,5.412,611,7.498,10036,2564,7472,3.569,13.971,9791,3293,6498,4.584,13.630,245,0.341,27.259,337,381,1992
1998,4246,9765,13676,156960,157732,1117,8.153,1165,8.504,22991,5802,17189,3.678,14.576,24373,9300,15073,5.896,15.452,-1382,-0.876,29.152,647,676,3427
1998,4247,7272,10498,127947,127399,825,7.871,791,7.547,21858,7419,14439,5.823,17.157,20511,6816,13695,5.350,16.100,1347,1.057,32.200,392,403,2454
1998,4248,3228,4104,145723,143430,253,6.124,307,7.432,16853,4511,12342,3.145,11.750,12111,3802,8309,2.651,8.444,4742,3.306,16.888,186,246,2503
1998,4249,22387,26735,351860,345964,3771,14.187,3464,13.032,68585,24969,43616,7.217,19.824,56725,21587,35138,6.240,16.396,11860,3.428,32.792,2503,2574,13503
1998,4251,33957,36331,292931,292249,3431,9.459,3310,9.126,48845,16420,32425,5.619,16.714,47141,17428,29713,5.963,16.130,1704,0.583,32.261,2186,2222,9719
1998,4411,42493,45643,1145682,1142011,4594,10.116,4132,9.099,138542,61229,77313,5.362,12.131,131117,41534,89583,3.637,11.481,7425,0.650,22.962,3213,3247,31056
1998,4412,11715,12605,107158,105284,1173,9.367,1009,8.057,17875,6389,11486,6.068,16.978,14103,4612,9491,4.381,13.395,3772,3.583,26.791,768,782,3357
1998,4413,35134,58407,514869,513985,4212,7.179,4736,8.072,81892,23897,57995,4.649,15.933,78433,28629,49804,5.570,15.260,3459,0.673,30.520,2417,2695,11362
1998,4421,19985,27801,271103,263907,2533,9.117,2500,8.998,50895,17897,32998,6.782,19.285,36635,13204,23431,5.003,13.882,14260,5.403,27.764,1640,1746,8031
1998,4422,24469,32046,240707,237099,3245,10.040,3795,11.742,46783,18252,28531,7.698,19.731,39385,17102,22283,7.213,16.611,7398,3.120,33.222,1916,2042,7159
1998,4431,32678,49530,436600,434286,5662,11.467,5357,10.849,82165,32077,50088,7.386,18.920,77663,32226,45437,7.420,17.883,4502,1.037,35.766,3248,3407,14644
1998,4441,49628,71234,999845,993893,4186,5.872,4305,6.038,131147,38552,92595,3.879,13.195,119056,39083,79973,3.932,11.979,12091,1.217,23.958,2735,2864,14996
1998,4442,16646,20664,176862,175500,1387,6.706,1426,6.894,26214,6648,19566,3.788,14.937,23372,6898,16474,3.930,13.317,2842,1.619,26.635,951,978,3953
1998,4451,59918,87718,2649596,2637533,8648,9.809,9542,10.823,354036,148745,205291,5.640,13.423,324917,136195,188722,5.164,12.319,29119,1.104,24.638,6228,6446,46165
1998,4452,16032,20465,128810,127559,3217,15.957,2607,12.932,27783,12110,15673,9.494,21.781,25411,11300,14111,8.859,19.921,2372,1.860,39.842,1857,1902,7892
1998,4453,23064,26070,130289,129962,2152,8.150,2821,10.684,23161,7249,15912,5.578,17.821,22259,8996,13263,6.922,17.127,902,0.694,34.255,1776,1804,5495
1998,4461,41255,79235,937542,917463,6907,8.751,6289,7.968,172972,65456,107516,7.134,18.853,133631,47566,86065,5.185,14.565,39341,4.288,29.131,3400,3705,20738
1998,4471,65437,117832,940319,926546,9482,8.028,10039,8.500,181033,63139,117894,6.814,19.538,153294,55891,97403,6.032,16.545,27739,2.994,33.089,5715,6361,32617
1998,4481,39243,86972,924943,908052,8785,10.051,9648,11.038,178231,60717,117514,6.687,19.628,144623,52393,92230,5.770,15.927,33608,3.701,31.853,4624,5086,19214
1998,4482,6934,29626,205332,194041,2793,9.578,1864,6.392,44639,23149,21490,11.930,23.005,22771,7964,14807,4.104,11.735,21868,11.270,23.470,664,736,2578
1998,4483,18945,28649,159557,162097,2745,9.596,2660,9.299,28510,10789,17721,6.656,17.588,34037,14237,19800,8.783,20.998,-5527,-3.410,35.177,1358,1497,4748
1998,4511,30833,41813,382044,372679,4474,10.654,4834,11.511,71984,29042,42942,7.793,19.315,53405,22838,30567,6.128,14.330,18579,4.985,28.660,3156,3395,12237
1998,4512,7875,13619,137531,133899,1381,10.095,1503,10.987,28751,15838,12913,11.828,21.472,21774,8566,13208,6.397,16.262,6977,5.211,32.523,836,918,3660
1998,4521,79,10191,1827871,1814649,343,3.391,190,1.878,156940,52009,104931,2.866,8.649,129062,18956,110106,1.045,7.112,27878,1.536,14.224,3,6,365
1998,4529,9078,24195,693662,699411,3025,12.600,2650,11.038,80840,43169,37671,6.172,11.558,92875,25535,67340,3.651,13.279,-12035,-1.721,23.117,1052,1191,5265
1998,4531,22333,23532,123461,123583,2310,9.766,2551,10.785,21552,7698,13854,6.229,17.439,21883,7614,14269,6.161,17.707,-331,-0.268,34.879,2003,2026,5888
1998,4532,29954,41296,336355,325559,4829,11.731,4568,11.097,71646,30224,41422,9.284,22.007,50237,17911,32326,5.502,15.431,21409,6.576,30.862,3151,3240,10964
1998,4533,12934,16349,105452,100560,2052,12.679,1722,10.640,23517,8545,14972,8.497,23.386,13563,4949,8614,4.921,13.488,9954,9.899,26.975,1352,1364,3523
1998,4539,30490,37147,235657,229303,5233,14.272,4271,11.648,54612,21858,32754,9.532,23.817,41514,17297,24217,7.543,18.104,13098,5.712,36.209,3061,3169,12325
1998,4541,8333,9087,215038,207889,1416,15.911,1041,11.697,40470,13830,26640,6.653,19.467,26149,7692,18457,3.700,12.578,14321,6.889,25.157,779,788,4392
1998,4542,5136,5726,66466,68443,644,11.112,783,13.510,9077,2949,6128,4.309,13.262,13238,7611,5627,11.120,19.342,-4161,-6.080,26.524,559,566,2521
1998,4543,19280,25377,221675,220301,2713,10.737,2495,9.874,37554,12433,25121,5.644,17.047,34985,13004,21981,5.903,15.881,2569,1.166,31.761,1757,1793,7641
1998,4811,613,3106,505593,497597,352,11.702,156,5.186,45472,8212,37260,1.650,9.138,29778,2654,27124,0.533,5.984,15694,3.154,11.969,53,65,1716
1998,4812,1516,1660,26967,26540,230,14.020,191,11.643,5675,829,4846,3.124,21.383,5099,1544,3555,5.818,19.213,576,2.170,38.425,152,152,887
1998,4831,771,1180,53732,53475,184,15.842,147,12.656,11094,4969,6125,9.292,20.746,10605,5714,4891,10.685,19.832,489,0.914,39.663,72,89,2296
1998,4832,494,536,18242,18165,55,10.319,49,9.193,2508,691,1817,3.804,13.807,2342,818,1524,4.503,12.893,166,0.914,25.787,32,32,280
1998,4841,33689,41851,890612,872626,7652,18.681,5872,14.336,145589,44776,100813,5.131,16.684,110224,43519,66705,4.987,12.631,35365,4.053,25.263,4285,4434,23768
1998,4842,47894,51303,495172,486442,7222,14.154,6662,13.057,99723,31326,68397,6.440,20.501,82144,30579,51565,6.286,16.887,17579,3.614,33.773,5149,5177,20545
1998,4851,446,560,29400,29034,77,13.787,74,13.250,3525,977,2548,3.365,12.141,2772,810,1962,2.790,9.548,753,2.594,19.095,63,63,511
1998,4852,196,355,17448,17235,28,7.865,30,8.427,2060,463,1597,2.686,11.953,1646,434,1212,2.518,9.551,414,2.402,19.101,19,19,139
1998,4853,5643,5728,60535,59731,927,16.374,794,14.025,13734,6103,7631,10.218,22.993,11978,4227,7751,7.077,20.053,1756,2.940,40.107,651,657,3404
1998,4854,3205,4253,153374,152660,317,7.447,324,7.612,22819,7068,15751,4.630,14.948,21843,5737,16106,3.758,14.308,976,0.639,28.617,222,224,2563
1998,4855,1246,1376,30799,30439,131,9.462,148,10.690,4952,1112,3840,3.653,16.269,4133,1584,2549,5.204,13.578,819,2.691,27.156,118,119,1363
1998,4859,2162,2330,47360,46609,358,15.491,320,13.847,9920,3476,6444,7.458,21.283,8489,3823,4666,8.202,18.213,1431,3.070,36.426,249,267,2766
1998,4861,45,359,7078,7444,43,11.797,54,14.815,809,374,435,5.024,10.868,1543,558,985,7.496,20.728,-734,-9.860,21.736,(D),(D),(D)
1998,4862,130,1564,32780,33149,232,15.354,126,8.339,5718,1941,3777,5.855,17.250,6303,2126,4177,6.414,19.014,-585,-1.765,34.499,6,10,153
1998,4869,52,523,5949,5843,97,19.497,46,9.246,1125,802,323,13.727,19.255,928,306,622,5.237,15.884,197,3.372,31.767,(D),(D),(D)
1998,4871,329,367,8803,8496,44,12.038,41,11.218,1958,811,1147,9.546,23.046,1315,343,972,4.037,15.478,643,7.568,30.956,33,33,305
1998,4872,1177,1206,12491,12806,172,14.411,147,12.317,2656,1145,1511,8.941,20.740,3342,1565,1777,12.221,26.097,-686,-5.357,41.481,107,108,852
1998,4879,141,145,1761,1698,26,18.310,20,14.085,460,147,313,8.657,27.091,323,78,245,4.594,19.022,137,8.068,38.045,15,15,68
1998,4881,3069,3974,115713,112093,478,12.174,383,9.754,21189,8843,12346,7.889,18.903,14186,5029,9157,4.486,12.656,7003,6.247,25.311,252,254,1799
1998,4882,432,753,19517,19399,97,12.647,125,16.297,3851,1690,2161,8.712,19.852,3575,1715,1860,8.841,18.429,276,1.423,36.858,41,59,474
1998,4883,1750,2253,71149,72232,233,10.411,203,9.071,12598,4900,7698,6.784,17.441,15075,3076,11999,4.259,20.870,-2477,-3.429,34.882,136,138,1611
1998,4884,5671,5916,47258,46329,872,14.949,706,12.104,9886,3921,5965,8.463,21.339,8137,3812,4325,8.228,17.564,1749,3.775,35.127,536,539,3015
1998,4885,11000,14570,148018,143563,1649,11.428,1369,9.487,29219,9008,20211,6.275,20.353,20505,7479,13026,5.210,14.283,8714,6.070,28.566,921,961,4746
1998,4889,792,1580,55606,37441,890,75.169,98,8.277,39044,35547,3497,94.943,104.283,3370,610,2760,1.629,9.001,35674,95.282,18.002,78,79,311
1998,4921,2013,5619,465992,464593,975,18.187,459,8.562,48628,21393,27235,4.605,10.467,42486,6908,35578,1.487,9.145,6142,1.322,18.290,213,216,1287
1998,4922,4414,4767,65414,66311,705,14.775,714,14.964,14209,3458,10751,5.215,21.428,15917,7223,8694,10.893,24.004,-1708,-2.576,42.856,577,584,3352
1998,4931,6495,11911,505616,503298,1325,11.248,1062,9.016,91601,35751,55850,7.103,18.200,88082,34794,53288,6.913,17.501,3519,0.699,35.002,336,356,4165
1998,5111,15817,19075,702276,696411,1989,10.479,1801,9.488,82633,27056,55577,3.885,11.866,70579,21636,48943,3.107,10.135,12054,1.731,20.269,1349,1359,7693
1998,5112,8540,10719,277861,267340,1399,13.145,1246,11.708,67575,18803,48772,7.033,25.277,46006,17913,28093,6.700,17.209,21569,8.068,34.418,779,804,7872
1998,5121,11883,16090,259080,255715,2283,14.283,2072,12.963,61135,28055,33080,10.971,23.908,54264,23691,30573,9.265,21.221,6871,2.687,42.441,1193,1272,8427
1998,5122,2411,2535,19987,19686,433,17.467,321,12.949,4333,1861,2472,9.453,22.011,3632,1272,2360,6.461,18.450,701,3.561,36.899,246,246,977
1998,5151,5636,7775,241102,242266,838,10.600,1100,13.913,37270,14961,22309,6.175,15.384,39476,21458,18018,8.857,16.295,-2206,-0.911,30.768,746,814,11446
1998,5152,280,635,29376,28306,190,33.539,53,9.356,6969,3925,3044,13.866,24.620,4823,1790,3033,6.324,17.039,2146,7.581,34.078,13,13,573
1998,5171,4511,26492,1009169,993827,4917,19.263,2985,11.694,225553,103251,122302,10.389,22.695,193608,93306,100302,9.389,19.481,31945,3.214,38.962,593,631,9345
1998,5172,2556,7103,162141,146128,2347,36.882,868,13.640,64232,35837,28395,24.524,43.956,31587,14277,17310,9.770,21.616,32645,22.340,43.232,311,353,2391
1998,5174,352,557,11141,10177,180,36.217,60,12.072,4619,2671,1948,26.245,45.387,2724,1268,1456,12.459,26.766,1895,18.620,53.532,28,29,370
1998,5179,4536,5177,85060,76622,1620,33.361,978,20.140,34080,14291,19789,18.651,44.478,17043,7324,9719,9.559,22.243,17037,22.235,44.486,666,672,3829
1998,5182,4524,8125,325624,317297,1505,19.358,804,10.342,73730,27501,46229,8.667,23.237,57258,21042,36216,6.632,18.046,16472,5.191,36.091,382,389,3631
1998,5191,2824,3450,51892,49869,358,10.623,198,5.875,8898,3060,5838,6.136,17.843,4935,1315,3620,2.637,9.896,3963,7.947,19.792,129,135,708
1998,5211,15,44,21936,22033,3,6.977,(D),(D),488,42,446,0.191,2.215,683,(D),664,(D),3.100,-195,-0.885,4.430,0,0,0
1998,5221,19102,102007,1901122,1916834,8385,8.174,9535,9.295,301008,110099,190909,5.744,15.703,338575,146579,191996,7.647,17.663,-37567,-1.960,31.407,415,775,13729
1998,5222,17650,44010,580988,553296,6580,15.122,5586,12.838,157462,59955,97507,10.836,28.459,102886,47173,55713,8.526,18.595,54576,9.864,37.190,1584,1702,10208
1998,5223,11722,16238,186996,170990,3494,22.819,1641,10.717,61515,24361,37154,14.247,35.976,29946,13552,16394,7.926,17.513,31569,18.462,35.027,911,957,5774
1998,5231,11166,29608,461945,474807,5586,19.605,3356,11.778,91102,34773,56329,7.324,19.187,118943,40855,78088,8.605,25.051,-27841,-5.864,38.374,871,899,7410
1998,5232,34,46,6172,6071,13,31.707,3,7.317,576,374,202,6.161,9.489,420,3,417,0.049,6.919,156,2.570,13.837,(D),(D),(D)
1998,5239,22407,25066,261397,255960,4225,17.249,3081,12.579,62682,21435,41247,8.374,24.489,51571,18536,33035,7.242,20.148,11111,4.341,40.296,2027,2053,8511
1998,5241,4574,38026,1542091,1540843,7233,19.575,5083,13.756,263932,95891,168041,6.223,17.129,265740,106715,159025,6.926,17.246,-1808,-0.117,34.258,280,313,5243
1998,5242,112724,123809,783936,768338,11704,9.495,10627,8.621,144207,46754,97453,6.085,18.769,112699,47332,65367,6.160,14.668,31508,4.101,29.336,7188,7314,24059
1998,5250,2052,2831,38917,37133,610,22.295,420,15.351,13918,7597,6321,20.459,37.481,10207,4300,5907,11.580,27.488,3711,9.994,54.975,263,267,2264
1998,5311,88447,97899,481424,479431,10237,10.464,10105,10.329,96499,42222,54277,8.807,20.128,92532,41195,51337,8.592,19.300,3967,0.827,38.601,7505,7649,28228
1998,5312,47081,52804,237105,231182,7844,15.055,6441,12.362,58110,25142,32968,10.875,25.136,46006,18968,27038,8.205,19.900,12104,5.236,39.801,4314,4408,12538
1998,5313,40301,46669,457164,457695,6365,13.849,4947,10.764,95428,35422,60006,7.739,20.850,95530,39823,55707,8.701,20.872,-102,-0.022,41.699,2947,3094,21776
1998,5321,4507,9926,169519,162904,1467,14.995,1182,12.082,33421,7960,25461,4.886,20.516,19970,10291,9679,6.317,12.259,13451,8.257,24.518,459,533,3440
1998,5322,17333,30737,242029,236094,3410,10.946,4243,13.620,56897,21324,35573,9.032,24.099,45736,19798,25938,8.386,19.372,11161,4.727,38.744,2521,3155,13693
1998,5323,3580,5955,39774,39008,492,8.307,428,7.226,6843,2590,4253,6.640,17.543,5289,2192,3097,5.619,13.559,1554,3.984,27.118,279,290,1455
1998,5324,7374,10764,139082,135746,1571,14.796,1279,12.046,31287,12702,18585,9.357,23.048,24169,9892,14277,7.287,17.805,7118,5.244,35.609,704,836,6202
1998,5331,1671,1789,19906,19778,231,12.959,218,12.230,4166,1452,2714,7.342,21.064,3909,1014,2895,5.127,19.765,257,1.299,39.530,143,143,723
1998,5411,155432,162681,1053087,1040615,14735,9.096,13355,8.244,146039,46324,99715,4.452,14.034,120906,37550,83356,3.608,11.619,25133,2.415,23.237,9616,9733,26375
1998,5412,84694,90188,1077257,1024639,9527,10.634,8338,9.306,244247,77563,166684,7.570,23.837,138887,57334,81553,5.596,13.555,105360,10.283,27.109,5658,5687,21578
1998,5413,80332,90041,1174308,1124385,11357,12.861,7885,8.929,243883,97274,146609,8.651,21.690,142315,42359,99956,3.767,12.657,101568,9.033,25.314,5299,5376,22189
1998,5414,22758,22966,123815,119944,3836,17.044,2918,12.965,28611,10984,17627,9.158,23.854,20790,8609,12181,7.178,17.333,7821,6.521,34.666,2234,2243,6845
1998,5415,59928,66472,867190,814101,17759,28.643,8816,14.219,270314,113981,156333,14.001,33.204,164312,65358,98954,8.028,20.183,106002,13.021,40.366,5746,5809,29907
1998,5416,58289,61830,530262,496475,14253,24.103,8860,14.983,158875,68207,90668,13.738,32.001,91559,40418,51141,8.141,18.442,67316,13.559,36.884,6553,6585,27850
1998,5417,9040,11415,517648,502452,1620,14.413,1269,11.291,92720,32921,59799,6.552,18.454,62051,20913,41138,4.162,12.350,30669,6.104,24.699,715,746,4403
1998,5418,32333,35483,445913,437344,4991,14.289,3884,11.120,90220,32314,57906,7.389,20.629,73000,24983,48017,5.712,16.692,17220,3.937,33.383,2790,2806,14937
1998,5419,41236,47912,424643,406501,6540,14.180,2956,6.409,92511,33171,59340,8.160,22.758,55607,18403,37204,4.527,13.679,36904,9.078,27.359,1584,1596,9519
1998,5511,28047,50203,3244225,3217932,5487,10.884,5910,11.723,617858,180006,437852,5.594,19.200,565592,195945,369647,6.089,17.576,52266,1.624,35.153,1126,1198,17317
1998,5611,18766,21716,365754,348995,3542,16.525,2979,13.898,103062,43440,59622,12.447,29.531,68996,28639,40357,8.206,19.770,34066,9.761,39.540,2077,2109,20320
1998,5612,1239,2412,108276,108712,404,17.079,311,13.147,22514,9622,12892,8.851,20.710,23588,9664,13924,8.890,21.698,-1074,-0.988,41.420,69,118,3331
1998,5613,24880,40331,3575786,3352003,7169,18.479,4097,10.561,1113109,369636,743473,11.027,33.207,657787,179811,477976,5.364,19.624,455322,13.584,39.247,2387,2515,81813
1998,5614,25654,30415,633965,606492,4758,15.901,3773,12.609,159067,59251,99816,9.769,26.227,103316,42824,60492,7.061,17.035,55751,9.192,34.070,2658,2722,21447
1998,5615,25153,33278,296165,291014,4114,12.476,3508,10.638,58269,24065,34204,8.269,20.023,48549,18987,29562,6.524,16.683,9720,3.340,33.365,2393,2507,12522
1998,5616,15590,19527,686178,665607,2846,14.758,2362,12.248,134615,38006,96609,5.710,20.224,91954,39610,52344,5.951,13.815,42661,6.409,27.630,1662,1705,24405
1998,5617,113449,118922,1391759,1355286,19442,16.965,10805,9.428,300830,98228,202602,7.248,22.197,227420,67665,159755,4.993,16.780,73410,5.417,33.560,8568,8615,47195
1998,5619,21033,22921,351705,342767,3376,14.854,2991,13.160,80047,21562,58485,6.291,23.353,62236,21087,41149,6.152,18.157,17811,5.196,36.314,2203,2222,13949
1998,5621,6421,7659,144435,143049,1013,13.370,848,11.193,22882,10556,12326,7.379,15.996,20401,9337,11064,6.527,14.262,2481,1.734,28.523,653,663,5478
1998,5622,1422,2206,56446,57396,301,13.744,269,12.283,10594,4637,5957,8.079,18.458,12462,5877,6585,10.239,21.712,-1868,-3.255,36.915,166,168,3129
1998,5629,5206,5797,90018,88518,695,12.147,544,9.508,19727,6571,13156,7.423,22.286,16608,4262,12346,4.815,18.762,3119,3.524,37.525,384,389,2344
1998,6111,15675,17815,662911,646907,830,4.768,17,0.098,67541,15982,51559,2.471,10.441,35266,43,35223,0.007,5.451,32275,4.989,10.903,(D),(D),(D)
1998,6112,533,796,74680,73235,25,3.191,0,0.000,7226,398,6828,0.543,9.867,4331,0,4331,0.000,5.914,2895,3.953,11.828,0,0,0
1998,6113,2295,2859,1266750,1244402,160,5.756,(D),(D),90711,6350,84361,0.510,7.290,46204,(D),46203,(D),3.713,44507,3.577,7.426,0,0,0
1998,6114,5236,5759,58326,58737,1019,17.964,846,14.914,15370,5340,10030,9.091,26.168,15925,8910,7015,15.169,27.113,-555,-0.945,52.335,607,619,3517
1998,6115,5361,6246,69721,68514,734,11.790,693,11.132,13616,3918,9698,5.719,19.873,11049,3755,7294,5.481,16.127,2567,3.747,32.253,489,503,2676
1998,6116,19781,21182,169594,162161,3143,15.142,2293,11.047,42067,15324,26743,9.450,25.942,27463,9952,17511,6.137,16.936,14604,9.006,33.871,1703,1709,7050
1998,6117,3099,3329,32004,30306,635,19.705,422,13.095,7792,3076,4716,10.150,25.712,4398,1407,2991,4.643,14.512,3394,11.199,29.024,314,314,908
1998,6211,158525,179722,1612110,1597478,14785,8.196,16132,8.943,291895,107559,184336,6.733,18.272,261679,94865,166814,5.938,16.381,30216,1.891,32.762,11706,12087,63520
1998,6212,106200,109811,663502,656637,5666,5.187,4534,4.150,90052,25878,64174,3.941,13.714,76511,20312,56199,3.093,11.652,13541,2.062,23.304,3453,3548,15420
1998,6213,76414,81891,419552,412522,8409,10.319,7611,9.340,81891,30599,51292,7.418,19.851,67701,27753,39948,6.728,16.412,14190,3.440,32.823,5467,5549,18677
1998,6214,10120,20965,516341,510117,2551,12.416,1713,8.337,90321,36747,53574,7.204,17.706,76709,33255,43454,6.519,15.038,13612,2.668,30.075,694,774,9779
1998,6215,5458,8905,151229,148647,999,11.137,1129,12.586,28569,10282,18287,6.917,19.219,23661,12107,11554,8.145,15.918,4908,3.302,31.835,565,584,4510
1998,6216,11071,17892,892448,903267,2142,11.987,2097,11.735,164813,43988,120825,4.870,18.246,187441,62283,125158,6.895,20.751,-22628,-2.505,36.493,1090,1174,26796
1998,6219,4161,6223,175125,172709,789,12.974,506,8.320,26142,9447,16695,5.470,15.136,21363,8312,13051,4.813,12.369,4779,2.767,24.739,326,343,4908
1998,6221,3532,5461,4534376,4500897,171,3.150,106,1.953,291376,74132,217244,1.647,6.474,225595,60707,164888,1.349,5.012,65781,1.462,10.024,39,39,25412
1998,6222,507,796,246256,250130,63,7.860,74,9.233,17230,5583,11647,2.232,6.888,25312,15448,9864,6.176,10.120,-8082,-3.231,13.777,12,12,4969
1998,6223,284,429,151954,150324,43,10.450,8,1.944,10097,3659,6438,2.434,6.717,6842,2201,4641,1.464,4.552,3255,2.165,9.103,3,3,1525
1998,6231,7995,15568,1553818,1543620,1524,9.994,886,5.810,178827,75438,103389,4.887,11.585,155082,68454,86628,4.435,10.047,23745,1.538,20.093,440,464,25489
1998,6232,7490,20355,377758,365644,1999,10.036,1124,5.643,73135,25019,48116,6.842,20.002,48671,14556,34115,3.981,13.311,24464,6.691,26.622,427,467,8311
1998,6233,12134,14881,431649,414794,2096,14.414,1416,9.738,76441,32176,44265,7.757,18.429,42693,18110,24583,4.366,10.293,33748,8.136,20.585,960,1009,10857
1998,6239,3380,5751,137536,134640,597,10.496,471,8.281,22714,6712,16002,4.985,16.870,16849,5035,11814,3.740,12.514,5865,4.356,25.028,260,292,2925
1998,6241,29430,41353,692903,676937,3786,9.253,2911,7.115,121661,30974,90687,4.576,17.972,89423,21303,68120,3.147,13.210,32238,4.762,26.420,1685,1757,10165
1998,6242,7947,9862,109793,106297,638,6.557,374,3.844,17733,4090,13643,3.848,16.683,10693,2022,8671,1.902,10.060,7040,6.623,20.119,201,203,995
1998,6243,5235,7852,296700,292123,613,7.807,612,7.795,53044,10050,42994,3.440,18.158,44134,7551,36583,2.585,15.108,8910,3.050,30.216,284,292,2435
1998,6244,46861,57881,640689,629044,6619,11.541,5566,9.705,110291,40201,70090,6.391,17.533,87162,31712,55450,5.041,13.856,23129,3.677,27.713,4102,4198,22176
1998,7111,7552,7670,112909,111200,1178,15.557,982,12.969,26299,8727,17572,7.848,23.650,22641,7811,14830,7.024,20.361,3658,3.290,40.721,672,673,4326
1998,7112,3128,3246,89599,88686,525,16.393,438,13.677,16572,6146,10426,6.930,18.686,14627,5211,9416,5.876,16.493,1945,2.193,32.986,333,338,2189
1998,7113,3136,3252,63164,63741,481,15.123,338,10.627,15348,6238,9110,9.787,24.079,16174,5558,10616,8.720,25.375,-826,-1.296,48.158,238,240,2783
1998,7114,2222,2278,14076,14086,347,15.460,280,12.475,3353,1727,1626,12.260,23.804,3396,1046,2350,7.426,24.109,-43,-0.305,47.608,198,199,613
1998,7115,8257,8276,32050,32727,1683,20.792,1320,16.307,11226,4809,6417,14.695,34.302,12465,4377,8088,13.374,38.088,-1239,-3.786,68.605,793,793,2187
1998,7121,4824,5185,94866,92923,343,6.679,244,4.751,11475,1438,10037,1.548,12.349,7552,957,6595,1.030,8.127,3923,4.222,16.254,144,144,656
1998,7131,1717,2802,138647,133430,394,14.129,367,13.161,26668,11096,15572,8.316,19.987,15928,4107,11821,3.078,11.937,10740,8.049,23.875,196,202,2936
1998,7132,1655,1977,163821,159608,224,11.434,188,9.597,22105,5273,16832,3.304,13.850,13620,3931,9689,2.463,8.533,8485,5.316,17.067,127,128,2930
1998,7139,44235,48122,861706,846031,5246,10.966,4676,9.775,154534,54551,99983,6.448,18.266,123359,44741,78618,5.288,14.581,31175,3.685,29.162,3400,3483,30819
1998,7211,33700,42505,1636801,1616113,5211,12.452,3896,9.310,288872,149675,139197,9.261,17.874,244007,112302,131705,6.949,15.098,44865,2.776,30.197,2426,2485,46249
1998,7212,5119,5512,35621,35135,565,10.297,515,9.386,7005,2169,4836,6.173,19.938,5991,1830,4161,5.209,17.052,1014,2.886,34.103,314,341,1219
1998,7213,3083,3158,15558,15447,241,7.556,304,9.531,2733,851,1882,5.509,17.693,2497,970,1527,6.280,16.165,236,1.528,32.330,215,215,630
1998,7223,9545,22973,476120,467965,3764,16.505,3429,15.036,111198,40191,71007,8.588,23.762,94445,45471,48974,9.717,20.182,16753,3.580,40.364,1167,1183,6991
1998,7224,46659,47083,319397,318257,5277,11.122,6004,12.654,70505,33755,36750,10.606,22.153,68062,28560,39502,8.974,21.386,2443,0.768,42.772,4737,4747,22552
1998,7225,263415,361613,6957109,6911741,43326,11.984,43169,11.940,1329054,620752,708302,8.981,19.229,1232940,506701,726239,7.331,17.838,96114,1.391,35.677,28875,29857,280990
1998,8111,138880,151483,840600,836450,16793,11.134,15488,10.268,154464,65157,89307,7.790,18.467,145849,57246,88603,6.844,17.437,8615,1.030,34.873,11205,11319,39442
1998,8112,13640,15823,141356,139895,1774,11.122,2029,12.721,29171,9818,19353,7.018,20.852,26651,12445,14206,8.896,19.051,2520,1.801,38.102,1363,1452,6014
1998,8113,21087,22608,191538,190778,2231,9.889,2135,9.464,31872,8737,23135,4.580,16.706,29914,9340,20574,4.896,15.680,1958,1.026,31.360,1571,1583,5777
1998,8114,24564,26041,148297,147614,3264,12.524,3305,12.682,25527,9708,15819,6.577,17.293,24094,9279,14815,6.286,16.322,1433,0.971,32.645,2584,2597,7107
1998,8121,75325,86461,477694,468437,11733,13.628,11006,12.783,106679,53146,53533,11.345,22.773,87786,41972,45814,8.960,18.740,18893,4.033,37.480,8143,8513,28324
1998,8122,15782,21876,164450,161359,1871,8.617,1547,7.124,33052,12848,20204,7.962,20.484,25704,9083,16621,5.629,15.930,7348,4.554,31.859,931,1013,5230
1998,8123,34421,40724,391169,391260,4063,9.938,4378,10.709,60583,21493,39090,5.493,15.484,60278,22155,38123,5.662,15.406,305,0.078,30.812,3089,3194,14049
1998,8129,16771,25947,211735,205696,4910,19.697,2872,11.521,50764,23414,27350,11.383,24.679,39424,17448,21976,8.482,19.166,11340,5.513,38.332,1118,1242,7492
1998,8131,156363,156491,1457319,1437657,7521,4.923,78,0.051,159845,21977,137868,1.529,11.118,120378,341,120037,0.024,8.373,39467,2.745,16.746,8,8,17
1998,8132,9932,11698,117104,114147,1332,11.732,643,5.663,19363,5696,13667,4.990,16.963,13581,2657,10924,2.328,11.898,5782,5.065,23.796,374,384,1298
1998,8133,8163,9748,89542,87773,929,9.654,679,7.056,15469,3820,11649,4.352,17.624,11920,2528,9392,2.880,13.580,3549,4.043,27.161,419,429,1667
1998,8134,27940,29690,308757,305220,1470,4.947,1515,5.099,40495,7111,33384,2.330,13.268,33306,5978,27328,1.959,10.912,7189,2.355,21.824,1047,1048,3972
1998,8139,63279,65219,497860,496051,3680,5.697,2422,3.750,65441,15571,49870,3.139,13.192,61679,9616,52063,1.939,12.434,3762,0.758,24.868,1733,1739,6502
1999,2111,5698,6875,85693,90595,563,7.966,948,13.414,11722,5130,6592,5.663,12.939,21544,6375,15169,7.037,23.781,-9822,-10.842,25.878,570,581,2833
1999,2121,844,1245,77215,79242,127,9.910,200,15.607,8791,3068,5723,3.872,11.094,12838,4570,8268,5.767,16.201,-4047,-5.107,22.188,120,127,2064
1999,2122,302,416,36822,38580,65,15.458,74,17.598,2167,1210,957,3.136,5.617,5736,663,5073,1.719,14.868,-3569,-9.251,11.234,49,50,250
1999,2123,3227,5095,101734,101724,424,8.389,343,6.786,13661,4140,9521,4.070,13.429,13740,4609,9131,4.531,13.507,-79,-0.078,26.859,198,203,1720
1999,2131,6629,7699,143995,157168,731,9.242,1152,14.565,22234,5823,16411,3.705,14.147,47888,15028,32860,9.562,30.469,-25654,-16.323,28.293,776,798,9373
1999,2211,1568,8719,534084,538697,944,11.146,445,5.254,49451,22052,27399,4.094,9.180,57973,12523,45450,2.325,10.762,-8522,-1.582,18.359,64,71,1029
1999,2212,555,2655,92842,95973,381,14.426,353,13.366,14719,8212,6507,8.557,15.337,20783,8836,11947,9.207,21.655,-6064,-6.318,30.673,47,52,560
1999,2213,4120,4564,35735,35883,239,5.216,275,6.002,4283,1240,3043,3.456,11.936,4544,1533,3011,4.272,12.663,-261,-0.727,23.872,168,178,665
1999,2361,132530,133190,724643,695623,22760,17.359,18604,14.189,208356,76606,131750,11.013,29.952,150256,64467,85789,9.268,21.600,58100,8.352,43.200,13452,13458,48492
1999,2362,40822,41632,777238,757636,4635,11.211,4054,9.806,159368,33169,126199,4.378,21.035,120481,25838,94643,3.410,15.902,38887,5.133,31.804,2916,2918,18523
1999,2371,16205,16574,398316,386491,1561,9.514,1227,7.479,82190,16389,65801,4.240,21.266,58429,15973,42456,4.133,15.118,23761,6.148,30.236,924,927,12525
1999,2372,9097,9277,65755,61396,1933,21.492,1367,15.199,21157,9960,11197,16.223,34.460,12427,5567,6860,9.067,20.241,8730,14.219,40.481,1016,1016,3935
1999,2373,10708,11120,280789,272521,895,8.056,874,7.867,58822,8971,49851,3.292,21.584,42131,10864,31267,3.986,15.460,16691,6.125,30.920,624,626,6183
1999,2379,4709,4801,69568,68188,602,12.517,619,12.870,14869,3659,11210,5.366,21.806,12091,3308,8783,4.851,17.732,2778,4.074,35.464,488,489,2461
1999,2381,91733,92111,941832,904687,12151,13.348,9998,10.983,236136,58017,178119,6.413,26.101,162345,49307,113038,5.450,17.945,73791,8.157,35.890,7460,7467,36805
1999,2382,141798,144216,1686907,1636280,15497,10.835,13127,9.178,335678,75486,260192,4.613,20.515,234100,75221,158879,4.597,14.307,101578,6.208,28.614,9792,9807,55035
1999,2383,95646,96318,797706,769374,14706,15.459,12326,12.957,203938,54815,149123,7.125,26.507,147077,51670,95407,6.716,19.116,56861,7.391,38.233,9257,9259,39364
1999,2389,49797,50074,422515,407758,6995,14.218,5246,10.663,101586,28719,72867,7.043,24.913,72222,24724,47498,6.063,17.712,29364,7.201,35.424,3834,3838,17676
1999,3111,1033,1629,49312,48660,105,6.440,108,6.624,6144,1792,4352,3.683,12.626,4874,1755,3119,3.607,10.016,1270,2.610,20.033,55,58,636
1999,3112,501,853,63288,62920,36,4.213,39,4.564,5116,1471,3645,2.338,8.131,4365,976,3389,1.551,6.937,751,1.194,13.875,26,26,296
1999,3113,1435,1626,83377,83779,127,7.784,138,8.458,7064,1288,5776,1.537,8.432,8077,1622,6455,1.936,9.641,-1013,-1.209,16.863,116,118,781
1999,3114,1299,1696,170883,170247,112,6.533,149,8.691,19563,3677,15886,2.160,11.491,18610,6847,11763,4.022,10.931,953,0.560,21.862,102,102,2372
1999,3115,1161,1683,130019,130376,88,5.167,128,7.516,12470,2748,9722,2.108,9.565,13068,5831,7237,4.472,10.023,-598,-0.459,19.129,73,73,1816
1999,3116,3284,3909,481799,474711,238,6.092,234,5.989,43724,9711,34013,2.046,9.211,29673,12730,16943,2.682,6.251,14051,2.960,12.502,161,163,3487
1999,3117,647,756,42051,42977,73,9.631,77,10.158,5151,1082,4069,2.518,11.985,7015,2283,4732,5.312,16.323,-1864,-4.337,23.971,48,48,1326
1999,3118,9258,10053,291791,296837,1062,10.468,1247,12.291,35175,9504,25671,3.202,11.850,45792,15407,30385,5.190,15.427,-10617,-3.577,23.700,949,969,7166
1999,3119,2265,2623,144675,144674,189,7.203,191,7.279,14245,3577,10668,2.472,9.846,14238,4670,9568,3.228,9.841,7,0.005,19.683,142,142,2277
1999,3121,1939,2399,138861,139216,198,8.253,198,8.253,11848,1562,10286,1.122,8.511,12372,4660,7712,3.347,8.887,-524,-0.376,17.021,142,144,1991
1999,3122,80,108,28047,29244,9,8.108,15,13.514,1610,25,1585,0.085,5.505,4006,565,3441,1.932,13.699,-2396,-8.193,11.011,11,11,133
1999,3131,348,586,83329,82881,48,8.297,33,5.704,9059,4836,4223,5.835,10.930,8071,1126,6945,1.359,9.738,988,1.192,19.476,20,20,233
1999,3132,1633,1961,196695,201776,123,6.220,156,7.889,12672,4057,8615,2.011,6.280,22578,3766,18812,1.866,11.190,-9906,-4.909,12.560,119,119,1139
1999,3133,2061,2211,91009,96689,159,6.975,296,12.985,7844,1918,5926,1.984,8.113,18983,6979,12004,7.218,19.633,-11139,-11.521,16.225,235,237,3276
1999,3141,2679,2916,122102,122117,226,7.639,311,10.512,14077,4965,9112,4.066,11.527,13887,4875,9012,3.992,11.372,190,0.156,22.744,235,245,3289
1999,3149,4345,4477,106107,107622,416,9.283,425,9.483,15214,5793,9421,5.383,14.137,18228,6220,12008,5.780,16.937,-3014,-2.801,28.273,323,325,3503
1999,3151,991,1084,86209,89783,77,6.857,155,13.802,8833,2788,6045,3.105,9.838,15958,6035,9923,6.722,17.774,-7125,-7.936,19.676,120,121,2295
1999,3152,9568,10190,412011,444376,1409,13.392,2072,19.693,56752,20524,36228,4.619,12.771,121876,54976,66900,12.372,27.426,-65124,-14.655,25.542,1603,1613,27926
1999,3159,1914,1992,50411,52872,198,9.677,306,14.956,5430,2194,3236,4.150,10.270,10322,3613,6709,6.833,19.523,-4892,-9.253,20.540,228,235,2260
1999,3161,286,309,15208,15612,21,6.542,45,14.019,1219,215,1004,1.377,7.808,2092,589,1503,3.773,13.400,-873,-5.592,15.617,32,32,237
1999,3162,310,358,33915,35821,26,7.027,50,13.514,3041,967,2074,2.700,8.490,6784,2148,4636,5.997,18.939,-3743,-10.449,16.979,31,31,340
1999,3169,918,945,24903,25962,70,7.224,118,12.178,2508,556,1952,2.142,9.660,4633,1665,2968,6.413,17.845,-2125,-8.185,19.321,89,89,1327
1999,3211,4099,4572,134911,134412,322,7.026,344,7.506,14187,4274,9913,3.180,10.555,13148,3447,9701,2.565,9.782,1039,0.773,19.564,254,254,1980
1999,3212,1428,1799,117863,115791,115,6.394,114,6.339,13346,3189,10157,2.754,11.526,9294,3347,5947,2.891,8.027,4052,3.499,16.053,82,84,1689
1999,3219,9153,9945,341724,335894,951,9.566,943,9.486,46489,11132,35357,3.314,13.840,35081,12298,22783,3.661,10.444,11408,3.396,20.888,738,739,8839
1999,3221,239,536,168436,171031,35,6.573,28,5.258,9417,5939,3478,3.472,5.506,14475,5526,8949,3.231,8.463,-5058,-2.957,11.012,8,8,533
1999,3222,3457,5211,395892,395774,258,4.946,268,5.138,39428,14046,25382,3.549,9.962,39685,16540,23145,4.179,10.027,-257,-0.065,19.925,158,160,3403
1999,3231,36638,38457,829043,832437,2275,5.840,3273,8.402,84622,22593,62029,2.714,10.166,91377,35853,55524,4.307,10.977,-6755,-0.811,20.331,2557,2573,21525
1999,3241,1098,2164,124147,125002,139,6.447,123,5.705,9542,2843,6699,2.274,7.633,11217,4047,7170,3.238,8.973,-1675,-1.340,15.267,56,59,902
1999,3251,1099,2360,208539,211061,135,5.718,137,5.803,16212,9847,6365,4.665,7.681,21143,6832,14311,3.237,10.018,-4931,-2.336,15.362,60,60,526
1999,3252,456,784,117727,119873,62,7.969,50,6.427,10103,3654,6449,3.048,8.428,14197,4212,9985,3.514,11.843,-4094,-3.415,16.856,22,22,777
1999,3253,654,879,36711,37072,62,7.045,64,7.273,2857,704,2153,1.899,7.707,3589,1126,2463,3.037,9.681,-732,-1.975,15.413,33,37,504
1999,3254,1399,1729,211982,208588,154,9.030,107,6.274,21719,4179,17540,2.003,10.412,15071,2751,12320,1.319,7.225,6648,3.187,14.451,62,64,1120
1999,3255,1568,2022,74620,74902,84,4.104,134,6.546,6277,904,5373,1.207,8.380,6954,2290,4664,3.057,9.284,-677,-0.904,16.761,97,97,1165
1999,3256,2077,2303,124740,125711,157,6.775,186,8.026,11662,2448,9214,1.947,9.277,13581,5217,8364,4.150,10.803,-1919,-1.527,18.554,125,125,2714
1999,3259,2127,2784,120460,122873,184,6.575,213,7.611,9177,2266,6911,1.844,7.469,14048,5321,8727,4.331,11.433,-4871,-3.964,14.937,132,132,1923
1999,3261,10580,13135,824072,820187,881,6.701,907,6.898,96058,24902,71156,3.036,11.712,87623,29264,58359,3.568,10.683,8435,1.028,21.367,582,589,11656
1999,3262,2021,2575,201318,200726,146,5.643,171,6.609,16625,4118,12507,2.052,8.282,15542,2792,12750,1.391,7.743,1083,0.540,15.486,116,117,1238
1999,3271,1514,1767,75024,76742,117,6.542,160,8.946,6105,947,5158,1.234,7.955,9479,2687,6792,3.501,12.352,-3374,-4.397,15.911,129,129,1159
1999,3272,1867,2158,130485,130800,190,8.914,137,6.427,9471,2536,6935,1.939,7.241,10116,1318,8798,1.008,7.734,-645,-0.493,14.482,105,105,576
1999,3273,5457,8909,204297,199324,562,6.345,459,5.182,33387,7634,25753,3.830,16.750,23290,6757,16533,3.390,11.685,10097,5.066,23.369,264,271,3535
1999,3274,238,368,20517,20345,25,6.748,30,8.097,1941,291,1650,1.430,9.541,1578,781,797,3.839,7.756,363,1.784,15.513,14,14,143
1999,3279,1998,2400,74932,75157,175,7.296,172,7.171,7698,1814,5884,2.414,10.243,8033,1778,6255,2.366,10.688,-335,-0.446,20.485,113,113,994
1999,3311,250,333,120934,122822,58,18.182,30,9.404,6210,820,5390,0.668,5.056,10121,1190,8931,0.969,8.240,-3911,-3.184,10.112,14,14,127
1999,3312,529,731,65008,65579,56,7.756,38,5.263,4767,1019,3748,1.554,7.269,5950,1383,4567,2.109,9.073,-1183,-1.804,14.538,23,26,906
1999,3313,387,564,87347,88037,35,6.284,21,3.770,6999,2796,4203,3.176,7.950,8418,3993,4425,4.536,9.562,-1419,-1.612,15.900,7,7,283
1999,3314,711,904,80506,82226,77,8.570,66,7.346,5709,3158,2551,3.841,6.943,9184,2790,6394,3.393,11.169,-3475,-4.226,13.886,43,45,619
1999,3315,2344,2664,220455,225504,114,4.247,154,5.738,14747,2656,12091,1.178,6.540,24888,7240,17648,3.211,11.037,-10141,-4.497,13.079,97,98,1757
1999,3321,2732,2964,147213,147772,125,4.210,135,4.547,13226,2778,10448,1.880,8.950,14439,3367,11072,2.279,9.771,-1213,-0.821,17.901,85,85,1303
1999,3322,1457,1610,81268,82005,76,4.681,103,6.344,6084,1198,4886,1.461,7.419,7588,1521,6067,1.855,9.253,-1504,-1.834,14.838,70,70,806
1999,3323,11174,12051,404625,398587,793,6.600,721,6.001,53432,13173,40259,3.305,13.405,41291,12640,28651,3.171,10.359,12141,3.046,20.719,530,534,7273
1999,3324,1441,1788,106002,106528,91,5.071,104,5.795,10614,3287,7327,3.086,9.964,11737,3112,8625,2.921,11.018,-1123,-1.054,19.927,62,62,787
1999,3325,773,858,64964,65973,44,5.081,60,6.928,5181,977,4204,1.481,7.853,7215,3473,3742,5.264,10.936,-2034,-3.083,15.706,46,46,1275
1999,3326,1628,1811,68944,69198,105,5.809,98,5.422,6324,1139,5185,1.646,9.139,6815,1935,4880,2.796,9.849,-491,-0.710,18.278,75,75,781
1999,3327,25289,25739,426490,435003,1660,6.420,1896,7.333,40316,10198,30118,2.344,9.268,57446,13677,43769,3.144,13.206,-17130,-3.938,18.536,1454,1454,9688
1999,3328,5537,6087,153567,155797,344,5.640,368,6.034,16033,4430,11603,2.843,10.291,20445,4688,15757,3.009,13.123,-4412,-2.832,20.582,273,275,2883
1999,3329,5785,6327,309032,313478,530,8.417,469,7.449,25678,7254,18424,2.314,8.191,34416,11190,23226,3.570,10.979,-8738,-2.787,16.383,334,337,4966
1999,3331,2625,2943,203915,210724,197,6.655,231,7.804,16106,4427,11679,2.101,7.643,29988,6926,23062,3.287,14.231,-13882,-6.588,15.286,172,172,2231
1999,3332,4113,4363,179786,186754,256,5.832,309,7.040,14051,4747,9304,2.542,7.524,27730,5505,22225,2.948,14.848,-13679,-7.325,15.048,217,218,2640
1999,3333,2289,2439,131594,132726,170,6.940,191,7.798,12398,2408,9990,1.814,9.341,14600,4150,10450,3.127,11.000,-2202,-1.659,18.682,131,131,1892
1999,3334,1450,1768,177894,174842,104,5.849,124,6.974,19185,4033,15152,2.307,10.973,12865,5732,7133,3.278,7.358,6320,3.615,14.716,77,79,1732
1999,3335,9396,9764,238679,243031,475,4.841,570,5.810,19531,4734,14797,1.948,8.036,28439,6613,21826,2.721,11.702,-8908,-3.665,16.073,436,440,3231
1999,3336,763,923,110300,110148,57,6.243,37,4.053,7144,2099,5045,1.906,6.486,7092,855,6237,0.776,6.439,52,0.047,12.877,27,27,231
1999,3339,5931,6591,349566,358552,351,5.285,451,6.791,25379,5873,19506,1.638,7.078,43514,9856,33658,2.749,12.136,-18135,-5.058,14.156,314,314,3769
1999,3341,1611,1709,205804,214957,197,11.404,234,13.546,26494,14832,11662,6.900,12.325,43899,8280,35619,3.852,20.422,-17405,-8.097,24.651,173,174,2782
1999,3342,1828,2028,247819,249732,146,7.141,179,8.755,26736,5018,21718,2.009,10.706,30473,8858,21615,3.547,12.202,-3737,-1.496,21.412,114,118,3049
1999,3343,484,518,29267,30958,59,11.303,67,12.835,2853,485,2368,1.567,9.216,6443,2882,3561,9.310,20.812,-3590,-11.597,18.432,46,46,309
1999,3344,5014,5695,551499,567304,432,7.521,530,9.227,58744,21365,37379,3.766,10.355,90404,31453,58951,5.544,15.936,-31660,-5.581,20.710,368,371,8379
1999,3345,4528,5174,496157,496045,345,6.635,397,7.635,54537,13560,40977,2.734,10.994,53244,15802,37442,3.186,10.734,1293,0.261,21.467,245,247,4189
1999,3346,743,810,46372,48149,80,9.798,93,11.390,5875,1318,4557,2.737,12.202,9559,4062,5497,8.436,19.853,-3684,-7.651,24.404,61,61,1361
1999,3351,1163,1273,74107,74028,97,7.626,95,7.469,7573,2258,5315,3.050,10.230,7349,3865,3484,5.221,9.927,224,0.303,19.855,64,67,1323
1999,3352,242,315,101807,102288,33,10.526,30,9.569,8018,2057,5961,2.011,7.839,9030,2878,6152,2.814,8.828,-1012,-0.989,15.677,16,16,191
1999,3353,2327,2760,195759,201702,135,4.839,195,6.989,13761,2670,11091,1.324,6.822,25359,5890,19469,2.920,12.573,-11598,-5.750,13.645,123,124,1539
1999,3359,1834,2210,195069,196975,167,7.584,151,6.857,16671,4423,12248,2.245,8.464,20457,6910,13547,3.508,10.386,-3786,-1.922,16.927,93,93,1706
1999,3361,282,346,226987,227251,34,9.841,33,9.551,11436,1164,10272,0.512,5.032,12685,840,11845,0.370,5.582,-1249,-0.550,10.065,21,21,420
1999,3362,1796,2008,142554,136859,145,7.192,161,7.986,20945,3445,17500,2.517,15.304,9635,3127,6508,2.285,7.040,11310,8.264,14.080,123,123,1961
1999,3363,4509,5666,810176,810191,352,6.166,438,7.672,75654,18430,57224,2.275,9.338,74973,19767,55206,2.440,9.254,681,0.084,18.507,283,287,6450
1999,3364,1392,1701,472639,474856,114,6.702,114,6.702,29711,11320,18391,2.384,6.257,33875,8878,24997,1.870,7.134,-4164,-0.877,12.514,69,69,772
1999,3365,156,219,31372,30815,16,7.306,16,7.306,4033,879,3154,2.853,13.088,2902,1120,1782,3.635,9.418,1131,3.670,18.835,9,9,1017
1999,3366,1482,1591,143399,142310,190,11.961,185,11.646,14573,3166,11407,2.225,10.240,12343,3657,8686,2.570,8.673,2230,1.567,17.347,135,135,3137
1999,3369,645,675,35398,35878,80,11.887,76,11.293,3560,656,2904,1.828,9.923,4525,1635,2890,4.557,12.612,-965,-2.690,19.845,58,58,585
1999,3371,13214,13708,395035,389210,1367,9.994,1307,9.555,46664,8203,38461,2.108,11.989,34872,11267,23605,2.895,8.960,11792,3.030,17.919,1003,1009,6985
1999,3372,3995,4211,185907,185410,260,6.145,300,7.091,20546,4578,15968,2.469,11.081,19334,5384,13950,2.904,10.428,1212,0.654,20.855,226,227,2875
1999,3379,983,1094,46279,45542,73,6.627,88,7.989,5937,1319,4618,2.896,13.036,4343,1842,2501,4.045,9.536,1594,3.500,19.073,63,65,879
1999,3391,10804,11435,284932,284840,788,6.847,934,8.116,36195,9118,27077,3.201,12.707,35634,9345,26289,3.281,12.510,561,0.197,25.020,697,699,4476
1999,3399,16956,17535,430251,433923,1864,10.663,1757,10.051,52136,14659,37477,3.378,12.015,59171,15309,43862,3.528,13.636,-7035,-1.621,24.030,1378,1383,9599
1999,4231,18911,23175,313953,310844,2084,8.924,2438,10.440,47187,15313,31874,4.926,15.180,40864,16015,24849,5.152,13.146,6323,2.034,26.292,1645,1806,9943
1999,4232,9704,10885,142945,140595,1196,11.038,1096,10.115,23410,5940,17470,4.225,16.651,18679,6736,11943,4.791,13.286,4731,3.365,26.571,817,838,4740
1999,4233,8647,11625,152645,147596,1373,12.012,983,8.600,29205,9160,20045,6.206,19.787,18991,6525,12466,4.421,12.867,10214,6.920,25.734,709,721,4217
1999,4234,28321,36268,688672,678642,4034,11.086,4277,11.753,128503,40644,87859,5.989,18.935,108565,43739,64826,6.445,15.997,19938,2.938,31.995,2792,3003,23957
1999,4235,7814,10453,162761,163231,697,6.656,735,7.019,19018,4759,14259,2.916,11.651,19790,5739,14051,3.516,12.124,-772,-0.473,23.302,469,487,3342
1999,4236,19507,29140,440987,436872,2769,9.490,2845,9.750,74441,26819,47622,6.139,17.040,66876,24518,42358,5.612,15.308,7565,1.732,30.616,1674,1778,11672
1999,4237,11089,16448,201212,197975,1202,7.314,1173,7.138,27953,8102,19851,4.092,14.119,21299,7906,13393,3.993,10.758,6654,3.361,21.517,761,813,4820
1999,4238,49117,64907,759798,756449,4767,7.341,4818,7.420,100064,29779,70285,3.937,13.228,93176,33096,60080,4.375,12.318,6888,0.911,24.635,3175,3348,19244
1999,4239,28117,30440,309588,313820,3634,11.926,3694,12.123,50002,15590,34412,4.968,15.933,58061,23015,35046,7.334,18.501,-8059,-2.568,31.867,2764,2806,14280
1999,4241,9655,12812,219834,219930,991,7.684,1160,8.995,35000,7972,27028,3.625,15.914,35373,14529,20844,6.606,16.084,-373,-0.170,31.828,685,737,4266
1999,4242,4890,6155,183555,180773,737,11.747,975,15.540,27470,7447,20023,4.120,15.196,21998,8390,13608,4.641,12.169,5472,3.027,24.338,537,544,3021
1999,4243,13762,14836,179540,180780,1801,12.080,1946,13.053,32519,9574,22945,5.296,17.988,35146,11812,23334,6.534,19.441,-2627,-1.453,35.976,1491,1506,7605
1999,4244,27064,32726,777643,769191,2862,8.684,3325,10.089,99094,29043,70051,3.776,12.883,81979,30760,51219,3.999,10.658,17115,2.225,21.316,2501,2547,18375
1999,4245,4969,7766,69238,70732,323,4.077,636,8.028,7649,1884,5765,2.664,10.814,10615,4194,6421,5.929,15.007,-2966,-4.193,21.628,418,454,2616
1999,4246,9663,13545,152182,153783,907,6.667,1024,7.527,18427,4413,14014,2.870,11.983,21716,6624,15092,4.307,14.121,-3289,-2.139,23.965,616,648,3349
1999,4247,7077,10385,127663,127661,639,6.120,752,7.202,18648,6266,12382,4.908,14.607,18688,7050,11638,5.522,14.639,-40,-0.031,29.215,397,422,3104
1999,4248,3195,4064,147739,147045,241,5.885,303,7.399,16018,5232,10786,3.558,10.893,14738,5405,9333,3.676,10.023,1280,0.870,20.046,199,212,2516
1999,4249,22401,26883,354913,354300,3379,12.591,3285,12.241,57498,18183,39315,5.132,16.229,56048,22996,33052,6.491,15.819,1450,0.409,31.639,2456,2514,12311
1999,4251,33700,36015,288574,290484,2992,8.283,3202,8.865,40605,11526,29079,3.968,13.978,44224,17124,27100,5.895,15.224,-3619,-1.246,27.957,2202,2224,10771
1999,4411,42377,45794,1170076,1156512,4381,9.577,4284,9.365,138545,45180,93365,3.907,11.980,111295,44764,66531,3.871,9.623,27250,2.356,19.247,3325,3360,34260
1999,4412,11854,12813,114201,110626,1231,9.678,1044,8.208,20178,5712,14466,5.163,18.240,13093,5613,7480,5.074,11.835,7085,6.404,23.671,797,806,4222
1999,4413,34229,57904,528228,520303,4178,7.192,4551,7.834,85746,28661,57085,5.509,16.480,70660,24982,45678,4.801,13.581,15086,2.899,27.161,2591,2960,13649
1999,4421,19934,27872,274534,271176,2407,8.650,2317,8.326,43761,14230,29531,5.248,16.137,37419,14159,23260,5.221,13.799,6342,2.339,27.598,1500,1660,7635
1999,4422,24442,32277,255225,250244,3178,9.878,2972,9.237,47302,18894,28408,7.550,18.902,37541,13344,24197,5.332,15.002,9761,3.901,30.004,1877,2005,6948
1999,4431,32801,49863,460339,447704,5486,11.038,5164,10.390,91506,34279,57227,7.657,20.439,66254,31016,35238,6.928,14.799,25252,5.640,29.597,3429,3606,17542
1999,4441,49029,70683,1045630,1019603,4161,5.878,4362,6.162,148878,55756,93122,5.468,14.602,98543,34060,64483,3.341,9.665,50335,4.937,19.330,2989,3133,18161
1999,4442,16553,20583,180906,179599,1296,6.270,1468,7.102,26198,7221,18977,4.021,14.587,23557,7581,15976,4.221,13.116,2641,1.470,26.233,1021,1086,5370
1999,4451,59675,87948,2709207,2679728,9054,10.299,8984,10.219,346031,163186,182845,6.090,12.913,288016,101972,186044,3.805,10.748,58015,2.165,21.496,6046,6160,40368
1999,4452,16664,21234,142218,136271,3740,17.828,3228,15.388,37079,20975,16104,15.392,27.210,25354,11478,13876,8.423,18.606,11725,8.604,37.211,1722,1776,6936
1999,4453,22974,26160,131564,130913,2310,8.845,2221,8.505,20405,7543,12862,5.762,15.587,19277,6666,12611,5.092,14.725,1128,0.862,29.450,1704,1723,4968
1999,4461,40373,78033,933254,935669,5741,7.305,6846,8.712,146206,42386,103820,4.530,15.626,151668,55209,96459,5.900,16.210,-5462,-0.584,31.252,3582,4001,23731
1999,4471,63340,115268,927001,932606,8645,7.424,10998,9.445,159450,58609,100841,6.284,17.097,171525,62919,108606,6.747,18.392,-12075,-1.295,34.195,6121,6534,32958
1999,4481,37727,84478,933666,930555,7033,8.204,9529,11.116,162202,52814,109388,5.676,17.431,152651,53262,99389,5.724,16.404,9551,1.026,32.809,4592,4949,19024
1999,4482,6614,29155,193350,199712,2643,8.995,3097,10.540,34597,17374,17223,8.700,17.323,48146,18623,29523,9.325,24.108,-13549,-6.784,34.647,676,895,4675
1999,4483,18916,28828,163763,161669,2452,8.534,2259,7.862,26283,9366,16917,5.793,16.257,22091,7780,14311,4.812,13.664,4192,2.593,27.329,1387,1545,4540
1999,4511,30259,41033,386910,384644,3972,9.594,4712,11.381,60985,27346,33639,7.109,15.855,56216,22656,33560,5.890,14.615,4769,1.240,29.230,3073,3345,12523
1999,4512,7573,13402,140853,139241,1182,8.758,1370,10.151,21259,9090,12169,6.528,15.268,17915,7252,10663,5.208,12.866,3344,2.402,25.732,894,942,3636
1999,4521,61,10113,1761308,1789706,255,2.528,202,2.003,134775,31612,103163,1.766,7.531,192439,20398,172041,1.140,10.753,-57664,-3.222,15.061,4,4,187
1999,4529,9172,25568,724981,714033,3071,12.307,1843,7.386,89436,32810,56626,4.595,12.525,68929,13134,55795,1.839,9.653,20507,2.872,19.307,1044,1128,4902
1999,4531,21676,22739,120699,122148,1769,7.652,2529,10.939,18639,5574,13065,4.563,15.259,21619,8552,13067,7.001,17.699,-2980,-2.440,30.519,1899,1958,6019
1999,4532,29704,40869,350435,343482,4779,11.661,5008,12.220,67358,30336,37022,8.832,19.610,53548,21783,31765,6.342,15.590,13810,4.021,31.180,3175,3257,11623
1999,4533,13026,16572,109960,107926,1918,11.649,1704,10.349,18652,7440,11212,6.894,17.282,14646,4881,9765,4.523,13.570,4006,3.712,27.141,1362,1383,3436
1999,4539,31199,38534,247373,249026,5534,14.551,4527,11.904,55746,24881,30865,9.991,22.386,59719,19224,40495,7.720,23.981,-3973,-1.595,44.771,3224,3457,14672
1999,4541,8535,9471,235543,226925,1575,16.994,1169,12.613,51687,19723,31964,8.691,22.777,34182,11942,22240,5.263,15.063,17505,7.714,30.126,826,830,6884
1999,4542,5038,5619,66606,66575,591,10.411,706,12.437,8843,3164,5679,4.753,13.283,8715,4168,4547,6.261,13.091,128,0.192,26.181,538,544,3070
1999,4543,19175,25353,224684,222861,2522,9.957,2476,9.775,36512,10867,25645,4.876,16.383,32893,11924,20969,5.350,14.759,3619,1.624,29.519,1809,1863,8615
1999,4811,632,3058,520439,506767,342,11.832,7,0.242,44010,6622,37388,1.307,8.684,16726,31,16695,0.006,3.301,27284,5.384,6.601,3,3,12
1999,4812,1610,1770,32666,31529,224,12.771,192,10.946,5607,1823,3784,5.782,17.784,3347,965,2382,3.061,10.616,2260,7.168,21.232,128,130,440
1999,4831,783,1189,50132,51979,151,12.786,135,11.431,8563,2758,5805,5.306,16.474,11699,7009,4690,13.484,22.507,-3136,-6.033,32.948,59,61,1374
1999,4832,483,521,18853,18565,48,9.057,66,12.453,2359,301,2058,1.621,12.707,1778,762,1016,4.104,9.577,581,3.130,19.154,47,49,328
1999,4841,36900,45444,952040,925020,9218,21.038,5962,13.607,192195,83545,108650,9.032,20.777,136036,48373,87663,5.229,14.706,56159,6.071,29.413,4363,4506,26336
1999,4842,47192,50697,496019,495712,6519,12.813,6884,13.530,94020,32724,61296,6.601,18.967,93072,34762,58310,7.013,18.775,948,0.191,37.551,5345,5384,23867
1999,4851,440,664,35301,32495,176,28.711,74,12.072,8062,5600,2462,17.234,24.810,2305,918,1387,2.825,7.094,5757,17.717,14.187,58,58,597
1999,4852,199,377,17978,18199,44,11.908,29,7.848,1330,566,764,3.110,7.308,1718,713,1005,3.918,9.440,-388,-2.132,14.616,17,17,509
1999,4853,5691,5785,63790,62438,850,14.728,823,14.260,12241,4047,8194,6.482,19.605,9562,4083,5479,6.539,15.315,2679,4.291,30.629,667,669,3189
1999,4854,3150,4206,159956,156752,272,6.426,326,7.701,25607,6528,19079,4.165,16.336,18847,8685,10162,5.541,12.023,6760,4.313,24.047,211,214,3336
1999,4855,1215,1355,32881,32496,107,7.776,149,10.828,5119,1055,4064,3.247,15.753,4394,1597,2797,4.914,13.522,725,2.231,27.043,114,120,1239
1999,4859,2198,2381,49482,48417,396,16.776,355,15.039,10136,3682,6454,7.605,20.935,8046,3970,4076,8.200,16.618,2090,4.317,33.237,284,285,2603
1999,4861,44,328,6495,6771,18,5.263,46,13.450,922,244,678,3.604,13.618,1428,616,812,9.098,21.091,-506,-7.474,27.236,(D),(D),(D)
1999,4862,125,1573,30610,31760,151,9.609,148,9.418,3383,1308,2075,4.118,10.652,5698,1280,4418,4.030,17.941,-2315,-7.289,21.304,11,11,36
1999,4869,58,500,6100,6001,49,9.627,67,13.163,1275,645,630,10.748,21.246,1075,444,631,7.399,17.914,200,3.333,35.827,(D),(D),(D)
1999,4871,362,401,8904,8867,70,18.253,35,9.126,1252,487,765,5.492,14.120,1194,245,949,2.763,13.466,58,0.654,26.931,25,25,210
1999,4872,1174,1204,12534,12545,154,12.769,158,13.101,2443,791,1652,6.305,19.474,2458,1055,1403,8.410,19.593,-15,-0.120,38.948,118,118,948
1999,4879,136,140,1954,1867,15,10.417,23,15.972,485,42,443,2.250,25.984,330,112,218,6.001,17.680,155,8.304,35.360,20,20,105
1999,4881,3112,4065,119925,117595,502,12.495,407,10.131,20313,7554,12759,6.424,17.274,15548,6313,9235,5.368,13.222,4765,4.052,26.443,276,296,3675
1999,4882,446,799,21004,20311,86,10.935,61,7.756,4518,1922,2596,9.463,22.244,3055,1095,1960,5.391,15.041,1463,7.203,30.082,26,27,189
1999,4883,1756,2272,69434,70487,213,9.375,213,9.375,11789,4468,7321,6.339,16.725,13638,3538,10100,5.019,19.348,-1849,-2.623,33.450,141,143,2104
1999,4884,5934,6229,50507,49362,979,16.060,713,11.696,11301,4863,6438,9.852,22.894,8885,4353,4532,8.819,18.000,2416,4.895,36.000,545,553,3372
1999,4885,10991,14653,156892,152323,1576,10.795,1469,10.062,31398,12456,18942,8.177,20.613,22181,8776,13405,5.761,14.562,9217,6.051,29.124,994,1061,5596
1999,4889,884,973,23085,23693,224,23.345,197,20.532,3387,1122,2265,4.736,14.296,4524,2167,2357,9.146,19.095,-1137,-4.799,28.591,86,86,324
1999,4921,2264,5903,507137,486710,657,11.390,387,6.709,57036,8215,48821,1.688,11.719,18336,4076,14260,0.837,3.767,38700,7.951,7.535,249,251,1799
1999,4922,4380,4827,67916,66577,778,16.220,717,14.948,15653,8466,7187,12.716,23.511,12814,5734,7080,8.613,19.247,2839,4.264,38.494,606,621,4870
1999,4931,6615,12212,531068,518630,1256,10.390,1008,8.339,102660,43132,59528,8.317,19.794,77904,26919,50985,5.190,15.021,24756,4.773,30.042,319,381,7225
1999,5111,15557,19128,692126,696508,2046,10.732,1918,10.061,77523,29006,48517,4.164,11.130,86673,29265,57408,4.202,12.444,-9150,-1.314,22.260,1418,1443,13217
1999,5112,8057,10209,297697,290837,1048,10.061,1462,14.036,65615,18130,47485,6.234,22.561,51977,19603,32374,6.740,17.872,13638,4.689,35.743,922,953,10758
1999,5121,11919,16265,254418,256853,2430,15.028,2239,13.847,61929,28860,33069,11.236,24.111,65237,17605,47632,6.854,25.399,-3308,-1.288,48.221,1262,1333,7345
1999,5122,2517,2663,21191,20757,453,17.333,354,13.545,4837,2366,2471,11.399,23.303,4001,1877,2124,9.043,19.275,836,4.028,38.551,248,254,984
1999,5151,5410,7747,246947,244112,943,12.123,1006,12.933,43561,25566,17995,10.473,17.845,38939,20569,18370,8.426,15.951,4622,1.893,31.903,700,759,10895
1999,5152,307,576,31089,30689,102,16.735,169,27.728,7608,1962,5646,6.393,24.791,6784,4897,1887,15.957,22.106,824,2.685,44.211,27,30,928
1999,5171,4803,26784,1013294,1014720,4817,18.063,4586,17.196,231409,110279,121130,10.868,22.805,236257,120923,115334,11.917,23.283,-4848,-0.478,45.610,542,612,9626
1999,5172,2750,8261,195336,179676,2256,29.240,1165,15.099,73013,32885,40128,18.302,40.636,42633,14913,27720,8.300,23.728,30380,16.908,47.455,387,420,4001
1999,5174,379,861,19773,16783,363,50.840,69,9.664,8384,4497,3887,26.796,49.957,2606,1144,1462,6.817,15.528,5778,34.429,31.056,32,33,367
1999,5179,5255,6267,97064,90278,2101,36.321,1136,19.639,36319,15188,21131,16.824,40.230,22590,11652,10938,12.907,25.023,13729,15.207,50.045,789,804,6815
1999,5182,4966,8950,345076,335395,1585,18.555,769,9.003,69698,27168,42530,8.100,20.781,50937,16945,33992,5.052,15.187,18761,5.594,30.374,427,433,3333
1999,5191,3010,3672,58137,54897,430,12.052,222,6.222,12157,4861,7296,8.855,22.145,5654,2250,3404,4.099,10.299,6503,11.846,20.599,146,148,1318
1999,5211,14,43,22876,22385,(D),(D),0,0.000,1109,(D),1007,(D),4.954,113,0,113,0.000,0.505,996,4.449,1.010,0,0,0
1999,5221,18665,102974,1920217,1911544,9668,9.434,8675,8.465,306155,110837,195318,5.798,16.016,290311,140588,149723,7.355,15.187,15844,0.829,30.375,642,1186,20323
1999,5222,18196,44875,635042,609594,7566,16.979,6938,15.570,178570,81437,97133,13.359,29.293,129519,60225,69294,9.880,21.247,49051,8.047,42.494,1823,2337,19739
1999,5223,13422,18698,207784,199167,4424,25.239,2085,11.895,59761,26359,33402,13.235,30.006,42252,19959,22293,10.021,21.214,17509,8.791,42.429,1287,1379,9905
1999,5231,11312,31832,483526,465994,5429,17.707,3086,10.065,103620,29714,73906,6.376,22.236,70600,32191,38409,6.908,15.150,33020,7.086,30.301,1003,1095,9999
1999,5232,54,65,6541,6359,25,44.643,7,12.500,1023,440,583,6.920,16.089,627,444,183,6.983,9.861,396,6.228,19.722,4,4,102
1999,5239,23456,26151,274028,264840,4247,16.558,3243,12.644,56126,20118,36008,7.596,21.192,37572,15977,21595,6.033,14.187,18554,7.006,28.373,2137,2168,7620
1999,5241,4817,40965,1538138,1548578,7703,19.490,4820,12.195,255821,106196,149625,6.858,16.520,276884,89853,187031,5.802,17.880,-21063,-1.360,33.039,278,323,7061
1999,5242,112644,123805,820044,813160,11715,9.481,11228,9.087,147939,57155,90784,7.029,18.193,136064,64391,71673,7.919,16.733,11875,1.460,33.466,7632,7859,27090
1999,5250,1320,2048,58567,47930,651,34.962,279,14.984,27158,4800,22358,10.015,56.662,5300,2802,2498,5.846,11.058,21858,45.604,22.116,47,154,1836
1999,5311,87495,98218,489090,487525,10670,10.864,10655,10.849,98578,47074,51504,9.656,20.220,95375,45669,49706,9.368,19.563,3203,0.657,39.126,8308,8478,34264
1999,5312,48861,55071,255907,247057,8663,16.042,6524,12.081,66599,30928,35671,12.519,26.957,49346,21991,27355,8.901,19.974,17253,6.983,39.947,4342,4501,12465
1999,5313,43268,50412,468118,463418,7894,16.171,4702,9.632,92647,41007,51640,8.849,19.992,84064,31460,52604,6.789,18.140,8583,1.852,36.280,3070,3183,16351
1999,5321,4424,10285,175151,172394,1199,11.856,855,8.454,26406,12561,13845,7.286,15.317,20529,7424,13105,4.306,11.908,5877,3.409,23.816,496,545,2812
1999,5322,16153,31516,253738,251138,4167,13.339,3613,11.566,53299,23925,29374,9.527,21.223,47939,16961,30978,6.754,19.089,5360,2.134,38.177,2360,2600,11499
1999,5323,3511,5837,40200,40057,534,9.120,570,9.735,7616,3170,4446,7.914,19.013,7192,3170,4022,7.914,17.955,424,1.059,35.909,271,335,2056
1999,5324,7239,11356,146936,143719,1943,17.539,1387,12.520,35013,16845,18168,11.721,24.362,28331,13027,15304,9.064,19.713,6682,4.649,39.426,796,932,8587
1999,5331,1681,1798,22541,21332,229,12.761,222,12.371,5253,2653,2600,12.437,24.625,2879,1084,1795,5.082,13.496,2374,11.129,26.992,151,151,700
1999,5411,155249,162580,1085827,1070688,13856,8.522,13896,8.546,145965,41235,104730,3.851,13.633,115739,40940,74799,3.824,10.810,30226,2.823,21.620,10143,10239,29201
1999,5412,85014,91237,1124433,1105586,9736,10.733,8679,9.568,227799,64398,163401,5.825,20.604,188583,64138,124445,5.801,17.057,39216,3.547,34.115,5802,5863,26162
1999,5413,81806,92285,1211266,1194802,10595,11.655,7829,8.613,207353,61151,146202,5.118,17.355,175288,45744,129544,3.829,14.671,32065,2.684,29.342,5389,5473,25264
1999,5414,23679,23896,129723,127577,3685,15.695,2852,12.147,27798,9908,17890,7.766,21.789,23524,9739,13785,7.634,18.439,4274,3.350,36.878,2175,2180,7695
1999,5415,68559,76912,1014641,949320,20378,28.314,10499,14.588,315516,130616,184900,13.759,33.236,184032,77889,106143,8.205,19.386,131484,13.850,38.771,7054,7233,41652
1999,5416,61064,65022,574255,549674,13393,21.129,10121,15.967,159021,68696,90325,12.498,28.930,109984,52168,57816,9.491,20.009,49037,8.921,40.018,7306,7374,30458
1999,5417,9475,12146,547619,532175,1838,15.581,1139,9.655,89077,30949,58128,5.816,16.738,57477,17300,40177,3.251,10.800,31600,5.938,21.601,698,703,4018
1999,5418,32377,35586,450225,448850,4285,12.062,4160,11.711,78721,23543,55178,5.245,17.538,75092,31530,43562,7.025,16.730,3629,0.809,33.460,3017,3073,17991
1999,5419,44308,51072,445152,433079,6570,13.337,2951,5.990,89710,32340,57370,7.467,20.714,66359,17370,48989,4.011,15.323,23351,5.392,30.645,1740,1756,8337
1999,5511,28056,51439,3244237,3251947,6733,13.270,5332,10.509,570685,211006,359679,6.489,17.549,583195,189667,393528,5.832,17.934,-12510,-0.385,35.098,1282,1353,25691
1999,5611,19121,21307,392028,376201,3299,15.471,3333,15.630,113863,39687,74176,10.549,30.267,80624,38222,42402,10.160,21.431,33239,8.835,42.862,2068,2099,20527
1999,5612,1330,2617,120645,114832,660,26.527,402,16.158,30259,14790,15469,12.880,26.351,18773,8337,10436,7.260,16.348,11486,10.002,32.697,99,112,3134
1999,5613,25636,43211,3941037,3766826,7558,18.066,4807,11.490,1217345,383939,833406,10.193,32.318,857638,256005,601633,6.796,22.768,359707,9.549,45.536,2637,2773,124387
1999,5614,25693,30732,676581,658858,4391,14.377,4010,13.130,160740,65151,95589,9.888,24.397,124833,46785,78048,7.101,18.947,35907,5.450,37.894,2942,3007,24029
1999,5615,23974,31918,296418,296902,2436,7.478,3754,11.523,47462,15926,31536,5.364,15.986,48568,18699,29869,6.298,16.358,-1106,-0.373,31.971,2647,2752,12059
1999,5616,15519,19590,697811,691382,2544,13.022,2437,12.474,142923,51934,90989,7.512,20.672,129313,44919,84394,6.497,18.704,13610,1.969,37.407,1657,1667,16271
1999,5617,114718,120885,1448472,1410203,18254,15.587,10712,9.147,296827,88913,207914,6.305,21.049,220711,67333,153378,4.775,15.651,76116,5.398,31.302,8433,8472,48012
1999,5619,20769,22713,380109,366016,2902,12.751,2994,13.155,95207,25705,69502,7.023,26.012,69250,28907,40343,7.898,18.920,25957,7.092,37.840,2278,2326,19439
1999,5621,6087,7396,150538,150662,883,11.704,1180,15.641,27343,10046,17297,6.668,18.149,27083,17589,9494,11.674,17.976,260,0.173,35.952,852,878,7873
1999,5622,1420,2146,50625,51793,260,11.927,328,15.046,8889,2870,6019,5.541,17.163,11101,6604,4497,12.751,21.434,-2212,-4.271,34.325,170,178,1958
1999,5629,5329,5883,89422,88670,745,12.790,629,10.798,19599,6549,13050,7.386,22.103,17930,6368,11562,7.182,20.221,1669,1.882,40.442,434,438,3533
1999,6111,16097,18239,692755,672292,1034,5.831,19,0.107,70232,17627,52605,2.622,10.447,29758,110,29648,0.016,4.426,40474,6.020,8.853,(D),(D),(D)
1999,6112,530,797,74769,73763,36,4.621,0,0.000,6103,978,5125,1.326,8.274,4066,0,4066,0.000,5.512,2037,2.762,11.024,0,0,0
1999,6113,2311,2906,1304503,1286115,142,5.004,5,0.176,82965,6941,76024,0.540,6.451,46125,11,46114,0.001,3.586,36840,2.864,7.173,0,0,0
1999,6114,5360,5877,59466,59064,954,16.428,814,14.018,14181,4567,9614,7.732,24.010,13500,6131,7369,10.380,22.857,681,1.153,45.714,587,604,4126
1999,6115,5282,6169,73065,70891,681,11.037,683,11.070,14852,4044,10808,5.705,20.950,10597,4213,6384,5.943,14.948,4255,6.002,29.897,497,510,2665
1999,6116,20377,22060,188128,178084,3238,14.991,2317,10.727,46006,18177,27829,10.207,25.834,26270,9804,16466,5.505,14.752,19736,11.082,29.503,1730,1755,6870
1999,6117,3191,3419,33173,36352,574,17.030,477,14.152,6938,2345,4593,6.451,19.086,13717,1932,11785,5.315,37.734,-6779,-18.648,38.172,349,352,1341
1999,6211,157240,178503,1677576,1647575,14796,8.264,15880,8.869,304674,110853,193821,6.728,18.492,244842,102920,141922,6.247,14.861,59832,3.632,29.721,11079,11568,59925
1999,6212,106007,109644,678778,671166,4979,4.540,5012,4.570,89148,22031,67117,3.282,13.283,74036,21916,52120,3.265,11.031,15112,2.252,22.062,3816,3881,16442
1999,6213,77135,82660,405203,413200,8786,10.679,8006,9.731,76349,28731,47618,6.953,18.477,92066,49779,42287,12.047,22.281,-15717,-3.804,36.955,5620,5769,22767
1999,6214,10245,21828,538256,529839,2485,11.564,1807,8.409,93982,36771,57211,6.940,17.738,75888,29423,46465,5.553,14.323,18094,3.415,28.646,825,932,12362
1999,6215,5366,8396,149386,150814,1126,13.018,1633,18.880,28627,13433,15194,8.907,18.982,31928,17437,14491,11.562,21.171,-3301,-2.189,37.963,592,645,5938
1999,6216,10267,15853,783043,836474,2029,12.100,3861,23.025,142348,41444,100904,4.955,17.018,247167,111835,135332,13.370,29.549,-104819,-12.531,34.035,1962,2214,53415
1999,6219,4327,6385,171426,172772,866,13.717,723,11.452,34108,11778,22330,6.817,19.742,37732,18066,19666,10.457,21.839,-3624,-2.098,39.483,340,353,4091
1999,6221,3447,5354,4523796,4529169,135,2.500,225,4.167,266347,70011,196336,1.546,5.881,281576,111553,170023,2.463,6.217,-15229,-0.336,11.761,49,49,13329
1999,6222,495,782,241241,242780,40,5.060,57,7.211,12751,1761,10990,0.725,5.252,15960,6194,9766,2.551,6.574,-3209,-1.322,10.504,17,19,2729
1999,6223,272,443,150630,151698,46,10.478,38,8.656,9348,3697,5651,2.437,6.162,11579,5578,6001,3.677,7.633,-2231,-1.471,12.324,16,16,3336
1999,6231,7845,15475,1526981,1545372,1139,7.346,1199,7.733,162158,63490,98668,4.108,10.493,199670,88612,111058,5.734,12.921,-37512,-2.427,20.986,547,619,39196
1999,6232,7485,21029,384422,379697,1967,9.542,1139,5.525,61205,21669,39536,5.707,16.119,51584,17828,33756,4.695,13.586,9621,2.534,27.171,481,588,9032
1999,6233,12462,16094,473551,453592,2678,17.230,1576,10.140,88503,44584,43919,9.829,19.512,48125,19737,28388,4.351,10.610,40378,8.902,21.220,1132,1167,13300
1999,6239,3378,5826,144604,141714,446,7.680,409,7.043,21707,4696,17011,3.314,15.317,16122,5001,11121,3.529,11.376,5585,3.941,22.753,224,236,2910
1999,6241,29836,42304,732577,716016,3581,8.547,2771,6.614,110327,27124,83203,3.788,15.408,77009,18861,58148,2.634,10.755,33318,4.653,21.510,1678,1730,10309
1999,6242,8151,10146,114592,111681,714,7.138,429,4.288,16443,3814,12629,3.415,14.723,10596,2177,8419,1.949,9.488,5847,5.235,18.976,238,247,1042
1999,6243,5198,7852,302305,301138,550,7.018,521,6.648,41385,10254,31131,3.405,13.743,39349,4625,34724,1.536,13.067,2036,0.676,26.134,263,268,1902
1999,6244,47263,58940,663380,652778,6760,11.568,5753,9.845,109931,42417,67514,6.498,16.841,88741,33490,55251,5.130,13.594,21190,3.246,27.189,4266,4376,24218
1999,7111,7630,7713,116715,114581,1061,13.839,969,12.639,24885,7433,17452,6.487,21.718,20718,6827,13891,5.958,18.082,4167,3.637,36.163,682,684,4944
1999,7112,3243,3386,91700,90404,585,17.491,502,15.010,15651,6034,9617,6.675,17.312,12871,4273,8598,4.727,14.237,2780,3.075,28.475,392,392,2862
1999,7113,3261,3402,66383,64838,497,14.943,345,10.373,12931,4239,8692,6.538,19.944,9688,2547,7141,3.928,14.942,3243,5.002,29.884,224,232,1430
1999,7114,2283,2334,14940,14467,361,15.665,302,13.105,3836,1450,2386,10.023,26.516,2941,1272,1669,8.792,20.329,895,6.186,40.658,223,224,830
1999,7115,8628,8647,37138,34580,1688,19.883,1373,16.173,15278,5456,9822,15.778,44.182,10061,4061,6000,11.744,29.095,5217,15.087,58.191,834,836,2403
1999,7121,4987,5377,100226,97544,362,6.836,199,3.758,11180,1370,9810,1.405,11.462,5715,818,4897,0.839,5.859,5465,5.603,11.718,129,129,689
1999,7131,1650,2639,124043,131643,261,9.604,418,15.382,13818,2949,10869,2.240,10.497,28643,5918,22725,4.496,21.758,-14825,-11.262,20.993,243,246,2632
1999,7132,1658,2004,164241,162523,234,11.723,218,10.922,17203,7606,9597,4.680,10.585,13814,3513,10301,2.162,8.500,3389,2.085,16.999,166,169,2177
1999,7139,44561,48781,903524,880710,5097,10.518,4453,9.189,163716,49020,114696,5.566,18.589,116620,41818,74802,4.748,13.242,47096,5.348,26.483,3368,3421,30444
1999,7211,34123,43546,1667989,1658632,4883,11.339,3918,9.098,236311,112030,124281,6.754,14.247,218757,96577,122180,5.823,13.189,17554,1.058,26.378,2648,2738,46752
1999,7212,5029,5416,37355,36580,452,8.316,491,9.033,6909,1889,5020,5.164,18.888,5393,1722,3671,4.708,14.743,1516,4.144,29.486,336,345,1258
1999,7213,2900,2965,14733,15148,159,5.226,314,10.320,2005,501,1504,3.307,13.236,2877,1073,1804,7.083,18.993,-872,-5.757,26.472,209,213,708
1999,7223,10128,23614,473765,474459,3417,14.619,2937,12.565,86034,43053,42981,9.074,18.133,87108,37932,49176,7.995,18.359,-1074,-0.226,36.266,1110,1226,9081
1999,7224,45752,46204,325030,323409,5169,11.074,6113,13.097,72767,35534,37233,10.987,22.500,69601,30173,39428,9.330,21.521,3166,0.979,43.042,4750,4766,23230
1999,7225,263525,363200,7118359,7037848,43319,11.956,41552,11.468,1345581,689897,655684,9.803,19.119,1186211,483392,702819,6.868,16.855,159370,2.264,33.709,27885,29641,291641
1999,8111,139013,151995,856233,849437,15894,10.475,15378,10.135,155071,61583,93488,7.250,18.256,141259,59584,81675,7.015,16.630,13812,1.626,33.259,11124,11360,41010
1999,8112,13051,15053,142054,141791,1483,9.605,2257,14.618,28359,10544,17815,7.436,20.001,28048,11322,16726,7.985,19.781,311,0.219,39.562,1454,1523,6755
1999,8113,21169,22686,195414,192981,2156,9.521,2074,9.159,32878,8594,24284,4.453,17.037,27946,9585,18361,4.967,14.481,4932,2.556,28.963,1486,1517,6280
1999,8114,24197,25498,141052,143796,2918,11.336,3403,13.220,21809,7757,14052,5.394,15.167,27812,12416,15396,8.634,19.341,-6003,-4.175,30.333,2540,2565,6710
1999,8121,74522,85712,486222,483119,10108,11.755,10661,12.398,96195,42411,53784,8.779,19.911,89868,40842,49026,8.454,18.602,6327,1.310,37.203,7989,8259,27524
1999,8122,15084,21215,156068,161453,1009,4.719,1342,6.276,13910,4287,9623,2.655,8.616,24251,7290,16961,4.515,15.021,-10341,-6.405,17.231,857,913,3910
1999,8123,33791,40305,390342,391176,3817,9.432,4142,10.235,54422,21046,33376,5.380,13.912,56202,21566,34636,5.513,14.367,-1780,-0.455,27.825,3048,3152,15099
1999,8129,18555,28248,227656,218489,5017,18.706,2162,8.061,56002,26062,29940,11.928,25.631,37955,13270,24685,6.074,17.372,18047,8.260,34.743,1333,1384,8261
1999,8131,158726,158854,1511518,1479295,7856,5.067,218,0.141,167522,24197,143325,1.636,11.324,103418,668,102750,0.045,6.991,64104,4.333,13.982,24,24,58
1999,8132,10292,12088,122414,120329,1163,9.788,751,6.320,17906,4985,12921,4.143,14.881,13592,5235,8357,4.351,11.296,4314,3.585,22.591,448,462,2582
1999,8133,8501,10195,94868,91719,1152,11.553,705,7.070,15717,3991,11726,4.351,17.136,9455,2782,6673,3.033,10.309,6262,6.827,20.617,395,401,1380
1999,8134,27795,29556,308638,306734,1341,4.530,1438,4.857,35826,5682,30144,1.852,11.680,31910,5775,26135,1.883,10.403,3916,1.277,20.806,999,999,3765
1999,8139,62255,64304,501613,496183,3251,5.088,2431,3.805,65413,13344,52069,2.689,13.183,54746,9084,45662,1.831,11.033,10667,2.150,22.067,1713,1719,6120
2000,2111,5653,6895,79128,81673,707,10.265,692,10.047,14089,6000,8089,7.346,17.250,19499,6119,13380,7.492,23.874,-5410,-6.624,34.501,415,417,1489
2000,2121,801,1165,71873,74638,123,10.267,189,15.776,9569,4871,4698,6.526,12.821,15026,6447,8579,8.638,20.132,-5457,-7.311,25.641,111,117,2459
2000,2122,311,412,35625,37252,63,15.036,77,18.377,3710,2258,1452,6.062,9.959,7160,1845,5315,4.953,19.221,-3450,-9.261,19.919,44,51,617
2000,2123,3234,5178,101679,101704,423,8.222,356,6.920,14346,5124,9222,5.038,14.106,14672,3626,11046,3.565,14.426,-326,-0.321,28.211,215,216,1585
2000,2131,6503,7701,165271,157252,880,11.409,904,11.720,43328,12309,31019,7.828,27.553,27572,7633,19939,4.854,17.534,15756,10.020,35.067,595,608,3304
2000,2211,1574,9081,523419,528591,849,9.536,494,5.548,53968,24515,29453,4.638,10.210,65038,14697,50341,2.780,12.304,-11070,-2.094,20.420,68,76,1368
2000,2212,547,2490,86012,88857,204,8.017,313,12.301,11561,5253,6308,5.912,13.011,17204,7313,9891,8.230,19.362,-5643,-6.351,26.022,44,55,447
2000,2213,4375,4897,38336,37449,571,12.038,264,5.566,6053,3033,3020,8.099,16.163,4195,1266,2929,3.381,11.202,1858,4.961,22.404,189,190,753
2000,2361,133485,134178,762140,743190,19977,14.965,18606,13.938,196037,64593,131444,8.691,26.378,157786,64570,93216,8.688,21.231,38251,5.147,42.462,13365,13394,48151
2000,2362,40813,41684,811287,792835,4179,10.027,4169,10.003,169643,28323,141320,3.572,21.397,132076,30876,101200,3.894,16.659,37567,4.738,33.317,2978,2980,19012
2000,2371,16554,17074,448442,423711,1811,10.774,1281,7.621,109532,31008,78524,7.318,25.851,59764,13367,46397,3.155,14.105,49768,11.746,28.210,940,940,8609
2000,2372,9920,10104,74624,71551,2143,22.012,1406,14.442,21120,9091,12029,12.706,29.518,15061,5977,9084,8.354,21.049,6059,8.468,42.099,1023,1025,4114
2000,2373,10549,10998,297480,287323,773,7.005,846,7.667,59314,7550,51764,2.628,20.644,38917,7127,31790,2.480,13.545,20397,7.099,27.089,627,627,5440
2000,2379,4596,4699,75527,72048,574,12.084,676,14.232,18668,4417,14251,6.131,25.911,11671,3869,7802,5.370,16.199,6997,9.712,32.398,540,541,2772
2000,2381,93663,94113,1004451,973077,12195,13.099,10161,10.915,242484,58689,183795,6.031,24.919,179734,51808,127926,5.324,18.471,62750,6.449,36.941,7377,7377,37505
2000,2382,143395,146228,1820546,1757931,15198,10.465,13192,9.084,371086,86050,285036,4.895,21.109,246459,79274,167185,4.510,14.020,124627,7.089,28.040,9832,9852,57307
2000,2383,96971,97723,838443,817752,14449,14.910,12818,13.227,202650,56565,146085,6.917,24.781,161376,53378,107998,6.527,19.734,41274,5.047,39.468,9479,9482,40356
2000,2389,51345,51663,455403,439853,7187,14.097,5825,11.426,111502,32314,79188,7.347,25.350,80378,27075,53303,6.155,18.274,31124,7.076,36.548,4275,4275,19760
2000,3111,1069,1696,51053,49829,162,9.744,95,5.714,7224,3046,4178,6.113,14.498,4665,1444,3221,2.898,9.362,2559,5.136,18.724,52,53,627
2000,3112,494,877,62215,62814,67,7.714,50,5.757,5148,1814,3334,2.888,8.196,6263,1768,4495,2.815,9.971,-1115,-1.775,16.391,25,25,418
2000,3113,1398,1579,83484,83278,111,6.955,145,9.085,9504,1313,8191,1.577,11.412,8880,2943,5937,3.534,10.663,624,0.749,21.326,94,95,1219
2000,3114,1286,1686,167545,169821,126,7.442,140,8.269,18035,5128,12907,3.020,10.620,22413,7936,14477,4.673,13.198,-4378,-2.578,21.240,91,95,2121
2000,3115,1132,1644,132913,131858,80,4.812,117,7.038,12372,3086,9286,2.340,9.383,10238,4100,6138,3.109,7.764,2134,1.618,15.529,74,76,1568
2000,3116,3212,3842,493569,488290,249,6.521,202,5.290,42406,9633,32773,1.973,8.685,31922,9692,22230,1.985,6.538,10484,2.147,13.075,136,139,2519
2000,3117,640,754,40336,41004,64,8.443,72,9.499,5325,1548,3777,3.775,12.987,6647,1595,5052,3.890,16.211,-1322,-3.224,25.973,49,49,747
2000,3118,9058,9855,297699,294920,932,9.388,1078,10.858,40987,9846,31141,3.339,13.898,35756,14478,21278,4.909,12.124,5231,1.774,24.248,818,824,5378
2000,3119,2250,2609,142245,143474,205,7.827,225,8.591,14897,4382,10515,3.054,10.383,17182,5801,11381,4.043,11.976,-2285,-1.593,20.766,152,152,2148
2000,3121,1995,2407,124973,132037,244,10.108,258,10.688,15800,5860,9940,4.438,11.966,28917,20338,8579,15.403,21.901,-13117,-9.934,23.933,147,147,1582
2000,3122,74,104,27173,27592,11,10.377,15,14.151,1912,210,1702,0.761,6.930,2760,927,1833,3.360,10.003,-848,-3.073,13.859,10,10,305
2000,3131,355,585,79635,81431,46,7.863,46,7.863,6714,2473,4241,3.037,8.245,10416,3076,7340,3.777,12.791,-3702,-4.546,16.490,27,27,633
2000,3132,1570,1881,181172,188892,114,5.951,183,9.554,11834,2387,9447,1.264,6.265,27214,9980,17234,5.283,14.407,-15380,-8.142,12.530,128,129,2569
2000,3133,1951,2079,85105,87548,127,5.953,236,11.062,8642,2180,6462,2.490,9.871,13580,5017,8563,5.731,15.512,-4938,-5.640,19.742,182,186,2935
2000,3141,2597,2841,119939,121170,223,7.751,295,10.254,14620,4901,9719,4.045,12.066,17038,3608,13430,2.978,14.061,-2418,-1.996,24.131,242,244,2036
2000,3149,4291,4426,102433,104486,438,9.838,490,11.006,14167,3766,10401,3.604,13.559,17988,7510,10478,7.188,17.216,-3821,-3.657,27.118,378,378,4725
2000,3151,927,1012,76378,80633,79,7.607,132,12.711,6403,1915,4488,2.375,7.941,14879,5041,9838,6.252,18.453,-8476,-10.512,15.882,102,103,1476
2000,3152,9471,9967,358826,383519,1584,15.649,1894,18.712,55293,22028,33265,5.744,14.417,104100,49038,55062,12.786,27.143,-48807,-12.726,28.835,1465,1489,25427
2000,3159,1779,1851,47005,48319,174,9.105,294,15.385,7651,3405,4246,7.047,15.835,10333,4404,5929,9.115,21.385,-2682,-5.551,31.669,224,229,2605
2000,3161,277,298,13999,14733,21,6.863,37,12.092,1161,436,725,2.959,7.880,2601,652,1949,4.425,17.654,-1440,-9.774,15.761,29,29,258
2000,3162,312,351,29016,31266,32,8.976,43,12.062,1604,375,1229,1.199,5.130,5995,2192,3803,7.011,19.174,-4391,-14.044,10.260,22,23,467
2000,3169,894,918,23680,24326,72,7.721,101,10.831,2370,261,2109,1.073,9.743,3704,1191,2513,4.896,15.227,-1334,-5.484,19.485,76,76,729
2000,3211,3993,4462,132919,133701,285,6.306,400,8.851,13285,3059,10226,2.288,9.936,14740,5284,9456,3.952,11.025,-1455,-1.088,19.873,301,303,2333
2000,3212,1442,1822,121580,119697,117,6.462,94,5.192,12082,3029,9053,2.531,10.094,8342,2599,5743,2.171,6.969,3740,3.125,13.939,65,66,1161
2000,3219,9210,10012,344555,343931,941,9.429,876,8.778,45261,12820,32441,3.727,13.160,43936,12648,31288,3.677,12.775,1325,0.385,25.549,661,666,6668
2000,3221,249,545,170928,169488,33,6.083,28,5.161,15148,12419,2729,7.327,8.938,12681,4883,7798,2.881,7.482,2467,1.456,14.964,9,9,288
2000,3222,3392,5148,394473,395568,236,4.562,286,5.529,34242,10654,23588,2.693,8.656,36528,17284,19244,4.369,9.234,-2286,-0.578,17.313,163,165,2614
2000,3231,35167,36975,811006,818382,2032,5.399,3349,8.899,77697,17686,60011,2.161,9.494,92902,35234,57668,4.305,11.352,-15205,-1.858,18.988,2637,2654,20340
2000,3241,1054,2119,123168,123157,129,6.041,162,7.586,9755,1875,7880,1.522,7.921,9746,3046,6700,2.473,7.914,9,0.007,15.827,55,55,751
2000,3251,1114,2339,198877,200373,130,5.563,126,5.392,12739,4637,8102,2.314,6.358,15735,3520,12215,1.757,7.853,-2996,-1.495,12.715,42,42,538
2000,3252,477,812,119336,118901,70,8.761,44,5.507,10675,3853,6822,3.241,8.978,9968,2691,7277,2.263,8.383,707,0.595,16.767,20,20,169
2000,3253,642,864,35554,36123,49,5.629,62,7.122,2713,590,2123,1.633,7.510,3896,1053,2843,2.915,10.785,-1183,-3.275,15.021,37,37,199
2000,3254,1377,1715,222162,217629,121,7.021,138,8.007,21890,3584,18306,1.647,10.058,13373,4071,9302,1.871,6.145,8517,3.914,12.290,90,90,1625
2000,3255,1562,2005,74591,74436,104,5.156,128,6.346,7588,2430,5158,3.265,10.194,7354,2601,4753,3.494,9.880,234,0.314,19.759,66,66,464
2000,3256,2049,2278,123744,123821,139,6.067,165,7.202,11523,2126,9397,1.717,9.306,11736,2932,8804,2.368,9.478,-213,-0.172,18.612,110,113,2167
2000,3259,2139,2790,118136,119765,190,6.808,192,6.879,10584,2928,7656,2.445,8.837,13816,3524,10292,2.942,11.536,-3232,-2.699,17.675,112,123,1324
2000,3261,10339,12929,836051,830150,724,5.560,908,6.973,98193,22409,75784,2.699,11.828,86417,28028,58389,3.376,10.410,11776,1.419,20.820,575,581,10466
2000,3262,1978,2574,207136,205449,161,6.254,162,6.292,17103,3643,13460,1.773,8.325,13820,3706,10114,1.804,6.727,3283,1.598,13.453,114,115,1040
2000,3271,1439,1686,75106,74693,113,6.568,182,10.578,7752,1528,6224,2.046,10.378,6931,2031,4900,2.719,9.279,821,1.099,18.559,137,137,993
2000,3272,1887,2181,130074,130054,175,8.066,152,7.006,11331,2012,9319,1.547,8.713,11092,3751,7341,2.884,8.529,239,0.184,17.058,107,107,850
2000,3273,5326,9009,216279,210429,581,6.486,479,5.347,34035,8682,25353,4.126,16.174,22137,6628,15509,3.150,10.520,11898,5.654,21.040,279,291,3963
2000,3274,237,375,20802,20620,36,9.717,27,7.287,1966,984,982,4.772,9.535,1618,313,1305,1.518,7.847,348,1.688,15.694,19,19,85
2000,3279,2031,2453,75538,75178,209,8.594,167,6.867,7833,2378,5455,3.163,10.419,7192,2366,4826,3.147,9.567,641,0.853,19.133,109,112,1055
2000,3311,377,477,143836,132836,119,27.642,26,6.039,27072,22410,4662,16.870,20.380,6535,1280,5255,0.964,4.920,20537,15.460,9.839,14,14,141
2000,3312,575,779,65613,65144,80,10.547,39,5.142,5971,2101,3870,3.225,9.166,4969,1251,3718,1.920,7.628,1002,1.538,15.256,21,21,333
2000,3313,398,569,86315,86894,36,6.355,31,5.472,4904,980,3924,1.128,5.644,6410,1985,4425,2.284,7.377,-1506,-1.733,11.287,13,13,182
2000,3314,724,916,76188,78278,67,7.346,59,6.469,5435,1043,4392,1.332,6.943,9733,2627,7106,3.356,12.434,-4298,-5.491,13.886,31,31,463
2000,3315,2295,2620,221808,221506,102,3.853,156,5.893,19755,3198,16557,1.444,8.919,19286,3661,15625,1.653,8.707,469,0.212,17.414,122,123,1753
2000,3321,2650,2886,147971,148832,96,3.278,181,6.181,13516,2000,11516,1.344,9.081,15480,6120,9360,4.112,10.401,-1964,-1.320,18.163,135,135,1798
2000,3322,1444,1593,79447,79623,95,5.941,107,6.692,6363,1294,5069,1.625,7.991,6928,1675,5253,2.104,8.701,-565,-0.710,15.983,75,75,481
2000,3323,11036,11984,416264,408522,782,6.526,780,6.509,56666,16920,39746,4.142,13.871,41268,12678,28590,3.103,10.102,15398,3.769,20.204,552,563,7758
2000,3324,1384,1723,100806,103075,69,3.936,129,7.359,9030,1050,7980,1.019,8.761,13605,4636,8969,4.498,13.199,-4575,-4.439,17.521,86,86,1396
2000,3325,770,859,67614,66759,46,5.346,49,5.694,6763,1470,5293,2.202,10.131,5108,1307,3801,1.958,7.651,1655,2.479,15.303,33,33,398
2000,3326,1623,1811,71111,70528,119,6.575,117,6.464,7503,1576,5927,2.235,10.638,6348,1485,4863,2.106,9.001,1155,1.638,18.001,84,85,803
2000,3327,24990,25460,430336,428892,1577,6.160,1860,7.265,51245,12144,39101,2.831,11.948,48607,12406,36201,2.893,11.333,2638,0.615,22.666,1430,1432,7787
2000,3328,5417,5997,155863,154993,315,5.219,392,6.495,18710,3988,14722,2.573,12.072,16953,5090,11863,3.284,10.938,1757,1.134,21.876,307,309,2810
2000,3329,5807,6367,310615,310311,475,7.460,475,7.460,29248,7459,21789,2.404,9.425,28799,8930,19869,2.878,9.281,449,0.145,18.561,343,343,3882
2000,3331,2555,2882,199261,201754,161,5.534,216,7.424,17837,4020,13817,1.993,8.841,23081,7182,15899,3.560,11.440,-5244,-2.599,17.682,143,143,2098
2000,3332,4033,4279,184624,182448,296,6.859,369,8.551,25592,8820,16772,4.834,14.027,21874,9610,12264,5.267,11.989,3718,2.038,23.978,252,254,3464
2000,3333,2228,2396,133813,134934,159,6.581,199,8.237,12640,2680,9960,1.986,9.368,14885,3644,11241,2.701,11.031,-2245,-1.664,18.735,150,151,1763
2000,3334,1413,1739,180520,179420,93,5.313,116,6.627,16348,3553,12795,1.980,9.112,14200,3924,10276,2.187,7.914,2148,1.197,15.829,71,71,1528
2000,3335,9176,9568,234075,236565,428,4.438,579,6.004,20970,5247,15723,2.218,8.864,25723,6305,19418,2.665,10.874,-4753,-2.009,17.729,452,453,3869
2000,3336,751,912,111097,111511,37,4.035,47,5.125,7623,422,7201,0.378,6.836,8224,2319,5905,2.080,7.375,-601,-0.539,13.672,26,26,672
2000,3339,5786,6460,343394,345406,325,4.993,424,6.514,32007,10741,21266,3.110,9.266,36236,9476,26760,2.743,10.491,-4229,-1.224,18.533,292,294,4035
2000,3341,1606,1700,186754,195561,214,12.625,204,12.035,24129,8038,16091,4.110,12.338,40584,18827,21757,9.627,20.753,-16455,-8.414,24.677,144,144,1789
2000,3342,1787,1991,228842,236600,169,8.429,197,9.825,27411,6791,20620,2.870,11.585,42002,14987,27015,6.334,17.752,-14591,-6.167,23.171,126,126,1963
2000,3343,498,524,30511,29707,62,11.935,53,10.202,4439,954,3485,3.211,14.943,2753,837,1916,2.818,9.267,1686,5.675,18.534,34,36,421
2000,3344,4888,5605,569995,561022,395,6.992,483,8.550,88041,22282,65759,3.972,15.693,69609,25979,43630,4.631,12.408,18432,3.285,24.815,310,313,5023
2000,3345,4368,5034,475382,485492,294,5.771,414,8.127,45623,10838,34785,2.232,9.397,64729,29859,34870,6.150,13.333,-19106,-3.935,18.795,244,250,5580
2000,3346,766,826,41958,43540,115,14.215,81,10.012,4702,1101,3601,2.529,10.799,7738,2510,5228,5.765,17.772,-3036,-6.973,21.599,61,62,892
2000,3351,1148,1266,77497,76227,94,7.404,101,7.956,9959,4417,5542,5.795,13.065,7380,2885,4495,3.785,9.682,2579,3.383,19.363,80,80,1129
2000,3352,243,312,102850,101924,27,8.599,31,9.873,9485,1586,7899,1.556,9.306,7458,2658,4800,2.608,7.317,2027,1.989,14.634,19,19,309
2000,3353,2278,2705,196170,196541,112,4.091,177,6.466,17029,3475,13554,1.768,8.664,17857,4773,13084,2.429,9.086,-828,-0.421,17.329,107,108,738
2000,3359,1867,2262,207095,201816,202,9.018,158,7.054,28802,10136,18666,5.022,14.271,18364,5945,12419,2.946,9.099,10438,5.172,18.199,102,102,1500
2000,3361,286,349,225813,225074,47,13.584,41,11.850,20787,6426,14361,2.855,9.236,19381,12034,7347,5.347,8.611,1406,0.625,17.222,25,25,372
2000,3362,1761,1980,152105,146832,155,7.818,160,8.071,20565,5825,14740,3.967,14.006,9988,3738,6250,2.546,6.802,10577,7.203,13.605,117,117,1571
2000,3363,4396,5538,826620,819180,315,5.631,428,7.650,85732,18030,67702,2.201,10.466,70519,27917,42602,3.408,8.608,15213,1.857,17.217,277,279,6117
2000,3364,1374,1702,416587,444932,137,8.049,137,8.049,30719,8518,22201,1.914,6.904,88603,21238,67365,4.773,19.914,-57884,-13.010,13.808,83,83,1587
2000,3365,148,212,29326,30203,15,6.993,20,9.324,2580,483,2097,1.599,8.542,4415,393,4022,1.301,14.618,-1835,-6.076,17.084,12,12,83
2000,3366,1505,1625,146063,144998,179,11.139,143,8.899,15380,3831,11549,2.642,10.607,13154,2229,10925,1.537,9.072,2226,1.535,18.144,107,107,1260
2000,3369,636,659,34441,34713,80,12.186,75,11.424,4034,760,3274,2.189,11.621,4660,1468,3192,4.229,13.424,-626,-1.803,23.242,56,56,408
2000,3371,13262,13777,415915,405687,1395,10.152,1324,9.635,55518,14567,40951,3.591,13.685,35137,11601,23536,2.860,8.661,20381,5.024,17.322,1004,1013,7918
2000,3372,3904,4126,188175,186520,261,6.285,314,7.562,21588,4090,17498,2.193,11.574,18352,6147,12205,3.296,9.839,3236,1.735,19.678,235,235,3711
2000,3379,956,1080,48324,47061,60,5.540,66,6.094,7026,1772,5254,3.765,14.930,4533,1540,2993,3.272,9.632,2493,5.297,19.264,50,51,625
2000,3391,10666,11296,288878,287553,767,6.762,861,7.591,37166,9185,27981,3.194,12.925,34392,11317,23075,3.936,11.960,2774,0.965,23.921,616,618,3804
2000,3399,17074,17644,430899,428723,1861,10.599,1688,9.614,55605,15357,40248,3.582,12.970,51190,16933,34257,3.950,11.940,4415,1.030,23.880,1342,1346,9502
2000,4231,18602,23238,322916,320432,2198,9.444,2272,9.762,46964,18672,28292,5.827,14.656,41889,16186,25703,5.051,13.073,5075,1.584,26.145,1582,1648,9861
2000,4232,9874,11116,151091,147141,1258,11.435,1028,9.345,26571,8357,18214,5.680,18.058,18599,7130,11469,4.846,12.640,7972,5.418,25.281,754,778,5032
2000,4233,8908,12074,167310,161022,1439,12.117,1043,8.782,32593,12808,19785,7.954,20.241,19846,7013,12833,4.355,12.325,12747,7.916,24.650,680,695,3980
2000,4234,28134,36307,705331,699644,4406,12.135,4409,12.143,145005,53521,91484,7.650,20.726,133580,59304,74276,8.476,19.093,11425,1.633,38.185,2770,2870,18496
2000,4235,7669,10414,167816,165784,753,7.226,767,7.360,21358,5905,15453,3.562,12.883,17373,5777,11596,3.485,10.479,3985,2.404,20.959,501,516,3197
2000,4236,19550,29576,469613,457663,3325,11.285,3102,10.528,95528,36985,58543,8.081,20.873,72326,27784,44542,6.071,15.803,23202,5.070,31.607,1568,1696,10770
2000,4237,10886,16489,212073,207037,1156,7.016,1132,6.870,32277,9143,23134,4.416,15.590,21980,6999,14981,3.381,10.616,10297,4.974,21.233,726,768,4585
2000,4238,48262,64204,759414,759250,4411,6.835,5081,7.873,99354,30321,69033,3.994,13.086,99493,38864,60629,5.119,13.104,-139,-0.018,26.172,3236,3575,20777
2000,4239,28698,31034,323679,318725,3867,12.554,3405,11.054,55657,17533,38124,5.501,17.462,46116,17723,28393,5.561,14.469,9541,2.993,28.938,2565,2604,12469
2000,4241,9571,12455,222253,221393,886,7.009,1257,9.944,33632,8164,25468,3.688,15.191,32473,17686,14787,7.989,14.668,1159,0.524,29.335,601,623,3079
2000,4242,4952,6338,194537,186446,934,14.951,752,12.038,40321,15787,24534,8.467,21.626,23596,10932,12664,5.863,12.656,16725,8.970,25.311,491,495,4230
2000,4243,13843,14952,190111,188500,1888,12.659,1813,12.156,33396,9854,23542,5.228,17.717,30293,11661,18632,6.186,16.071,3103,1.646,32.141,1401,1421,7364
2000,4244,26597,31821,765392,772085,2838,8.793,3746,11.607,104956,30392,74564,3.936,13.594,118739,55502,63237,7.189,15.379,-13783,-1.785,27.188,2416,2489,20229
2000,4245,4832,7578,68928,69109,376,4.899,571,7.439,8701,2354,6347,3.406,12.590,9075,3135,5940,4.536,13.132,-374,-0.541,25.181,328,366,2096
2000,4246,9535,13629,162469,157959,1238,9.108,1164,8.564,30065,11646,18419,7.373,19.033,21192,8106,13086,5.132,13.416,8873,5.617,26.832,653,667,3557
2000,4247,6908,9954,126381,127195,491,4.821,954,9.366,17619,3530,14089,2.775,13.852,19325,8330,10995,6.549,15.193,-1706,-1.341,27.704,356,398,3547
2000,4248,3140,3989,153611,150993,243,6.027,329,8.160,17005,3272,13733,2.167,11.262,11793,5673,6120,3.757,7.810,5212,3.452,15.621,227,234,2626
2000,4249,22560,27054,366635,362066,3250,12.033,3161,11.703,63431,21590,41841,5.963,17.519,54346,22512,31834,6.218,15.010,9085,2.509,30.020,2253,2296,11169
2000,4251,33469,35712,291596,291050,2932,8.186,3146,8.783,45883,11249,34634,3.865,15.765,45119,18440,26679,6.336,15.502,764,0.262,31.004,2087,2111,9755
2000,4411,42843,46415,1217176,1195536,4519,9.785,4057,8.784,153816,49043,104773,4.102,12.866,110120,47573,62547,3.979,9.211,43696,3.655,18.422,3050,3108,30749
2000,4412,12176,13193,125446,120283,1320,10.122,1017,7.798,24190,7373,16817,6.130,20.111,13818,5307,8511,4.412,11.488,10372,8.623,22.976,787,799,3975
2000,4413,33485,57378,531805,528576,4447,7.718,4922,8.543,73288,25977,47311,4.915,13.865,66599,28299,38300,5.354,12.600,6689,1.265,25.199,2607,3046,14747
2000,4421,19828,27809,287710,281614,2248,8.072,2329,8.363,45548,13532,32016,4.805,16.174,33353,12608,20745,4.477,11.844,12195,4.330,23.687,1523,1670,7107
2000,4422,24716,32895,269450,262626,3605,11.057,3020,9.263,55677,27514,28163,10.477,21.200,42069,15668,26401,5.966,16.019,13608,5.182,32.037,1895,2176,10623
2000,4431,32463,50195,486181,473601,5370,10.727,5103,10.193,92116,34020,58096,7.183,19.450,66551,25493,41058,5.383,14.052,25565,5.398,28.104,3616,3772,16862
2000,4441,48367,69830,1092613,1067364,4018,5.729,4634,6.607,157498,49959,107539,4.681,14.756,107029,56674,50355,5.310,10.027,50469,4.728,20.055,2983,3178,18772
2000,4442,16468,20373,188063,185046,1356,6.610,1638,7.985,29519,7627,21892,4.122,15.952,23410,9024,14386,4.877,12.651,6109,3.301,25.302,1069,1083,5046
2000,4451,60182,87785,2686731,2699895,8965,10.182,9487,10.775,330281,142652,187629,5.284,12.233,355654,151094,204560,5.596,13.173,-25373,-0.940,24.466,5850,6026,42483
2000,4452,17531,21981,148993,147038,3069,14.068,2739,12.555,32181,14671,17510,9.978,21.886,28192,12679,15513,8.623,19.173,3989,2.713,38.347,1807,1903,8229
2000,4453,22900,26039,134176,133093,2125,8.142,2246,8.606,20847,6928,13919,5.205,15.663,18737,7116,11621,5.347,14.078,2110,1.585,28.156,1638,1660,5227
2000,4461,40082,77776,904712,920721,6446,8.273,6720,8.625,132619,51884,80735,5.635,14.404,162745,56722,106023,6.161,17.676,-30126,-3.272,28.808,3232,3511,19137
2000,4471,61638,113825,936573,931386,8289,7.244,9494,8.297,160068,56775,103293,6.096,17.186,149205,54244,94961,5.824,16.020,10863,1.166,32.039,5623,6049,33167
2000,4481,36812,83858,1005698,970867,8636,10.261,9243,10.982,208189,80107,128082,8.251,21.444,137382,58567,78815,6.032,14.150,70807,7.293,28.301,4129,4520,17332
2000,4482,6424,28977,195058,194197,2693,9.266,2868,9.868,40556,13787,26769,7.100,20.884,39152,14475,24677,7.454,20.161,1404,0.723,40.322,596,688,2565
2000,4483,19016,29285,170890,167589,2583,8.872,2240,7.694,28766,9939,18827,5.931,17.165,22059,8603,13456,5.133,13.163,6707,4.002,26.325,1310,1392,4891
2000,4511,29587,40449,394836,391634,3991,9.805,4501,11.058,71430,33219,38211,8.482,18.239,64935,24476,40459,6.250,16.581,6495,1.658,33.161,2912,3123,12273
2000,4512,7246,12936,150208,145675,988,7.512,1421,10.804,28274,9824,18450,6.744,19.409,19276,8487,10789,5.826,13.232,8998,6.177,26.464,808,961,4636
2000,4521,61,9958,1774017,1763671,258,2.586,292,2.927,143135,34745,108390,1.970,8.116,119584,34954,84630,1.982,6.780,23551,1.335,13.561,(D),(D),(D)
2000,4529,9121,27531,789908,761537,3653,13.732,1795,6.748,124774,67379,57395,8.848,16.384,67450,20977,46473,2.755,8.857,57324,7.527,17.714,994,1062,9368
2000,4531,20957,21995,120876,120630,1794,8.030,2487,11.132,20400,5886,14514,4.879,16.911,19928,8971,10957,7.437,16.520,472,0.391,33.040,1904,1962,6969
2000,4532,29349,40994,360153,356323,4233,10.352,4029,9.853,61855,27362,34493,7.679,17.359,53970,16929,37041,4.751,15.146,7885,2.213,30.293,2937,3019,10263
2000,4533,12685,16382,114089,112001,1712,10.406,1853,11.263,19267,7277,11990,6.497,17.203,15056,5385,9671,4.808,13.443,4211,3.760,26.886,1470,1485,4075
2000,4539,31458,39509,253954,250378,5506,14.090,4643,11.882,53793,23851,29942,9.526,21.485,46446,19804,26642,7.910,18.550,7347,2.934,37.101,3325,3460,13921
2000,4541,10027,10961,268084,252597,2600,25.432,1125,11.004,64983,28731,36252,11.374,25.726,34193,10599,23594,4.196,13.537,30790,12.189,27.073,797,800,4832
2000,4542,4950,5533,66513,66364,589,10.575,662,11.886,8828,2328,6500,3.508,13.302,8614,3804,4810,5.732,12.980,214,0.322,25.960,531,535,2989
2000,4543,19456,25493,228535,226190,2675,10.535,2473,9.739,37587,11043,26544,4.882,16.617,33182,12713,20469,5.620,14.670,4405,1.947,29.340,1629,1682,8304
2000,4811,661,3140,523213,505796,291,9.706,7,0.233,47873,4871,43002,0.963,9.465,12542,24,12518,0.005,2.480,35331,6.985,4.959,(D),(D),(D)
2000,4812,1652,1804,34464,33181,282,15.878,226,12.725,6530,1812,4718,5.461,19.680,3917,1654,2263,4.985,11.805,2613,7.875,23.610,144,146,802
2000,4831,796,1185,51130,50739,146,12.305,149,12.558,9452,2402,7050,4.734,18.629,8880,1825,7055,3.597,17.501,572,1.127,35.003,72,80,1132
2000,4832,486,529,19083,19034,66,12.524,62,11.765,2074,489,1585,2.569,10.897,1979,488,1491,2.564,10.397,95,0.499,20.795,45,45,187
2000,4841,38780,47572,987777,971293,8996,19.275,7196,15.418,190899,65870,125029,6.782,19.654,161360,59471,101889,6.123,16.613,29539,3.041,33.226,5304,5440,27625
2000,4842,45877,49403,502936,499480,5841,11.696,6917,13.850,91348,26234,65114,5.252,18.289,84582,32561,52021,6.519,16.934,6766,1.355,33.868,5308,5351,21755
2000,4851,458,693,39440,37849,102,14.967,79,11.592,5813,2848,2965,7.525,15.359,2726,1634,1092,4.317,7.202,3087,8.156,14.405,39,39,703
2000,4852,211,384,21211,19807,36,9.351,38,9.870,4382,277,4105,1.399,22.124,1497,721,776,3.640,7.558,2885,14.566,15.116,22,22,189
2000,4853,5807,5911,68190,65885,960,16.396,848,14.483,13750,4811,8939,7.302,20.870,9130,4433,4697,6.728,13.858,4620,7.012,27.715,677,679,3289
2000,4854,3066,4127,161797,160944,246,5.909,318,7.639,17372,4706,12666,2.924,10.794,15747,6558,9189,4.075,9.784,1625,1.010,19.568,215,227,3538
2000,4855,1186,1327,33494,33080,124,9.247,152,11.335,5316,998,4318,3.017,16.070,4490,1718,2772,5.194,13.573,826,2.497,27.147,119,119,988
2000,4859,2254,2449,52228,50722,371,15.340,310,12.818,10715,3116,7599,6.143,21.125,7707,3246,4461,6.400,15.195,3008,5.930,30.389,226,229,1861
2000,4861,40,306,6544,6517,29,9.177,49,15.506,1470,478,992,7.335,22.558,1437,811,626,12.445,22.052,33,0.506,44.103,3,3,5
2000,4862,123,2022,36962,34949,656,35.886,268,14.661,12092,9147,2945,26.172,34.599,8271,3800,4471,10.873,23.666,3821,10.933,47.332,9,9,159
2000,4869,54,512,6554,6304,81,16.040,67,13.267,1422,538,884,8.534,22.557,971,384,587,6.091,15.403,451,7.154,30.806,(D),(D),(D)
2000,4871,366,408,8774,8647,51,12.608,44,10.878,1343,221,1122,2.556,15.532,1082,261,821,3.019,12.514,261,3.019,25.027,32,32,165
2000,4872,1165,1196,13334,12922,136,11.324,146,12.157,2705,508,2197,3.931,20.934,1920,401,1519,3.103,14.859,785,6.075,29.718,113,113,354
2000,4879,138,142,2046,1996,16,11.348,14,9.929,332,49,283,2.455,16.633,238,108,130,5.411,11.924,94,4.709,23.848,12,12,99
2000,4881,3136,4110,129278,125408,418,10.213,384,9.382,22512,5053,17459,4.029,17.951,14937,7843,7094,6.254,11.911,7575,6.040,23.822,242,246,1847
2000,4882,422,764,22997,21872,61,7.907,76,9.851,5721,2349,3372,10.740,26.157,3632,1395,2237,6.378,16.606,2089,9.551,33.212,29,31,363
2000,4883,1722,2252,79440,74741,207,9.139,233,10.287,19652,5090,14562,6.810,26.293,10227,2131,8096,2.851,13.683,9425,12.610,27.367,144,157,1075
2000,4884,5996,6279,54240,52263,858,13.713,814,13.009,12963,4387,8576,8.394,24.804,9034,4152,4882,7.945,17.286,3929,7.518,34.572,607,610,2754
2000,4885,10877,14576,165061,160688,1465,10.031,1521,10.415,32568,10976,21592,6.831,20.268,23860,10352,13508,6.442,14.849,8708,5.419,29.697,958,1052,6871
2000,4889,1027,1149,25672,24395,286,26.629,136,12.663,4690,1836,2854,7.526,19.226,2154,838,1316,3.435,8.830,2536,10.396,17.660,99,99,341
2000,4921,2409,6375,551796,530370,1143,18.602,682,11.099,91023,22572,68451,4.256,17.162,46497,24110,22387,4.546,8.767,44526,8.395,17.534,297,332,2536
2000,4922,4334,4774,68509,68123,665,13.844,724,15.072,11794,3537,8257,5.192,17.313,10740,4784,5956,7.023,15.766,1054,1.547,31.531,594,610,3600
2000,4931,6692,12300,549133,539951,1312,10.686,1268,10.327,104344,42840,61504,7.934,19.325,86192,34378,51814,6.367,15.963,18152,3.362,31.926,354,572,7992
2000,5111,15406,19302,687908,736780,2126,11.048,2008,10.435,76489,26742,49747,3.630,10.382,173528,35899,137629,4.872,23.552,-97039,-13.171,20.763,1391,1395,9931
2000,5112,7625,10021,331321,316090,1393,13.783,1565,15.484,88809,29309,59500,9.272,28.096,58253,29875,28378,9.451,18.429,30556,9.667,36.858,939,1009,13411
2000,5121,11988,16096,270049,266516,2096,12.960,2249,13.906,60257,19809,40448,7.433,22.609,52477,24525,27952,9.202,19.690,7780,2.919,39.380,1266,1308,6375
2000,5122,2538,2731,23417,22417,433,16.025,375,13.879,6001,2889,3112,12.888,26.770,4165,1950,2215,8.699,18.580,1836,8.190,37.159,301,301,1507
2000,5151,5219,7665,247848,246742,837,10.864,916,11.889,35865,16079,19786,6.517,14.535,33658,15718,17940,6.370,13.641,2207,0.894,27.282,598,674,10089
2000,5152,310,546,32650,31692,101,18.004,131,23.351,5182,1877,3305,5.923,16.351,3155,1496,1659,4.720,9.955,2027,6.396,19.910,44,84,855
2000,5171,5150,28116,1076108,1047390,5705,20.718,4547,16.512,232995,112763,120232,10.766,22.245,172922,103408,69514,9.873,16.510,60073,5.735,33.020,651,812,13470
2000,5172,2942,8996,208433,200994,2081,24.080,1373,15.888,66144,40234,25910,20.018,32.909,50129,23698,26431,11.790,24.941,16015,7.968,49.881,413,666,4479
2000,5174,429,651,18873,17874,137,20.117,197,28.928,6086,2089,3997,11.688,34.050,4067,1588,2479,8.885,22.754,2019,11.296,45.509,46,48,537
2000,5179,6687,7904,140635,119772,2883,40.302,1382,19.319,66947,32546,34401,27.173,55.896,24859,13219,11640,11.037,20.755,42088,35.140,41.511,999,1022,9269
2000,5182,5499,9399,362436,354430,2201,23.990,1752,19.096,86649,38829,47820,10.955,24.447,69994,28167,41827,7.947,19.748,16655,4.699,39.497,435,451,7502
2000,5191,3674,4380,82963,73177,795,19.367,245,5.968,26012,13436,12576,18.361,35.547,6092,2603,3489,3.557,8.325,19920,27.222,16.650,128,131,1359
2000,5211,14,43,22279,22575,(D),(D),0,0.000,332,(D),326,(D),1.471,918,0,918,0.000,4.067,-586,-2.596,2.941,0,0,0
2000,5221,18367,105175,1916139,1922398,9738,9.355,7581,7.283,330681,152488,178193,7.932,17.201,344843,143543,201300,7.467,17.938,-14162,-0.737,34.403,609,1187,14983
2000,5222,17881,44911,608549,621545,6355,14.169,6239,13.910,134202,63497,70705,10.216,21.592,160722,61484,99238,9.892,25.858,-26520,-4.267,43.183,2122,2368,15728
2000,5223,13957,20603,211172,210419,4951,25.167,3090,15.707,57139,28513,28626,13.551,27.155,55043,25845,29198,12.283,26.159,2096,0.996,52.318,1742,1922,12510
2000,5231,11660,36748,531453,507434,7632,22.289,2619,7.649,105329,40308,65021,7.943,20.757,56992,20076,36916,3.956,11.231,48337,9.526,22.463,946,984,5378
2000,5232,86,97,6874,6722,36,42.857,10,11.905,527,181,346,2.693,7.841,239,33,206,0.491,3.556,288,4.285,7.112,9,9,32
2000,5239,25003,28311,312663,294715,5491,20.130,3425,12.556,79067,36388,42679,12.347,26.828,43892,23156,20736,7.857,14.893,35175,11.935,29.786,2219,2267,10043
2000,5241,5012,36111,1488194,1513493,5229,13.562,10119,26.245,236609,72167,164442,4.768,15.633,288371,108712,179659,7.183,19.053,-51762,-3.420,31.267,351,429,7848
2000,5242,111808,123152,792467,791799,11348,9.196,11844,9.598,137935,48540,89395,6.130,17.420,136115,62716,73399,7.921,17.191,1820,0.230,34.381,7886,8136,30463
2000,5250,2010,2806,36681,36441,957,39.448,197,8.120,10307,7209,3098,19.783,28.284,10021,1350,8671,3.705,27.500,286,0.785,54.999,62,73,408
2000,5311,86905,98303,502478,496863,9946,10.115,9989,10.159,95836,42362,53474,8.526,19.288,84330,36440,47890,7.334,16.973,11506,2.316,33.945,7484,7733,26190
2000,5312,49454,55829,268782,264085,7553,13.622,6790,12.246,61431,24490,36941,9.274,23.262,51240,22823,28417,8.642,19.403,10191,3.859,38.806,4392,4499,12472
2000,5313,44955,51194,487995,480197,7192,14.115,6710,13.169,94530,34391,60139,7.162,19.686,78709,33010,45699,6.874,16.391,15821,3.295,32.782,3492,3561,15685
2000,5321,4470,10433,178750,176976,1101,10.619,972,9.375,24341,7664,16677,4.331,13.754,20851,13093,7758,7.398,11.782,3490,1.972,23.564,470,500,2606
2000,5322,14701,30659,251504,252272,3060,9.866,3774,12.168,47590,19235,28355,7.625,18.865,48091,18638,29453,7.388,19.063,-501,-0.199,37.729,2402,2858,12365
2000,5323,3403,5795,39539,39599,400,6.898,408,7.036,5718,1571,4147,3.967,14.440,5729,2961,2768,7.478,14.468,-11,-0.028,28.880,305,322,2562
2000,5324,7190,11422,157645,152783,1391,12.205,1341,11.766,36927,14851,22076,9.720,24.170,27576,12002,15574,7.856,18.049,9351,6.120,36.098,738,836,5902
2000,5331,1684,1822,22531,22236,229,12.638,209,11.534,5131,1869,3262,8.405,23.076,4580,1877,2703,8.441,20.598,551,2.478,41.195,146,149,1252
2000,5411,154252,161739,1092085,1089208,13180,8.134,13782,8.505,134499,40558,93941,3.724,12.348,128868,40269,88599,3.697,11.831,5631,0.517,23.663,9798,9893,28653
2000,5412,85236,92309,1184385,1140328,9665,10.544,8375,9.137,254452,73353,181099,6.433,22.314,163455,58044,105411,5.090,14.334,90997,7.980,28.668,5738,5814,33369
2000,5413,82357,92983,1234923,1216288,10089,10.959,8243,8.954,210428,66702,143726,5.484,17.301,173051,61079,111972,5.022,14.228,37377,3.073,28.456,5286,5400,24415
2000,5414,23986,24222,137882,134170,3507,14.582,3163,13.152,30315,10602,19713,7.902,22.594,22716,9682,13034,7.216,16.931,7599,5.664,33.862,2396,2400,7419
2000,5415,73202,82520,1161198,1093092,18511,23.188,13129,16.446,359402,144008,215394,13.174,32.879,222669,90804,131865,8.307,20.371,136733,12.509,40.741,9174,9281,46033
2000,5416,64845,69172,622873,601092,14364,21.383,10371,15.439,159403,65032,94371,10.819,26.519,115555,51926,63629,8.639,19.224,43848,7.295,38.448,7484,7561,28559
2000,5417,9772,12562,574688,562393,1779,14.378,1402,11.331,102622,39860,62762,7.088,18.247,79034,28733,50301,5.109,14.053,23588,4.194,28.106,740,755,5665
2000,5418,32071,35512,485232,470178,4305,12.129,4266,12.019,106809,33171,73638,7.055,22.717,76329,35058,41271,7.456,16.234,30480,6.483,32.468,3142,3201,17530
2000,5419,47327,54313,481590,464345,6972,13.270,3428,6.524,96896,32724,64172,7.047,20.867,63311,17668,45643,3.805,13.634,33585,7.233,27.269,2224,2247,9149
2000,5511,28199,52476,3291882,3275404,6504,12.518,5467,10.522,623843,215907,407936,6.592,19.046,596809,186614,410195,5.697,18.221,27034,0.825,36.442,1271,1428,21540
2000,5611,19700,21691,433536,417104,3287,15.232,3064,14.199,108327,41518,66810,9.954,25.971,75540,34983,40557,8.387,18.111,32787,7.861,36.221,2027,2091,21936
2000,5612,1446,3114,128863,126242,756,26.296,278,9.670,28328,10154,18174,8.043,22.440,23063,10106,12957,8.005,18.269,5265,4.171,36.538,99,101,3224
2000,5613,26455,45079,4466176,4233213,7323,16.533,5752,12.986,1318837,341660,977177,8.071,31.155,857206,335777,521429,7.932,20.250,461631,10.905,40.499,2723,2851,89647
2000,5614,25371,30478,700207,689067,4154,13.596,4303,14.084,169352,61740,107612,8.960,24.577,145831,62379,83452,9.053,21.164,23521,3.413,42.327,2981,3080,28149
2000,5615,22444,30390,302701,300383,2740,8.814,4132,13.292,59737,21727,38010,7.233,19.887,54835,25080,29755,8.349,18.255,4902,1.632,36.510,2636,2711,13726
2000,5616,15543,19807,706151,702711,2506,12.722,2287,11.611,113070,39091,73979,5.563,16.091,108039,30671,77368,4.365,15.375,5031,0.716,30.749,1568,1583,16687
2000,5617,115794,121776,1507015,1463117,17545,14.804,11019,9.298,322182,100105,222077,6.842,22.020,234987,72514,162473,4.956,16.061,87195,5.960,32.121,8345,8366,47336
2000,5619,20022,22097,467673,426929,2223,9.936,2774,12.399,139212,20133,119079,4.716,32.608,60927,19197,41730,4.497,14.271,78285,18.337,28.542,2046,2075,11102
2000,5621,5790,7194,152001,150970,834,11.481,974,13.409,30687,12176,18511,8.065,20.327,28426,14418,14008,9.550,18.829,2261,1.498,37.658,732,745,8218
2000,5622,1410,2322,52320,51443,439,19.607,273,12.193,12767,7121,5646,13.843,24.818,11089,6067,5022,11.794,21.556,1678,3.262,43.112,163,166,2462
2000,5629,5293,5847,93097,91096,654,11.171,669,11.427,21019,4326,16693,4.749,23.074,16898,6511,10387,7.147,18.550,4121,4.524,37.100,458,472,3223
2000,6111,16514,18831,739541,715169,1018,5.552,27,0.147,79503,20685,58818,2.892,11.117,31231,175,31056,0.024,4.367,48272,6.750,8.734,3,3,43
2000,6112,527,789,80094,77807,28,3.613,0,0.000,8493,320,8173,0.411,10.915,3703,0,3703,0.000,4.759,4790,6.156,9.518,0,0,0
2000,6113,2355,2989,1336874,1321432,159,5.461,4,0.137,86202,4702,81500,0.356,6.523,55429,16,55413,0.001,4.195,30773,2.329,8.389,(D),(D),(D)
2000,6114,5511,6071,64514,62381,1007,16.842,823,13.765,15691,6303,9388,10.104,25.154,11518,4077,7441,6.536,18.464,4173,6.690,36.928,602,622,2823
2000,6115,5294,6230,79644,76826,704,11.346,654,10.540,16009,5570,10439,7.250,20.838,10240,4034,6206,5.251,13.329,5769,7.509,26.658,448,467,2771
2000,6116,21143,22975,203124,194447,3289,14.602,2389,10.606,46389,16004,30385,8.231,23.857,28712,10499,18213,5.399,14.766,17677,9.091,29.532,1748,1770,7874
2000,6117,3271,3540,39119,36440,574,16.497,453,13.019,10727,5271,5456,14.465,29.438,5228,1406,3822,3.858,14.347,5499,15.091,28.694,329,332,1035
2000,6211,157544,178383,1747734,1712367,14884,8.339,15088,8.453,303637,109072,194565,6.370,17.732,233647,103429,130218,6.040,13.645,69990,4.087,27.289,9885,10425,52978
2000,6212,106208,110262,705313,692202,5388,4.900,4800,4.365,98262,26480,71782,3.825,14.196,72062,19921,52141,2.878,10.411,26200,3.785,20.821,3676,3736,15184
2000,6213,78486,84292,419191,413204,9153,10.965,7514,9.002,85976,32227,53749,7.799,20.807,74346,33050,41296,7.998,17.993,11630,2.815,35.985,5227,5323,17648
2000,6214,10435,21902,552838,546421,2385,10.897,2356,10.764,94032,30882,63150,5.652,17.209,81510,36289,45221,6.641,14.917,12522,2.292,29.834,732,784,8372
2000,6215,5478,8595,150768,150116,1447,17.015,1266,14.886,31166,13918,17248,9.271,20.761,30503,13287,17216,8.851,20.320,663,0.442,40.639,489,652,5476
2000,6216,10121,14952,779181,780991,1946,12.623,2875,18.649,149756,39439,110317,5.050,19.175,154679,69093,85586,8.847,19.805,-4923,-0.630,38.350,1359,1540,28256
2000,6219,4450,6707,182473,177189,902,13.773,586,8.948,38660,15067,23593,8.503,21.819,27665,9547,18118,5.388,15.613,10995,6.205,31.227,318,336,4375
2000,6221,3404,5468,4564749,4544572,289,5.343,170,3.143,273502,92208,181294,2.029,6.018,233233,72598,160635,1.597,5.132,40269,0.886,10.264,60,60,30202
2000,6222,506,750,234772,238107,41,5.349,74,9.654,11671,5244,6427,2.202,4.902,18183,9533,8650,4.004,7.636,-6512,-2.735,9.803,18,33,5202
2000,6223,289,433,145545,148119,43,9.751,59,13.379,11438,4246,7192,2.867,7.722,16709,8574,8135,5.789,11.281,-5271,-3.559,15.444,15,17,1574
2000,6231,7910,15713,1521096,1523321,1442,9.245,1210,7.758,174339,75976,98363,4.988,11.445,178139,73941,104198,4.854,11.694,-3800,-0.249,22.889,472,550,29461
2000,6232,7456,22359,402861,393787,2438,11.241,1096,5.053,65873,26972,38901,6.849,16.728,47664,13162,34502,3.342,12.104,18209,4.624,24.208,402,443,4884
2000,6233,12478,16512,512572,493630,2069,12.698,1632,10.016,86782,35517,51265,7.195,17.580,49105,20494,28611,4.152,9.948,37677,7.633,19.895,1135,1177,11074
2000,6239,3424,5920,149209,147174,506,8.619,408,6.949,20516,5400,15116,3.669,13.940,16543,4115,12428,2.796,11.240,3973,2.700,22.481,181,190,1710
2000,6241,30538,43451,792758,768235,3596,8.367,2651,6.168,123223,30159,93064,3.926,16.040,74521,18464,56057,2.403,9.700,48702,6.339,19.401,1593,1637,9817
2000,6242,8313,10375,122374,118896,631,6.138,443,4.309,17711,3450,14261,2.902,14.896,10698,2971,7727,2.499,8.998,7013,5.898,17.996,243,258,1796
2000,6243,5166,7919,313539,309021,561,7.099,528,6.681,44923,7738,37185,2.504,14.537,35842,6889,28953,2.229,11.599,9081,2.939,23.197,232,235,1820
2000,6244,47764,60012,700415,683177,6885,11.570,5873,9.870,121200,46190,75010,6.761,17.741,87300,32870,54430,4.811,12.779,33900,4.962,25.557,4257,4339,22997
2000,7111,7580,7660,122390,119486,931,12.119,975,12.692,26457,6682,19775,5.592,22.142,20640,6237,14403,5.220,17.274,5817,4.868,34.548,665,668,4335
2000,7112,3289,3441,98097,96234,551,16.102,513,14.991,18015,4293,13722,4.461,18.720,14156,5114,9042,5.314,14.710,3859,4.010,29.420,372,372,2974
2000,7113,3471,3649,75961,70566,579,16.340,368,10.385,18734,5654,13080,8.012,26.548,7889,2253,5636,3.193,11.180,10845,15.369,22.359,262,262,1606
2000,7114,2456,2508,16006,15264,401,16.505,244,10.043,4186,1766,2420,11.570,27.425,2651,1027,1624,6.728,17.368,1535,10.057,34.736,182,182,739
2000,7115,9005,9027,39859,39014,1728,19.504,1393,15.723,14885,5983,8902,15.336,38.153,13185,4825,8360,12.368,33.796,1700,4.357,67.592,856,857,2574
2000,7121,5098,5502,108251,105708,346,6.335,265,4.852,12518,2030,10488,1.920,11.842,7430,1041,6389,0.985,7.029,5088,4.813,14.058,158,159,595
2000,7131,1625,2409,129780,125532,317,12.515,565,22.306,26067,4673,21394,3.723,20.765,18097,9159,8938,7.296,14.416,7970,6.349,28.832,232,425,6004
2000,7132,1645,2038,187415,176483,248,12.274,213,10.542,34855,12717,22138,7.206,19.750,12107,3240,8867,1.836,6.860,22748,12.890,13.720,156,157,1698
2000,7139,44720,49084,951670,925222,4812,9.827,4578,9.349,165192,47580,117612,5.143,17.854,112309,38541,73768,4.166,12.139,52883,5.716,24.277,3410,3433,26778
2000,7211,34482,44319,1718954,1699770,4676,10.641,3921,8.923,241812,110738,131074,6.515,14.226,203215,79150,124065,4.657,11.955,38597,2.271,23.911,2531,2585,38015
2000,7212,5021,5439,38547,37858,452,8.348,403,7.443,6637,1577,5060,4.166,17.531,5200,1588,3612,4.195,13.736,1437,3.796,27.471,281,285,1248
2000,7213,2765,2825,15043,14916,140,4.829,288,9.934,2625,759,1866,5.089,17.599,2365,942,1423,6.316,15.856,260,1.743,31.712,209,209,676
2000,7223,10666,24702,503684,489427,3429,14.141,2523,10.405,91508,40461,51047,8.267,18.697,62901,28193,34708,5.760,12.852,28607,5.845,25.704,1174,1198,8252
2000,7224,44770,45257,327631,327410,4933,10.782,5926,12.952,69932,32610,37322,9.960,21.359,69438,31340,38098,9.572,21.208,494,0.151,42.417,4602,4616,23561
2000,7225,262659,363287,7303070,7209172,40661,11.201,40105,11.048,1333799,622851,710948,8.640,18.501,1144532,454574,689958,6.305,15.876,189267,2.625,31.752,27154,28901,271500
2000,8111,138228,150371,869271,863841,14482,9.583,15979,10.574,154313,56917,97396,6.589,17.864,143574,62092,81482,7.188,16.620,10739,1.243,33.241,10911,11243,40866
2000,8112,12403,14284,144455,143461,1344,9.189,2028,13.866,27942,11435,16507,7.971,19.477,25642,11105,14537,7.741,17.874,2300,1.603,35.748,1445,1480,6062
2000,8113,20788,22358,194793,194156,1851,8.232,2105,9.362,30363,7557,22806,3.892,15.638,28927,9085,19842,4.679,14.899,1436,0.740,29.798,1540,1549,5821
2000,8114,23665,24784,139210,139930,2677,10.676,3257,12.990,20802,7222,13580,5.161,14.866,22391,11516,10875,8.230,16.002,-1589,-1.136,29.732,2386,2474,7632
2000,8121,73932,85268,501246,494012,10204,11.941,10568,12.367,97582,40458,57124,8.190,19.753,83264,38965,44299,7.887,16.855,14318,2.898,33.709,7733,8096,28151
2000,8122,14967,21393,162565,159389,1175,5.515,999,4.689,19923,7057,12866,4.428,12.500,13982,4446,9536,2.789,8.772,5941,3.727,17.545,664,691,3321
2000,8123,33001,39447,391674,391447,3487,8.749,4307,10.806,57972,19710,38262,5.035,14.810,57178,22015,35163,5.624,14.607,794,0.203,29.214,3145,3276,14890
2000,8129,20011,30789,231074,229945,5817,19.883,2752,9.406,53588,28607,24981,12.441,23.305,51496,16247,35249,7.066,22.395,2092,0.910,44.790,1605,1636,7527
2000,8131,160563,160680,1564810,1526268,7890,5.029,299,0.191,181309,27926,153383,1.830,11.879,104865,665,104200,0.044,6.871,76444,5.009,13.741,43,43,72
2000,8132,10616,12453,131004,127128,1126,9.157,813,6.612,21365,5087,16278,4.001,16.806,13490,5101,8389,4.012,10.611,7875,6.195,21.223,443,444,1577
2000,8133,8941,10710,105316,102630,1001,9.507,639,6.069,16074,3456,12618,3.367,15.662,10688,2818,7870,2.746,10.414,5386,5.248,20.828,385,386,1603
2000,8134,27558,29355,320794,315851,1275,4.328,1481,5.027,39467,5395,34072,1.708,12.495,29619,5785,23834,1.832,9.378,9848,3.118,18.755,939,939,2995
2000,8139,61985,64032,520080,510606,3218,5.058,2397,3.768,68738,12849,55889,2.516,13.462,50038,7649,42389,1.498,9.800,18700,3.662,19.599,1645,1657,5203
2001,2111,5721,6974,86413,83035,712,10.271,628,9.059,19068,7688,11380,9.259,22.964,12054,4073,7981,4.905,14.517,7014,8.447,29.034,372,375,1595
2001,2121,756,1127,70157,70842,128,11.160,168,14.647,11299,3957,7342,5.586,15.950,12940,5443,7497,7.683,18.266,-1641,-2.316,31.899,102,103,1767
2001,2122,282,382,32361,34040,36,9.000,72,18.000,1782,504,1278,1.481,5.235,5229,1847,3382,5.426,15.362,-3447,-10.126,10.470,50,54,196
2001,2123,3279,5294,99451,101061,434,8.240,380,7.215,11005,3170,7835,3.137,10.890,14238,3431,10807,3.395,14.089,-3233,-3.199,21.779,228,229,1814
2001,2131,6874,8151,195709,180817,1065,13.334,737,9.227,47000,10143,36857,5.610,25.993,17470,6529,10941,3.611,9.662,29530,16.331,19.323,487,508,3803
2001,2211,1579,9105,523927,525030,780,8.557,800,8.777,59940,30014,29926,5.717,11.417,62688,16718,45970,3.184,11.940,-2748,-0.523,22.833,70,77,1376
2001,2212,521,2469,87925,87135,256,10.318,280,11.286,16081,4227,11854,4.851,18.455,14791,4491,10300,5.154,16.975,1290,1.480,33.950,52,74,795
2001,2213,4518,5174,39812,39241,497,9.821,270,5.335,6057,3060,2997,7.798,15.435,4984,2076,2908,5.290,12.701,1073,2.734,25.402,180,181,1019
2001,2361,132977,133711,733644,731663,20057,15.089,18479,13.902,169693,64474,105219,8.812,23.193,165635,65847,99788,9.000,22.638,4058,0.555,45.276,12626,12630,45912
2001,2362,43480,44377,835705,830502,4213,9.494,4212,9.492,153425,29800,123625,3.588,18.474,142334,30538,111796,3.677,17.138,11091,1.335,34.277,2964,2970,21180
2001,2371,18639,19229,480839,470014,1956,10.341,1327,7.016,100657,20142,80515,4.285,21.416,79884,16951,62933,3.606,16.996,20773,4.420,33.992,968,968,12052
2001,2372,10297,10464,82565,82102,1771,17.004,1674,16.072,18644,7367,11277,8.973,22.708,17536,6996,10540,8.521,21.359,1108,1.350,42.718,1246,1246,5035
2001,2373,10842,11336,305098,308855,856,7.546,871,7.678,50106,11558,38548,3.742,16.223,57535,11779,45756,3.814,18.628,-7429,-2.405,32.446,591,591,5539
2001,2379,4397,4530,71444,71246,567,12.407,647,14.158,15650,4047,11603,5.680,21.966,15308,3611,11697,5.068,21.486,342,0.480,42.973,498,500,2403
2001,2381,92247,92711,976695,975058,11435,12.372,10871,11.761,206678,54436,152242,5.583,21.196,203055,56308,146747,5.775,20.825,3623,0.372,41.650,7787,7789,41586
2001,2382,142485,145430,1822719,1807140,14701,10.145,13670,9.433,337238,80942,256296,4.479,18.661,305729,103495,202234,5.727,16.918,31509,1.744,33.836,9730,9737,62837
2001,2383,95703,96459,813650,806864,14128,14.744,12860,13.420,180108,53252,126856,6.600,22.322,166811,53384,113427,6.616,20.674,13297,1.648,41.348,9307,9322,37958
2001,2389,47891,48232,401931,408444,5735,11.804,6439,13.253,77449,23703,53746,5.803,18.962,90741,31013,59728,7.593,22.216,-13292,-3.254,37.924,4610,4612,22453
2001,3111,1106,1681,48504,50062,114,6.645,183,10.667,5378,1843,3535,3.681,10.743,8447,4214,4233,8.418,16.873,-3069,-6.130,21.485,59,59,492
2001,3112,485,845,59389,60628,39,4.524,73,8.469,4036,934,3102,1.541,6.657,6593,1814,4779,2.992,10.875,-2557,-4.218,13.314,30,31,348
2001,3113,1446,1623,84621,84135,139,8.642,110,6.839,8325,1882,6443,2.237,9.895,7297,1947,5350,2.314,8.673,1028,1.222,17.346,78,81,616
2001,3114,1258,1660,166829,167330,108,6.436,144,8.582,19270,5559,13711,3.322,11.516,20197,6716,13481,4.014,12.070,-927,-0.554,23.032,93,94,1382
2001,3115,1131,1631,131473,132343,86,5.233,111,6.754,11279,3030,8249,2.290,8.523,12673,5235,7438,3.956,9.576,-1394,-1.053,17.045,71,72,1449
2001,3116,3155,3788,493176,493575,235,6.194,247,6.510,35785,5453,30332,1.105,7.250,36618,9461,27157,1.917,7.419,-833,-0.169,14.500,178,180,5223
2001,3117,610,722,39125,39823,53,7.172,87,11.773,4758,972,3786,2.441,11.948,6114,1823,4291,4.578,15.353,-1356,-3.405,23.896,64,64,1157
2001,3118,9059,9880,302005,300126,1020,10.324,1020,10.324,37357,10152,27205,3.383,12.447,33792,12805,20987,4.267,11.259,3565,1.188,22.519,786,799,7345
2001,3119,2272,2649,138470,141279,205,7.745,201,7.594,14037,3242,10795,2.295,9.936,19557,6309,13248,4.466,13.843,-5520,-3.907,19.871,140,142,2437
2001,3121,2196,2680,146015,137276,309,11.758,205,7.801,28704,19096,9608,13.911,20.910,12067,2388,9679,1.740,8.790,16637,12.119,17.581,150,150,1438
2001,3122,95,124,23114,25180,24,20.779,7,6.061,747,189,558,0.751,2.967,4856,431,4425,1.712,19.286,-4109,-16.319,5.933,4,4,48
2001,3131,364,580,69241,74167,51,8.718,61,10.427,5265,2581,2684,3.480,7.099,15239,5283,9956,7.123,20.547,-9974,-13.448,14.198,24,27,697
2001,3132,1548,1840,165385,173436,110,5.871,177,9.448,9633,1918,7715,1.106,5.554,25865,6341,19524,3.656,14.913,-16232,-9.359,11.108,127,128,1458
2001,3133,1824,1954,78351,81431,143,7.106,260,12.919,6689,1986,4703,2.439,8.214,12865,3834,9031,4.708,15.799,-6176,-7.584,16.429,195,197,2524
2001,3141,2558,2793,112621,116908,204,7.206,280,9.890,8017,2107,5910,1.802,6.858,16368,5137,11231,4.394,14.001,-8351,-7.143,13.715,215,217,1915
2001,3149,4331,4468,94888,98698,441,9.810,496,11.033,11045,4471,6574,4.530,11.191,18638,6737,11901,6.826,18.884,-7593,-7.693,22.381,394,395,4954
2001,3151,862,938,67399,71883,65,6.670,138,14.161,5039,1101,3938,1.532,7.010,13887,4434,9453,6.168,19.319,-8848,-12.309,14.020,110,111,1849
2001,3152,9179,9611,312644,336119,1445,14.683,1905,19.358,40848,17420,23428,5.183,12.153,87496,39224,48272,11.670,26.031,-46648,-13.878,24.306,1528,1543,25233
2001,3159,1577,1632,42094,44224,120,7.015,277,16.194,4394,1146,3248,2.591,9.936,8674,3460,5214,7.824,19.614,-4280,-9.678,19.872,209,222,1803
2001,3161,272,286,11495,12791,18,6.154,31,10.598,610,139,471,1.087,4.769,3143,1223,1920,9.561,24.572,-2533,-19.803,9.538,17,21,954
2001,3162,313,348,24967,26435,35,10.086,33,9.510,2255,304,1951,1.150,8.530,5092,2060,3032,7.793,19.262,-2837,-10.732,17.061,22,22,504
2001,3169,896,920,21469,22532,94,10.201,97,10.526,2549,978,1571,4.341,11.313,4685,981,3704,4.354,20.793,-2136,-9.480,22.626,79,79,784
2001,3211,3873,4343,123898,128688,265,6.015,391,8.874,8879,2381,6498,1.850,6.900,18367,5007,13360,3.891,14.273,-9488,-7.373,13.799,287,293,2763
2001,3212,1464,1857,117123,120290,105,5.647,110,5.916,8962,2933,6029,2.438,7.450,15312,5168,10144,4.296,12.729,-6350,-5.279,14.901,70,70,2021
2001,3219,9301,10130,321315,334400,923,9.101,946,9.328,33407,12283,21124,3.673,9.990,59627,16447,43180,4.918,17.831,-26220,-7.841,19.980,690,700,9510
2001,3221,268,549,161463,165777,28,5.086,31,5.631,7415,4520,2895,2.727,4.473,15872,8428,7444,5.084,9.574,-8457,-5.101,8.946,10,10,492
2001,3222,3341,5057,378227,386660,191,3.740,292,5.717,25182,5072,20110,1.312,6.513,42262,16874,25388,4.364,10.930,-17080,-4.417,13.025,156,170,4633
2001,3231,34227,36012,782109,794605,2089,5.725,3043,8.339,67031,16891,50140,2.126,8.436,92143,29122,63021,3.665,11.596,-25112,-3.160,16.872,2422,2431,19382
2001,3241,1036,2150,105196,114278,179,8.361,161,7.520,8236,3691,4545,3.230,7.207,26859,16739,10120,14.648,23.503,-18623,-16.296,14.414,55,57,840
2001,3251,1119,2288,187627,193315,95,4.091,163,7.020,9387,2314,7073,1.197,4.856,20373,6914,13459,3.577,10.539,-10986,-5.683,9.712,51,51,1004
2001,3252,486,811,111816,115836,48,5.850,67,8.166,5181,1794,3387,1.549,4.473,13347,4095,9252,3.535,11.522,-8166,-7.050,8.945,35,35,605
2001,3253,651,877,34472,35005,77,8.755,82,9.323,3625,1077,2548,3.077,10.356,4685,1893,2792,5.408,13.384,-1060,-3.028,20.711,55,56,883
2001,3254,1383,1735,231254,227097,134,7.768,114,6.609,24535,5143,19392,2.265,10.804,15869,2806,13063,1.236,6.988,8666,3.816,13.976,78,80,1529
2001,3255,1579,2023,73409,74306,116,5.727,121,5.974,7125,2187,4938,2.943,9.589,8958,1901,7057,2.558,12.056,-1833,-2.467,19.177,67,67,464
2001,3256,2016,2261,123658,124172,162,7.137,180,7.930,14349,5390,8959,4.341,11.556,14797,4747,10050,3.823,11.917,-448,-0.361,23.112,121,123,1285
2001,3259,2136,2789,120336,119731,173,6.171,202,7.205,13142,3621,9521,3.024,10.976,12029,3707,8322,3.096,10.047,1113,0.930,20.093,131,132,1637
2001,3261,10152,12755,800011,818373,656,5.104,853,6.636,70520,20579,49941,2.515,8.617,107188,27009,80179,3.300,13.098,-36668,-4.481,17.234,558,567,11626
2001,3262,1920,2510,194628,200528,119,4.677,188,7.388,11205,2962,8243,1.477,5.588,22898,5775,17123,2.880,11.419,-11693,-5.831,11.175,114,115,2172
2001,3271,1425,1672,75338,75593,130,7.663,179,10.551,8808,4072,4736,5.387,11.652,9184,2837,6347,3.753,12.149,-376,-0.497,23.304,134,134,906
2001,3272,1892,2196,128656,129477,170,7.722,181,8.222,9193,2769,6424,2.139,7.100,10574,2627,7947,2.029,8.167,-1381,-1.067,14.200,118,118,780
2001,3273,5261,9094,218514,218290,592,6.511,588,6.467,29080,7799,21281,3.573,13.322,28610,8561,20049,3.922,13.106,470,0.215,26.213,299,321,4419
2001,3274,235,376,19531,20185,28,7.467,26,6.933,1431,502,929,2.487,7.089,2710,699,2011,3.463,13.426,-1279,-6.336,14.179,16,16,99
2001,3279,2252,2658,77359,76886,260,9.948,171,6.543,8881,2350,6531,3.056,11.551,7929,2265,5664,2.946,10.313,952,1.238,20.625,115,116,1353
2001,3311,457,554,138443,142308,101,18.738,71,13.173,7836,3131,4705,2.200,5.506,15946,7079,8867,4.974,11.205,-8110,-5.699,11.013,53,53,1833
2001,3312,579,784,62912,64233,68,8.791,47,6.076,5088,2147,2941,3.343,7.921,7536,1530,6006,2.382,11.732,-2448,-3.811,15.842,25,25,92
2001,3313,421,587,79216,82808,44,7.547,36,6.175,3864,1520,2344,1.836,4.666,11203,3400,7803,4.106,13.529,-7339,-8.863,9.332,12,12,200
2001,3314,701,894,75083,75643,57,6.316,74,8.199,5833,804,5029,1.063,7.711,6902,1667,5235,2.204,9.124,-1069,-1.413,15.422,47,47,683
2001,3315,2272,2596,206482,214379,102,3.883,164,6.243,12798,2513,10285,1.172,5.970,28568,4776,23792,2.228,13.326,-15770,-7.356,11.940,119,121,2059
2001,3321,2575,2806,144525,146597,88,3.091,170,5.971,14305,3575,10730,2.439,9.758,18320,5944,12376,4.055,12.497,-4015,-2.739,19.516,108,113,3254
2001,3322,1389,1539,73474,76398,59,3.765,115,7.339,4066,710,3356,0.929,5.322,9914,2349,7565,3.075,12.977,-5848,-7.655,10.644,87,87,572
2001,3323,11691,12682,428112,428687,899,7.135,735,5.833,52326,15535,36791,3.624,12.206,53651,16131,37520,3.763,12.515,-1325,-0.309,24.412,513,516,7688
2001,3324,1339,1671,97621,99523,46,2.704,106,6.232,7394,1165,6229,1.171,7.429,11212,2084,9128,2.094,11.266,-3818,-3.836,14.859,75,76,1101
2001,3325,750,835,62676,65186,31,3.664,53,6.265,3336,1022,2314,1.568,5.118,8314,1032,7282,1.583,12.754,-4978,-7.637,10.235,37,38,554
2001,3326,1632,1813,69357,70410,113,6.221,120,6.606,6342,1361,4981,1.933,9.007,8337,2174,6163,3.088,11.841,-1995,-2.833,18.014,83,85,1114
2001,3327,25150,25635,427241,429049,1693,6.611,1643,6.415,48192,10439,37753,2.433,11.232,51904,13076,38828,3.048,12.097,-3712,-0.865,22.465,1264,1267,9071
2001,3328,5451,6044,153537,155612,357,5.879,413,6.802,16287,4500,11787,2.892,10.466,20428,5684,14744,3.653,13.128,-4141,-2.661,20.933,309,309,3709
2001,3329,5662,6230,303917,307675,462,7.383,518,8.277,26115,7950,18165,2.584,8.488,33814,9991,23823,3.247,10.990,-7699,-2.502,16.976,383,384,4752
2001,3331,2536,2865,194857,197336,170,5.897,206,7.145,17018,3068,13950,1.555,8.624,21968,5377,16591,2.725,11.132,-4950,-2.508,17.248,142,143,2045
2001,3332,3968,4216,177061,180971,273,6.420,346,8.136,20791,5368,15423,2.966,11.489,28079,7056,21023,3.899,15.516,-7288,-4.027,22.977,249,251,3702
2001,3333,2160,2331,129167,132109,125,5.263,213,8.968,16959,2994,13965,2.266,12.837,23028,10031,12997,7.593,17.431,-6069,-4.594,25.674,136,136,1679
2001,3334,1419,1746,179028,179641,87,4.964,100,5.706,15581,2287,13294,1.273,8.673,16837,3502,13335,1.949,9.373,-1256,-0.699,17.347,72,72,1195
2001,3335,9082,9476,222150,228229,434,4.536,616,6.439,16878,3913,12965,1.715,7.395,28887,6580,22307,2.883,12.657,-12009,-5.262,14.790,462,463,3529
2001,3336,733,900,103457,107328,46,5.100,50,5.543,6811,1599,5212,1.490,6.346,14661,3108,11553,2.896,13.660,-7850,-7.314,12.692,32,32,250
2001,3339,5717,6413,337504,341255,341,5.268,461,7.122,32409,10315,22094,3.023,9.497,39924,11458,28466,3.358,11.699,-7515,-2.202,18.994,322,325,3437
2001,3341,1519,1620,196178,190436,175,10.600,237,14.355,34602,16783,17819,8.813,18.170,23670,8153,15517,4.281,12.429,10932,5.741,24.859,181,181,2671
2001,3342,1794,2019,253596,240845,216,10.730,204,10.134,52694,18687,34007,7.759,21.879,26862,11630,15232,4.829,11.153,25832,10.726,22.306,125,128,2568
2001,3343,518,543,28885,29726,62,11.481,56,10.370,2234,518,1716,1.743,7.515,3994,744,3250,2.503,13.436,-1760,-5.921,15.031,42,42,282
2001,3344,4862,5598,601857,586039,442,7.870,479,8.528,91124,21913,69211,3.739,15.549,60338,18917,41421,3.228,10.296,30786,5.253,20.592,331,332,7698
2001,3345,4421,5108,476421,476131,372,7.302,345,6.772,51283,19052,32231,4.001,10.771,51366,16059,35307,3.373,10.788,-83,-0.017,21.542,204,204,3532
2001,3346,791,862,38460,40206,121,14.144,108,12.624,5161,1725,3436,4.290,12.837,8346,3664,4682,9.113,20.758,-3185,-7.922,25.673,72,73,714
2001,3351,1115,1223,72141,74802,60,4.819,104,8.353,5038,1593,3445,2.130,6.735,10299,4465,5834,5.969,13.768,-5261,-7.033,13.470,75,75,843
2001,3352,243,309,95324,99163,27,8.654,33,10.577,4108,415,3693,0.419,4.143,11621,2228,9393,2.247,11.719,-7513,-7.576,8.285,21,21,216
2001,3353,2223,2651,192354,194582,135,5.020,211,7.847,16914,3913,13001,2.011,8.692,21290,5092,16198,2.617,10.941,-4376,-2.249,17.385,148,148,1450
2001,3359,1813,2216,205953,206535,152,6.813,182,8.158,20027,4175,15852,2.021,9.697,21338,6346,14992,3.073,10.331,-1311,-0.635,19.393,123,124,1492
2001,3361,280,344,204640,214762,37,10.725,39,11.304,4928,910,4018,0.424,2.295,25182,792,24390,0.369,11.726,-20254,-9.431,4.589,27,27,301
2001,3362,1759,1991,134929,143948,153,7.673,159,7.974,11381,5083,6298,3.531,7.906,29285,3416,25869,2.373,20.344,-17904,-12.438,15.813,111,113,1747
2001,3363,4331,5493,763659,796037,317,5.723,409,7.384,51606,14056,37550,1.766,6.483,116027,16997,99030,2.135,14.576,-64421,-8.093,12.966,281,287,7354
2001,3364,1356,1675,414526,415455,105,6.213,135,7.988,24824,2409,22415,0.580,5.975,26409,10458,15951,2.517,6.357,-1585,-0.382,11.950,100,100,1262
2001,3365,143,206,26301,27919,15,7.143,23,10.952,1691,824,867,2.951,6.057,4957,1518,3439,5.437,17.755,-3266,-11.698,12.114,13,13,408
2001,3366,1536,1660,137987,142572,163,9.819,163,9.819,8959,2300,6659,1.613,6.284,17964,2620,15344,1.838,12.600,-9005,-6.316,12.568,115,115,966
2001,3369,655,679,35546,35415,82,12.175,71,10.542,4747,1104,3643,3.117,13.404,4470,550,3920,1.553,12.622,277,0.782,25.244,54,54,232
2001,3371,13966,14458,401716,412373,1456,10.111,1341,9.312,37288,9750,27538,2.364,9.042,58209,20529,37680,4.978,14.116,-20921,-5.073,18.085,978,982,9549
2001,3372,3990,4219,183372,187101,250,5.876,321,7.545,15000,2798,12202,1.495,8.017,22260,6001,16259,3.207,11.897,-7260,-3.880,16.034,231,234,3310
2001,3379,941,1066,47131,47815,63,5.877,75,6.996,3476,706,2770,1.477,7.270,4861,1083,3778,2.265,10.166,-1385,-2.897,14.539,59,60,727
2001,3391,10690,11345,291422,290117,835,7.346,877,7.716,32306,6735,25571,2.321,11.136,29623,9675,19948,3.335,10.211,2683,0.925,20.421,656,656,4411
2001,3399,16925,17492,414406,422548,1610,9.175,1723,9.819,43394,10771,32623,2.549,10.270,59249,16213,43036,3.837,14.022,-15855,-3.752,20.539,1315,1321,9809
2001,4231,18209,23078,322063,324541,2205,9.524,2352,10.159,45528,19813,25715,6.105,14.028,50436,19522,30914,6.015,15.541,-4908,-1.512,28.057,1547,1650,11351
2001,4232,9951,11227,152955,153079,1201,10.734,1125,10.055,21942,6102,15840,3.986,14.334,21943,8306,13637,5.426,14.334,-1,-0.001,28.668,806,832,4171
2001,4233,9122,12844,171414,169829,1747,13.979,1053,8.426,29964,13888,16076,8.178,17.644,26661,7912,18749,4.659,15.699,3303,1.945,31.398,674,693,4526
2001,4234,27613,35849,747862,728824,4065,11.263,4552,12.612,163079,65978,97101,9.053,22.376,125987,50130,75857,6.878,17.286,37092,5.089,34.573,2787,2943,22047
2001,4235,7620,10343,161423,164465,701,6.752,779,7.503,16718,4819,11899,2.930,10.165,22857,7511,15346,4.567,13.898,-6139,-3.733,20.330,459,489,2952
2001,4236,19593,30105,507936,494497,3802,12.710,3421,11.436,117538,51235,66303,10.361,23.769,90988,36989,53999,7.480,18.400,26550,5.369,36.800,1631,1741,13197
2001,4237,10748,16534,210769,211899,1269,7.670,1291,7.803,27378,9396,17982,4.434,12.920,29839,8857,20982,4.180,14.082,-2461,-1.161,25.841,705,752,4339
2001,4238,47197,63628,763842,764071,4421,6.914,5045,7.890,95980,27954,68026,3.659,12.562,96387,32641,63746,4.272,12.615,-407,-0.053,25.123,3157,3353,19184
2001,4239,28648,31033,325722,325147,3605,11.637,3499,11.294,53356,16880,36476,5.192,16.410,52614,19248,33366,5.920,16.182,742,0.228,32.363,2650,2684,13708
2001,4241,9361,12288,220329,221046,893,7.225,1038,8.398,27657,8114,19543,3.671,12.512,28874,10864,18010,4.915,13.062,-1217,-0.551,25.024,629,639,3632
2001,4242,5002,6408,220781,208716,761,11.940,692,10.857,51045,15507,35538,7.430,24.457,25813,11469,14344,5.495,12.368,25232,12.089,24.735,455,471,4168
2001,4243,13756,14909,190703,191991,1878,12.599,1872,12.559,31132,11470,19662,5.974,16.215,33333,9704,23629,5.054,17.362,-2201,-1.146,32.431,1444,1467,6543
2001,4244,26283,32181,782367,776596,3511,10.955,3247,10.131,115523,47005,68518,6.053,14.876,104276,39832,64444,5.129,13.427,11247,1.448,26.855,2310,2355,19052
2001,4245,4664,7338,67088,68343,406,5.421,708,9.454,9302,3104,6198,4.542,13.611,11722,4695,7027,6.870,17.152,-2420,-3.541,27.222,377,420,2307
2001,4246,9448,14446,161840,162232,1950,13.887,1141,8.126,25794,12135,13659,7.480,15.899,26587,9377,17210,5.780,16.388,-793,-0.489,31.799,613,640,2858
2001,4247,6652,9687,124263,125318,576,5.871,824,8.399,19374,7129,12245,5.689,15.460,20966,6730,14236,5.370,16.730,-1592,-1.270,30.920,384,397,2589
2001,4248,3102,3985,157258,155249,297,7.446,304,7.622,16230,3879,12351,2.499,10.454,12046,5495,6551,3.539,7.759,4184,2.695,15.518,225,239,3394
2001,4249,22804,27474,381770,380601,3560,12.977,3478,12.678,65267,24933,40334,6.551,17.148,62523,23424,39099,6.154,16.427,2744,0.721,32.855,2336,2398,12908
2001,4251,32899,35028,277037,285069,2714,7.682,3318,9.391,42427,15811,26616,5.546,14.883,58483,20642,37841,7.241,20.515,-16056,-5.632,29.766,2192,2218,10254
2001,4411,43095,46739,1219507,1219632,4292,9.180,4324,9.248,127798,42883,84915,3.516,10.478,128126,44514,83612,3.650,10.505,-328,-0.027,20.957,3316,3367,32085
2001,4412,12421,13459,129828,128019,1331,9.946,1178,8.803,21565,7041,14524,5.500,16.845,18093,6502,11591,5.079,14.133,3472,2.712,28.266,870,901,4999
2001,4413,32864,56935,501003,514923,3629,6.343,4182,7.310,57413,21126,36287,4.103,11.150,86080,25533,60547,4.959,16.717,-28667,-5.567,22.300,2503,2724,13221
2001,4421,19745,27583,277756,282919,2492,8.978,2838,10.225,40448,13718,26730,4.849,14.297,49663,19832,29831,7.010,17.554,-9215,-3.257,28.593,1599,1923,9393
2001,4422,25307,33561,294298,283201,3376,10.098,3118,9.326,59667,21758,37909,7.683,21.069,38578,14036,24542,4.956,13.622,21089,7.447,27.244,1918,2042,8075
2001,4431,32250,50598,489900,489838,5425,10.717,5466,10.798,83471,33325,50146,6.803,17.041,83589,29592,53997,6.041,17.065,-118,-0.024,34.081,3852,3992,19831
2001,4441,48404,70280,1088948,1093864,4480,6.367,4642,6.597,142449,78022,64427,7.133,13.023,154788,38092,116696,3.482,14.151,-12339,-1.128,26.045,3084,3254,20181
2001,4442,17528,21353,193645,196625,1488,6.939,1672,7.797,25761,8550,17211,4.348,13.102,31745,10229,21516,5.202,16.145,-5984,-3.043,26.203,1075,1122,5661
2001,4451,59765,86935,2625485,2655067,8706,9.965,9572,10.956,303658,126555,177103,4.767,11.437,363952,135218,228734,5.093,13.708,-60294,-2.271,22.874,6227,6360,45210
2001,4452,17310,21725,148744,147797,2870,13.171,3002,13.776,31042,12742,18300,8.621,21.003,29668,13260,16408,8.972,20.073,1374,0.930,40.147,2033,2155,9445
2001,4453,22908,26044,135470,134778,2137,8.191,2231,8.551,20716,6820,13896,5.060,15.371,19198,7325,11873,5.435,14.244,1518,1.126,28.488,1668,1684,5620
2001,4461,39741,77486,946972,928333,5514,7.096,5959,7.668,141381,36915,104466,3.976,15.230,104843,37541,67302,4.044,11.294,36538,3.936,22.587,3206,3460,17934
2001,4471,60320,112745,930259,935123,8510,7.510,9656,8.521,151955,55470,96485,5.932,16.250,161848,53706,108142,5.743,17.308,-9893,-1.058,32.499,5709,6259,32840
2001,4481,36142,84055,1023546,1015004,8935,10.636,8845,10.529,187844,78239,109605,7.708,18.507,172385,59012,113373,5.814,16.984,15459,1.523,33.967,3948,4719,21298
2001,4482,6213,26934,191543,193438,2106,7.532,4158,14.871,37285,15002,22283,7.755,19.275,41671,21895,19776,11.319,21.542,-4386,-2.267,38.550,589,1894,9831
2001,4483,19008,29363,172499,172135,2688,9.150,2719,9.255,27590,11844,15746,6.881,16.028,26614,9674,16940,5.620,15.461,976,0.567,30.922,1392,1526,4572
2001,4511,29038,39878,418568,407057,3627,9.022,4273,10.629,79820,27998,51822,6.878,19.609,57610,21954,35656,5.393,14.153,22210,5.456,28.306,2922,3131,14229
2001,4512,6963,12683,141705,146122,988,7.715,1234,9.636,18914,7409,11505,5.070,12.944,26952,6483,20469,4.437,18.445,-8038,-5.501,25.888,775,797,3136
2001,4521,60,9591,1707392,1731513,350,3.626,474,4.910,118419,40789,77630,2.356,6.839,168192,59958,108234,3.463,9.714,-49773,-2.875,13.678,(D),(D),(D)
2001,4529,8898,28415,856541,833108,2599,9.266,1867,6.656,120630,56345,64285,6.763,14.480,74917,16764,58153,2.012,8.992,45713,5.487,17.985,1073,1097,4428
2001,4531,20702,21738,123979,123804,1814,8.243,2352,10.688,20827,5981,14846,4.831,16.823,20587,7854,12733,6.344,16.629,240,0.194,33.258,1864,1895,6082
2001,4532,28979,40770,345496,352976,4229,10.345,4451,10.888,50590,22943,27647,6.500,14.332,65586,23370,42216,6.621,18.581,-14996,-4.248,28.665,3122,3279,13179
2001,4533,12439,16261,115776,115260,1650,10.097,1812,11.088,17487,6517,10970,5.654,15.172,16597,5755,10842,4.993,14.400,890,0.772,28.799,1405,1441,3959
2001,4539,30850,38822,247445,250529,4627,11.849,5084,13.019,45846,17252,28594,6.886,18.300,51643,20906,30737,8.345,20.614,-5797,-2.314,36.599,3497,3637,13948
2001,4541,10477,11418,268126,270641,2144,19.174,1672,14.953,54415,19659,34756,7.264,20.106,60069,21548,38521,7.962,22.195,-5654,-2.089,40.212,1251,1263,11016
2001,4542,4851,5454,64107,65343,569,10.356,650,11.830,7001,3221,3780,4.929,10.714,9501,4044,5457,6.189,14.540,-2500,-3.826,21.429,527,528,2195
2001,4543,19467,25535,231092,229660,2884,11.340,2678,10.530,37591,12711,24880,5.535,16.368,34380,13007,21373,5.664,14.970,3211,1.398,29.940,1727,1766,7377
2001,4811,624,3214,524116,520891,348,11.434,7,0.230,50393,7120,43273,1.367,9.674,45529,83,45446,0.016,8.741,4864,0.934,17.481,4,4,73
2001,4812,1708,1859,36180,35708,281,15.385,216,11.826,5925,1802,4123,5.046,16.593,5057,1247,3810,3.492,14.162,868,2.431,28.324,160,164,988
2001,4831,766,1166,52384,52352,132,11.287,139,11.885,8699,2893,5806,5.526,16.617,8538,2311,6227,4.414,16.309,161,0.308,32.618,75,84,1693
2001,4832,482,530,19897,19568,52,9.774,56,10.526,3609,1151,2458,5.882,18.443,3059,861,2198,4.400,15.633,550,2.811,31.265,40,40,401
2001,4841,39385,48732,986195,987244,8734,18.076,7904,16.359,155111,59278,95833,6.004,15.712,156264,66386,89878,6.724,15.828,-1153,-0.117,31.423,5806,6009,41779
2001,4842,45373,48845,492563,499022,5806,11.772,6758,13.702,79589,25501,54088,5.110,15.949,92549,33522,59027,6.718,18.546,-12960,-2.597,31.898,5064,5095,21333
2001,4851,495,722,42178,41999,107,15.007,89,12.482,4797,2143,2654,5.103,11.422,4572,2295,2277,5.464,10.886,225,0.536,21.772,40,51,1086
2001,4852,203,402,20218,20775,57,14.504,39,9.924,2765,800,1965,3.851,13.309,3901,624,3277,3.004,18.777,-1136,-5.468,26.619,23,26,237
2001,4853,5917,6033,69499,68941,950,15.873,854,14.269,12061,4593,7468,6.662,17.495,10884,4634,6250,6.722,15.788,1177,1.707,31.575,671,672,3734
2001,4854,3057,4222,169171,165610,325,7.754,264,6.298,22168,8616,13552,5.203,13.386,14709,4125,10584,2.491,8.882,7459,4.504,17.763,189,189,2055
2001,4855,1155,1298,33538,33329,110,8.397,134,10.229,4882,1457,3425,4.372,14.648,4527,1094,3433,3.282,13.583,355,1.065,27.166,99,103,843
2001,4859,2275,2473,53117,52527,387,15.751,355,14.449,10063,3932,6131,7.486,19.158,8789,3512,5277,6.686,16.732,1274,2.425,33.465,269,269,1805
2001,4861,42,243,6290,6453,28,10.182,92,33.455,806,198,608,3.069,12.491,1160,686,474,10.632,17.978,-354,-5.486,24.983,0,0,0
2001,4862,127,2099,35654,36267,210,10.202,129,6.267,4605,1876,2729,5.173,12.697,5927,2148,3779,5.923,16.343,-1322,-3.645,25.395,4,4,14
2001,4869,56,495,6411,6485,47,9.316,66,13.082,1005,375,630,5.783,15.498,1129,384,745,5.922,17.411,-124,-1.912,30.997,(D),(D),(D)
2001,4871,395,435,8655,8529,71,16.745,49,11.557,1192,398,794,4.667,13.977,946,372,574,4.362,11.092,246,2.884,22.184,30,30,194
2001,4872,1206,1238,13071,12792,167,13.627,142,11.587,2443,576,1867,4.503,19.099,1887,651,1236,5.089,14.752,556,4.347,29.504,114,114,473
2001,4879,131,135,1941,1992,14,10.072,22,15.827,166,18,148,0.904,8.335,270,121,149,6.076,13.558,-104,-5.222,16.671,18,18,101
2001,4881,3197,4203,132713,131353,516,12.379,447,10.723,24005,8496,15509,6.468,18.275,21175,9873,11302,7.516,16.121,2830,2.154,32.241,284,289,2073
2001,4882,429,801,22883,23074,78,9.799,68,8.543,4182,1618,2564,7.012,18.125,4526,1494,3032,6.475,19.616,-344,-1.491,36.249,32,33,488
2001,4883,1707,2226,78926,79249,197,8.777,234,10.425,11888,2884,9004,3.639,15.001,12581,2688,9893,3.392,15.875,-693,-0.874,30.002,137,141,681
2001,4884,6191,6515,58351,56540,940,14.609,779,12.107,13194,4808,8386,8.504,23.336,9587,4369,5218,7.727,16.956,3607,6.380,33.912,580,582,2437
2001,4885,11056,15055,172826,170302,1829,12.309,1436,9.665,34666,13157,21509,7.726,20.356,29408,10257,19151,6.023,17.268,5258,3.087,34.536,921,973,5931
2001,4889,1004,1111,26258,26002,194,17.446,196,17.626,4225,1393,2832,5.357,16.249,3645,1231,2414,4.734,14.018,580,2.231,28.037,140,140,582
2001,4921,2554,6663,517479,534447,1106,17.059,747,11.522,32164,12838,19326,2.402,6.018,65763,8732,57031,1.634,12.305,-33599,-6.287,12.036,340,345,2289
2001,4922,4356,4790,60763,64646,707,14.723,731,15.223,9371,3621,5750,5.601,14.496,17133,5415,11718,8.376,26.503,-7762,-12.007,28.992,578,599,4667
2001,4931,6833,12594,570443,561368,1491,11.926,1308,10.462,116932,47515,69417,8.464,20.830,98132,38888,59244,6.927,17.481,18800,3.349,34.962,372,423,5034
2001,5111,15132,19637,706322,698179,2166,11.107,1894,9.712,92436,36658,55778,5.251,13.240,75226,26111,49115,3.740,10.775,17210,2.465,21.549,1348,1362,10644
2001,5112,7466,10068,366863,350869,1489,14.809,1462,14.541,94776,33823,60953,9.640,27.012,63983,28904,35079,8.238,18.236,30793,8.776,36.471,910,978,15686
2001,5121,12192,15878,265397,268759,2119,13.187,2500,15.558,56033,16979,39054,6.318,20.849,61865,22923,38942,8.529,23.019,-5832,-2.170,41.698,1252,1295,7031
2001,5122,2576,2772,22288,22894,385,13.914,375,13.553,3752,1348,2404,5.888,16.389,4996,1812,3184,7.915,21.823,-1244,-5.434,32.778,278,279,959
2001,5151,4851,8389,256975,252546,2047,25.583,1272,15.897,61531,39683,21848,15.713,24.364,50233,35172,15061,13.927,19.891,11298,4.474,39.781,611,656,7786
2001,5152,310,576,32549,32736,104,18.407,82,14.513,6968,3850,3118,11.761,21.285,7649,2439,5210,7.451,23.366,-681,-2.080,42.571,40,45,1487
2001,5171,4964,32986,1207169,1141945,9148,29.972,4220,13.826,289351,182955,106396,16.021,25.338,168937,71640,97297,6.274,14.794,120414,10.545,29.588,719,971,15119
2001,5172,2926,11209,271010,244883,3535,35.012,1310,12.975,99550,64504,35046,26.341,40.652,48653,16414,32239,6.703,19.868,50897,20.784,39.736,516,551,5128
2001,5174,428,653,20368,20564,106,16.308,100,15.385,5253,1841,3412,8.953,25.545,5682,2177,3505,10.587,27.631,-429,-2.086,51.091,57,58,592
2001,5179,6300,7578,140290,139792,1874,24.514,2007,26.254,42264,16242,26022,11.619,30.233,41068,20284,20784,14.510,29.378,1196,0.856,58.756,1637,1663,16579
2001,5182,5977,10807,413652,394682,2553,25.196,1204,11.883,100294,41401,58893,10.490,25.411,62550,19458,43092,4.930,15.848,37744,9.563,31.696,459,467,6719
2001,5191,3870,4729,89747,84906,800,17.835,313,6.978,22167,9878,12289,11.634,26.108,12565,4122,8443,4.855,14.799,9602,11.309,29.597,221,238,2790
2001,5211,15,52,22282,22443,(D),(D),(D),(D),346,(D),321,(D),1.542,656,(D),570,(D),2.923,-310,-1.381,3.083,0,0,0
2001,5221,17866,107637,2052974,1982099,11368,10.695,8672,8.159,436956,189698,247258,9.571,22.045,289312,105076,184236,5.301,14.596,147644,7.449,29.192,658,1123,14968
2001,5222,17642,44942,628679,621011,6847,15.201,7052,15.656,159939,73010,86929,11.757,25.755,143969,62571,81398,10.076,23.183,15970,2.572,46.366,2003,2297,14718
2001,5223,15346,23059,227234,218856,5180,23.584,2990,13.613,63978,28330,35648,12.945,29.233,47195,20400,26795,9.321,21.564,16783,7.669,43.129,1577,1734,10473
2001,5231,12091,37653,559602,550616,5547,14.843,4983,13.334,123138,60121,63017,10.919,22.364,102469,48258,54211,8.764,18.610,20669,3.754,37.220,1034,1164,11013
2001,5232,31,42,6292,6430,9,18.947,20,42.105,206,73,133,1.135,3.204,496,45,451,0.700,7.714,-290,-4.510,6.407,16,16,35
2001,5239,27091,30315,343027,328482,5580,18.889,4031,13.646,84937,33164,51773,10.096,25.857,54622,21366,33256,6.504,16.629,30315,9.229,33.257,2443,2466,10903
2001,5241,5203,29695,1508585,1503468,4956,15.036,11486,34.848,259691,104741,154950,6.967,17.273,245545,107164,138381,7.128,16.332,14146,0.941,32.664,372,405,4962
2001,5242,112736,124384,818912,809226,12726,10.261,11999,9.675,140984,60456,80528,7.471,17.422,121790,57289,64501,7.079,15.050,19194,2.372,30.100,8209,8482,30602
2001,5250,2746,3565,44992,41115,1106,35.752,163,5.269,13984,8526,5458,20.737,34.012,6559,2220,4339,5.399,15.953,7425,18.059,31.906,69,72,715
2001,5311,85421,98830,509040,505672,10377,10.533,9749,9.896,92771,42674,50097,8.439,18.346,86100,36194,49906,7.158,17.027,6671,1.319,34.054,7454,7630,26660
2001,5312,51498,58105,283039,278151,8598,15.010,6949,12.132,66795,30446,36349,10.946,24.014,56310,23381,32929,8.406,20.244,10485,3.770,40.489,4415,4579,13324
2001,5313,46363,53041,503217,499762,7215,13.812,5604,10.728,88485,36118,52367,7.227,17.705,81661,31750,49911,6.353,16.340,6824,1.365,32.680,3625,3713,17324
2001,5321,4448,11060,187847,183051,1891,17.613,1244,11.587,36569,16679,19890,9.112,19.978,26684,7946,18738,4.341,14.577,9885,5.400,29.155,500,555,3001
2001,5322,13844,30097,251550,251811,2669,8.775,3307,10.873,43351,15319,28032,6.084,17.216,44457,17393,27064,6.907,17.655,-1106,-0.439,34.431,2007,2177,9176
2001,5323,3370,5858,39071,39283,442,7.568,406,6.952,5254,1861,3393,4.737,13.375,5600,2082,3518,5.300,14.256,-346,-0.881,26.750,253,283,1448
2001,5324,7123,11825,163298,161548,1600,13.716,1280,10.973,34054,12927,21127,8.002,21.080,30458,12914,17544,7.994,18.854,3596,2.226,37.708,716,748,5220
2001,5331,1737,1857,22692,22266,228,12.222,245,13.133,4646,1800,2846,8.084,20.866,3829,1728,2101,7.761,17.197,817,3.669,34.393,167,170,906
2001,5411,153895,161558,1110954,1101628,13561,8.383,13969,8.636,146003,43345,102658,3.935,13.253,127005,46219,80786,4.196,11.529,18998,1.725,23.058,9935,10108,32888
2001,5412,86331,93652,1187200,1163555,9362,10.039,8568,9.188,234278,65686,168592,5.645,20.135,188946,54912,134034,4.719,16.239,45332,3.896,32.477,5667,5740,27773
2001,5413,83634,94762,1300615,1272486,10681,11.412,8349,8.920,218979,62566,156413,4.917,17.209,162956,51823,111133,4.073,12.806,56023,4.403,25.612,5466,5535,25553
2001,5414,24923,25183,143618,141378,3888,15.678,3121,12.585,30674,10362,20312,7.329,21.697,25950,11266,14684,7.969,18.355,4724,3.341,36.710,2365,2367,8093
2001,5415,76879,86545,1262507,1223493,19141,22.588,15527,18.324,361408,139645,221763,11.414,29.539,283021,115179,167842,9.414,23.132,78387,6.407,46.264,10784,10874,63841
2001,5416,71486,76497,683302,657506,16815,22.816,11219,15.223,192441,89099,103342,13.551,29.268,141460,62447,79013,9.498,21.515,50981,7.754,43.029,8091,8173,36517
2001,5417,10303,13325,619033,598068,2064,15.917,1349,10.403,138229,45637,92592,7.631,23.113,95859,29675,66184,4.962,16.028,42370,7.084,32.056,767,783,8972
2001,5418,31892,35424,477762,481186,4173,11.760,4295,12.104,84691,29670,55021,6.166,17.600,91664,33592,58072,6.981,19.050,-6973,-1.449,35.201,3007,3053,17216
2001,5419,46724,53897,491195,482294,6659,12.557,4927,9.291,92292,34280,58012,7.108,19.136,73318,23424,49894,4.857,15.202,18974,3.934,30.404,2750,2760,10903
2001,5511,28118,52274,3284061,3295647,5658,10.804,5852,11.174,583607,195600,388007,5.935,17.708,607962,186797,421165,5.668,18.447,-24355,-0.739,35.417,1308,1351,24377
2001,5611,20207,22183,442432,435486,3827,17.449,3327,15.169,102379,44798,57581,10.287,23.509,89110,40367,48743,9.269,20.462,13269,3.047,40.924,2121,2138,23926
2001,5612,1527,3340,132399,131051,539,16.802,275,8.572,20822,8318,12504,6.347,15.889,18159,7000,11159,5.341,13.856,2663,2.032,27.713,85,91,2439
2001,5613,27455,47366,4240931,4394000,7671,16.562,5572,12.030,1084211,337996,746215,7.692,24.675,1401547,399201,1002346,9.085,31.897,-317336,-7.222,49.350,2968,3097,125542
2001,5614,25184,30564,731375,720445,4073,13.362,3909,12.824,176622,62169,114453,8.629,24.516,153996,54212,99784,7.525,21.375,22626,3.141,42.750,2750,2841,21957
2001,5615,21390,29302,306060,305797,2278,7.621,3460,11.575,46448,13808,32640,4.515,15.189,46161,17257,28904,5.643,15.095,287,0.094,30.191,2440,2488,10651
2001,5616,15895,20229,717965,713854,2589,12.850,2427,12.046,125038,42428,82610,5.944,17.516,115836,51510,64326,7.216,16.227,9202,1.289,32.454,1587,1657,20598
2001,5617,120156,126553,1580254,1540953,18489,15.085,10509,8.574,346488,117031,229457,7.595,22.485,264810,84377,180433,5.476,17.185,81678,5.300,34.370,7731,7757,38756
2001,5619,19531,21787,469800,467500,2436,11.144,2580,11.803,83692,21003,62689,4.493,17.902,79034,22220,56814,4.753,16.906,4658,0.996,33.811,1870,1913,12359
2001,5621,5952,7466,153842,154013,929,12.633,705,9.587,26266,11044,15222,7.171,17.054,26749,10850,15899,7.045,17.368,-483,-0.314,34.109,473,477,3474
2001,5622,1453,2419,53242,52849,313,13.047,273,11.380,9690,4451,5239,8.422,18.335,9015,3602,5413,6.816,17.058,675,1.277,34.116,135,137,986
2001,5629,5662,6285,99666,98408,810,13.132,576,9.339,19760,6071,13689,6.169,20.080,17151,5481,11670,5.570,17.428,2609,2.651,34.857,394,403,3947
2001,6111,16016,18199,718742,701023,999,5.641,19,0.107,67049,13654,53395,1.948,9.564,31698,71,31627,0.010,4.522,35351,5.043,9.043,4,4,14
2001,6112,527,808,81834,79268,60,7.707,(D),(D),8610,975,7635,1.230,10.862,3475,(D),3474,(D),4.384,5135,6.478,8.768,0,0,0
2001,6113,2193,2850,1263428,1251859,159,5.735,4,0.144,75252,4383,70869,0.350,6.011,51307,22,51285,0.002,4.098,23945,1.913,8.197,0,0,0
2001,6114,5605,6153,64163,63533,1010,16.598,874,14.363,15347,6439,8908,10.135,24.156,13959,5527,8432,8.699,21.971,1388,2.185,43.943,613,624,3380
2001,6115,5274,6228,85277,82088,689,11.125,619,9.995,18460,6662,11798,8.116,22.488,12209,5378,6831,6.552,14.873,6251,7.615,29.746,449,460,3648
2001,6116,21601,23593,211342,204683,3401,14.718,2430,10.516,46156,15943,30213,7.789,22.550,32665,11447,21218,5.593,15.959,13491,6.591,31.918,1754,1778,7881
2001,6117,3346,3643,43926,41627,594,16.662,438,12.286,10416,3496,6920,8.398,25.023,5803,2424,3379,5.823,13.941,4613,11.082,27.881,334,334,1759
2001,6211,160027,180126,1820821,1788083,15513,8.642,14274,7.952,293911,96411,197500,5.392,16.437,228231,93858,134373,5.249,12.764,65680,3.673,25.528,9275,9640,47277
2001,6212,106657,110836,727412,716987,5252,4.748,4804,4.343,98652,24999,73653,3.487,13.759,78084,22219,55865,3.099,10.891,20568,2.869,21.781,3609,3692,16919
2001,6213,81032,87090,444726,432522,9875,11.525,7055,8.234,91756,38013,53743,8.789,21.214,67404,27290,40114,6.310,15.584,24352,5.630,31.168,4844,4942,15715
2001,6214,10719,22684,569900,558246,2551,11.480,1627,7.322,87897,31560,56337,5.653,15.745,64457,21915,42542,3.926,11.546,23440,4.199,23.093,603,656,7556
2001,6215,5726,10136,168785,160402,2419,25.746,938,9.984,42071,18840,23231,11.745,26.228,24750,12981,11769,8.093,15.430,17321,10.798,30.860,470,495,3515
2001,6216,10248,15225,766689,776754,2205,14.639,1880,12.481,124043,33436,90607,4.305,15.969,144936,44482,100454,5.727,18.659,-20893,-2.690,31.939,997,1086,21907
2001,6219,4542,7134,182223,182966,1090,15.848,578,8.404,31656,10697,20959,5.846,17.302,33610,11921,21689,6.515,18.370,-1954,-1.068,34.603,317,343,4481
2001,6221,3350,5376,4624955,4597123,132,2.439,202,3.733,250351,52593,197758,1.144,5.446,195869,65642,130227,1.428,4.261,54482,1.185,8.521,56,56,20625
2001,6222,504,665,234794,235018,38,5.356,127,17.900,11203,4405,6798,1.874,4.767,11243,8287,2956,3.526,4.784,-40,-0.017,9.534,15,15,883
2001,6223,295,505,159713,152918,104,22.011,39,8.254,21782,14200,7582,9.286,14.244,8336,1997,6339,1.306,5.451,13446,8.793,10.903,14,19,725
2001,6231,7945,15633,1537232,1525327,1272,8.132,1291,8.253,180282,77007,103275,5.049,11.819,157036,64553,92483,4.232,10.295,23246,1.524,20.590,477,554,26645
2001,6232,7319,24002,416400,407483,2874,12.431,1108,4.793,68046,25974,42072,6.374,16.699,50374,13466,36908,3.305,12.362,17672,4.337,24.724,375,431,4733
2001,6233,12511,16773,534485,522369,1969,11.844,1673,10.063,82061,31725,50336,6.073,15.709,57690,26610,31080,5.094,11.044,24371,4.665,22.088,1082,1147,17075
2001,6239,3307,5907,149507,147488,521,8.879,443,7.549,20286,6057,14229,4.107,13.754,16222,4823,11399,3.270,10.999,4064,2.755,21.998,206,229,2053
2001,6241,29857,43426,805870,787634,4058,9.480,2814,6.574,120700,32080,88620,4.073,15.324,84304,21303,63001,2.705,10.703,36396,4.621,21.407,1591,1644,10845
2001,6242,7808,9949,121453,118992,579,5.846,489,4.937,15950,3649,12301,3.067,13.404,10962,2542,8420,2.136,9.212,4988,4.192,18.425,286,294,1237
2001,6243,4944,7713,306918,305841,558,7.221,587,7.596,42178,7134,35044,2.333,13.791,39980,8027,31953,2.625,13.072,2198,0.719,26.144,267,322,2700
2001,6244,47924,60592,735129,715071,6987,11.623,6032,10.034,130922,43107,87815,6.028,18.309,90138,35844,54294,5.013,12.605,40784,5.703,25.211,4244,4328,24445
2001,7111,7312,7395,118424,117191,987,13.408,920,12.497,24476,6383,18093,5.447,20.886,21951,6949,15002,5.930,18.731,2525,2.155,37.462,627,627,4138
2001,7112,3353,3508,103935,101280,510,14.518,520,14.802,19834,7673,12161,7.576,19.583,14813,4359,10454,4.304,14.626,5021,4.958,29.252,397,400,2375
2001,7113,3470,3656,78591,76887,542,15.047,434,12.049,15778,7145,8633,9.293,20.521,12382,3538,8844,4.602,16.104,3396,4.417,32.209,284,286,1952
2001,7114,2490,2547,15791,15891,397,15.814,324,12.906,3024,1225,1799,7.709,19.030,3254,1312,1942,8.256,20.477,-230,-1.447,38.059,235,235,848
2001,7115,9356,9381,40186,40322,1811,19.627,1503,16.289,12812,6895,5917,17.100,31.774,13076,5131,7945,12.725,32.429,-264,-0.655,63.548,924,924,2835
2001,7121,4853,5268,107362,105830,327,6.254,249,4.762,10557,1760,8797,1.663,9.975,7611,1745,5866,1.649,7.192,2946,2.784,14.383,154,154,1103
2001,7131,1585,2337,120136,122768,278,11.747,337,14.240,9634,3285,6349,2.676,7.847,14559,2934,11625,2.390,11.859,-4925,-4.012,15.695,219,239,2076
2001,7132,1564,1932,193443,190321,189,9.567,276,13.971,23387,5026,18361,2.641,12.288,17470,4650,12820,2.443,9.179,5917,3.109,18.358,207,210,3076
2001,7139,44861,49462,965447,957569,4997,10.140,4635,9.405,146952,47734,99218,4.985,15.346,131714,46283,85431,4.833,13.755,15238,1.591,27.510,3415,3456,31624
2001,7211,35272,45239,1703768,1716626,4734,10.541,4073,9.070,215564,91408,124156,5.325,12.557,243625,102509,141116,5.972,14.192,-28061,-1.635,25.115,2508,2593,42349
2001,7212,5077,5512,38502,38614,488,8.895,436,7.948,5662,1487,4175,3.851,14.663,5868,1659,4209,4.296,15.197,-206,-0.533,29.327,303,309,1106
2001,7213,2647,2695,14651,14721,162,5.899,264,9.614,2173,659,1514,4.477,14.761,2278,672,1606,4.565,15.474,-105,-0.713,29.522,181,183,435
2001,7223,10613,25361,520160,511845,3294,13.173,2583,10.330,86735,39430,47305,7.704,16.946,69857,30517,39340,5.962,13.648,16878,3.297,27.296,1244,1258,8428
2001,7224,44029,44521,332024,330193,5009,11.150,5817,12.948,69205,32450,36755,9.828,20.959,65311,28555,36756,8.648,19.780,3894,1.179,39.559,4542,4554,22099
2001,7225,265383,367900,7377793,7349688,43599,11.903,40375,11.023,1272904,630844,642060,8.583,17.319,1219027,462281,756746,6.290,16.586,53877,0.733,33.172,26938,28617,289874
2001,8111,138219,150780,882162,876664,15172,10.062,15170,10.061,151755,57917,93838,6.607,17.311,141249,55746,85503,6.359,16.112,10506,1.198,32.224,10913,11111,38870
2001,8112,11936,13721,139772,141356,1375,9.815,1950,13.920,24267,8749,15518,6.189,17.167,27275,12967,14308,9.173,19.295,-3008,-2.128,34.335,1371,1385,6674
2001,8113,20975,22529,197143,197445,1984,8.782,2109,9.335,30827,9043,21784,4.580,15.613,31063,9969,21094,5.049,15.733,-236,-0.120,31.226,1448,1465,6370
2001,8114,22792,23988,131243,134915,2561,10.548,3145,12.953,20238,8312,11926,6.161,15.001,27577,9558,18019,7.084,20.440,-7339,-5.440,30.001,2440,2453,6997
2001,8121,74307,86279,514115,507765,11200,13.051,10281,11.980,101683,47117,54566,9.279,20.026,89563,38637,50926,7.609,17.639,12120,2.387,35.277,7600,7803,26591
2001,8122,14861,21115,165715,164209,891,4.190,1187,5.582,18502,4568,13934,2.782,11.267,15561,5130,10431,3.124,9.476,2941,1.791,18.953,588,626,2358
2001,8123,32421,38773,384113,387324,3461,8.843,4193,10.713,48601,18096,30505,4.672,12.548,55080,21258,33822,5.488,14.221,-6479,-1.673,25.096,3107,3255,15481
2001,8129,18591,29004,236043,229601,3689,12.777,3427,11.869,52658,16693,35965,7.270,22.935,40068,18224,21844,7.937,17.451,12590,5.483,34.902,1952,2025,8931
2001,8131,155321,155448,1537599,1508062,7557,4.980,178,0.117,164817,27573,137244,1.828,10.929,105477,523,104954,0.035,6.994,59340,3.935,13.988,20,20,37
2001,8132,10333,12279,128804,127093,1138,9.449,668,5.546,17097,3989,13108,3.139,13.452,13738,3539,10199,2.785,10.809,3359,2.643,21.619,454,456,2097
2001,8133,8609,10529,104974,102389,1095,10.639,621,6.034,15418,3718,11700,3.631,15.058,10349,2984,7365,2.914,10.108,5069,4.951,20.215,382,385,2006
2001,8134,26676,28548,317081,314439,1199,4.177,1512,5.267,35915,5118,30797,1.628,11.422,30518,5544,24974,1.763,9.706,5397,1.716,19.411,992,996,3408
2001,8139,60463,62516,507394,508494,2817,4.514,2583,4.139,56760,10326,46434,2.031,11.162,58793,9652,49141,1.898,11.562,-2033,-0.400,22.325,1772,1786,6343
2002,2111,5790,7066,84396,84947,692,9.781,710,10.035,18150,6921,11229,8.147,21.366,19388,9653,9735,11.364,22.824,-1238,-1.457,42.733,378,386,3777
2002,2121,740,1134,77635,75731,146,12.920,138,12.212,13812,5094,8718,6.726,18.238,10022,2807,7215,3.707,13.234,3790,5.005,26.468,70,72,1586
2002,2122,232,314,26023,29219,35,10.160,96,27.866,997,244,753,0.835,3.412,7538,2205,5333,7.547,25.799,-6541,-22.387,6.824,45,45,161
2002,2123,3325,5412,96738,99499,470,8.628,541,9.931,15100,4800,10300,4.824,15.176,20357,6887,13470,6.922,20.460,-5257,-5.283,30.352,242,243,2229
2002,2131,6861,8427,195138,199535,1296,15.697,955,11.567,35951,18070,17881,9.056,18.017,45925,15373,30552,7.704,23.016,-9974,-4.999,36.035,551,557,4685
2002,2211,1534,9534,531750,530204,789,8.467,358,3.842,59645,30659,28986,5.782,11.249,56808,13413,43395,2.530,10.714,2837,0.535,21.429,87,94,1283
2002,2212,498,2515,89433,93494,154,6.017,243,9.494,7032,2667,4365,2.853,7.521,15195,4315,10880,4.615,16.252,-8163,-8.731,15.043,38,41,217
2002,2213,4530,5285,43467,42374,334,6.321,332,6.283,7574,3148,4426,7.429,17.874,5503,2209,3294,5.213,12.987,2071,4.887,25.974,215,215,1339
2002,2361,137745,138630,771735,767800,22460,16.355,19864,14.464,184981,76880,108101,10.013,24.092,176559,66771,109788,8.696,22.995,8422,1.097,45.991,12614,12616,45109
2002,2362,38492,39414,730650,751855,4077,10.270,4642,11.694,134227,35635,98592,4.740,17.853,176904,42092,134812,5.598,23.529,-42677,-5.676,35.706,3184,3244,25428
2002,2371,18983,19735,516731,527742,1913,9.748,1693,8.627,99323,28456,70867,5.392,18.820,122522,26040,96482,4.934,23.216,-23199,-4.396,37.641,1077,1081,13236
2002,2372,10310,10457,71496,71417,1765,16.966,1657,15.928,17083,7016,10067,9.824,23.920,17021,7227,9794,10.120,23.833,62,0.087,47.667,1208,1225,5539
2002,2373,10363,10905,317135,316772,924,8.366,1204,10.901,64244,15587,48657,4.921,20.281,63900,15849,48051,5.003,20.172,344,0.109,40.344,687,688,8421
2002,2379,4330,4498,86478,85142,575,12.535,753,16.416,19835,5676,14159,6.667,23.296,17132,3940,13192,4.628,20.122,2703,3.175,40.243,514,514,2223
2002,2381,90321,90850,964478,974189,12478,13.673,13302,14.576,212411,66918,145493,6.869,21.804,231849,63945,167904,6.564,23.799,-19438,-1.995,43.608,8604,8610,44815
2002,2382,141845,145152,1757203,1794120,15011,10.364,14385,9.932,301209,88797,212412,4.949,16.789,375616,97344,278272,5.426,20.936,-74407,-4.147,33.577,10213,10218,66750
2002,2383,94888,95785,804083,809707,15051,15.794,14076,14.771,181554,61559,119995,7.603,22.422,192010,58330,133680,7.204,23.714,-10456,-1.291,44.844,9623,9632,42458
2002,2389,46677,47096,428146,433891,6166,12.858,7886,16.444,90069,28609,61460,6.594,20.758,102192,34998,67194,8.066,23.552,-12123,-2.794,41.517,5148,5152,23940
2002,3111,1142,1738,46827,48089,133,7.670,125,7.209,5664,2484,3180,5.165,11.778,8333,2651,5682,5.513,17.328,-2669,-5.550,23.557,66,66,1239
2002,3112,474,806,56411,57478,35,4.253,69,8.384,4491,1425,3066,2.479,7.813,6586,2210,4376,3.845,11.458,-2095,-3.645,15.627,28,29,595
2002,3113,1537,1723,82374,84988,154,8.904,167,9.656,7364,2665,4699,3.136,8.665,12767,3931,8836,4.625,15.022,-5403,-6.357,17.330,122,122,2521
2002,3114,1279,1671,165468,169061,114,6.782,134,7.971,18034,6439,11595,3.809,10.667,25404,9596,15808,5.676,15.027,-7370,-4.359,21.334,91,93,4782
2002,3115,1082,1589,132084,132380,102,6.357,133,8.289,11783,3300,8483,2.493,8.901,12302,3633,8669,2.744,9.293,-519,-0.392,17.802,76,78,1061
2002,3116,3099,3731,496177,495940,231,6.162,266,7.096,44332,11892,32440,2.398,8.939,43906,13314,30592,2.685,8.853,426,0.086,17.706,181,183,6751
2002,3117,574,673,39046,39699,47,6.758,92,13.228,5475,1777,3698,4.476,13.791,6743,2498,4245,6.292,16.986,-1268,-3.194,27.583,60,61,1575
2002,3118,9628,10639,306556,310290,1147,10.791,1128,10.612,38546,14199,24347,4.576,12.423,45708,15357,30351,4.949,14.731,-7162,-2.308,24.845,835,841,7432
2002,3119,2445,2860,156728,153616,267,9.375,243,8.532,24720,5910,18810,3.847,16.092,18859,7297,11562,4.750,12.277,5861,3.815,24.554,165,167,3036
2002,3121,2168,2643,137581,140864,276,10.472,261,9.903,16188,3669,12519,2.605,11.492,22833,6626,16207,4.704,16.209,-6645,-4.717,22.984,169,173,3715
2002,3122,78,104,23415,23810,7,6.167,26,22.907,1559,39,1520,0.164,6.548,2228,1610,618,6.762,9.357,-669,-2.810,13.095,13,13,78
2002,3131,359,552,65333,69936,41,7.124,88,15.291,5047,2080,2967,2.974,7.217,14145,5752,8393,8.225,20.226,-9098,-13.009,14.433,35,38,1502
2002,3132,1436,1687,141803,154924,119,6.800,245,14.000,9710,3124,6586,2.016,6.268,35397,14494,20903,9.356,22.848,-25687,-16.580,12.535,155,168,7562
2002,3133,1388,1488,61313,67147,122,7.707,312,19.709,5505,2609,2896,3.886,8.198,16917,7698,9219,11.464,25.194,-11412,-16.996,16.397,234,241,5183
2002,3141,2602,2802,103033,107240,197,6.887,314,10.977,8300,3422,4878,3.191,7.740,16777,4994,11783,4.657,15.644,-8477,-7.905,15.479,243,249,2690
2002,3149,4558,4706,89260,94436,474,10.036,508,10.756,11036,4820,6216,5.104,11.686,21303,7208,14095,7.633,22.558,-10267,-10.872,23.372,396,398,5251
2002,3151,740,803,52914,59749,50,5.824,161,18.754,3879,1718,2161,2.875,6.492,17426,6775,10651,11.339,29.166,-13547,-22.673,12.984,130,133,4058
2002,3152,8311,8630,243360,274857,1377,15.256,2169,24.031,36946,20010,16936,7.280,13.442,100332,49550,50782,18.028,36.503,-63386,-23.061,26.884,1792,1811,30982
2002,3159,1215,1253,28089,32021,116,8.699,277,20.772,3562,1329,2233,4.150,11.124,11386,5698,5688,17.795,35.558,-7824,-24.434,22.248,218,221,2597
2002,3161,230,241,9195,10236,25,10.000,43,17.200,643,202,441,1.974,6.282,2726,997,1729,9.741,26.633,-2083,-20.351,12.564,31,32,702
2002,3162,296,328,20056,22457,33,9.749,54,15.953,1129,347,782,1.545,5.027,5752,2589,3163,11.529,25.614,-4623,-20.586,10.055,38,38,448
2002,3169,822,838,17075,18300,86,9.919,144,16.609,1890,772,1118,4.219,10.328,4313,1350,2963,7.377,23.569,-2423,-13.241,20.656,102,102,800
2002,3211,3590,4052,113716,117258,292,7.042,481,11.600,10780,3819,6961,3.257,9.193,17769,6488,11281,5.533,15.154,-6989,-5.960,18.387,343,347,3732
2002,3212,1476,1875,113014,115487,111,5.887,132,7.001,9887,2650,7237,2.295,8.561,14752,4945,9807,4.282,12.774,-4865,-4.213,17.122,92,99,2569
2002,3219,9496,10309,312557,321237,949,9.130,1119,10.766,36717,12386,24331,3.856,11.430,54182,17827,36355,5.549,16.867,-17465,-5.437,22.860,805,816,9075
2002,3221,285,581,165120,173326,41,6.937,61,10.321,6135,3203,2932,1.848,3.540,22852,8006,14846,4.619,13.184,-16717,-9.645,7.079,34,36,3194
2002,3222,3226,4850,338887,353231,202,4.092,374,7.577,22309,6522,15787,1.846,6.316,51335,16923,34412,4.791,14.533,-29026,-8.217,12.631,208,210,5998
2002,3231,33662,35448,720776,759106,2144,5.935,3496,9.678,57209,21056,36153,2.774,7.536,133888,42798,91090,5.638,17.638,-76679,-10.101,15.073,2750,2771,26371
2002,3241,1036,2163,96412,100130,162,7.495,159,7.356,8132,2728,5404,2.724,8.121,15635,7906,7729,7.896,15.615,-7503,-7.493,16.243,52,53,2557
2002,3251,1164,2316,182494,189760,97,4.116,178,7.554,8918,2139,6779,1.127,4.700,23302,5760,17542,3.035,12.280,-14384,-7.580,9.399,70,72,1028
2002,3252,608,929,101588,108281,48,5.093,75,7.958,4796,1972,2824,1.821,4.429,18015,4099,13916,3.786,16.637,-13219,-12.208,8.858,36,38,1536
2002,3253,651,907,30809,31680,104,11.601,83,9.258,3253,1351,1902,4.265,10.268,4992,1436,3556,4.533,15.758,-1739,-5.489,20.537,43,43,344
2002,3254,1362,1747,243117,240672,133,7.593,142,8.107,31220,4326,26894,1.797,12.972,25895,5960,19935,2.476,10.759,5325,2.213,21.519,86,86,1989
2002,3255,1517,1943,70272,71823,133,6.727,201,10.167,7614,3619,3995,5.039,10.601,10694,3730,6964,5.193,14.889,-3080,-4.288,21.202,121,126,1715
2002,3256,2028,2293,112342,118172,195,8.465,216,9.377,11251,5240,6011,4.434,9.521,22885,8723,14162,7.382,19.366,-11634,-9.845,19.042,139,139,3188
2002,3259,2168,2795,113065,116708,195,6.936,228,8.110,8916,2461,6455,2.109,7.640,16374,4665,11709,3.997,14.030,-7458,-6.390,15.279,115,116,1351
2002,3261,9995,12608,756470,785694,762,5.971,1069,8.377,71555,27117,44438,3.451,9.107,130218,39685,90533,5.051,16.574,-58663,-7.466,18.214,673,695,19089
2002,3262,1838,2371,176453,185592,144,5.974,223,9.251,11103,3842,7261,2.070,5.982,29492,9103,20389,4.905,15.891,-18389,-9.908,11.965,129,130,2373
2002,3271,1302,1520,61607,67449,110,7.022,203,12.959,4223,912,3311,1.352,6.261,15600,5897,9703,8.743,23.129,-11377,-16.868,12.522,136,147,4074
2002,3272,1793,2105,115084,121769,167,7.846,214,10.054,6476,1906,4570,1.565,5.318,20118,3919,16199,3.218,16.522,-13642,-11.203,10.637,153,154,1823
2002,3273,5096,9072,204647,213247,616,6.775,657,7.226,24962,7882,17080,3.696,11.706,42563,11202,31361,5.253,19.959,-17601,-8.254,23.411,327,339,6084
2002,3274,231,356,17005,17740,24,6.630,36,9.945,905,239,666,1.347,5.102,2364,627,1737,3.534,13.326,-1459,-8.225,10.203,15,20,195
2002,3279,2362,2761,73320,74550,267,9.791,199,7.297,8918,3216,5702,4.314,11.962,11455,3098,8357,4.156,15.366,-2537,-3.403,23.925,123,126,1194
2002,3311,320,427,124277,133707,43,9.188,125,26.709,4673,1565,3108,1.170,3.495,23067,8648,14419,6.468,17.252,-18394,-13.757,6.990,97,97,1948
2002,3312,487,643,50525,53618,57,8.591,98,14.770,4267,1691,2576,3.154,7.958,10238,4732,5506,8.825,19.094,-5971,-11.136,15.916,66,70,1889
2002,3313,421,577,70870,75568,44,7.464,69,11.705,4295,1900,2395,2.514,5.684,13512,3911,9601,5.175,17.881,-9217,-12.197,11.367,36,36,1243
2002,3314,761,972,67526,72151,78,8.045,73,7.530,3230,1316,1914,1.824,4.477,12462,2052,10410,2.844,17.272,-9232,-12.795,8.954,45,48,991
2002,3315,2122,2418,181411,194202,101,4.078,219,8.841,9600,3672,5928,1.891,4.943,35464,9864,25600,5.079,18.261,-25864,-13.318,9.887,146,154,4073
2002,3321,2545,2800,127347,137937,132,4.664,192,6.784,8499,3798,4701,2.753,6.162,29810,7418,22392,5.378,21.611,-21311,-15.450,12.323,125,129,4875
2002,3322,1336,1472,61407,65342,81,5.438,116,7.788,4015,1391,2624,2.129,6.145,11737,3010,8727,4.607,17.963,-7722,-11.818,12.289,72,72,1020
2002,3323,12016,12937,380322,401188,912,7.049,914,7.064,40243,12049,28194,3.003,10.031,81796,25213,56583,6.285,20.388,-41553,-10.357,20.062,617,631,15562
2002,3324,1271,1571,92523,97298,63,3.909,144,8.936,6513,1396,5117,1.435,6.694,15954,5080,10874,5.221,16.397,-9441,-9.703,13.388,76,79,1674
2002,3325,767,855,59750,62002,52,5.994,77,8.876,7342,4717,2625,7.608,11.842,11947,4809,7138,7.756,19.269,-4605,-7.427,23.683,44,45,1561
2002,3326,1744,1925,60616,64023,131,6.788,141,7.306,4925,1751,3174,2.735,7.693,11633,3141,8492,4.906,18.170,-6708,-10.477,15.385,93,94,1451
2002,3327,24369,24832,372775,398767,1526,6.045,2347,9.298,33901,11112,22789,2.787,8.501,85699,20907,64792,5.243,21.491,-51798,-12.990,17.003,1705,1709,12702
2002,3328,5511,6078,139451,148920,329,5.339,498,8.081,13278,5041,8237,3.385,8.916,32260,7139,25121,4.794,21.663,-18982,-12.746,17.832,336,338,4082
2002,3329,5894,6459,282968,298463,461,7.058,607,9.293,23017,8937,14080,2.994,7.712,53872,17092,36780,5.727,18.050,-30855,-10.338,15.424,427,436,7289
2002,3331,2521,2839,180293,187327,181,6.299,250,8.700,14439,5463,8976,2.916,7.708,28445,7156,21289,3.820,15.185,-14006,-7.477,15.416,153,154,3027
2002,3332,3923,4168,153665,170159,240,5.610,460,10.753,13843,5784,8059,3.399,8.135,46932,12845,34087,7.549,27.581,-33089,-19.446,16.271,327,328,5617
2002,3333,2117,2292,112560,118502,151,6.510,206,8.881,8612,2344,6268,1.978,7.267,20443,5624,14819,4.746,17.251,-11831,-9.984,14.535,138,138,1933
2002,3334,1463,1791,161573,174093,125,6.941,145,8.051,10372,4136,6236,2.376,5.958,35768,7564,28204,4.345,20.545,-25396,-14.588,11.916,86,86,3073
2002,3335,8411,8793,192040,209344,395,4.376,863,9.560,14363,5733,8630,2.739,6.861,49125,10825,38300,5.171,23.466,-34762,-16.605,13.722,632,633,6446
2002,3336,730,899,99211,102855,49,5.426,57,6.312,6711,1640,5071,1.594,6.525,14049,2353,11696,2.288,13.659,-7338,-7.134,13.049,32,33,550
2002,3339,5656,6382,298664,320697,363,5.601,561,8.656,21176,6852,14324,2.137,6.603,65084,14167,50917,4.418,20.295,-43908,-13.691,13.206,376,378,5194
2002,3341,1343,1428,149458,172677,112,7.434,269,17.856,20580,3267,17313,1.892,11.918,66208,28401,37807,16.447,38.342,-45628,-26.424,23.836,175,179,11894
2002,3342,1699,1940,197959,231710,179,9.022,267,13.458,21819,7528,14291,3.249,9.417,90466,22428,68038,9.679,39.043,-68647,-29.626,18.833,171,173,7359
2002,3343,504,529,25326,26643,50,9.225,76,14.022,2221,890,1331,3.341,8.336,4927,1286,3641,4.827,18.493,-2706,-10.157,16.673,57,57,830
2002,3344,4545,5209,440250,518715,363,6.770,668,12.459,31617,11995,19622,2.312,6.095,188562,48825,139737,9.413,36.352,-156945,-30.256,12.191,417,422,14605
2002,3345,4410,5078,425340,450315,338,6.576,462,8.988,42978,17943,25035,3.985,9.544,93145,24617,68528,5.467,20.684,-50167,-11.140,19.088,275,277,6827
2002,3346,803,861,36768,38168,80,8.969,142,15.919,4410,1376,3034,3.605,11.554,7211,2401,4810,6.291,18.893,-2801,-7.339,23.109,100,109,1320
2002,3351,1079,1186,66011,70075,76,6.302,116,9.619,3714,2204,1510,3.145,5.300,11728,2953,8775,4.214,16.736,-8014,-11.436,10.600,89,90,1356
2002,3352,246,314,95217,96353,33,10.662,24,7.754,6961,1509,5452,1.566,7.225,9131,600,8531,0.623,9.477,-2170,-2.252,14.449,14,14,348
2002,3353,2087,2470,160545,174407,161,6.378,270,10.695,10851,5174,5677,2.967,6.222,38399,12211,26188,7.001,22.017,-27548,-15.795,12.443,147,149,5678
2002,3359,1897,2266,175672,194324,166,7.217,234,10.174,9576,3908,5668,2.011,4.928,46758,9892,36866,5.090,24.062,-37182,-19.134,9.856,128,130,3167
2002,3361,282,348,208545,210001,37,10.803,26,7.591,12706,1543,11163,0.735,6.050,14846,625,14221,0.298,7.069,-2140,-1.019,12.101,20,20,604
2002,3362,1823,2058,122797,129873,155,7.493,176,8.509,11364,3425,7939,2.637,8.750,25427,8549,16878,6.583,19.578,-14063,-10.828,17.500,125,127,3338
2002,3363,4392,5555,681674,724729,371,6.608,490,8.727,55326,22593,32733,3.117,7.634,140144,28714,111430,3.962,19.337,-84818,-11.703,15.268,308,324,11007
2002,3364,1182,1506,363663,387468,104,6.822,141,9.249,22744,6917,15827,1.785,5.870,71427,12502,58925,3.227,18.434,-48683,-12.564,11.740,95,95,4763
2002,3365,140,201,28507,32139,11,5.288,25,12.019,2076,471,1605,1.466,6.459,9063,1755,7308,5.461,28.199,-6987,-21.740,12.919,11,12,816
2002,3366,1508,1624,133883,136055,146,8.848,198,12.000,11226,2178,9048,1.601,8.251,15707,3990,11717,2.933,11.545,-4481,-3.294,16.502,143,147,2587
2002,3369,678,708,37021,38153,73,10.203,88,12.299,3529,1215,2314,3.185,9.250,5783,1353,4430,3.546,15.158,-2254,-5.908,18.499,74,74,1157
2002,3371,15071,15649,388729,400434,1502,9.608,1471,9.409,42492,13693,28799,3.420,10.611,65944,22541,43403,5.629,16.468,-23452,-5.857,21.223,1053,1057,12945
2002,3372,3937,4154,163660,174740,231,5.473,365,8.647,13436,4566,8870,2.613,7.689,35556,7439,28117,4.257,20.348,-22120,-12.659,15.378,262,263,4275
2002,3379,947,1074,46883,47783,73,6.766,83,7.692,4655,1539,3116,3.221,9.742,6550,2421,4129,5.067,13.708,-1895,-3.966,19.484,59,64,898
2002,3391,10563,11279,301258,304655,826,7.305,882,7.800,36139,10858,25281,3.564,11.862,42803,14259,28544,4.680,14.050,-6664,-2.187,23.725,633,635,6890
2002,3399,18186,18709,412134,430918,1586,8.404,1911,10.126,43210,13456,29754,3.123,10.027,81096,20416,60680,4.738,18.819,-37886,-8.792,20.055,1410,1423,11604
2002,4231,18021,24549,357027,361097,2454,9.992,2476,10.081,54025,20235,33790,5.604,14.961,61862,21521,40341,5.960,17.132,-7837,-2.170,29.923,1497,1602,11319
2002,4232,11166,12719,160176,164782,1421,11.225,1302,10.285,23606,9693,13913,5.882,14.326,32693,10549,22144,6.402,19.840,-9087,-5.515,28.651,895,915,7670
2002,4233,11303,16456,224145,226027,1661,10.087,1683,10.220,35375,13942,21433,6.168,15.651,39012,14720,24292,6.513,17.260,-3637,-1.609,31.302,791,1048,8353
2002,4234,26566,33858,695006,725432,3771,10.856,5526,15.909,122401,46384,76017,6.394,16.873,181163,78318,102845,10.796,24.973,-58762,-8.100,33.746,2992,3330,43200
2002,4235,7511,10226,146763,153218,734,7.096,971,9.387,16488,6241,10247,4.073,10.761,29437,8751,20686,5.711,19.212,-12949,-8.451,21.522,503,524,3845
2002,4236,20524,30916,498928,522887,2932,9.314,4056,12.885,94566,28672,65894,5.483,18.085,140787,52477,88310,10.036,26.925,-46221,-8.840,36.171,1796,1866,17490
2002,4237,11304,18001,207702,214224,1219,6.725,1472,8.120,27560,9481,18079,4.426,12.865,40378,16581,23797,7.740,18.849,-12818,-5.983,25.730,763,809,7707
2002,4238,44636,60382,698655,721343,4521,7.365,6521,10.624,93742,34939,58803,4.844,12.995,138723,50634,88089,7.019,19.231,-44981,-6.236,25.991,3552,3770,26064
2002,4239,28612,31572,319749,327523,3782,11.923,4078,12.856,50469,18479,31990,5.642,15.409,66262,23328,42934,7.123,20.231,-15793,-4.822,30.819,2941,3007,14178
2002,4241,9921,12472,211347,218324,925,7.234,1553,12.146,24872,10421,14451,4.773,11.392,38467,14893,23574,6.822,17.619,-13595,-6.227,22.785,690,743,5865
2002,4242,5492,6992,226128,229068,847,12.167,786,11.291,46079,15488,30591,6.761,20.116,53006,21740,31266,9.491,23.140,-6927,-3.024,40.232,429,433,5645
2002,4243,14292,15522,198517,203988,2023,12.996,2112,13.568,36382,12253,24129,6.007,17.835,47501,14642,32859,7.178,23.286,-11119,-5.451,35.671,1516,1540,9674
2002,4244,26560,32217,744583,764869,3269,10.080,3699,11.405,98536,33933,64603,4.436,12.883,139224,51162,88062,6.689,18.202,-40688,-5.320,25.765,2310,2477,27381
2002,4245,4450,7096,65346,66862,489,6.785,712,9.879,10668,3345,7323,5.003,15.955,13703,4627,9076,6.920,20.495,-3035,-4.539,31.911,373,410,2873
2002,4246,8850,13641,145971,150360,1002,7.231,1434,10.349,21927,6964,14963,4.632,14.583,30687,13918,16769,9.256,20.409,-8760,-5.826,29.166,666,689,4478
2002,4247,5408,7664,103975,107866,694,8.759,1212,15.297,19282,7953,11329,7.373,17.876,26765,10900,15865,10.105,24.813,-7483,-6.937,35.752,554,575,5450
2002,4248,3225,4037,160852,160348,356,8.672,492,11.985,22632,9512,13120,5.932,14.114,21479,11073,10406,6.906,13.395,1153,0.719,26.790,262,279,6799
2002,4249,23727,29561,385397,394864,3541,11.966,3604,12.179,65516,27232,38284,6.897,16.592,84407,34721,49686,8.793,21.376,-18891,-4.784,33.184,2426,2476,19639
2002,4251,29045,30905,246690,244594,2945,9.408,3739,11.945,53804,17377,36427,7.104,21.997,50204,26167,24037,10.698,20.525,3600,1.472,41.051,2228,2251,14188
2002,4411,43417,47398,1258433,1242091,5243,11.097,4942,10.460,188740,78652,110088,6.332,15.195,156092,69305,86787,5.580,12.567,32648,2.628,25.134,3634,3674,48660
2002,4412,12873,14076,137924,136438,1512,10.778,1418,10.108,24926,9355,15571,6.857,18.269,22076,8731,13345,6.399,16.180,2850,2.089,32.361,1011,1024,6418
2002,4413,32280,55364,475610,474949,4201,7.547,4806,8.634,78517,25163,53354,5.298,16.532,76454,27624,48830,5.816,16.097,2063,0.434,32.195,2840,3015,16211
2002,4421,18561,25830,251343,258255,3113,11.938,3606,13.829,44906,21277,23629,8.239,17.388,58012,25492,32520,9.871,22.463,-13106,-5.075,34.776,1868,2210,15652
2002,4422,25205,33636,286940,289834,3955,11.731,4111,12.194,61211,29545,31666,10.194,21.119,66691,35952,30739,12.404,23.010,-5480,-1.891,42.239,2312,3014,29166
2002,4431,29562,48341,446801,454638,6059,12.477,6500,13.385,74243,35668,38575,7.845,16.330,89425,38811,50614,8.537,19.670,-15182,-3.339,32.660,4150,4448,23056
2002,4441,44313,63385,1016255,1000964,5089,7.977,5917,9.274,169595,88982,80613,8.890,16.943,142098,54221,87877,5.417,14.196,27497,2.747,28.392,3651,4077,39202
2002,4442,15687,18923,167875,170921,1701,8.864,2234,11.642,29801,11679,18122,6.833,17.436,36025,14787,21238,8.651,21.077,-6224,-3.641,34.871,1333,1370,8364
2002,4451,58498,85276,2551031,2586848,9473,11.114,9394,11.021,285459,136015,149444,5.258,11.035,360276,102795,257481,3.974,13.927,-74817,-2.892,22.070,6331,6450,47301
2002,4452,15710,20534,130849,132982,3330,16.230,3298,16.074,28466,13776,14690,10.359,21.406,32818,14690,18128,11.047,24.679,-4352,-3.273,42.812,2264,2366,10471
2002,4453,22879,25994,133067,132826,2620,10.103,2499,9.636,24734,9403,15331,7.079,18.621,24357,8620,15737,6.490,18.338,377,0.284,36.675,1764,1784,6074
2002,4461,38283,77075,938704,932562,7589,9.900,6756,8.813,182176,83528,98648,8.957,19.535,168340,47007,121333,5.041,18.051,13836,1.484,36.103,3390,3974,21919
2002,4471,60509,114015,926392,943050,9967,8.698,11112,9.697,171576,68824,102752,7.298,18.194,206367,65696,140671,6.966,21.883,-34791,-3.689,36.387,5983,6718,37205
2002,4481,34560,83954,1014904,1017157,10519,12.620,9321,11.182,217611,112238,105373,11.034,21.394,219666,64874,154792,6.378,21.596,-2055,-0.202,42.788,4334,5121,29483
2002,4482,6232,27212,209219,202164,2463,9.027,2609,9.562,51519,16846,34673,8.333,25.484,37936,12954,24982,6.408,18.765,13583,6.719,37.530,658,902,3927
2002,4483,18202,28034,159024,163104,2390,8.450,2890,10.218,24691,9678,15013,5.934,15.138,32796,11329,21467,6.946,20.107,-8105,-4.969,30.276,1618,1668,5945
2002,4511,27622,38376,393570,402539,4112,10.631,4717,12.195,76651,30905,45746,7.678,19.042,93376,28799,64577,7.154,23.197,-16725,-4.155,38.084,3023,3361,19389
2002,4512,6394,11870,141679,141499,1059,8.788,1421,11.792,24746,8274,16472,5.847,17.489,24967,10353,14614,7.317,17.645,-221,-0.156,34.977,743,864,4859
2002,4521,83,9200,1460555,1467632,169,1.835,185,2.009,85632,23410,62222,1.595,5.835,101852,20227,81625,1.378,6.940,-16220,-1.105,11.669,(D),(D),(D)
2002,4529,8131,28769,1121602,1098919,3214,11.304,2540,8.934,142530,60905,81625,5.542,12.970,101316,23950,77366,2.179,9.220,41214,3.750,18.439,1134,1408,7220
2002,4531,20026,20878,115676,118696,2115,10.011,2611,12.359,23123,10929,12194,9.208,19.481,28901,13674,15227,11.520,24.349,-5778,-4.868,38.962,1946,1966,7617
2002,4532,28207,39739,320366,331364,4525,11.235,5602,13.909,54954,23147,31807,6.985,16.584,76743,29581,47162,8.927,23.160,-21789,-6.576,33.168,3467,3796,16656
2002,4533,12472,16504,119369,119636,1806,10.901,1934,11.673,20174,9212,10962,7.700,16.863,20739,6998,13741,5.849,17.335,-565,-0.472,33.726,1433,1454,4572
2002,4539,30181,38764,238221,240322,6014,15.587,5653,14.651,51104,24340,26764,10.128,21.265,55328,23330,31998,9.708,23.022,-4224,-1.758,42.530,3615,3944,16419
2002,4541,13004,13927,258238,268409,2386,17.422,1923,14.041,55316,27238,28078,10.148,20.609,75768,35037,40731,13.054,28.229,-20452,-7.620,41.218,1369,1405,17980
2002,4542,4648,5336,62747,63157,665,12.337,774,14.359,15402,9532,5870,15.093,24.387,16006,7867,8139,12.456,25.343,-604,-0.956,48.774,538,538,3719
2002,4543,23438,29660,240754,244841,3335,11.352,2770,9.429,40442,15389,25053,6.285,16.518,48772,19316,29456,7.889,19.920,-8330,-3.402,33.035,1680,1723,11857
2002,4811,582,3052,496404,519220,251,8.269,218,7.182,29670,5035,24635,0.970,5.714,74227,2212,72015,0.426,14.296,-44557,-8.582,11.429,76,98,1225
2002,4812,1779,1915,34291,35298,297,15.714,247,13.069,6963,3189,3774,9.035,19.726,9293,2488,6805,7.049,26.327,-2330,-6.601,39.453,185,185,1889
2002,4831,802,1215,46061,49567,98,7.961,130,10.561,8866,3666,5200,7.396,17.887,15569,5897,9672,11.897,31.410,-6703,-13.523,35.774,65,65,2220
2002,4832,429,477,19083,19501,54,11.227,62,12.890,2602,757,1845,3.882,13.343,3497,1495,2002,7.666,17.932,-895,-4.590,26.686,41,41,307
2002,4841,40740,50270,988922,996890,7960,15.773,8352,16.550,160445,51956,108489,5.212,16.095,176705,58105,118600,5.829,17.726,-16260,-1.631,32.189,6002,6227,39213
2002,4842,42891,46181,443146,457203,5951,12.698,7319,15.617,76636,28270,48366,6.183,16.762,104064,39703,64361,8.684,22.761,-27428,-5.999,33.524,5116,5226,26851
2002,4851,613,902,46584,46230,135,15.271,99,11.199,7460,3942,3518,8.527,16.137,6703,4347,2356,9.403,14.499,757,1.637,28.999,40,49,1844
2002,4852,208,455,13258,15263,81,18.794,33,7.657,2173,1525,648,9.992,14.238,6354,353,6001,2.313,41.631,-4181,-27.394,28.475,19,19,251
2002,4853,5913,6033,63522,66437,933,15.318,1049,17.222,10357,5233,5124,7.877,15.589,16207,5902,10305,8.884,24.395,-5850,-8.805,31.179,837,838,4232
2002,4854,3107,4308,174823,172452,304,7.049,313,7.258,26929,10954,15975,6.352,15.615,22144,10011,12133,5.805,12.841,4785,2.775,25.681,200,204,5856
2002,4855,1055,1174,28156,28790,121,10.177,151,12.700,4821,2444,2377,8.489,16.746,6053,2479,3574,8.611,21.025,-1232,-4.279,33.491,112,113,1275
2002,4859,2407,2636,53519,53494,478,18.686,322,12.588,13555,6968,6587,13.026,25.340,13577,5953,7624,11.128,25.381,-22,-0.041,50.679,242,244,4240
2002,4861,49,260,6357,6267,50,19.920,32,12.749,2790,2217,573,35.376,44.519,2587,1300,1287,20.744,41.280,203,3.239,82.559,(D),(D),(D)
2002,4862,115,1872,27446,27689,122,6.362,213,11.108,3755,1953,1802,7.053,13.562,4230,3488,742,12.597,15.277,-475,-1.716,27.123,11,11,64
2002,4869,54,458,6051,6324,28,5.651,103,20.787,1294,180,1114,2.846,20.462,1859,1435,424,22.691,29.396,-565,-8.934,40.923,3,3,41
2002,4871,439,485,8371,9093,64,12.864,89,17.889,1187,495,692,5.444,13.054,2663,877,1786,9.645,29.286,-1476,-16.232,26.108,60,60,712
2002,4872,1155,1189,10783,12247,179,14.529,265,21.510,1698,723,975,5.904,13.865,4565,1686,2879,13.767,37.276,-2867,-23.411,27.730,159,159,1080
2002,4879,139,143,1540,1677,26,18.310,24,16.901,224,87,137,5.188,13.357,479,100,379,5.963,28.563,-255,-15.206,26.714,11,11,51
2002,4881,3282,4520,132411,131655,780,17.713,547,12.422,30700,14216,16484,10.798,23.319,28998,11272,17726,8.562,22.026,1702,1.293,44.051,275,282,2712
2002,4882,422,792,21882,22473,85,10.652,97,12.155,2936,1061,1875,4.721,13.065,4108,1417,2691,6.305,18.280,-1172,-5.215,26.129,46,59,726
2002,4883,1616,2098,64530,65819,215,10.106,274,12.879,12244,5352,6892,8.131,18.603,14837,4875,9962,7.407,22.542,-2593,-3.940,37.205,136,138,1638
2002,4884,6643,6944,54408,55113,996,14.465,879,12.766,11955,5141,6814,9.328,21.692,13231,5211,8020,9.455,24.007,-1276,-2.315,43.384,650,653,2916
2002,4885,11117,15302,165694,170591,1725,11.276,1716,11.218,27177,12089,15088,7.087,15.931,37266,13013,24253,7.628,21.845,-10089,-5.914,31.862,1020,1104,6675
2002,4889,1025,1144,26417,27136,170,14.636,205,17.650,3261,1298,1963,4.783,12.017,4644,1619,3025,5.966,17.114,-1383,-5.097,24.034,158,158,1072
2002,4921,2766,6948,508776,517192,928,13.544,735,10.728,32190,8766,23424,1.695,6.224,48111,11240,36871,2.173,9.302,-15921,-3.078,12.448,367,369,3277
2002,4922,4078,4485,46305,50059,731,16.192,790,17.499,8597,4216,4381,8.422,17.174,16037,5812,10225,11.610,32.037,-7440,-14.863,34.348,634,642,4685
2002,4931,6683,11929,543384,547771,1309,10.841,1601,13.259,100637,47399,53238,8.653,18.372,108961,34323,74638,6.266,19.892,-8324,-1.520,36.744,415,468,7821
2002,5111,15008,20594,712766,735361,2423,11.844,2150,10.510,85337,39557,45780,5.379,11.605,131872,40400,91472,5.494,17.933,-46535,-6.328,23.210,1318,1386,21858
2002,5112,6530,9037,357064,379228,1129,12.146,1645,17.698,56982,24450,32532,6.447,15.026,100489,36677,63812,9.671,26.498,-43507,-11.473,30.052,915,927,15497
2002,5121,11675,15256,255802,264045,2075,13.417,2495,16.132,50968,17901,33067,6.780,19.303,67507,17698,49809,6.703,25.567,-16539,-6.264,38.606,1443,1491,8894
2002,5122,2558,2853,30501,30818,451,15.852,435,15.290,5548,3109,2439,10.088,18.002,6298,2064,4234,6.697,20.436,-750,-2.434,36.005,302,302,1146
2002,5151,4624,8351,245702,252900,735,8.757,819,9.758,28667,13798,14869,5.456,11.335,42672,15723,26949,6.217,16.873,-14005,-5.538,22.671,513,527,7585
2002,5152,301,620,37097,37363,139,23.579,78,13.232,7063,1247,5816,3.338,18.904,7495,2246,5249,6.011,20.060,-432,-1.156,37.808,40,40,989
2002,5171,4373,33634,1164899,1192956,8102,24.308,7494,22.484,337806,226540,111266,18.990,28.317,392299,137700,254599,11.543,32.885,-54493,-4.568,56.633,894,989,23662
2002,5172,2555,10422,260397,270404,2057,19.213,2626,24.527,61453,33283,28170,12.309,22.726,80394,45131,35263,16.690,29.731,-18941,-7.005,45.453,528,544,10729
2002,5174,411,575,14346,16902,124,20.345,193,31.665,3695,2045,1650,12.100,21.862,8611,4534,4077,26.826,50.948,-4916,-29.086,43.724,64,72,855
2002,5179,4700,5492,93700,111378,1372,21.818,2965,47.150,22996,12833,10163,11.522,20.647,59052,36261,22791,32.557,53.020,-36056,-32.373,41.294,1948,2002,24596
2002,5182,7270,12776,432588,439066,2423,19.650,1533,12.432,99220,49761,49459,11.333,22.598,112058,31459,80599,7.165,25.522,-12838,-2.924,45.196,507,527,6556
2002,5191,4430,5404,100608,104777,650,12.311,402,7.614,16594,6794,9800,6.484,15.837,24737,4941,19796,4.716,23.609,-8143,-7.772,31.675,249,255,2684
2002,5211,12,47,22869,22950,(D),(D),(D),(D),440,(D),377,(D),1.917,594,(D),569,(D),2.588,-154,-0.671,3.835,(D),(D),(D)
2002,5221,17293,111807,2104626,2087808,10005,9.109,6058,5.516,364707,127604,237103,6.112,17.468,330977,110828,220149,5.308,15.853,33730,1.616,31.706,667,830,16098
2002,5222,16827,46082,667010,659352,7318,16.175,5638,12.462,154163,64841,89322,9.834,23.381,138321,51311,87010,7.782,20.978,15842,2.403,41.957,1847,2013,13538
2002,5223,18845,28522,279308,264548,6691,25.314,2512,9.503,82861,37215,45646,14.067,31.322,53111,20168,32943,7.624,20.076,29750,11.246,40.152,1407,1540,11826
2002,5231,12157,39329,599115,576301,7054,18.300,5491,14.245,194758,94342,100416,16.370,33.794,145989,69470,76519,12.054,25.332,48769,8.462,50.664,1269,1345,11602
2002,5232,22,30,6629,6472,5,14.706,13,38.235,817,530,287,8.190,12.625,517,269,248,4.157,7.989,300,4.636,15.978,9,9,56
2002,5239,27603,31450,362445,362335,5680,18.432,4411,14.314,75141,43239,31902,11.933,20.738,74805,28656,46149,7.909,20.645,336,0.093,41.291,3022,3055,16994
2002,5241,5113,30397,1549531,1549287,4106,13.645,3494,11.611,211101,83992,127109,5.421,13.626,209909,63329,146580,4.088,13.549,1192,0.077,27.098,440,498,10542
2002,5242,113563,126056,825249,815056,13306,10.613,11939,9.523,174926,73898,101028,9.067,21.462,154857,67285,87572,8.255,19.000,20069,2.462,37.999,7909,8080,36720
2002,5250,2833,3921,49709,45421,1032,29.579,168,4.815,17859,10411,7448,22.921,39.319,9254,1420,7834,3.126,20.374,8605,18.945,40.748,85,85,797
2002,5311,85441,101820,505276,506522,10679,10.546,9554,9.435,91641,42613,49028,8.413,18.092,94493,35577,58916,7.024,18.655,-2852,-0.563,36.184,7202,7265,24945
2002,5312,53724,61130,269053,271374,9810,16.360,7473,12.463,63330,32212,31118,11.870,23.337,67871,29323,38548,10.805,25.010,-4541,-1.673,46.674,4680,4750,19688
2002,5313,50748,55839,519807,518673,8285,15.108,6282,11.456,100229,44940,55289,8.664,19.324,98887,41554,57333,8.012,19.065,1342,0.259,38.131,3730,3769,24394
2002,5321,4266,11001,176515,182769,1121,10.164,1178,10.680,24738,8589,16149,4.699,13.535,36508,13909,22599,7.610,19.975,-11770,-6.440,27.070,527,712,7975
2002,5322,13140,31059,254035,255143,3800,12.249,3730,12.023,52853,27054,25799,10.603,20.715,55528,20663,34865,8.099,21.764,-2675,-1.048,41.430,1741,2073,9269
2002,5323,3427,5084,32293,32075,586,11.685,448,8.933,6854,3061,3793,9.543,21.369,6212,2090,4122,6.516,19.367,642,2.002,38.735,259,265,1237
2002,5324,7138,11920,154222,156289,1333,11.181,1338,11.222,29016,9942,19074,6.361,18.566,33550,12469,21081,7.978,21.467,-4534,-2.901,37.131,694,736,5163
2002,5331,1913,2039,26101,26145,277,13.655,256,12.620,6575,2777,3798,10.622,25.149,6528,2990,3538,11.436,24.969,47,0.180,49.938,176,176,2082
2002,5411,154624,162800,1140356,1126399,15535,9.584,14108,8.704,171681,63192,108489,5.610,15.242,143531,55912,87619,4.964,12.742,28150,2.499,25.485,9855,9963,41333
2002,5412,87912,99596,1238399,1238036,15108,15.591,9722,10.033,330094,176447,153647,14.252,26.663,332154,171848,160306,13.881,26.829,-2060,-0.166,53.325,5668,5704,34471
2002,5413,83004,94411,1247733,1258380,10801,11.504,9760,10.395,228908,79062,149846,6.283,18.191,250658,96893,153765,7.700,19.919,-21750,-1.728,36.381,5917,5989,38080
2002,5414,25193,25431,116992,123546,3812,15.015,3725,14.673,21424,10509,10915,8.506,17.341,34626,13927,20699,11.273,28.027,-13202,-10.686,34.682,2712,2722,10295
2002,5415,75820,85863,1095423,1188904,16829,19.273,19741,22.608,246304,119286,127018,10.033,20.717,431971,166990,264981,14.046,36.334,-185667,-15.617,41.434,13150,13347,93867
2002,5416,76727,81929,682878,690477,16401,20.280,14285,17.664,156101,68751,87350,9.957,22.608,172211,73946,98265,10.709,24.941,-16110,-2.333,45.215,9844,9896,45884
2002,5417,10456,13495,606874,610963,1899,14.171,1710,12.761,100152,30571,69581,5.004,16.392,108883,46201,62682,7.562,17.822,-8731,-1.429,32.785,916,940,11775
2002,5418,30288,33523,404554,428530,3883,11.419,4849,14.259,66165,28656,37509,6.687,15.440,113992,41403,72589,9.662,26.601,-47827,-11.161,30.880,3360,3384,22051
2002,5419,48016,55904,507067,503245,6666,12.117,4886,8.881,99919,36586,63333,7.270,19.855,92176,25518,66658,5.071,18.316,7743,1.539,36.633,3036,3063,15032
2002,5511,26438,46899,2791331,2896405,5297,11.052,7353,15.342,500585,171152,329433,5.909,17.283,708864,275546,433318,9.513,24.474,-208279,-7.191,34.566,1570,1725,57908
2002,5611,16163,18181,383710,388463,3287,18.068,3309,18.189,98889,45432,53457,11.695,25.456,109309,54185,55124,13.949,28.139,-10420,-2.682,50.913,2389,2412,28389
2002,5612,1680,3255,141068,149483,692,20.979,779,23.617,39805,21197,18608,14.180,26.629,57616,12034,45582,8.050,38.544,-17811,-11.915,53.257,114,122,4032
2002,5613,26021,44199,3911458,4122276,6732,14.831,9114,20.079,1073551,320546,753005,7.776,26.043,1506816,483836,1022980,11.737,36.553,-433265,-10.510,52.085,4053,4269,225030
2002,5614,25747,30888,743366,750151,4146,13.352,4474,14.408,171928,63382,108546,8.449,22.919,185605,72828,112777,9.708,24.742,-13677,-1.823,45.838,2875,2973,33794
2002,5615,18829,26339,264822,285024,2087,7.565,4582,16.610,41098,17764,23334,6.232,14.419,81966,34162,47804,11.986,28.758,-40868,-14.338,28.838,2980,3087,15677
2002,5616,16527,20703,739980,733457,3152,15.241,3108,15.028,199792,87374,112418,11.913,27.240,188757,95551,93206,13.027,25.735,11035,1.505,51.471,1547,1642,20618
2002,5617,116747,123452,1514336,1503039,19621,16.478,10865,9.125,301487,112017,189470,7.453,20.059,278510,73375,205135,4.882,18.530,22977,1.529,37.060,7786,7809,42622
2002,5619,16631,18776,337777,390374,2356,12.434,2700,14.250,59609,22526,37083,5.770,15.270,160963,27272,133691,6.986,41.233,-101354,-25.963,30.539,1922,1966,17791
2002,5621,6177,8006,170672,169271,943,11.952,711,9.011,33360,14967,18393,8.842,19.708,30833,7967,22866,4.707,18.215,2527,1.493,36.430,515,523,4138
2002,5622,1432,2313,48333,49411,236,10.116,276,11.830,6847,2587,4260,5.236,13.857,9174,4587,4587,9.283,18.567,-2327,-4.709,27.714,144,146,1817
2002,5629,5988,6633,97788,97730,881,13.537,631,9.696,20119,6587,13532,6.740,20.586,20202,5831,14371,5.966,20.671,-83,-0.085,41.173,399,399,3102
2002,6111,17602,19828,790372,770817,1232,6.411,7,0.036,84596,22515,62081,2.921,10.975,45226,50,45176,0.006,5.867,39370,5.108,11.735,(D),(D),(D)
2002,6112,577,883,93138,89797,61,7.155,0,0.000,11718,3052,8666,3.399,13.049,4797,0,4797,0.000,5.342,6921,7.707,10.684,0,0,0
2002,6113,2415,3167,1412772,1383969,214,6.991,(D),(D),122942,16780,106162,1.212,8.883,66607,(D),66566,(D),4.813,56335,4.071,9.626,0,0,0
2002,6114,6254,6875,68035,69983,1085,15.843,1032,15.069,15493,7065,8428,10.095,22.138,19221,7163,12058,10.235,27.465,-3728,-5.327,44.277,680,728,4341
2002,6115,5503,6544,90979,89988,748,11.476,696,10.678,18764,6012,12752,6.681,20.852,16514,5124,11390,5.694,18.351,2250,2.500,36.703,463,470,3402
2002,6116,22798,24750,215232,212008,3730,15.416,2621,10.833,50653,18906,31747,8.918,23.892,44275,17473,26802,8.242,20.884,6378,3.008,41.767,1679,1727,10071
2002,6117,3563,3948,46482,44542,796,20.805,552,14.428,12436,6629,5807,14.883,27.920,8310,3254,5056,7.305,18.657,4126,9.263,37.313,372,387,2393
2002,6211,162698,185378,1865956,1838538,19986,10.932,14857,8.127,352565,147571,204994,8.027,19.176,299094,111450,187644,6.062,16.268,53471,2.908,32.536,9527,9812,67991
2002,6212,107381,111886,748384,738976,6688,6.008,5535,4.973,116829,35751,81078,4.838,15.810,98080,31848,66232,4.310,13.272,18749,2.537,26.545,3952,4019,21751
2002,6213,85423,93079,482988,467624,12436,13.721,7549,8.329,111372,47238,64134,10.102,23.817,80320,28488,51832,6.092,17.176,31052,6.640,34.352,5031,5133,18811
2002,6214,11728,24153,576827,575256,3106,13.144,2060,8.718,97417,38655,58762,6.720,16.935,95104,37808,57296,6.572,16.532,2313,0.402,33.065,630,731,12536
2002,6215,6153,10109,194192,188545,1722,16.749,2066,20.095,50740,25413,25327,13.478,26.911,39569,21464,18105,11.384,20.987,11171,5.925,41.973,491,524,6068
2002,6216,10979,15862,756643,746840,2970,19.242,2116,13.709,178125,66283,111842,8.875,23.851,157213,62711,94502,8.397,21.050,20912,2.800,42.101,878,950,25003
2002,6219,5177,8169,212567,206162,1192,15.014,733,9.232,49150,16586,32564,8.045,23.841,37064,19161,17903,9.294,17.978,12086,5.862,35.956,353,358,5903
2002,6221,3210,5186,4682548,4651870,199,3.809,277,5.301,367864,93726,274138,2.015,7.908,307294,118096,189198,2.539,6.606,60570,1.302,13.212,122,161,72076
2002,6222,483,609,216190,218911,36,5.797,60,9.662,21311,8853,12458,4.044,9.735,26730,10326,16404,4.717,12.210,-5419,-2.475,19.470,23,23,3868
2002,6223,320,603,185047,179320,61,10.218,49,8.208,24325,8030,16295,4.478,13.565,13705,6651,7054,3.709,7.643,10620,5.922,15.286,28,29,3117
2002,6231,8168,15727,1582725,1570757,1262,8.003,1346,8.536,201419,85127,116292,5.419,12.823,178353,93863,84490,5.976,11.355,23066,1.468,22.709,499,562,36326
2002,6232,7890,27549,489000,476917,3596,13.527,1666,6.267,96449,37795,58654,7.925,20.223,72207,21396,50811,4.486,15.140,24242,5.083,30.281,358,481,7651
2002,6233,12622,16667,559945,550622,2002,12.113,1724,10.431,85464,37378,48086,6.788,15.521,66995,27493,39502,4.993,12.167,18469,3.354,24.334,1105,1131,15412
2002,6239,3342,6055,158551,155847,684,11.543,425,7.172,25664,8595,17069,5.515,16.467,20210,5846,14364,3.751,12.968,5454,3.500,25.936,193,205,2633
2002,6241,33378,46550,890602,867680,5479,12.092,3004,6.630,168720,58655,110065,6.760,19.445,123620,32260,91360,3.718,14.247,45100,5.198,28.494,1554,1613,20219
2002,6242,9054,12065,145673,143828,1099,9.373,420,3.582,23711,7605,16106,5.288,16.486,20303,4673,15630,3.249,14.116,3408,2.370,28.232,223,226,3162
2002,6243,5093,8147,319887,318841,918,11.479,618,7.728,55806,16660,39146,5.225,17.503,54028,11489,42539,3.603,16.945,1778,0.558,33.890,229,243,5429
2002,6244,49766,63270,746323,746107,8030,12.876,6218,9.970,132611,55606,77005,7.453,17.774,132991,43771,89220,5.867,17.825,-380,-0.051,35.547,4353,4418,29325
2002,7111,7469,7590,130266,127358,1048,13.849,1003,13.254,33759,9886,23873,7.762,26.507,27577,8779,18798,6.893,21.653,6182,4.854,43.306,671,673,6933
2002,7112,3113,3264,101151,103316,458,13.715,609,18.236,17285,5072,12213,4.909,16.730,21332,6475,14857,6.267,20.647,-4047,-3.917,33.460,435,436,4835
2002,7113,4064,4299,94343,91468,653,15.531,464,11.036,22854,7614,15240,8.324,24.986,17200,4997,12203,5.463,18.804,5654,6.181,37.609,316,317,3041
2002,7114,2560,2622,15216,15638,461,17.785,401,15.471,3475,2167,1308,13.857,22.222,4305,2041,2264,13.052,27.529,-830,-5.308,44.443,298,299,1526
2002,7115,10438,10456,40513,42707,1979,19.053,1841,17.724,12197,5314,6883,12.443,28.560,16866,5100,11766,11.942,39.492,-4669,-10.933,57.119,1023,1025,2712
2002,7121,5543,5980,117717,117324,491,8.339,307,5.214,12045,3007,9038,2.563,10.266,11263,2029,9234,1.729,9.600,782,0.667,19.200,167,167,1548
2002,7131,1712,2455,121418,121929,345,13.942,384,15.518,17225,3420,13805,2.805,14.127,19092,3139,15953,2.574,15.658,-1867,-1.531,28.254,221,224,1600
2002,7132,1543,1917,163644,160795,231,12.060,228,11.903,24424,9684,14740,6.023,15.190,18837,10860,7977,6.754,11.715,5587,3.475,23.430,157,159,9027
2002,7139,44266,49179,991948,983632,6038,12.317,5722,11.673,173145,66570,106575,6.768,17.603,156579,52021,104558,5.289,15.918,16566,1.684,31.837,3851,3949,34169
2002,7211,35207,45204,1687319,1729788,4788,10.580,4890,10.805,234757,121291,113466,7.012,13.571,316006,101914,214092,5.892,18.268,-81249,-4.697,27.143,2935,2992,48453
2002,7212,5064,5527,36875,36870,609,10.979,649,11.700,7383,2298,5085,6.233,20.024,7337,2572,4765,6.976,19.900,46,0.125,39.799,355,356,1506
2002,7213,2385,2457,12737,13175,202,8.150,245,9.885,1691,619,1072,4.698,12.835,2581,1173,1408,8.903,19.590,-890,-6.755,25.670,182,183,899
2002,7223,10346,27704,552968,542583,7374,27.789,5037,18.982,165502,102937,62565,18.972,30.503,139195,59315,79880,10.932,25.654,26307,4.848,51.308,1406,1456,9967
2002,7224,43004,43480,335544,332219,5392,12.358,5693,13.048,78525,38955,39570,11.726,23.637,71472,29578,41894,8.903,21.514,7053,2.123,43.027,4548,4558,23789
2002,7225,272618,376613,7442102,7415523,50217,13.474,42376,11.370,1408217,729875,678342,9.843,18.990,1353607,501347,852260,6.761,18.254,54610,0.736,36.507,28602,29855,302808
2002,8111,138731,151970,869473,873011,16084,10.617,15125,9.984,158006,67410,90596,7.722,18.099,164482,59000,105482,6.758,18.841,-6476,-0.742,36.198,11075,11217,42879
2002,8112,11514,13146,132148,133375,1758,13.259,1983,14.956,29491,15207,14284,11.402,22.111,31738,13881,17857,10.408,23.796,-2247,-1.685,44.223,1266,1305,7910
2002,8113,20989,22210,170223,174786,2208,9.910,2348,10.539,29335,11200,18135,6.408,16.783,38484,14989,23495,8.576,22.018,-9149,-5.234,33.567,1543,1558,7333
2002,8114,20709,21858,114108,115294,2615,11.804,3207,14.476,18740,8268,10472,7.171,16.254,21250,9321,11929,8.085,18.431,-2510,-2.177,32.508,2366,2376,6673
2002,8121,75049,87680,526533,519374,11903,13.707,10217,11.766,110398,52526,57872,10.113,21.256,96174,38978,57196,7.505,18.517,14224,2.739,37.035,7692,7785,27040
2002,8122,14646,21152,145307,155448,1839,8.718,1725,8.177,26694,10530,16164,6.774,17.172,47799,9367,38432,6.026,30.749,-21105,-13.577,34.345,656,667,2852
2002,8123,32148,38384,372461,378513,3940,10.206,4380,11.346,54087,21599,32488,5.706,14.289,66195,23134,43061,6.112,17.488,-12108,-3.199,28.579,3106,3200,16350
2002,8129,20548,31178,228866,236340,5604,18.321,4425,14.466,56224,29212,27012,12.360,23.789,70929,27426,43503,11.604,30.011,-14705,-6.222,47.579,1921,2030,10913
2002,8131,164255,164419,1636159,1604541,9141,5.717,106,0.066,185993,30227,155766,1.884,11.592,122820,338,122482,0.021,7.655,63173,3.937,15.309,14,14,20
2002,8132,11738,13801,141363,138700,1415,10.512,735,5.460,23281,7145,16136,5.151,16.785,18016,6045,11971,4.358,12.989,5265,3.796,25.978,420,420,3222
2002,8133,9503,11572,104311,102752,1413,12.574,744,6.621,18377,5580,12797,5.431,17.885,15299,4345,10954,4.229,14.889,3078,2.996,29.778,407,409,2586
2002,8134,27788,29807,316391,312813,1571,5.286,1395,4.694,43811,9555,34256,3.055,14.005,36453,5836,30617,1.866,11.653,7358,2.352,23.307,923,925,3961
2002,8139,60364,62414,508298,500986,3654,5.913,2416,3.910,76820,18709,58111,3.734,15.334,61879,11537,50342,2.303,12.351,14941,2.982,24.703,1544,1548,8170
2003,2111,5592,6739,82131,83575,631,9.247,800,11.724,16247,5991,10256,7.168,19.440,19327,8305,11022,9.937,23.125,-3080,-3.685,38.880,373,384,2682
2003,2121,655,1061,69459,72883,118,10.776,186,16.986,9244,3246,5998,4.454,12.683,15998,6194,9804,8.499,21.950,-6754,-9.267,25.367,90,90,1568
2003,2122,198,268,24737,25225,27,9.591,54,19.183,2050,483,1567,1.915,8.127,2914,1174,1740,4.654,11.552,-864,-3.425,16.254,30,33,181
2003,2123,3171,5152,91689,92250,303,5.827,399,7.673,10756,2234,8522,2.422,11.660,11945,2980,8965,3.230,12.949,-1189,-1.289,23.319,224,230,1429
2003,2131,6784,8251,187490,188788,828,9.986,909,10.963,33328,7624,25704,4.038,17.654,35226,9328,25898,4.941,18.659,-1898,-1.005,35.307,530,544,4554
2003,2211,1542,9632,530330,530832,752,7.851,644,6.724,57592,15678,41914,2.953,10.849,58825,13199,45626,2.486,11.082,-1233,-0.232,21.699,68,69,892
2003,2212,527,2619,88426,88545,314,12.180,232,8.999,14145,8924,5221,10.079,15.975,13898,5292,8606,5.977,15.696,247,0.279,31.392,25,29,205
2003,2213,4471,5309,42745,42170,405,7.739,253,4.835,5216,1959,3257,4.646,12.369,4039,1651,2388,3.915,9.578,1177,2.791,19.156,150,156,803
2003,2361,139922,140828,792770,775852,23610,16.919,21053,15.086,202315,78872,123443,10.166,26.076,169263,67782,101481,8.736,21.816,33052,4.260,43.633,13831,13831,47455
2003,2362,38070,39045,704553,713693,4237,10.838,4338,11.096,133196,34075,99121,4.774,18.663,151573,33644,117929,4.714,21.238,-18377,-2.575,37.326,3117,3118,21206
2003,2371,18416,19100,453536,479469,1583,8.199,1998,10.348,68265,10930,57335,2.280,14.238,118783,18981,99802,3.959,24.774,-50518,-10.536,28.475,1349,1349,10240
2003,2372,10102,10199,64979,62410,1809,17.869,1658,16.378,18966,8567,10399,13.727,30.389,13678,6811,6867,10.913,21.916,5288,8.473,43.833,1219,1248,5156
2003,2373,10129,10839,304502,309487,1059,9.770,1059,9.770,50704,7909,42795,2.556,16.383,60745,10715,50030,3.462,19.628,-10041,-3.244,32.767,682,684,5237
2003,2379,4255,4412,82660,83094,656,14.882,648,14.701,17141,5308,11833,6.388,20.629,17872,4800,13072,5.777,21.508,-731,-0.880,41.257,454,457,2623
2003,2381,90655,91139,977307,967562,12716,13.997,12128,13.350,227187,63547,163640,6.568,23.480,207629,58814,148815,6.079,21.459,19558,2.021,42.918,7868,7869,42016
2003,2382,144401,147595,1738830,1740834,16191,11.077,13348,9.132,305618,80459,225159,4.622,17.556,309451,80425,229026,4.620,17.776,-3833,-0.220,35.112,9610,9618,51990
2003,2383,96455,97340,810442,804990,16008,16.577,14462,14.976,189274,60403,128871,7.504,23.513,178488,53771,124717,6.680,22.173,10786,1.340,44.345,10185,10187,39141
2003,2389,47887,48286,427405,425435,8203,17.231,6843,14.374,95960,34129,61831,8.022,22.556,91697,30922,60775,7.268,21.554,4263,1.002,43.107,4644,4645,21465
2003,3111,1166,1732,45734,46375,94,5.404,109,6.266,4904,864,4040,1.863,10.575,6171,1618,4553,3.489,13.307,-1267,-2.732,21.149,56,56,640
2003,3112,464,784,56301,56259,41,5.196,51,6.464,5007,865,4142,1.538,8.900,4997,1937,3060,3.443,8.882,10,0.018,17.764,25,25,277
2003,3113,1502,1663,78700,80196,133,7.943,156,9.316,7460,1880,5580,2.344,9.302,10462,4261,6201,5.313,13.046,-3002,-3.743,18.605,97,103,1377
2003,3114,1263,1648,161832,163567,124,7.479,144,8.685,15836,3062,12774,1.872,9.682,19374,7397,11977,4.522,11.845,-3538,-2.163,19.363,77,77,2609
2003,3115,1055,1564,132408,132354,95,6.037,114,7.245,10569,1621,8948,1.225,7.985,10493,3361,7132,2.539,7.928,76,0.057,15.856,76,77,1030
2003,3116,3079,3690,491686,492949,218,5.884,248,6.694,33362,3379,29983,0.685,6.768,36354,12130,24224,2.461,7.375,-2992,-0.607,13.536,159,160,2374
2003,3117,574,670,38838,39045,61,9.098,62,9.247,5317,731,4586,1.872,13.618,5702,1204,4498,3.084,14.604,-385,-0.986,27.236,42,44,632
2003,3118,9528,10450,315429,310745,975,9.290,1065,10.148,48268,10305,37963,3.316,15.533,38774,15343,23431,4.937,12.478,9494,3.055,24.956,830,835,6885
2003,3119,2684,3089,163556,159768,492,16.591,245,8.262,23112,7887,15225,4.937,14.466,15546,5595,9951,3.502,9.730,7566,4.736,19.461,167,169,2424
2003,3121,2265,2768,131416,133337,329,12.194,189,7.005,14386,3556,10830,2.667,10.789,18016,3865,14151,2.899,13.512,-3630,-2.722,21.578,124,124,885
2003,3122,88,112,23323,23386,13,11.982,6,5.530,1173,81,1092,0.346,5.016,1317,300,1017,1.283,5.632,-144,-0.616,10.032,4,4,15
2003,3131,350,532,60099,62905,35,6.464,54,9.972,3795,1604,2191,2.550,6.033,9224,3634,5590,5.777,14.663,-5429,-8.631,12.066,30,30,852
2003,3132,1325,1564,135052,137970,85,5.291,170,10.582,10161,2577,7584,1.868,7.365,15695,5638,10057,4.086,11.376,-5534,-4.011,14.729,126,128,1999
2003,3133,1369,1467,59885,61519,108,7.236,159,10.653,5360,1111,4249,1.806,8.713,8748,2550,6198,4.145,14.220,-3388,-5.507,17.426,122,122,1522
2003,3141,2495,2690,99794,101558,164,5.999,252,9.217,8244,2027,6217,1.996,8.118,11645,3118,8527,3.070,11.466,-3401,-3.349,16.235,192,194,1361
2003,3149,4468,4613,87054,88152,386,8.272,493,10.565,12160,3507,8653,3.978,13.794,14358,5441,8917,6.172,16.288,-2198,-2.493,27.589,382,384,3864
2003,3151,646,704,43984,47482,35,4.670,126,16.811,4005,993,3012,2.091,8.435,11166,4087,7079,8.607,23.516,-7161,-15.082,16.870,100,102,1667
2003,3152,8303,8552,223292,233575,1575,18.257,1725,19.995,43774,18664,25110,7.991,18.741,64093,34712,29381,14.861,27.440,-20319,-8.699,37.482,1430,1439,19805
2003,3159,1105,1143,27360,28331,95,8.007,182,15.339,3444,863,2581,3.046,12.156,5434,2222,3212,7.843,19.180,-1990,-7.024,24.313,153,153,1338
2003,3161,213,223,8478,8852,17,7.375,32,13.883,717,87,630,0.983,8.100,1452,437,1015,4.937,16.404,-735,-8.304,16.201,25,25,223
2003,3162,276,306,17079,17955,24,7.717,34,10.932,1042,190,852,1.058,5.803,2813,1455,1358,8.104,15.667,-1771,-9.864,11.607,21,21,397
2003,3169,784,800,17140,17084,75,9.242,98,12.076,2506,639,1867,3.740,14.669,2420,882,1538,5.163,14.165,86,0.503,28.331,80,80,585
2003,3211,3514,3954,111567,112649,272,6.797,367,9.172,10779,2533,8246,2.249,9.569,13007,4153,8854,3.687,11.547,-2228,-1.978,19.137,261,261,1767
2003,3212,1452,1847,110746,111931,96,5.159,124,6.663,10075,2093,7982,1.870,9.001,12328,3973,8355,3.550,11.014,-2253,-2.013,18.002,80,82,1753
2003,3219,9405,10231,308004,310143,900,8.759,989,9.625,39176,11857,27319,3.823,12.632,43901,15019,28882,4.843,14.155,-4725,-1.523,25.263,730,733,6503
2003,3221,278,596,154614,159088,63,10.705,48,8.156,6738,2397,4341,1.507,4.235,16055,6375,9680,4.007,10.092,-9317,-5.857,8.471,19,20,1265
2003,3222,3138,4742,330439,334238,210,4.383,309,6.449,25043,7229,17814,2.163,7.493,32370,12671,19699,3.791,9.685,-7327,-2.192,14.985,174,186,4303
2003,3231,32515,34218,698189,708954,2018,5.798,3191,9.168,67724,19214,48510,2.710,9.553,89231,30550,58681,4.309,12.586,-21507,-3.034,19.105,2530,2569,19318
2003,3241,1049,2231,96224,96698,122,5.478,114,5.119,5997,1137,4860,1.176,6.202,6958,1883,5075,1.947,7.196,-961,-0.994,12.404,56,56,556
2003,3251,1166,2301,176834,179826,122,5.281,140,6.061,8968,1572,7396,0.874,4.987,14996,2781,12215,1.546,8.339,-6028,-3.352,9.974,51,53,507
2003,3252,647,965,99627,100927,55,5.697,56,5.800,6591,1947,4644,1.929,6.530,9178,2002,7176,1.984,9.094,-2587,-2.563,13.061,26,28,558
2003,3253,617,859,30406,30535,55,6.315,79,9.070,3591,1572,2019,5.148,11.760,3878,1172,2706,3.838,12.700,-287,-0.940,23.521,48,50,691
2003,3254,1364,1754,251040,247529,136,7.787,121,6.928,24557,2997,21560,1.211,9.921,17895,3544,14351,1.432,7.229,6662,2.691,14.459,71,71,941
2003,3255,1481,1892,67834,68911,90,4.706,131,6.850,5905,959,4946,1.392,8.569,7862,2494,5368,3.619,11.409,-1957,-2.840,17.138,84,87,965
2003,3256,1958,2195,107592,109655,121,5.409,205,9.164,9924,1928,7996,1.758,9.050,14204,5555,8649,5.066,12.953,-4280,-3.903,18.100,134,134,1317
2003,3259,2118,2759,113651,113013,209,7.570,213,7.715,11483,4180,7303,3.699,10.161,10346,3473,6873,3.073,9.155,1137,1.006,18.309,127,131,1324
2003,3261,9683,12261,747828,750853,591,4.762,891,7.179,78054,17908,60146,2.385,10.395,83905,28162,55743,3.751,11.175,-5851,-0.779,20.791,568,587,10014
2003,3262,1778,2288,173515,174949,117,5.056,169,7.303,13644,2317,11327,1.324,7.799,16726,3948,12778,2.257,9.561,-3082,-1.762,15.598,102,105,1490
2003,3271,1265,1470,60373,61223,111,7.437,156,10.452,5051,637,4414,1.040,8.250,6878,1800,5078,2.940,11.234,-1827,-2.984,16.500,112,112,494
2003,3272,1716,2034,111021,113018,146,7.101,190,9.241,9457,2956,6501,2.616,8.368,13385,4160,9225,3.681,11.843,-3928,-3.476,16.735,137,140,1228
2003,3273,5027,9113,206679,206473,456,5.001,467,5.121,27099,5399,21700,2.615,13.125,26501,5627,20874,2.725,12.835,598,0.290,25.670,231,251,3188
2003,3274,227,342,16487,16698,23,6.600,36,10.330,2041,180,1861,1.078,12.223,2484,869,1615,5.204,14.876,-443,-2.653,24.446,16,16,143
2003,3279,2369,2777,72288,73352,212,7.630,215,7.738,7983,1625,6358,2.215,10.883,10082,3527,6555,4.808,13.745,-2099,-2.862,21.766,131,133,1144
2003,3311,447,558,122153,122659,87,16.369,34,6.397,12177,9200,2977,7.500,9.928,12594,1984,10610,1.617,10.268,-417,-0.340,19.855,18,18,872
2003,3312,531,680,50426,51425,58,8.504,62,9.091,4880,1894,2986,3.683,9.490,6748,3395,3353,6.602,13.122,-1868,-3.633,18.979,29,30,987
2003,3313,407,551,66446,68746,29,5.124,59,10.424,3085,360,2725,0.524,4.488,7674,2690,4984,3.913,11.163,-4589,-6.675,8.975,26,26,690
2003,3314,754,963,62539,65147,65,6.722,73,7.549,3996,1657,2339,2.543,6.134,9197,2737,6460,4.201,14.117,-5201,-7.984,12.268,38,42,570
2003,3315,2048,2326,170649,175683,101,4.263,187,7.894,12494,2310,10184,1.315,7.112,22757,7993,14764,4.550,12.953,-10263,-5.842,14.223,130,134,4587
2003,3321,2461,2705,123707,125191,93,3.382,183,6.655,11134,2418,8716,1.931,8.894,14179,4075,10104,3.255,11.326,-3045,-2.432,17.787,113,113,1123
2003,3322,1316,1453,60449,60954,75,5.109,105,7.153,5758,1449,4309,2.377,9.447,6876,1937,4939,3.178,11.281,-1118,-1.834,18.893,64,64,314
2003,3323,11827,12734,364585,373451,726,5.638,1011,7.852,39810,8941,30869,2.394,10.660,57458,16576,40882,4.439,15.386,-17648,-4.726,21.320,689,692,6648
2003,3324,1244,1534,88928,90410,61,3.924,102,6.562,7788,1211,6577,1.339,8.614,10564,2931,7633,3.242,11.685,-2776,-3.070,17.228,61,61,764
2003,3325,727,810,56720,57993,33,4.007,60,7.286,3959,1078,2881,1.859,6.827,6583,922,5661,1.590,11.351,-2624,-4.525,13.653,43,43,350
2003,3326,1655,1840,60149,60726,123,6.624,157,8.454,5977,1850,4127,3.046,9.843,7197,1703,5494,2.804,11.852,-1220,-2.009,19.685,108,108,796
2003,3327,23468,23917,357000,364429,1277,5.243,2159,8.864,38395,7987,30408,2.192,10.536,53145,14490,38655,3.976,14.583,-14750,-4.047,21.071,1616,1623,8793
2003,3328,5432,5973,135893,137585,307,5.085,436,7.222,14535,3333,11202,2.423,10.564,17972,5521,12451,4.013,13.062,-3437,-2.498,21.129,306,306,2431
2003,3329,5713,6261,273685,278265,439,6.940,569,8.995,25984,8603,17381,3.092,9.338,35064,12505,22559,4.494,12.601,-9080,-3.263,18.676,424,425,4810
2003,3331,2442,2720,170385,174729,138,4.979,241,8.696,13880,2417,11463,1.383,7.944,22781,6573,16208,3.762,13.038,-8901,-5.094,15.887,147,148,1810
2003,3332,3751,3974,144856,148613,218,5.367,393,9.676,17347,3610,13737,2.429,11.673,24882,9027,15855,6.074,16.743,-7535,-5.070,23.345,270,271,2815
2003,3333,2088,2262,107520,110091,133,5.807,190,8.295,8856,2286,6570,2.076,8.044,13961,4342,9619,3.944,12.681,-5105,-4.637,16.089,138,138,2478
2003,3334,1448,1746,153063,156808,94,5.308,144,8.131,12765,1835,10930,1.170,8.141,19935,7556,12379,4.819,12.713,-7170,-4.572,16.281,74,76,1898
2003,3335,8064,8398,183458,187860,362,4.212,757,8.807,18362,4557,13805,2.426,9.774,27173,9703,17470,5.165,14.464,-8811,-4.690,19.549,563,566,5219
2003,3336,733,886,93072,96230,41,4.553,70,7.773,5770,1262,4508,1.311,5.996,12168,2072,10096,2.153,12.645,-6398,-6.649,11.992,31,32,448
2003,3339,5550,6234,287233,293664,328,5.214,441,7.011,23263,5169,18094,1.760,7.922,36199,9617,26582,3.275,12.327,-12936,-4.405,15.843,285,289,3062
2003,3341,1315,1406,128349,136213,157,11.103,173,12.235,14341,3504,10837,2.572,10.528,30969,8842,22127,6.491,22.736,-16628,-12.207,21.057,131,131,2110
2003,3342,1585,1810,141792,167886,125,6.749,209,11.285,10818,3461,7357,2.062,6.444,63399,21954,41445,13.077,37.763,-52581,-31.319,12.887,130,132,3003
2003,3343,490,512,24005,24662,59,11.501,61,11.891,1899,517,1382,2.096,7.700,3224,1212,2012,4.914,13.073,-1325,-5.373,15.400,45,46,412
2003,3344,4370,4976,383907,409860,320,6.288,546,10.729,32406,9574,22832,2.336,7.907,83708,27853,55855,6.796,20.424,-51302,-12.517,15.813,360,363,6785
2003,3345,4279,4945,407263,418215,305,6.078,451,8.988,41169,10724,30445,2.564,9.844,63175,14536,48639,3.476,15.106,-22006,-5.262,19.688,269,269,4502
2003,3346,766,816,37339,36300,91,10.898,129,15.449,7345,1672,5673,4.606,20.234,5154,1815,3339,5.000,14.199,2191,6.036,28.397,101,101,670
2003,3351,1058,1161,62049,63812,57,4.845,88,7.480,4532,1298,3234,2.034,7.102,8084,2979,5105,4.668,12.668,-3552,-5.566,14.204,61,62,690
2003,3352,255,313,90912,92296,32,10.207,33,10.526,6185,2761,3424,2.991,6.701,8680,1219,7461,1.321,9.405,-2495,-2.703,13.403,21,21,149
2003,3353,2032,2399,145951,152920,126,5.169,203,8.328,8205,1927,6278,1.260,5.366,22072,5702,16370,3.729,14.434,-13867,-9.068,10.731,136,141,1415
2003,3359,1843,2181,158133,165458,135,6.093,204,9.208,11061,2263,8798,1.368,6.685,25752,6823,18929,4.124,15.564,-14691,-8.879,13.370,119,121,1880
2003,3361,269,337,206371,207396,27,7.883,38,11.095,10607,1506,9101,0.726,5.114,13029,1575,11454,0.759,6.282,-2422,-1.168,10.229,27,27,450
2003,3362,1788,2017,132631,127480,133,6.558,155,7.643,22387,4025,18362,3.157,17.561,11974,4538,7436,3.560,9.393,10413,8.168,18.786,110,111,1570
2003,3363,4319,5472,687965,685036,335,6.087,398,7.232,76291,15214,61077,2.221,11.137,71370,19197,52173,2.802,10.418,4921,0.718,20.837,252,254,5226
2003,3364,1144,1486,371795,380981,85,5.686,103,6.890,21236,9674,11562,2.539,5.574,40109,5204,34905,1.366,10.528,-18873,-4.954,11.148,75,76,1141
2003,3365,144,199,25550,27078,17,8.608,14,7.089,2902,257,2645,0.949,10.717,6099,1891,4208,6.984,22.524,-3197,-11.807,21.435,3,3,8
2003,3366,1518,1642,136087,135318,156,9.515,151,9.210,13191,2415,10776,1.785,9.748,11423,3367,8056,2.488,8.442,1768,1.307,16.883,101,101,1166
2003,3369,684,713,38606,37840,81,11.392,77,10.830,4913,858,4055,2.267,12.984,3321,1283,2038,3.391,8.776,1592,4.207,17.553,59,60,585
2003,3371,14718,15252,369978,379352,1209,7.833,1576,10.210,36939,8281,28658,2.183,9.737,55328,17950,37378,4.732,14.585,-18389,-4.847,19.475,1156,1160,9584
2003,3372,3931,4128,156214,159829,261,6.282,315,7.581,14924,3206,11718,2.006,9.338,22202,5691,16511,3.561,13.891,-7278,-4.554,18.675,233,233,2618
2003,3379,914,1042,45676,46247,51,4.834,77,7.299,4200,1095,3105,2.368,9.082,5495,1676,3819,3.624,11.882,-1295,-2.800,18.163,52,52,510
2003,3391,10549,11250,297501,298603,765,6.797,774,6.877,32249,7389,24860,2.475,10.800,34538,12004,22534,4.020,11.567,-2289,-0.767,21.600,585,585,4206
2003,3399,17660,18167,404378,407195,1446,7.873,1843,10.035,47528,9768,37760,2.399,11.672,53288,17739,35549,4.356,13.087,-5760,-1.415,23.344,1445,1448,10812
2003,4231,17945,24258,356456,355171,2088,8.601,2123,8.745,46625,12477,34148,3.513,13.127,43990,15607,28383,4.394,12.386,2635,0.742,24.771,1361,1401,8061
2003,4232,11072,12609,161054,160026,1346,10.695,1299,10.321,25770,7886,17884,4.928,16.104,23648,7955,15693,4.971,14.778,2122,1.326,29.555,909,933,5308
2003,4233,11453,16645,230271,226554,1523,9.224,1254,7.595,34447,9865,24582,4.354,15.205,27096,8759,18337,3.866,11.960,7351,3.245,23.920,737,764,4262
2003,4234,26239,33703,696437,695127,3863,11.433,4033,11.936,121558,55680,65878,8.010,17.487,118634,40732,77902,5.860,17.067,2924,0.421,34.133,2580,2651,16698
2003,4235,7471,10156,146236,146091,767,7.537,807,7.930,18590,6464,12126,4.425,12.725,18336,5848,12488,4.003,12.551,254,0.174,25.102,489,509,3059
2003,4236,20085,29449,464372,479506,2520,8.399,3631,12.102,70545,27933,42612,5.825,14.712,101217,36570,64647,7.627,21.109,-30672,-6.397,29.424,1820,1910,11944
2003,4237,11285,18026,209840,209791,1348,7.500,1243,6.916,26459,8119,18340,3.870,12.612,26767,8755,18012,4.173,12.759,-308,-0.147,25.224,674,741,5310
2003,4238,44050,58947,687528,692026,4067,6.827,5317,8.925,92070,33025,59045,4.772,13.304,101173,34785,66388,5.027,14.620,-9103,-1.315,26.609,3037,3178,16387
2003,4239,29057,31941,324340,320173,4010,12.650,3529,11.132,54636,16922,37714,5.285,17.065,46284,16860,29424,5.266,14.456,8352,2.609,28.912,2660,2696,10962
2003,4241,9692,12181,218670,214014,970,7.913,1124,9.170,33064,17072,15992,7.977,15.449,24009,9569,14440,4.471,11.218,9055,4.231,22.437,691,745,3980
2003,4242,5522,6978,249829,237124,819,11.753,800,11.480,52967,12627,40340,5.325,22.337,26637,11154,15483,4.704,11.233,26330,11.104,22.467,510,521,4917
2003,4243,14052,15212,193457,194472,1845,12.070,1992,13.032,35935,10711,25224,5.508,18.478,37887,15101,22786,7.765,19.482,-1952,-1.004,36.957,1530,1575,8339
2003,4244,26490,32132,755148,748621,3096,9.651,2993,9.330,102085,25238,76847,3.371,13.636,88630,32397,56233,4.328,11.839,13455,1.797,23.678,2117,2148,13641
2003,4245,4377,6927,64914,65316,412,5.887,556,7.944,9515,2246,7269,3.439,14.568,10292,2635,7657,4.034,15.757,-777,-1.190,29.136,296,312,1444
2003,4246,8833,12405,145449,145340,967,7.439,2155,16.578,24636,5116,19520,3.520,16.951,24264,12126,12138,8.343,16.695,372,0.256,33.389,599,611,2742
2003,4247,5368,7490,104496,104228,459,6.022,723,9.486,20312,5165,15147,4.955,19.488,19903,6894,13009,6.614,19.096,409,0.392,38.191,342,369,2154
2003,4248,3190,3986,166146,163324,271,6.778,295,7.379,19356,3943,15413,2.414,11.851,13579,5812,7767,3.559,8.314,5777,3.537,16.628,210,215,3055
2003,4249,23946,29541,379048,381326,3432,11.641,3314,11.241,59558,17409,42149,4.565,15.619,64116,22650,41466,5.940,16.814,-4558,-1.195,31.237,2218,2243,11001
2003,4251,30099,31948,258443,254660,3018,9.499,2663,8.382,40401,11656,28745,4.577,15.865,32818,9033,23785,3.547,12.887,7583,2.978,25.774,1802,1811,5142
2003,4411,43737,47884,1284482,1270326,4718,9.919,4085,8.588,154339,49205,105134,3.873,12.150,126106,40454,85652,3.185,9.927,28233,2.223,19.854,3157,3181,27877
2003,4412,13218,14575,147609,143016,1614,11.248,1162,8.098,26964,9778,17186,6.837,18.854,17733,5549,12184,3.880,12.399,9231,6.455,24.799,861,887,4157
2003,4413,32295,55646,483930,481333,4001,7.189,4019,7.221,69926,22343,47583,4.642,14.528,64665,19553,45112,4.062,13.435,5261,1.093,26.869,2309,2524,10988
2003,4421,18874,26176,265933,259596,2828,10.855,2582,9.911,50789,18741,32048,7.219,19.565,38320,14699,23621,5.662,14.761,12469,4.803,29.523,1543,1701,9233
2003,4422,25454,34268,298822,293009,3669,10.818,2964,8.739,59034,25372,33662,8.659,20.148,47670,12512,35158,4.270,16.269,11364,3.878,32.538,1937,2010,6614
2003,4431,30210,49795,467904,459617,6434,13.054,5419,10.995,83685,36838,46847,8.015,18.208,67786,24615,43171,5.356,14.748,15899,3.459,29.497,3616,3896,15648
2003,4441,44704,64271,1039222,1031030,4548,7.099,4134,6.453,112409,40239,72170,3.903,10.903,95542,26749,68793,2.594,9.267,16867,1.636,18.533,2646,2783,14276
2003,4442,15638,18856,171480,169979,1471,7.767,1639,8.654,29421,7400,22021,4.353,17.309,26190,7622,18568,4.484,15.408,3231,1.901,30.816,1086,1117,4793
2003,4451,59827,86833,2570806,2558134,10510,12.228,8746,10.176,308263,139390,168873,5.449,12.050,284411,102275,182136,3.998,11.118,23852,0.932,22.236,5892,5981,36492
2003,4452,17096,21224,149190,142378,3516,16.637,3336,15.785,41879,19966,21913,14.023,29.414,27647,12197,15450,8.567,19.418,14232,9.996,38.836,1937,1987,8538
2003,4453,23220,26516,139539,136316,2808,10.708,2223,8.477,27135,10072,17063,7.389,19.906,20813,7424,13389,5.446,15.268,6322,4.638,30.536,1680,1693,5639
2003,4461,39192,78345,954891,948190,6090,7.819,5175,6.644,113607,39411,74196,4.156,11.981,101997,36652,65345,3.865,10.757,11610,1.224,21.514,2714,2917,15358
2003,4471,60810,112532,930978,927621,9940,8.777,11372,10.042,171856,61894,109962,6.672,18.527,165410,66956,98454,7.218,17.832,6446,0.695,35.663,5199,5690,30477
2003,4481,35040,84569,1100790,1060376,8694,10.314,8144,9.661,214153,59305,154848,5.593,20.196,131805,52684,79121,4.968,12.430,82348,7.766,24.860,3789,3971,16932
2003,4482,6142,26553,190815,199962,1892,7.042,2521,9.383,30435,10819,19616,5.411,15.220,47768,12698,35070,6.350,23.889,-17333,-8.668,30.441,755,1015,3701
2003,4483,18458,28227,163078,161217,2496,8.875,2292,8.149,27791,8397,19394,5.209,17.238,23813,8761,15052,5.434,14.771,3978,2.467,29.542,1307,1427,4168
2003,4511,27802,38197,403701,399915,3866,10.072,4237,11.039,75682,21262,54420,5.317,18.925,68630,24541,44089,6.137,17.161,7052,1.763,34.322,2609,2790,10974
2003,4512,6413,12054,141926,142220,1166,9.699,1102,9.167,19944,7058,12886,4.963,14.023,20698,7660,13038,5.386,14.554,-754,-0.530,28.047,642,660,4489
2003,4521,204,9059,1411625,1446419,497,5.420,720,7.851,91808,44273,47535,3.061,6.347,162053,52058,109995,3.599,11.204,-70245,-4.856,12.695,5,355,20588
2003,4529,8267,30237,1194233,1156864,3426,11.616,1941,6.581,151491,69572,81919,6.014,13.095,76816,20148,56668,1.742,6.640,74675,6.455,13.280,990,1029,4856
2003,4531,19487,20345,113151,114147,1749,8.505,2187,10.635,19769,6199,13570,5.431,17.319,21739,7127,14612,6.244,19.045,-1970,-1.726,34.638,1729,1753,5531
2003,4532,27775,39108,325317,323176,4053,10.306,4494,11.427,54074,17384,36690,5.379,16.732,50106,18952,31154,5.864,15.504,3968,1.228,31.009,3165,3255,11095
2003,4533,12274,16406,127076,123239,1682,10.224,1773,10.777,23920,7161,16759,5.811,19.410,15947,6128,9819,4.972,12.940,7973,6.470,25.880,1361,1372,4039
2003,4539,31033,39773,251893,246939,5163,13.054,4718,11.929,54546,21333,33213,8.639,22.089,44077,17480,26597,7.079,17.849,10469,4.240,35.699,3155,3277,11646
2003,4541,13258,14211,271225,268110,2278,16.319,1775,12.715,46994,15530,31464,5.792,17.528,40428,13597,26831,5.071,15.079,6566,2.449,30.158,1332,1354,6751
2003,4542,4528,5132,61667,61931,507,9.743,650,12.492,7525,2411,5114,3.893,12.151,8004,3764,4240,6.078,12.924,-479,-0.773,24.301,462,464,2467
2003,4543,22920,29021,241891,240997,2900,9.984,2950,10.156,36048,11809,24239,4.900,14.958,34326,12433,21893,5.159,14.243,1722,0.715,28.487,2016,2065,7977
2003,4811,582,3064,483855,488396,288,9.828,21,0.717,30137,12033,18104,2.464,6.171,38291,338,37953,0.069,7.840,-8154,-1.670,12.341,15,15,323
2003,4812,1830,1988,35204,34895,300,15.396,221,11.342,6077,2084,3993,5.972,17.415,5589,1270,4319,3.640,16.017,488,1.399,32.034,166,167,826
2003,4831,802,1178,47430,47201,130,10.829,175,14.577,8097,2793,5304,5.917,17.154,7466,3042,4424,6.445,15.817,631,1.337,31.635,75,77,916
2003,4832,473,528,19310,19029,82,15.922,56,10.874,6625,5427,1198,28.520,34.815,5881,1983,3898,10.421,30.905,744,3.910,61.811,35,35,182
2003,4841,41872,50992,969997,982781,8420,16.568,8080,15.899,146155,41702,104453,4.243,14.872,171884,84285,87599,8.576,17.490,-25729,-2.618,29.743,5774,5857,30289
2003,4842,41521,44710,439476,440907,5437,12.006,6589,14.550,78646,24623,54023,5.585,17.837,81089,30911,50178,7.011,18.391,-2443,-0.554,35.675,4796,4828,20395
2003,4851,626,898,47240,46314,112,12.458,114,12.681,7499,4022,3477,8.684,16.192,5982,3334,2648,7.199,12.916,1517,3.275,25.832,60,64,1031
2003,4852,211,486,17649,15480,108,23.126,70,14.989,6551,2281,4270,14.736,42.320,2051,1357,694,8.766,13.250,4500,29.071,26.500,20,22,274
2003,4853,5863,5983,64009,63585,893,14.909,906,15.126,11344,4087,7257,6.428,17.841,10573,4187,6386,6.585,16.628,771,1.213,33.257,740,740,3586
2003,4854,3022,4230,180906,177781,298,7.004,348,8.179,24904,8154,16750,4.587,14.008,18577,5469,13108,3.076,10.449,6327,3.559,20.899,235,235,2579
2003,4855,1055,1165,28843,28313,107,9.106,127,10.809,4854,1097,3757,3.875,17.144,3870,1328,2542,4.690,13.669,984,3.475,27.337,92,94,800
2003,4859,2525,2755,55797,54843,401,14.705,345,12.651,11619,4348,7271,7.928,21.186,9811,4383,5428,7.992,17.889,1808,3.297,35.778,256,257,2333
2003,4861,56,286,6154,6261,56,20.588,28,10.294,1569,468,1101,7.475,25.062,1810,887,923,14.168,28.911,-241,-3.850,50.124,0,0,0
2003,4862,123,1868,27283,28615,136,7.261,146,7.795,3069,1422,1647,4.969,10.725,5696,1040,4656,3.634,19.906,-2627,-9.180,21.450,6,6,30
2003,4869,60,511,5738,5907,94,19.342,44,9.053,1784,1007,777,17.048,30.201,2022,270,1752,4.571,34.231,-238,-4.029,60.403,(D),(D),(D)
2003,4871,433,483,9119,8859,60,12.474,56,11.642,1654,395,1259,4.459,18.671,1132,382,750,4.312,12.779,522,5.893,25.557,40,40,188
2003,4872,1116,1146,11167,10937,169,14.525,204,17.533,2415,672,1743,6.145,22.082,1945,544,1401,4.974,17.784,470,4.298,35.569,133,133,406
2003,4879,126,129,1663,1588,15,11.278,23,17.293,294,42,252,2.645,18.514,148,46,102,2.897,9.320,146,9.194,18.640,14,15,28
2003,4881,3283,4668,131445,134167,625,13.611,473,10.301,23362,10111,13251,7.536,17.413,27951,7061,20890,5.263,20.833,-4589,-3.420,34.825,292,305,3705
2003,4882,439,857,25386,23931,134,16.203,74,8.948,5383,2112,3271,8.826,22.494,2455,800,1655,3.343,10.259,2928,12.235,20.518,29,30,254
2003,4883,1634,2123,78851,76949,247,11.726,214,10.159,16600,4686,11914,6.090,21.573,12900,3971,8929,5.161,16.764,3700,4.808,33.529,120,122,1634
2003,4884,6940,7316,60456,57742,1175,16.430,846,11.830,15375,7832,7543,13.564,26.627,10107,4082,6025,7.069,17.504,5268,9.123,35.007,632,636,2796
2003,4885,11151,15480,172865,168265,1837,11.990,1520,9.921,37928,14831,23097,8.814,22.541,28476,11230,17246,6.674,16.923,9452,5.617,33.847,913,937,5239
2003,4889,1031,1147,21473,20977,179,15.431,205,17.672,3878,1794,2084,8.552,18.487,2978,1036,1942,4.939,14.197,900,4.291,28.394,165,165,680
2003,4921,2839,8561,444625,475162,2635,34.002,1012,13.059,184780,182290,2490,38.364,38.888,246166,19315,226851,4.065,51.807,-61386,-12.919,77.776,370,372,2488
2003,4922,4175,4572,44045,45043,773,17.081,680,15.026,8422,3342,5080,7.420,18.698,10472,3775,6697,8.381,23.249,-2050,-4.551,37.396,565,574,3015
2003,4931,6681,12008,543016,542983,1186,9.871,1200,9.988,88409,26681,61728,4.914,16.282,88430,28747,59683,5.294,16.286,-21,-0.004,32.564,382,411,5648
2003,5111,15099,20520,694282,701766,1953,9.513,1974,9.615,66196,21468,44728,3.059,9.433,81469,22231,59238,3.168,11.609,-15273,-2.176,18.866,1205,1232,7626
2003,5112,6254,8587,334650,341703,953,10.896,1271,14.532,46436,18740,27696,5.484,13.590,60909,22423,38486,6.562,17.825,-14473,-4.236,27.179,698,729,8832
2003,5121,11698,15276,267483,261561,2180,14.270,2181,14.277,74877,39562,35315,15.125,28.627,61068,17714,43354,6.772,23.348,13809,5.279,46.695,1270,1285,6861
2003,5122,2537,2814,27031,28321,398,14.012,451,15.877,2889,1238,1651,4.371,10.201,5494,2874,2620,10.148,19.399,-2605,-9.198,20.402,328,332,1073
2003,5151,4656,9194,252864,249889,1664,18.960,829,9.446,39686,17511,22175,7.008,15.881,34024,11237,22787,4.497,13.616,5662,2.266,27.231,345,357,3189
2003,5152,316,880,44445,47169,94,10.479,128,14.270,5035,1507,3528,3.195,10.674,10548,2291,8257,4.857,22.362,-5513,-11.688,21.349,40,42,1292
2003,5171,4474,31877,1109735,1130206,3292,10.115,4629,14.223,166945,51413,115532,4.549,14.771,215054,139002,76052,12.299,19.028,-48109,-4.257,29.542,572,582,10835
2003,5172,2532,11695,263975,263435,2628,23.625,1486,13.359,57652,32196,25456,12.222,21.885,55186,21871,33315,8.302,20.949,2466,0.936,41.897,544,602,4484
2003,5174,414,552,13742,14660,81,14.298,110,19.417,1739,549,1190,3.745,11.863,3595,1607,1988,10.962,24.523,-1856,-12.661,23.725,66,68,874
2003,5179,5197,5977,91868,97686,1376,23.173,1298,21.859,18240,7054,11186,7.221,18.672,29724,13494,16230,13.814,30.428,-11484,-11.756,37.344,965,988,7125
2003,5182,6929,12604,401279,409433,2387,19.135,2128,17.059,68390,29612,38778,7.232,16.704,84534,35139,49395,8.582,20.647,-16144,-3.943,33.407,775,793,9296
2003,5191,4331,5224,92393,93441,581,11.086,615,11.734,13365,4745,8620,5.078,14.303,15558,6147,9411,6.578,16.650,-2193,-2.347,28.606,419,431,3394
2003,5211,19,54,22561,22946,(D),(D),0,0.000,473,(D),469,(D),2.061,1217,0,1217,0.000,5.304,-744,-3.242,4.123,0,0,0
2003,5221,16918,113384,2063290,2083691,9569,8.513,7608,6.768,293062,109661,183401,5.263,14.065,336839,103685,233154,4.976,16.165,-43777,-2.101,28.129,492,641,7351
2003,5222,18265,48421,719721,695096,7072,14.890,5223,10.997,176964,70375,106589,10.125,25.459,126570,56845,69725,8.178,18.209,50394,7.250,36.418,1534,1661,8640
2003,5223,20332,30791,307031,289132,5401,18.310,2815,9.543,86948,32536,54412,11.253,30.072,51746,20023,31723,6.925,17.897,35202,12.175,35.794,1617,1702,8895
2003,5231,11894,42956,520027,559141,10071,24.537,6248,15.223,92361,45724,46637,8.178,16.518,178177,69342,108835,12.402,31.866,-85816,-15.348,33.037,1172,1365,6430
2003,5232,50,59,7022,6762,19,35.849,7,13.208,988,702,286,10.382,14.611,473,28,445,0.414,6.995,515,7.616,13.990,(D),(D),(D)
2003,5239,28946,32610,352750,356829,5773,18.023,4617,14.414,69724,36982,32742,10.364,19.540,76786,29444,47342,8.252,21.519,-7062,-1.979,39.080,2904,2928,11586
2003,5241,5451,29529,1496307,1517452,3637,12.130,4545,15.159,191141,61720,129421,4.067,12.596,233138,83992,149146,5.535,15.364,-41997,-2.768,25.192,350,372,6462
2003,5242,114881,127707,865586,844567,12650,9.984,10631,8.391,167585,56313,111272,6.668,19.843,125480,49179,76301,5.823,14.857,42105,4.985,29.715,7153,7271,23369
2003,5250,2278,3347,40571,34506,858,28.633,157,5.239,16202,7338,8864,21.266,46.955,4228,826,3402,2.394,12.253,11974,34.702,24.506,64,64,316
2003,5311,86429,102280,520670,515214,10662,10.459,9976,9.786,102341,43144,59197,8.374,19.864,90959,36097,54862,7.006,17.655,11382,2.209,35.309,6958,7093,23340
2003,5312,57922,65422,297459,284538,10734,16.889,7001,11.016,72811,31350,41461,11.018,25.589,46631,19878,26753,6.986,16.388,26180,9.201,32.777,4406,4511,12575
2003,5313,53880,59941,570058,552395,9277,15.986,5460,9.409,114760,43842,70918,7.937,20.775,79662,29022,50640,5.254,14.421,35098,6.354,28.842,3772,3816,18490
2003,5321,4189,10372,168089,172510,1035,9.682,1670,15.623,22035,7469,14566,4.330,12.773,30633,13224,17409,7.666,17.757,-8598,-4.984,25.546,548,595,3103
2003,5322,12494,31249,271379,262508,2921,9.399,2576,8.289,50749,14815,35934,5.644,19.332,34146,13151,20995,5.010,13.008,16603,6.325,26.015,1442,1592,7030
2003,5323,3306,4863,32684,32546,356,7.219,493,9.997,5606,1772,3834,5.445,17.225,5306,1958,3348,6.016,16.303,300,0.922,32.606,248,279,1066
2003,5324,7232,11839,148739,151904,1221,10.273,1314,11.055,23572,7565,16007,4.980,15.518,30143,10642,19501,7.006,19.843,-6571,-4.326,31.035,638,648,3534
2003,5331,1939,2061,27783,27175,277,13.535,248,12.118,5160,2102,3058,7.735,18.988,3879,1690,2189,6.219,14.274,1281,4.714,28.548,165,166,752
2003,5411,156833,165197,1189409,1166154,14817,9.038,12307,7.507,173224,47844,125380,4.103,14.854,126706,40980,85726,3.514,10.865,46518,3.989,21.731,8756,8865,26655
2003,5412,89331,101702,1245916,1237952,11009,10.936,8934,8.875,252326,77776,174550,6.283,20.383,241200,77243,163957,6.240,19.484,11126,0.899,38.968,5454,5528,32727
2003,5413,82522,94354,1240406,1252032,10357,11.024,9550,10.165,193841,59401,134440,4.744,15.482,218808,58272,160536,4.654,17.476,-24967,-1.994,30.964,5903,5993,26233
2003,5414,25162,25443,116937,117650,3626,14.216,3754,14.718,23132,9559,13573,8.125,19.662,24466,9712,14754,8.255,20.796,-1334,-1.134,39.324,2722,2724,7266
2003,5415,73188,82900,1074038,1088738,15193,18.033,17898,21.243,226315,97895,128420,8.992,20.787,254087,110336,143751,10.134,23.338,-27772,-2.551,41.574,12025,12124,56383
2003,5416,80195,85767,723991,706214,17878,21.246,14641,17.399,180892,74015,106877,10.481,25.614,145910,68502,77408,9.700,20.661,34982,4.953,41.322,10145,10222,35430
2003,5417,10491,13519,608458,606490,1695,12.559,1649,12.218,89045,33089,55956,5.456,14.682,85134,26820,58314,4.422,14.037,3911,0.645,28.074,980,986,8835
2003,5418,29909,33061,404097,404393,3655,10.992,4036,12.138,67703,18529,49174,4.582,16.742,67721,25596,42125,6.329,16.746,-18,-0.004,33.484,2925,2960,16113
2003,5419,52008,59453,538659,529276,7977,13.703,5494,9.438,107006,37217,69789,7.032,20.217,89749,28386,61363,5.363,16.957,17257,3.260,33.914,3487,3505,18279
2003,5511,26441,46477,2789551,2811005,4768,10.196,5342,11.423,483404,142284,341120,5.062,17.197,521708,163162,358546,5.804,18.559,-38304,-1.363,34.394,1132,1201,16072
2003,5611,17839,19700,413856,400687,4232,22.159,3028,15.855,107496,50546,56950,12.615,26.828,80747,33918,46829,8.465,20.152,26749,6.676,40.304,1832,1852,20551
2003,5612,1704,3176,138052,139260,489,15.492,450,14.256,27290,11798,15492,8.472,19.596,30063,14189,15874,10.189,21.588,-2773,-1.991,39.193,129,133,2140
2003,5613,26053,43171,3709898,3794481,5903,13.519,6892,15.784,930302,204897,725405,5.400,24.517,1093604,374989,718615,9.882,28.821,-163302,-4.304,49.034,3400,3527,160278
2003,5614,26016,31163,754864,749433,4094,13.187,3860,12.433,155382,53590,101792,7.151,20.733,143777,53405,90372,7.126,19.185,11605,1.549,38.370,2686,2824,25032
2003,5615,17445,23758,278705,282770,2550,10.189,5088,20.330,51279,19043,32236,6.734,18.135,59897,23911,35986,8.456,21.182,-8618,-3.048,36.269,2325,2377,8594
2003,5616,16597,20891,738973,740136,2508,12.066,2298,11.056,163930,48529,115401,6.557,22.149,163410,40555,122855,5.479,22.078,520,0.070,44.157,1532,1548,19542
2003,5617,119113,125346,1539925,1529387,19401,15.593,17552,14.107,302495,93872,208623,6.138,19.779,280060,98292,181768,6.427,18.312,22435,1.467,36.624,11633,11666,55876
2003,5619,16438,18504,342968,339275,2098,11.257,2365,12.689,73351,16998,56353,5.010,21.620,64936,23465,41471,6.916,19.140,8415,2.480,38.279,1609,1642,10325
2003,5621,6208,7936,176910,173329,708,8.897,751,9.438,24810,6979,17831,4.026,14.314,17817,7809,10008,4.505,10.279,6993,4.035,20.559,490,492,3653
2003,5622,1423,2396,53684,52390,268,11.239,245,10.275,9756,3971,5785,7.580,18.622,7282,3264,4018,6.230,13.900,2474,4.722,27.799,135,135,1218
2003,5629,6154,6814,100280,100135,732,10.789,674,9.934,21509,5903,15606,5.895,21.480,21093,5729,15364,5.721,21.065,416,0.415,42.129,464,472,3717
2003,6111,17785,19856,803545,788961,1013,5.234,13,0.067,79435,15102,64333,1.914,10.068,50282,57,50225,0.007,6.373,29153,3.695,12.746,5,5,25
2003,6112,548,853,92751,91668,38,4.556,0,0.000,11043,344,10699,0.375,12.047,9027,0,9027,0.000,9.847,2016,2.199,19.695,0,0,0
2003,6113,2425,3235,1443045,1423324,205,6.544,0,0.000,106964,4401,102563,0.309,7.515,68042,0,68042,0.000,4.781,38922,2.735,9.561,0,0,0
2003,6114,5940,6478,64278,65734,880,13.258,1199,18.064,12863,4604,8259,7.004,19.568,15550,7637,7913,11.618,23.656,-2687,-4.088,39.137,788,823,5739
2003,6115,5710,6762,94355,92603,766,11.470,599,8.969,18618,5281,13337,5.703,20.105,15093,5071,10022,5.476,16.299,3525,3.807,32.597,406,424,2659
2003,6116,24398,26360,235239,225840,4110,16.088,2484,9.723,56607,19397,37210,8.589,25.065,38182,12594,25588,5.577,16.907,18425,8.158,33.813,1777,1808,9362
2003,6117,3890,4330,49753,48482,899,21.574,573,13.751,12337,5071,7266,10.460,25.447,9794,3638,6156,7.504,20.202,2543,5.245,40.403,391,393,1414
2003,6211,167093,190193,1958463,1915815,17209,9.154,12828,6.823,324886,100833,224053,5.263,16.958,239082,74694,164388,3.899,12.479,85804,4.479,24.959,8606,8817,40457
2003,6212,109208,113849,771714,759304,6447,5.717,4271,3.788,112524,32692,79832,4.306,14.819,87341,22959,64382,3.024,11.503,25183,3.317,23.006,3187,3221,17581
2003,6213,88363,96201,516008,499681,10823,11.467,7194,7.622,108795,38394,70401,7.684,21.773,76049,26174,49875,5.238,15.220,32746,6.553,30.439,4941,5043,15962
2003,6214,12171,24148,622411,599628,2353,9.753,2311,9.578,121017,31247,89770,5.211,20.182,75690,32794,42896,5.469,12.623,45327,7.559,25.246,684,740,7835
2003,6215,6372,9729,201061,196965,1340,13.507,1724,17.377,41249,17588,23661,8.930,20.942,32661,16567,16094,8.411,16.582,8588,4.360,33.164,497,1129,11081
2003,6216,11330,16408,804365,778915,2424,15.151,1606,10.038,154086,39230,114856,5.036,19.782,103390,29787,73603,3.824,13.274,50696,6.509,26.547,974,1040,15123
2003,6219,5297,8228,224014,217845,822,10.046,731,8.934,40869,12941,27928,5.940,18.761,28683,9894,18789,4.542,13.167,12186,5.594,26.333,384,391,4203
2003,6221,3235,5295,4772703,4731813,172,3.271,99,1.883,269208,47668,221540,1.007,5.689,187791,45939,141852,0.971,3.969,81417,1.721,7.937,34,34,10033
2003,6222,489,624,214266,214021,38,6.139,28,4.523,12272,5613,6659,2.623,5.734,11332,6495,4837,3.035,5.295,940,0.439,10.590,9,9,3059
2003,6223,376,657,185735,184902,86,13.375,58,9.020,15882,4609,11273,2.493,8.589,14440,9881,4559,5.344,7.810,1442,0.780,15.619,13,13,2361
2003,6231,8256,15751,1598719,1588890,1064,6.772,986,6.275,173252,61366,111886,3.862,10.904,153315,62853,90462,3.956,9.649,19937,1.255,19.298,467,535,30033
2003,6232,7943,27836,516377,501403,1916,6.945,1421,5.151,90775,19975,70800,3.984,18.104,60464,16550,43914,3.301,12.059,30311,6.045,24.118,366,429,5844
2003,6233,12783,16891,592499,576820,1753,10.416,1631,9.691,86814,28632,58182,4.964,15.050,55259,24348,30911,4.221,9.580,31555,5.471,19.160,1184,1202,15556
2003,6239,3395,5956,159501,157177,445,7.467,452,7.585,24612,6009,18603,3.823,15.659,19897,5482,14415,3.488,12.659,4715,3.000,25.318,171,188,2171
2003,6241,34367,47710,931642,913693,4253,9.009,3247,6.878,151518,33714,117804,3.690,16.583,115347,25765,89582,2.820,12.624,36171,3.959,25.249,1753,1822,11109
2003,6242,9124,12250,152514,150221,722,5.918,623,5.106,21788,4471,17317,2.976,14.504,17065,4160,12905,2.769,11.360,4723,3.144,22.720,297,301,1923
2003,6243,5006,8017,325804,322957,537,6.679,583,7.251,49530,6911,42619,2.140,15.336,43671,7740,35931,2.397,13.522,5859,1.814,27.044,189,206,1857
2003,6244,51198,64769,772089,759153,7174,11.182,5944,9.265,132490,46048,86442,6.066,17.452,107343,35747,71596,4.709,14.140,25147,3.313,28.280,4253,4305,23138
2003,7111,7478,7643,131428,130689,973,12.761,936,12.276,28273,6730,21543,5.150,21.634,26909,6795,20114,5.199,20.590,1364,1.044,41.180,643,643,4309
2003,7112,3165,3332,111378,107958,557,16.782,531,15.999,23703,8182,15521,7.579,21.956,17189,5776,11413,5.350,15.922,6514,6.034,31.844,422,425,4039
2003,7113,4180,4441,98022,95624,632,14.484,477,10.932,24252,7032,17220,7.354,25.362,19167,7772,11395,8.128,20.044,5085,5.318,40.088,308,309,5446
2003,7114,2584,2648,15715,15416,424,16.100,395,14.999,3444,1607,1837,10.425,22.341,2754,1191,1563,7.726,17.865,690,4.476,35.730,286,286,914
2003,7115,11037,11058,41665,41441,2386,22.105,1858,17.213,14384,6936,7448,16.737,34.710,13959,5349,8610,12.908,33.684,425,1.026,67.368,1108,1108,3145
2003,7121,5714,6154,120174,123941,490,8.069,327,5.385,12916,1799,11117,1.452,10.421,20966,1251,19715,1.009,16.916,-8050,-6.495,20.842,187,187,789
2003,7131,1720,2388,133294,127515,298,12.238,392,16.099,27726,3445,24281,2.702,21.743,15391,5247,10144,4.115,12.070,12335,9.673,24.140,229,229,2364
2003,7132,1577,1993,162171,159583,223,11.351,166,8.450,19963,7037,12926,4.410,12.509,15069,4886,10183,3.062,9.443,4894,3.067,18.885,116,122,4151
2003,7139,45981,50961,1019234,1004809,6633,13.249,4843,9.673,175592,57769,117823,5.749,17.475,146114,42594,103520,4.239,14.541,29478,2.934,29.083,3461,3506,27087
2003,7211,35740,45735,1745450,1717382,4512,9.914,4069,8.940,243829,88640,155189,5.161,14.198,189309,65593,123716,3.819,11.023,54520,3.175,22.046,2554,2630,34218
2003,7212,5015,5462,37117,36886,509,9.277,558,10.170,6847,1660,5187,4.500,18.563,6334,1885,4449,5.110,17.172,513,1.391,34.344,315,316,1083
2003,7213,2332,2411,13281,13050,144,5.887,214,8.749,2146,494,1652,3.786,16.445,1712,540,1172,4.138,13.119,434,3.326,26.239,153,153,350
2003,7223,10658,27585,556402,553914,4604,16.608,4877,17.593,132199,68106,64093,12.295,23.866,126918,75179,51739,13.572,22.913,5281,0.953,45.826,1346,1382,8105
2003,7224,42993,43495,351650,344663,5234,12.015,5367,12.321,81977,38171,43806,11.075,23.785,68006,27694,40312,8.035,19.731,13971,4.054,39.462,4308,4320,22901
2003,7225,280743,387083,7729076,7583402,50085,13.120,39398,10.321,1459246,688501,770745,9.079,19.243,1168459,436521,731938,5.756,15.408,290787,3.835,30.816,27658,28525,265244
2003,8111,139247,151973,892328,881904,14920,9.822,14786,9.734,164840,59474,105366,6.744,18.691,144122,54932,89190,6.229,16.342,20718,2.349,32.684,10474,10675,37737
2003,8112,11286,12802,132722,133112,1312,10.107,1670,12.865,24111,6232,17879,4.682,18.113,25215,9065,16150,6.810,18.943,-1104,-0.829,36.227,1198,1204,4770
2003,8113,20684,21843,171574,171201,2013,9.151,2324,10.564,30240,8946,21294,5.225,17.663,29234,10748,18486,6.278,17.076,1006,0.588,34.152,1682,1705,6526
2003,8114,20916,22140,110251,112435,2825,12.823,2607,11.833,21686,6925,14761,6.159,19.288,25546,7770,17776,6.911,22.721,-3860,-3.433,38.575,1946,1958,4909
2003,8121,77033,90314,550716,539011,12623,14.187,9949,11.182,111399,52094,59305,9.665,20.667,88340,38720,49620,7.184,16.389,23059,4.278,32.779,7360,7759,28520
2003,8122,14709,20885,145193,145223,888,4.227,1134,5.398,16136,3115,13021,2.145,11.111,16367,4169,12198,2.871,11.270,-231,-0.159,22.222,464,478,1632
2003,8123,32179,38101,364889,367658,3638,9.511,3940,10.300,53211,16430,36781,4.469,14.473,58228,22872,35356,6.221,15.838,-5017,-1.365,28.946,2772,2860,13690
2003,8129,22148,33170,238990,234052,6122,19.021,4152,12.900,55842,23906,31936,10.214,23.859,46281,20029,26252,8.558,19.774,9561,4.085,39.548,2405,2428,11214
2003,8131,166733,166968,1657624,1634169,9029,5.555,143,0.088,180461,27178,153283,1.663,11.043,133754,345,133409,0.021,8.185,46707,2.858,16.370,81,81,175
2003,8132,12117,14071,142356,141536,1190,8.552,879,6.317,18390,4210,14180,2.975,12.993,16929,2847,14082,2.012,11.961,1461,1.032,23.922,585,586,1643
2003,8133,9892,11996,109528,107063,1183,10.008,831,7.030,19132,3916,15216,3.658,17.870,13821,3031,10790,2.831,12.909,5311,4.961,25.819,486,503,1890
2003,8134,27861,29890,320246,317536,1591,5.337,1438,4.823,43080,7129,35951,2.245,13.567,37559,6177,31382,1.945,11.828,5521,1.739,23.657,967,972,3485
2003,8139,59670,61704,521308,511003,3139,5.128,2164,3.535,75767,15311,60456,2.996,14.827,55378,6779,48599,1.327,10.837,20389,3.990,21.674,1507,1510,4565
2004,2111,5590,6656,80173,80576,606,9.077,647,9.691,13781,6551,7230,8.130,17.103,14246,6542,7704,8.119,17.680,-465,-0.577,34.206,324,329,2471
2004,2121,624,1013,69471,69281,115,11.084,164,15.807,11639,3773,7866,5.446,16.800,11334,5466,5868,7.890,16.359,305,0.440,32.719,82,88,1704
2004,2122,190,260,25584,25177,40,15.355,41,15.739,3150,1273,1877,5.056,12.512,2331,369,1962,1.466,9.259,819,3.253,18.517,29,29,131
2004,2123,3196,5175,94123,92824,397,7.677,389,7.523,12320,3553,8767,3.828,13.272,9817,3026,6791,3.260,10.576,2503,2.697,21.152,194,200,955
2004,2131,7088,8567,196716,191817,968,11.471,712,8.437,33066,8087,24979,4.216,17.238,23197,7120,16077,3.712,12.093,9869,5.145,24.187,465,478,4301
2004,2211,1586,9605,504408,517711,787,8.183,813,8.453,42302,16190,26112,3.127,8.171,68749,17559,51190,3.392,13.279,-26447,-5.108,16.342,57,60,492
2004,2212,499,2478,82864,85703,102,4.015,227,8.935,7111,1946,5165,2.271,8.297,12739,3404,9335,3.972,14.864,-5628,-6.567,16.595,29,29,196
2004,2213,4333,5160,42220,41940,350,6.802,321,6.238,6293,2752,3541,6.562,15.005,5800,2457,3343,5.858,13.829,493,1.175,27.659,197,197,738
2004,2361,148403,149339,855893,824564,28313,19.483,20285,13.958,225709,85550,140159,10.375,27.373,162737,67261,95476,8.157,19.736,62972,7.637,39.472,13580,13582,48108
2004,2362,37761,38728,707085,705518,4282,11.073,4170,10.783,131762,26989,104773,3.825,18.676,129156,33707,95449,4.778,18.307,2606,0.369,36.613,3040,3046,24837
2004,2371,18174,18870,454024,456422,1570,8.262,1834,9.652,91916,14614,77302,3.202,20.138,96711,15492,81219,3.394,21.189,-4795,-1.051,40.277,1305,1307,10953
2004,2372,9727,9824,67687,65380,1395,14.085,1556,15.710,18563,7160,11403,10.951,28.393,13990,7195,6795,11.005,21.398,4573,6.995,42.796,1196,1196,5327
2004,2373,9915,10639,311323,307504,901,8.440,973,9.115,52893,8338,44555,2.712,17.201,45602,11656,33946,3.791,14.830,7291,2.371,29.659,644,645,7107
2004,2379,4206,4395,81175,81898,619,14.059,635,14.422,15858,3949,11909,4.822,19.363,16968,6526,10442,7.968,20.718,-1110,-1.355,38.726,448,448,2165
2004,2381,92749,93223,1043996,1009885,14298,15.527,12025,13.058,261156,66845,194311,6.619,25.860,192914,62591,130323,6.198,19.103,68242,6.757,38.205,8293,8299,47457
2004,2382,148438,151463,1777982,1757435,17644,11.797,13839,9.253,333198,79954,253244,4.549,18.959,292573,87873,204700,5.000,16.648,40625,2.312,33.295,9944,9992,57974
2004,2383,100364,101276,856129,831641,18368,18.500,14390,14.493,211793,61900,149893,7.443,25.467,163515,57474,106041,6.911,19.662,48278,5.805,39.323,10238,10246,42296
2004,2389,51530,51930,464430,443640,10059,20.127,6156,12.317,115183,38713,76470,8.726,25.963,73963,25696,48267,5.792,16.672,41220,9.291,33.344,4180,4183,18332
2004,3111,1160,1711,46986,46311,102,5.929,121,7.033,6112,2450,3662,5.290,13.198,4809,1686,3123,3.641,10.384,1303,2.814,20.769,57,59,843
2004,3112,461,783,54813,55471,48,6.146,44,5.634,3079,808,2271,1.457,5.551,4484,502,3982,0.905,8.084,-1405,-2.533,11.101,24,24,236
2004,3113,1526,1696,78567,78829,152,9.034,125,7.429,8440,2384,6056,3.024,10.707,9024,2316,6708,2.938,11.448,-584,-0.741,21.413,87,88,873
2004,3114,1251,1640,163549,163233,120,7.308,124,7.552,15678,4113,11565,2.520,9.605,15292,5119,10173,3.136,9.368,386,0.236,18.736,79,79,692
2004,3115,1044,1546,133675,133146,92,5.941,97,6.264,10827,2058,8769,1.546,8.132,9540,1783,7757,1.339,7.165,1287,0.967,14.330,62,62,484
2004,3116,3060,3676,491098,491953,226,6.127,251,6.805,35126,10285,24841,2.091,7.140,37996,12904,25092,2.623,7.724,-2870,-0.583,14.280,172,174,2303
2004,3117,555,649,37581,38177,45,6.860,59,8.994,3753,642,3111,1.682,9.831,5036,1314,3722,3.442,13.191,-1283,-3.361,19.661,42,42,448
2004,3118,9312,10183,304199,309526,833,8.108,1015,9.879,34753,8035,26718,2.596,11.228,45263,14581,30682,4.711,14.623,-10510,-3.396,22.456,788,792,6368
2004,3119,2803,3219,163714,164458,257,8.059,197,6.177,18217,5442,12775,3.309,11.077,19407,3832,15575,2.330,11.801,-1190,-0.724,22.154,127,127,1658
2004,3121,2320,2831,131429,131737,308,11.018,237,8.478,11780,2602,9178,1.975,8.942,12354,3318,9036,2.519,9.378,-574,-0.436,17.884,147,147,1271
2004,3122,103,127,21802,22580,16,13.223,4,3.306,866,190,676,0.841,3.835,2487,22,2465,0.097,11.014,-1621,-7.179,7.671,3,3,21
2004,3131,335,511,54951,57413,29,5.572,48,9.222,3245,941,2304,1.639,5.652,8243,2783,5460,4.847,14.357,-4998,-8.705,11.304,27,27,455
2004,3132,1237,1461,114581,124904,72,4.771,168,11.133,5394,656,4738,0.525,4.319,26493,10813,15680,8.657,21.211,-21099,-16.892,8.637,115,117,2119
2004,3133,1321,1408,54484,57205,110,7.650,170,11.822,5310,2147,3163,3.753,9.282,10663,3501,7162,6.120,18.640,-5353,-9.358,18.565,130,133,1841
2004,3141,2430,2613,95005,97387,185,6.985,256,9.666,10272,4907,5365,5.039,10.548,15113,6575,8538,6.751,15.519,-4841,-4.971,21.095,191,192,1531
2004,3149,4408,4544,83626,85277,388,8.462,470,10.251,11568,3095,8473,3.629,13.565,14979,5493,9486,6.441,17.565,-3411,-4.000,27.130,366,367,3843
2004,3151,575,626,37818,40909,48,7.229,124,18.675,2624,809,1815,1.978,6.414,8747,3553,5194,8.685,21.382,-6123,-14.968,12.829,102,102,1661
2004,3152,8040,8235,206583,212762,1486,17.746,1763,21.055,41139,17071,24068,8.024,19.336,53896,27842,26054,13.086,25.332,-12757,-5.996,38.671,1497,1503,19604
2004,3159,1036,1070,27163,27149,95,8.664,148,13.497,4980,570,4410,2.100,18.344,4688,2111,2577,7.776,17.268,292,1.076,34.536,114,114,1575
2004,3161,213,223,7928,8271,22,9.821,24,10.714,779,277,502,3.349,9.419,1428,234,1194,2.829,17.266,-649,-7.847,18.838,18,18,114
2004,3162,275,306,16135,16407,28,9.091,32,10.390,1562,542,1020,3.304,9.521,2135,249,1886,1.518,13.013,-573,-3.493,19.041,26,26,222
2004,3169,790,803,17187,17124,87,10.774,96,11.889,2584,1210,1374,7.066,15.090,2386,875,1511,5.110,13.934,198,1.156,27.867,78,80,730
2004,3211,3544,3954,111527,111548,303,7.651,316,7.979,12279,3105,9174,2.784,11.008,12336,5226,7110,4.685,11.059,-57,-0.051,22.016,219,220,2524
2004,3212,1465,1847,112853,111676,106,5.728,113,6.106,12304,2113,10191,1.892,11.018,9869,3926,5943,3.516,8.837,2435,2.180,17.674,69,69,1218
2004,3219,9294,10149,312889,310262,871,8.533,988,9.679,39991,9339,30652,3.010,12.889,34714,13156,21558,4.240,11.189,5277,1.701,22.377,733,734,6536
2004,3221,297,609,149648,152213,40,6.623,30,4.967,8078,1497,6581,0.983,5.307,12904,3332,9572,2.189,8.478,-4826,-3.171,10.614,8,8,1128
2004,3222,3109,4668,315565,322097,192,4.077,275,5.839,20210,5302,14908,1.646,6.275,33076,10456,22620,3.246,10.269,-12866,-3.994,12.549,158,160,2697
2004,3231,31625,33290,673570,685610,1901,5.627,2888,8.549,60485,14103,46382,2.057,8.822,84465,26640,57825,3.886,12.320,-23980,-3.498,17.644,2301,2320,16865
2004,3241,1042,2324,99521,97909,269,11.780,188,8.233,11463,5145,6318,5.255,11.708,8138,2011,6127,2.054,8.312,3325,3.396,16.624,51,51,537
2004,3251,1165,2322,168934,172348,129,5.559,126,5.430,10082,3381,6701,1.962,5.850,16768,3075,13693,1.784,9.729,-6686,-3.879,11.700,52,52,655
2004,3252,660,994,94888,97024,81,8.240,59,6.002,7773,4668,3105,4.811,8.011,12153,1523,10630,1.570,12.526,-4380,-4.514,16.023,38,39,635
2004,3253,624,871,30824,30665,78,8.976,74,8.516,3629,1371,2258,4.471,11.835,3273,809,2464,2.638,10.674,356,1.161,21.347,38,39,215
2004,3254,1362,1751,242399,245889,126,7.200,124,7.086,20989,5333,15656,2.169,8.536,28363,8182,20181,3.328,11.535,-7374,-2.999,17.072,75,76,1319
2004,3255,1487,1893,65952,66821,111,5.870,107,5.658,6067,1456,4611,2.179,9.080,7818,2157,5661,3.228,11.700,-1751,-2.620,18.159,75,75,1273
2004,3256,1947,2188,106130,108134,144,6.554,162,7.374,9098,2305,6793,2.132,8.414,13241,3210,10031,2.969,12.245,-4143,-3.831,16.827,110,111,1429
2004,3259,2109,2744,113652,114070,153,5.539,189,6.843,10187,2095,8092,1.837,8.931,10990,3299,7691,2.892,9.634,-803,-0.704,17.861,114,114,888
2004,3261,9551,12084,733439,739779,576,4.731,756,6.210,67484,13431,54053,1.816,9.122,80430,21562,58868,2.915,10.872,-12946,-1.750,18.244,460,463,7596
2004,3262,1744,2247,164921,168548,103,4.551,135,5.966,10173,1454,8719,0.863,6.036,17369,3335,14034,1.979,10.305,-7196,-4.269,12.071,89,89,881
2004,3271,1243,1444,56021,58089,102,6.967,142,9.699,3985,876,3109,1.508,6.860,8054,2725,5329,4.691,13.865,-4069,-7.005,13.720,104,108,1016
2004,3272,1732,2044,108247,109552,148,7.214,163,7.945,8663,2144,6519,1.957,7.908,11101,3932,7169,3.589,10.133,-2438,-2.225,15.815,111,111,792
2004,3273,4962,9119,211304,209170,447,4.894,478,5.233,27207,5692,21515,2.721,13.007,22803,5817,16986,2.781,10.902,4404,2.105,21.803,248,255,2996
2004,3274,223,341,18537,17520,23,6.715,26,7.591,3412,170,3242,0.970,19.475,1179,277,902,1.581,6.730,2233,12.746,13.459,19,19,121
2004,3279,2469,2875,73206,72793,286,10.090,205,7.232,9878,2997,6881,4.117,13.570,8919,2398,6521,3.294,12.253,959,1.317,24.505,129,129,916
2004,3311,490,606,108435,115546,123,20.812,93,15.736,9166,5146,4020,4.454,7.933,23193,12525,10668,10.840,20.073,-14027,-12.140,15.866,72,72,3761
2004,3312,503,643,45603,47897,49,7.402,87,13.142,3411,738,2673,1.541,7.122,7855,3700,4155,7.725,16.400,-4444,-9.278,14.243,48,50,1230
2004,3313,413,558,64590,65505,44,7.921,39,7.021,3087,984,2103,1.502,4.713,4940,845,4095,1.290,7.541,-1853,-2.829,9.425,30,30,248
2004,3314,741,938,61411,62179,46,4.834,73,7.672,5520,2381,3139,3.829,8.878,7088,2464,4624,3.963,11.399,-1568,-2.522,17.755,38,39,736
2004,3315,1994,2252,164072,167228,107,4.667,188,8.201,12029,2577,9452,1.541,7.193,18295,6529,11766,3.904,10.940,-6266,-3.747,14.386,134,142,3200
2004,3321,2403,2651,120334,121809,95,3.545,153,5.709,10506,1964,8542,1.612,8.625,13376,4213,9163,3.459,10.981,-2870,-2.356,17.250,104,104,1319
2004,3322,1310,1436,56021,58215,83,5.728,109,7.522,3725,734,2991,1.261,6.399,8140,1842,6298,3.164,13.983,-4415,-7.584,12.797,70,70,474
2004,3323,11598,12504,369327,367714,725,5.733,1008,7.971,46258,9450,36808,2.570,12.580,42962,12746,30216,3.466,11.684,3296,0.896,23.367,752,756,7373
2004,3324,1252,1550,89406,89266,71,4.591,64,4.138,8378,1939,6439,2.172,9.385,8115,1756,6359,1.967,9.091,263,0.295,18.182,42,42,607
2004,3325,717,799,52605,54476,47,5.864,52,6.488,3459,727,2732,1.335,6.350,7065,1586,5479,2.911,12.969,-3606,-6.619,12.699,38,38,316
2004,3326,1631,1821,60091,60450,78,4.255,102,5.565,5523,1188,4335,1.965,9.136,6261,1883,4378,3.115,10.357,-738,-1.221,18.273,68,68,798
2004,3327,23077,23518,362247,360540,1284,5.407,1742,7.336,43495,8439,35056,2.341,12.064,40085,11305,28780,3.136,11.118,3410,0.946,22.236,1284,1288,6732
2004,3328,5370,5908,132448,133950,346,5.811,438,7.356,14859,3902,10957,2.913,11.093,17832,6079,11753,4.538,13.312,-2973,-2.219,22.186,290,304,3001
2004,3329,5672,6202,267674,270330,451,7.257,476,7.660,24712,4549,20163,1.683,9.141,30487,10605,19882,3.923,11.278,-5775,-2.136,18.283,337,339,4816
2004,3331,2474,2770,171844,171466,188,6.830,153,5.559,15566,3507,12059,2.045,9.078,15083,4188,10895,2.442,8.796,483,0.282,17.593,100,100,1269
2004,3332,3686,3896,137160,140601,249,6.332,322,8.188,13432,3913,9519,2.783,9.553,20323,6893,13430,4.903,14.454,-6891,-4.901,19.107,229,230,2104
2004,3333,2069,2227,102754,105280,149,6.616,199,8.837,9346,1837,7509,1.745,8.877,14166,2428,11738,2.306,13.456,-4820,-4.578,17.755,137,138,1484
2004,3334,1434,1724,146314,149262,102,5.872,128,7.369,11662,2598,9064,1.741,7.813,18014,5147,12867,3.448,12.069,-6352,-4.256,15.626,84,86,919
2004,3335,7846,8146,175829,179585,374,4.514,654,7.893,16915,4085,12830,2.275,9.419,24587,9221,15366,5.135,13.691,-7672,-4.272,18.838,476,480,4155
2004,3336,732,880,88507,90315,45,5.114,45,5.114,5158,285,4873,0.316,5.711,8734,1715,7019,1.899,9.671,-3576,-3.959,11.422,28,28,299
2004,3339,5475,6153,279232,282809,351,5.672,421,6.803,22544,6501,16043,2.299,7.971,29725,10177,19548,3.599,10.511,-7181,-2.539,15.943,282,287,4957
2004,3341,1295,1376,109005,116428,154,11.091,179,12.892,8809,2151,6658,1.847,7.566,23888,7889,15999,6.776,20.517,-15079,-12.951,15.132,135,137,2410
2004,3342,1577,1784,140938,144297,139,7.707,178,9.870,19412,4576,14836,3.171,13.453,26852,11306,15546,7.835,18.609,-7440,-5.156,26.906,102,102,2970
2004,3343,469,485,22135,22577,42,8.537,56,11.382,1997,383,1614,1.696,8.845,2874,755,2119,3.344,12.730,-877,-3.885,17.691,41,41,329
2004,3344,4189,4741,363830,373266,261,5.381,480,9.896,32896,6911,25985,1.851,8.813,51511,17192,34319,4.606,13.800,-18615,-4.987,17.626,315,321,6451
2004,3345,4287,4938,403765,400662,334,6.750,355,7.174,42307,10157,32150,2.535,10.559,35094,11406,23688,2.847,8.759,7213,1.800,17.518,228,232,2940
2004,3346,742,793,33359,34806,81,10.068,104,12.927,3369,1056,2313,3.034,9.680,6218,2734,3484,7.855,17.865,-2849,-8.185,19.359,81,81,674
2004,3351,1053,1151,60670,61413,75,6.479,88,7.603,4817,1426,3391,2.322,7.844,6338,1584,4754,2.579,10.320,-1521,-2.477,15.687,67,67,690
2004,3352,264,321,87080,88796,32,10.095,24,7.571,4508,125,4383,0.141,5.077,7684,1162,6522,1.309,8.654,-3176,-3.577,10.154,17,17,153
2004,3353,2005,2344,136349,140842,130,5.476,190,8.003,10800,3835,6965,2.723,7.668,19696,6523,13173,4.631,13.984,-8896,-6.316,15.336,113,118,1455
2004,3359,1847,2172,152436,155180,157,7.212,167,7.671,14122,3140,10982,2.023,9.100,19617,7277,12340,4.689,12.641,-5495,-3.541,18.201,91,92,1146
2004,3361,280,353,214867,210727,38,10.983,24,6.936,26960,12052,14908,5.719,12.794,18326,5715,12611,2.712,8.697,8634,4.097,17.393,19,19,295
2004,3362,1808,2053,142600,137480,181,8.864,159,7.786,21564,5461,16103,3.972,15.685,11425,3891,7534,2.830,8.310,10139,7.375,16.621,122,123,2193
2004,3363,4346,5463,681869,684942,330,6.018,371,6.766,57352,12271,45081,1.792,8.373,62716,14198,48518,2.073,9.156,-5364,-0.783,16.747,236,251,4892
2004,3364,1156,1506,361171,366514,111,7.400,99,6.600,20664,6470,14194,1.765,5.638,31493,3974,27519,1.084,8.593,-10829,-2.955,11.276,66,68,1210
2004,3365,144,197,24909,25296,14,7.071,16,8.081,2793,606,2187,2.396,11.041,3562,1169,2393,4.621,14.081,-769,-3.040,22.083,10,10,650
2004,3366,1524,1647,140861,138024,158,9.584,161,9.766,15054,3251,11803,2.355,10.907,9270,3163,6107,2.292,6.716,5784,4.191,13.432,109,109,1662
2004,3369,714,742,37493,37461,110,15.038,89,12.167,4495,1245,3250,3.324,11.999,4492,1000,3492,2.669,11.991,3,0.008,23.983,65,65,451
2004,3371,14511,15011,364917,367078,1237,8.160,1534,10.119,40551,9574,30977,2.608,11.047,44296,15643,28653,4.261,12.067,-3745,-1.020,22.094,1154,1162,8033
2004,3372,3817,4010,148601,151958,244,5.998,360,8.850,14415,3211,11204,2.113,9.486,20931,5556,15375,3.656,13.774,-6516,-4.288,18.972,286,288,3308
2004,3379,908,1043,47102,46398,77,7.365,82,7.843,6538,1853,4685,3.994,14.091,5058,1596,3462,3.440,10.901,1480,3.190,21.803,62,62,599
2004,3391,10689,11406,293124,293786,795,6.994,718,6.316,31766,5453,26313,1.856,10.813,33482,9403,24079,3.201,11.397,-1716,-0.584,21.625,521,523,3488
2004,3399,17660,18139,392193,398023,1540,8.471,1620,8.911,43223,11630,31593,2.922,10.859,54703,15003,39700,3.769,13.744,-11480,-2.884,21.719,1270,1273,9190
2004,4231,17867,24163,361873,360064,1913,7.910,1957,8.092,42376,12522,29854,3.478,11.769,38555,12204,26351,3.389,10.708,3821,1.061,21.416,1266,1350,6717
2004,4232,11205,12734,160710,161256,1271,10.053,1088,8.606,21473,6824,14649,4.232,13.316,22525,5931,16594,3.678,13.968,-1052,-0.652,26.632,812,833,3506
2004,4233,11709,17057,244753,237960,1438,8.518,1089,6.450,37074,9829,27245,4.131,15.580,23496,8130,15366,3.417,9.874,13578,5.706,19.748,717,736,4551
2004,4234,25816,34551,701932,701234,4519,13.239,3687,10.801,117132,52226,64906,7.448,16.704,116714,40885,75829,5.830,16.644,418,0.060,33.288,2287,2381,16745
2004,4235,7343,9986,146488,146482,598,5.939,763,7.578,16595,3757,12838,2.565,11.329,16727,5316,11411,3.629,11.419,-132,-0.090,22.658,454,462,2770
2004,4236,19975,29117,464305,464441,2530,8.651,2788,9.533,76579,30861,45718,6.645,16.488,77696,30502,47194,6.567,16.729,-1117,-0.241,32.977,1442,1492,8176
2004,4237,11194,18010,215626,212715,1210,6.711,1249,6.928,28423,6857,21566,3.224,13.362,22612,8407,14205,3.952,10.630,5811,2.732,21.260,608,623,3356
2004,4238,43261,57987,689286,688353,3584,6.142,4319,7.401,82786,22421,60365,3.257,12.027,80668,29852,50816,4.337,11.719,2118,0.308,23.438,2688,2869,17986
2004,4239,28490,31376,330606,327827,3579,11.453,3328,10.649,52610,15955,36655,4.867,16.048,47532,17937,29595,5.471,14.499,5078,1.549,28.998,2556,2603,12370
2004,4241,9558,12185,204265,212053,947,7.790,890,7.321,24779,10395,14384,4.902,11.685,39062,24862,14200,11.724,18.421,-14283,-6.736,23.371,585,596,3556
2004,4242,5661,7286,269554,260602,851,11.879,607,8.473,43876,12435,31441,4.772,16.836,26272,7882,18390,3.025,10.081,17604,6.755,20.163,439,444,3162
2004,4243,14032,15149,193893,194817,1796,11.868,1764,11.657,30009,9397,20612,4.824,15.404,31942,10786,21156,5.536,16.396,-1933,-0.992,30.807,1350,1367,6506
2004,4244,26262,32152,769883,760889,2982,9.298,2819,8.790,113572,31490,82082,4.139,14.926,95933,38067,57866,5.003,12.608,17639,2.318,25.216,2084,2105,15022
2004,4245,4254,6783,64773,64752,340,4.970,455,6.652,8672,3020,5652,4.664,13.393,8746,2622,6124,4.049,13.507,-74,-0.114,26.785,269,279,1286
2004,4246,8671,12185,151337,148524,773,6.294,967,7.873,26744,14302,12442,9.629,18.007,21397,6748,14649,4.543,14.406,5347,3.600,28.813,564,576,2773
2004,4247,5192,7229,106924,106284,443,6.020,703,9.553,16513,6200,10313,5.833,15.537,15250,5708,9542,5.371,14.348,1263,1.188,28.697,355,375,2394
2004,4248,3230,4028,170774,168299,302,7.548,248,6.198,17146,5258,11888,3.124,10.188,12405,3847,8558,2.286,7.371,4741,2.817,14.742,185,196,2776
2004,4249,23342,29089,383260,380867,2990,10.290,2925,10.067,58920,19638,39282,5.156,15.470,54831,19651,35180,5.160,14.396,4089,1.074,28.793,2170,2210,11195
2004,4251,32146,34068,272319,268466,4067,12.103,3137,9.335,43701,14844,28857,5.529,16.278,35822,11153,24669,4.154,13.343,7879,2.935,26.686,2218,2238,7401
2004,4411,43907,48225,1297054,1291013,4553,9.485,4105,8.552,134633,45323,89310,3.511,10.428,122442,40436,82006,3.132,9.484,12191,0.944,18.968,3214,3265,29732
2004,4412,13366,14806,159413,153400,1622,11.072,1310,8.942,29865,9363,20502,6.104,19.469,17771,7554,10217,4.924,11.585,12094,7.884,23.169,1015,1044,5437
2004,4413,32233,55952,492096,488096,3851,6.897,3622,6.487,67352,21050,46302,4.313,13.799,59860,18992,40868,3.891,12.264,7492,1.535,24.528,2367,2524,11687
2004,4421,19075,26524,271581,269129,2598,9.840,2357,8.927,43622,16977,26645,6.308,16.209,38515,15251,23264,5.667,14.311,5107,1.898,28.622,1626,1834,11807
2004,4422,25380,34267,304596,300777,3340,9.769,3185,9.316,55828,19631,36197,6.527,18.561,47444,16699,30745,5.552,15.774,8384,2.787,31.548,2159,2243,8577
2004,4431,30448,49451,499107,484094,5795,11.664,6255,12.590,96568,29001,67567,5.991,19.948,67230,30589,36641,6.319,13.888,29338,6.060,27.776,3792,4055,16258
2004,4441,44648,64159,1077716,1058852,4148,6.464,4166,6.492,114085,36594,77491,3.456,10.774,76416,25446,50970,2.403,7.217,37669,3.558,14.434,2835,3079,16391
2004,4442,15572,18829,173548,172483,1425,7.560,1464,7.767,26016,6650,19366,3.855,15.083,24125,6752,17373,3.915,13.987,1891,1.096,27.974,1044,1078,4696
2004,4451,61060,87947,2647365,2608421,10005,11.471,8551,9.804,353743,127756,225987,4.898,13.562,272665,87443,185222,3.352,10.453,81078,3.108,20.907,6041,6138,36098
2004,4452,17377,21210,149073,148089,3706,17.596,3409,16.186,35504,17863,17641,12.062,23.975,33816,15823,17993,10.685,22.835,1688,1.140,45.670,2447,2492,11439
2004,4453,23631,26956,143386,141484,2710,10.147,2211,8.279,25434,9680,15754,6.842,17.977,21742,7681,14061,5.429,15.367,3692,2.609,30.734,1717,1731,5997
2004,4461,40027,79754,1032229,994261,6936,8.767,5650,7.142,188813,62341,126472,6.270,18.990,115439,43331,72108,4.358,11.611,73374,7.380,23.221,3002,3088,14904
2004,4471,61587,111047,929024,931452,8524,7.614,10338,9.234,154515,50706,103809,5.444,16.589,159490,65755,93735,7.059,17.123,-4975,-0.534,33.177,5293,6289,38862
2004,4481,34986,85724,1183938,1143143,9185,10.788,8019,9.418,223408,70251,153157,6.145,19.543,140638,50112,90526,4.384,12.303,82770,7.241,24.606,4044,4639,19922
2004,4482,6158,26390,196809,193816,1623,6.128,1810,6.834,35511,8720,26791,4.499,18.322,29445,7920,21525,4.086,15.192,6066,3.130,30.385,572,677,2617
2004,4483,18508,28308,165131,164056,2342,8.291,2224,7.873,25437,8378,17059,5.107,15.505,23113,7821,15292,4.767,14.088,2324,1.417,28.177,1382,1433,4104
2004,4511,28036,38180,410538,407364,3878,10.147,3957,10.353,59398,24448,34950,6.002,14.581,53511,18775,34736,4.609,13.136,5887,1.445,26.272,2698,2777,10314
2004,4512,6289,11833,146475,144496,984,8.243,1193,9.994,23358,10421,12937,7.212,16.165,18913,5941,12972,4.112,13.089,4445,3.076,26.178,748,754,3076
2004,4521,164,8831,1455652,1432416,244,2.729,465,5.200,154176,24124,130052,1.684,10.763,108660,39049,69611,2.726,7.586,45516,3.178,15.172,64,79,1435
2004,4529,8688,32195,1280654,1237856,3899,12.468,2054,6.568,155203,53651,101552,4.334,12.538,72315,22005,50310,1.778,5.842,82888,6.696,11.684,1076,1109,4871
2004,4531,18885,19754,109398,111318,1625,8.112,2181,10.888,17300,5536,11764,4.973,15.541,21185,6870,14315,6.172,19.031,-3885,-3.490,31.082,1757,1771,5462
2004,4532,27420,38433,322570,324961,4229,10.900,4958,12.779,51155,19792,31363,6.091,15.742,56285,25083,31202,7.719,17.321,-5130,-1.579,31.484,3453,3665,14200
2004,4533,12207,16366,127559,127464,1563,9.520,1668,10.159,17738,6808,10930,5.341,13.916,17745,5532,12213,4.340,13.922,-7,-0.005,27.832,1309,1334,3995
2004,4539,31497,39932,254475,254208,4861,12.153,4993,12.483,47593,20309,27284,7.989,18.722,47091,17505,29586,6.886,18.525,502,0.197,37.049,3317,3877,12549
2004,4541,13790,14694,267150,268121,2158,14.972,1597,11.080,50521,19705,30816,7.349,18.843,51799,21480,30319,8.011,19.319,-1278,-0.477,37.685,1120,1130,8168
2004,4542,4407,5002,54858,58420,522,10.342,613,12.145,6827,2560,4267,4.382,11.686,14247,3348,10899,5.731,24.387,-7420,-12.701,23.372,441,442,1982
2004,4543,22844,28680,234271,237194,2439,8.500,2464,8.588,29531,8526,21005,3.595,12.450,35451,14127,21324,5.956,14.946,-5920,-2.496,24.900,1635,1652,7691
2004,4811,587,3166,440646,451398,447,15.171,8,0.272,37430,18833,18597,4.172,8.292,58542,26,58516,0.006,12.969,-21112,-4.677,16.584,7,7,23
2004,4812,1904,2076,37784,36736,322,15.831,238,11.701,6023,1704,4319,4.639,16.396,4000,1436,2564,3.909,10.889,2023,5.507,21.777,185,190,1221
2004,4831,783,1143,46733,47037,106,9.130,142,12.231,6237,2018,4219,4.290,13.260,6753,1488,5265,3.163,14.357,-516,-1.097,26.520,73,84,518
2004,4832,453,506,19281,19455,50,9.690,70,13.566,2075,334,1741,1.717,10.666,2484,510,1974,2.621,12.768,-409,-2.102,21.331,56,56,433
2004,4841,42761,52066,995914,981375,8991,17.461,7844,15.233,154307,62343,91964,6.353,15.724,124129,46959,77170,4.785,12.648,30178,3.075,25.297,5853,5932,29950
2004,4842,41447,44804,448218,445032,5774,12.879,5834,13.012,81248,27259,53989,6.125,18.257,74570,26581,47989,5.973,16.756,6678,1.501,33.512,4284,4342,18668
2004,4851,631,897,49228,48411,77,8.513,92,10.171,5903,830,5073,1.715,12.194,4480,2131,2349,4.402,9.254,1423,2.939,18.508,56,56,615
2004,4852,199,485,18133,17925,63,13.003,62,12.797,2389,950,1439,5.300,13.328,1969,743,1226,4.145,10.985,420,2.343,21.969,31,33,488
2004,4853,5831,5967,63957,64004,878,14.714,878,14.714,11390,4379,7011,6.842,17.796,11460,4797,6663,7.495,17.905,-70,-0.109,35.592,719,719,4105
2004,4854,2990,4140,180003,180094,203,4.850,294,7.024,20868,6450,14418,3.581,11.587,21197,9144,12053,5.077,11.770,-329,-0.183,23.175,176,176,2664
2004,4855,1039,1149,29829,29461,113,9.754,132,11.394,5292,908,4384,3.082,17.963,4505,1799,2706,6.106,15.292,787,2.671,30.583,102,106,1184
2004,4859,2518,2752,57052,56257,417,15.147,419,15.220,11064,3754,7310,6.673,19.667,9297,4434,4863,7.882,16.526,1767,3.141,33.052,326,327,3392
2004,4861,58,335,6291,6221,60,19.324,11,3.543,735,387,348,6.221,11.816,616,147,469,2.363,9.903,119,1.913,19.805,(D),(D),(D)
2004,4862,128,1595,24311,26367,369,21.311,642,37.078,7593,4897,2696,18.573,28.798,11783,8126,3657,30.819,44.689,-4190,-15.891,57.596,5,12,230
2004,4869,56,542,5993,5832,78,14.829,46,8.745,1163,902,261,15.466,19.942,850,445,405,7.630,14.575,313,5.367,29.150,3,3,170
2004,4871,438,488,8615,8797,65,13.361,62,12.744,1124,481,643,5.468,12.778,1451,589,862,6.696,16.495,-327,-3.717,25.556,41,42,290
2004,4872,1155,1190,11388,11321,199,16.980,163,13.908,2011,774,1237,6.837,17.764,1863,808,1055,7.137,16.457,148,1.307,32.914,114,114,645
2004,4879,122,125,1992,1824,11,8.696,14,11.067,510,201,309,11.023,27.968,158,27,131,1.481,8.665,352,19.304,17.329,9,9,19
2004,4881,3375,4803,145112,139506,548,11.570,415,8.762,29414,17020,12394,12.200,21.084,17733,5202,12531,3.729,12.711,11681,8.373,25.423,269,277,2125
2004,4882,437,857,26620,26167,68,7.916,72,8.382,3833,1183,2650,4.521,14.648,2802,1125,1677,4.299,10.708,1031,3.940,21.416,39,47,759
2004,4883,1631,2143,82563,80915,172,8.019,176,8.205,12213,2570,9643,3.176,15.094,9020,2221,6799,2.745,11.148,3193,3.946,22.295,112,115,1422
2004,4884,7208,7630,63629,61446,1179,15.765,876,11.714,16025,8075,7950,13.142,26.080,11546,4796,6750,7.805,18.791,4479,7.289,37.581,675,679,3239
2004,4885,11574,16107,182602,179320,1877,11.859,1318,8.327,29935,12315,17620,6.868,16.694,23244,9706,13538,5.413,12.962,6691,3.731,25.925,854,894,4613
2004,4889,1153,1271,21595,21202,282,23.248,166,13.685,3966,1313,2653,6.193,18.706,3189,813,2376,3.835,15.041,777,3.665,30.083,141,141,721
2004,4921,2826,8481,527601,500210,824,9.656,929,10.887,95235,18296,76939,3.658,19.039,42759,26893,15866,5.376,8.548,52476,10.491,17.096,390,398,1890
2004,4922,4054,4535,47229,48670,585,12.798,657,14.373,8112,2841,5271,5.837,16.667,10802,3515,7287,7.222,22.194,-2690,-5.527,33.335,541,543,2871
2004,4931,6770,12813,574561,560931,1669,13.391,971,7.790,98749,42212,56537,7.525,17.604,71669,20318,51351,3.622,12.777,27080,4.828,25.554,388,399,3523
2004,5111,14983,20734,699285,697347,2132,10.343,1890,9.169,73165,24742,48423,3.548,10.492,68819,18697,50122,2.681,9.869,4346,0.623,19.737,1215,1252,8234
2004,5112,6002,8370,323516,327571,916,10.809,1125,13.275,40832,13271,27561,4.051,12.465,48944,20632,28312,6.298,14.942,-8112,-2.476,24.930,574,613,8153
2004,5121,11878,15269,280342,278806,2170,14.202,2191,14.339,54812,20236,34576,7.258,19.660,51112,22189,28923,7.959,18.332,3700,1.327,36.665,1198,1219,5477
2004,5122,2585,2863,25326,25919,414,14.575,369,12.991,3284,1421,1863,5.483,12.670,4479,1494,2985,5.764,17.281,-1195,-4.611,25.341,272,273,790
2004,5151,4522,8951,241989,246742,779,8.607,978,10.806,26596,7896,18700,3.200,10.779,36201,10598,25603,4.295,14.672,-9605,-3.893,21.558,360,376,3975
2004,5152,337,858,43701,43963,385,44.304,407,46.835,16229,8519,7710,19.378,36.915,16365,15156,1209,34.474,37.224,-136,-0.309,73.830,38,38,861
2004,5171,4449,32104,1016381,1064047,5016,15.699,4710,14.741,179718,49732,129986,4.674,16.890,272603,83178,189425,7.817,25.619,-92885,-8.729,33.780,506,656,6731
2004,5172,2437,11793,265981,265088,1660,14.167,1509,12.878,51881,11647,40234,4.394,19.571,50035,15512,34523,5.852,18.875,1846,0.696,37.750,471,487,3895
2004,5174,420,551,12809,13417,103,18.559,111,20.000,2191,1299,892,9.682,16.331,3393,1156,2237,8.616,25.290,-1202,-8.959,32.661,67,67,421
2004,5179,4989,5745,71694,81354,1386,23.624,1630,27.783,17061,7285,9776,8.955,20.971,36096,15376,20720,18.900,44.369,-19035,-23.398,41.943,1186,1193,7768
2004,5182,7048,13200,374380,389002,2739,21.323,2029,15.796,76197,40427,35770,10.393,19.588,105485,46316,59169,11.906,27.117,-29288,-7.529,39.176,521,533,4739
2004,5191,4586,5480,97102,96001,654,12.207,409,7.634,14543,3097,11446,3.226,15.149,12106,2900,9206,3.021,12.610,2437,2.539,25.221,258,269,1493
2004,5211,19,57,21510,22037,5,8.929,3,5.357,653,435,218,1.974,2.963,1758,310,1448,1.407,7.978,-1105,-5.014,5.927,(D),(D),(D)
2004,5221,16558,114144,2076170,2072702,6285,5.516,5864,5.147,287258,76178,211080,3.675,13.859,283372,75877,207495,3.661,13.672,3886,0.187,27.343,514,665,6551
2004,5222,18901,49811,759784,742379,9435,19.278,7697,15.727,210571,117559,93012,15.835,28.364,177004,87895,89109,11.840,23.843,33567,4.522,47.686,1774,1858,9597
2004,5223,22564,34990,315393,311073,6857,20.751,2965,8.973,80585,35584,45001,11.439,25.905,70768,28235,42533,9.077,22.750,9817,3.156,45.499,1756,1824,9410
2004,5231,12124,38223,510207,517429,6942,17.159,11408,28.199,143611,52687,90924,10.182,27.755,156974,83035,73939,16.048,30.337,-13363,-2.583,55.509,981,1010,4286
2004,5232,47,53,6652,6839,18,31.858,25,44.248,595,261,334,3.816,8.700,959,543,416,7.940,14.023,-364,-5.322,17.400,18,18,98
2004,5239,31116,34968,336853,345983,6168,18.133,4263,12.533,63244,30922,32322,8.937,18.280,82925,45047,37878,13.020,23.968,-19681,-5.688,36.559,2898,2916,19349
2004,5241,5934,31288,1482455,1490835,5089,16.701,3455,11.339,185692,75405,110287,5.058,12.456,203860,74662,129198,5.008,13.674,-18168,-1.219,24.911,368,391,6300
2004,5242,116319,128996,879548,871365,11766,9.172,10340,8.060,130918,47559,83359,5.458,15.024,114722,46454,68268,5.331,13.166,16196,1.859,26.332,6922,7115,24022
2004,5250,2876,4041,57899,53994,1119,31.196,211,5.882,12739,6899,5840,12.777,23.593,4809,1673,3136,3.098,8.907,7930,14.687,17.813,106,108,768
2004,5311,86605,102903,529976,524635,10086,9.849,9093,8.879,90735,38774,51961,7.391,17.295,80057,35176,44881,6.705,15.260,10678,2.035,30.519,6877,7084,26501
2004,5312,63580,71574,318877,308065,12734,18.509,7182,10.439,69691,33387,36304,10.838,22.622,48505,20978,27527,6.810,15.745,21186,6.877,31.490,4599,4730,13609
2004,5313,55574,62035,582457,574365,9894,16.371,6697,11.081,105712,47496,58216,8.269,18.405,89083,37303,51780,6.495,15.510,16629,2.895,31.020,4260,4471,23233
2004,5321,4153,10515,167122,167981,1270,12.153,1140,10.909,16845,7593,9252,4.520,10.028,18435,8342,10093,4.966,10.974,-1590,-0.947,20.056,481,539,2870
2004,5322,12351,31659,259732,265643,2923,9.299,2469,7.855,42857,16176,26681,6.089,16.133,52709,14850,37859,5.590,19.842,-9852,-3.709,32.267,1268,1668,7706
2004,5323,3260,5011,32932,32808,503,10.205,339,6.878,5809,1935,3874,5.898,17.706,5549,1499,4050,4.569,16.914,260,0.792,33.827,233,240,979
2004,5324,7340,12362,154548,151229,1673,13.795,1205,9.936,30857,10416,20441,6.888,20.404,24399,9083,15316,6.006,16.134,6458,4.270,32.268,626,643,3209
2004,5331,2051,2139,30799,28797,326,15.666,210,10.091,7738,3006,4732,10.439,26.871,3668,1474,2194,5.119,12.738,4070,14.134,25.475,145,146,993
2004,5411,160180,168752,1213443,1201450,15142,9.064,11763,7.041,159250,51158,108092,4.258,13.255,135280,46617,88663,3.880,11.260,23970,1.995,22.519,8372,8502,28900
2004,5412,91091,104158,1225825,1221428,11416,11.097,8854,8.606,242914,82147,160767,6.725,19.888,234532,91464,143068,7.488,19.201,8382,0.686,38.403,5538,5627,44572
2004,5413,83900,96213,1258197,1250520,10402,10.917,8536,8.959,195899,68108,127791,5.446,15.665,180083,70516,109567,5.639,14.401,15816,1.265,28.801,5382,5475,25133
2004,5414,25726,26006,118624,118192,3826,14.784,3574,13.810,22703,9336,13367,7.899,19.209,21881,9458,12423,8.002,18.513,822,0.695,37.026,2550,2559,6826
2004,5415,73614,84282,1095696,1090206,17071,20.438,15559,18.628,222851,94634,128217,8.680,20.441,212955,93670,119285,8.592,19.533,9896,0.908,39.067,10116,10205,44691
2004,5416,84496,90349,754174,745440,18208,20.595,14328,16.206,170992,76479,94513,10.260,22.938,154589,62089,92500,8.329,20.738,16403,2.200,41.476,10003,10065,37883
2004,5417,10888,14274,632694,621235,2092,15.023,1395,10.018,91849,24144,67705,3.886,14.785,69467,18977,50490,3.055,11.182,22382,3.603,22.364,835,854,7147
2004,5418,30037,33358,388407,395871,3861,11.601,3706,11.136,64586,19686,44900,4.973,16.315,80769,24221,56548,6.118,20.403,-16183,-4.088,32.630,2753,2770,14244
2004,5419,52650,60776,545321,540597,7506,12.539,5675,9.480,90357,31473,58884,5.822,16.714,80477,31958,48519,5.912,14.887,9880,1.828,29.773,4100,4145,23881
2004,5511,26101,46470,2756159,2790194,4167,8.972,4115,8.860,422681,141561,281120,5.074,15.149,487747,161451,326296,5.786,17.481,-65066,-2.332,30.298,1131,1194,20403
2004,5611,19906,21834,438080,424338,4740,22.743,2755,13.219,104762,50388,54374,11.874,24.688,77309,35660,41649,8.404,18.219,27453,6.470,36.437,1882,1902,23400
2004,5612,1651,3935,164974,153628,1125,31.789,333,9.409,44241,22737,21504,14.800,28.798,22588,9554,13034,6.219,14.703,21653,14.094,29.406,132,155,3245
2004,5613,26352,43166,3779148,3782475,6511,15.067,6604,15.283,973105,242114,730991,6.401,25.727,996740,356076,640664,9.414,26.352,-23635,-0.625,51.453,3153,3388,122756
2004,5614,26274,31752,774897,764488,4173,13.226,3773,11.958,151187,54892,96295,7.180,19.776,129720,52781,76939,6.904,16.968,21467,2.808,33.936,2701,2782,25160
2004,5615,16628,22490,262175,270935,1869,8.069,3212,13.868,33893,11819,22074,4.362,12.510,51660,18911,32749,6.980,19.067,-17767,-6.558,25.019,1884,1948,8249
2004,5616,16764,21188,738122,735862,2508,11.918,2219,10.545,125874,29855,96019,4.057,17.106,119909,35880,84029,4.876,16.295,5965,0.811,32.590,1512,1578,21319
2004,5617,124198,130227,1594134,1568857,20917,16.308,16988,13.245,309462,93831,215631,5.981,19.725,260203,95266,164937,6.072,16.586,49259,3.140,33.171,11629,11661,58786
2004,5619,16610,18675,337544,341455,2044,10.942,2053,10.991,55542,16445,39097,4.816,16.266,62544,20196,42348,5.915,18.317,-7002,-2.051,32.533,1404,1420,10265
2004,5621,6316,8136,179083,178195,779,9.661,634,7.863,19828,6334,13494,3.555,11.127,18071,5701,12370,3.199,10.141,1757,0.986,20.282,476,481,3796
2004,5622,1439,2430,55029,54105,224,9.283,190,7.874,7475,2598,4877,4.802,13.816,5737,2062,3675,3.811,10.604,1738,3.212,21.207,115,117,834
2004,5629,6352,7009,109874,106323,775,11.162,644,9.275,26452,7532,18920,7.084,24.879,19666,5039,14627,4.739,18.497,6786,6.382,36.993,440,447,3096
2004,6111,18043,20130,812166,799387,1045,5.323,51,0.260,67051,15078,51973,1.886,8.388,41451,244,41207,0.031,5.185,25600,3.202,10.371,41,41,210
2004,6112,554,882,92931,90201,73,8.629,(D),(D),11462,3133,8329,3.473,12.707,5984,(D),5983,(D),6.634,5478,6.073,13.268,0,0,0
2004,6113,2422,3304,1505380,1469205,217,6.779,11,0.344,113411,8830,104581,0.601,7.719,40986,42,40944,0.003,2.790,72425,4.930,5.579,9,9,29
2004,6114,5947,6493,63729,63936,901,13.843,932,14.320,11845,4820,7025,7.539,18.526,12252,4137,8115,6.471,19.163,-407,-0.637,37.053,647,658,2829
2004,6115,5841,6935,98817,96411,814,11.869,660,9.624,19530,6814,12716,7.068,20.257,14735,5373,9362,5.573,15.284,4795,4.973,30.567,457,477,3918
2004,6116,25948,27848,253157,244114,4063,14.963,2675,9.851,56092,19797,36295,8.110,22.978,37921,12194,25727,4.995,15.534,18171,7.444,31.068,1940,1960,8853
2004,6117,4209,4673,56677,53470,808,17.825,528,11.648,13528,4910,8618,9.183,25.300,7046,2548,4498,4.765,13.177,6482,12.123,26.355,373,374,1442
2004,6211,170036,193539,2032117,1997634,15884,8.277,12631,6.582,288276,85254,203022,4.268,14.431,219364,66187,153177,3.313,10.981,68912,3.450,21.962,8923,9137,41364
2004,6212,112107,116913,805161,788543,7184,6.227,4101,3.555,113706,31784,81922,4.031,14.420,80741,18133,62608,2.300,10.239,32965,4.180,20.479,3194,3273,14322
2004,6213,90305,99305,542456,527699,10717,10.986,7214,7.395,105666,38829,66837,7.358,20.024,76604,26633,49971,5.047,14.517,29062,5.507,29.033,5172,5239,18904
2004,6214,12389,24668,644854,633845,1941,7.957,1390,5.698,81136,22934,58202,3.618,12.801,59151,19032,40119,3.003,9.332,21985,3.469,18.664,707,768,7370
2004,6215,6673,10183,208360,204481,1396,13.985,994,9.958,32646,12994,19652,6.355,15.965,24938,9876,15062,4.830,12.196,7708,3.770,24.392,564,585,4166
2004,6216,12018,17194,861765,831546,2737,16.382,1763,10.552,155081,45731,109350,5.500,18.650,95463,31052,64411,3.734,11.480,59618,7.170,22.960,1184,1237,16946
2004,6219,5402,8243,232405,227517,788,9.572,766,9.305,36978,9891,27087,4.347,16.253,27148,11056,16092,4.859,11.932,9830,4.321,23.865,389,461,5086
2004,6221,3269,5349,4804912,4783211,175,3.285,132,2.478,216356,20966,195390,0.438,4.523,172934,51015,121919,1.067,3.615,43422,0.908,7.231,49,49,13794
2004,6222,509,652,214388,213861,49,7.638,28,4.365,9369,3357,6012,1.570,4.381,8185,3522,4663,1.647,3.827,1184,0.554,7.655,18,19,2989
2004,6223,455,783,197195,191053,159,21.901,45,6.198,20209,7708,12501,4.034,10.578,8494,1341,7153,0.702,4.446,11715,6.132,8.892,26,26,795
2004,6231,8514,15885,1607361,1603068,1021,6.448,918,5.798,151385,63982,87403,3.991,9.443,143003,56905,86098,3.550,8.921,8382,0.523,17.841,435,469,27974
2004,6232,7921,28746,528843,522635,2044,7.226,1123,3.970,67459,22202,45257,4.248,12.907,55793,14150,41643,2.707,10.675,11666,2.232,21.351,391,483,5989
2004,6233,12694,16969,600901,596345,1752,10.351,1665,9.837,70977,27774,43203,4.657,11.902,62193,25391,36802,4.258,10.429,8784,1.473,20.858,1180,1210,15511
2004,6239,3477,6078,156995,157787,454,7.549,326,5.421,17929,5918,12011,3.751,11.363,19441,5449,13992,3.453,12.321,-1512,-0.958,22.726,165,174,2344
2004,6241,35486,49211,969096,952230,4325,8.896,3142,6.462,142540,45278,97262,4.755,14.969,107610,23522,84088,2.470,11.301,34930,3.668,22.602,1870,1961,13020
2004,6242,9157,12411,152104,152507,667,5.407,515,4.175,16523,4112,12411,2.696,10.834,17321,3069,14252,2.012,11.358,-798,-0.523,21.669,288,297,1551
2004,6243,4949,7916,321820,323017,435,5.470,508,6.388,43459,9715,33744,3.008,13.454,45972,7603,38369,2.354,14.232,-2513,-0.778,26.908,218,241,2229
2004,6244,52041,65291,777750,775535,6774,10.413,6302,9.687,113647,41161,72486,5.307,14.654,109303,37303,72000,4.810,14.094,4344,0.560,28.188,4516,4582,25867
2004,7111,7433,7596,127325,129471,848,11.106,927,12.141,21757,6787,14970,5.242,16.805,26412,7059,19353,5.452,20.400,-4655,-3.595,33.609,592,596,3816
2004,7112,3193,3357,111306,111342,556,16.642,524,15.684,19182,4301,14881,3.863,17.228,19193,7143,12050,6.415,17.238,-11,-0.010,34.456,390,390,3223
2004,7113,4288,4598,101869,99826,625,13.809,481,10.627,22061,6774,15287,6.786,22.100,18294,6370,11924,6.381,18.326,3767,3.774,36.652,332,332,2498
2004,7114,2612,2682,16155,16060,413,15.500,378,14.187,3125,1521,1604,9.471,19.459,2917,1406,1511,8.755,18.164,208,1.295,36.327,285,285,875
2004,7115,11522,11542,43340,42890,2488,22.055,1966,17.428,13803,6580,7223,15.342,32.182,13032,5192,7840,12.105,30.385,771,1.798,60.769,1192,1192,2801
2004,7121,5836,6265,118799,119428,429,6.900,333,5.356,8990,1063,7927,0.890,7.528,10251,1937,8314,1.622,8.583,-1261,-1.056,15.055,205,205,1510
2004,7131,1742,2320,138147,135606,326,13.852,393,16.699,20241,5251,14990,3.872,14.926,15768,3503,12265,2.583,11.628,4473,3.299,23.256,224,227,2443
2004,7132,1606,2068,172687,168319,241,11.849,173,8.505,23006,5953,17053,3.537,13.668,14279,5317,8962,3.159,8.483,8727,5.185,16.967,141,141,2406
2004,7139,48628,53815,1055280,1037784,7444,14.186,4764,9.079,163839,60050,103789,5.786,15.787,128695,38701,89994,3.729,12.401,35144,3.386,24.802,3543,3572,28130
2004,7211,36214,46175,1774572,1760600,4449,9.669,4121,8.957,217905,88941,128964,5.052,12.377,190515,72365,118150,4.110,10.821,27390,1.556,21.642,2683,2748,38671
2004,7212,4970,5401,37652,37382,479,8.821,537,9.890,6578,1945,4633,5.203,17.597,6106,2034,4072,5.441,16.334,472,1.263,32.668,345,374,1544
2004,7213,2217,2285,13587,13534,127,5.417,246,10.493,2233,425,1808,3.140,16.500,2083,983,1100,7.263,15.391,150,1.108,30.783,176,176,836
2004,7223,11159,27824,521582,538141,4980,17.979,4730,17.076,120836,64769,56067,12.036,22.454,159680,61647,98033,11.456,29.673,-38844,-7.218,44.909,1280,1297,9000
2004,7224,42029,42569,355197,353709,4795,11.145,5703,13.256,77577,37096,40481,10.488,21.932,74982,33321,41661,9.420,21.199,2595,0.734,42.398,4608,4612,25457
2004,7225,290451,396818,8011867,7873729,49488,12.621,40092,10.224,1424209,667572,756637,8.478,18.088,1150107,431261,718846,5.477,14.607,274102,3.481,29.214,29223,30220,282615
2004,8111,139301,152040,896739,894909,13982,9.197,13955,9.179,147680,52177,95503,5.830,16.502,144037,52414,91623,5.857,16.095,3643,0.407,32.190,10625,10751,39812
2004,8112,11050,12524,129927,131060,1214,9.568,1541,12.146,21639,6671,14968,5.090,16.511,23798,9766,14032,7.452,18.158,-2159,-1.647,33.022,1114,1118,3926
2004,8113,20555,21850,177078,174739,2133,9.756,2162,9.888,32520,10420,22100,5.963,18.611,28091,9657,18434,5.527,16.076,4429,2.535,32.152,1597,1601,6390
2004,8114,20465,21625,108741,108780,2597,11.959,2780,12.801,17152,6441,10711,5.921,15.768,17243,8357,8886,7.683,15.851,-91,-0.084,31.535,2102,2108,5615
2004,8121,79106,92526,577983,564563,12229,13.375,10047,10.988,117432,50319,67113,8.913,20.801,90601,38080,52521,6.745,16.048,26831,4.753,32.096,7839,7978,27188
2004,8122,14722,20754,145275,145228,808,3.882,928,4.459,13703,3575,10128,2.462,9.436,13654,3916,9738,2.696,9.402,49,0.034,18.804,470,532,1776
2004,8123,31976,38595,379604,377493,4120,10.710,3870,10.060,62176,27542,34634,7.296,16.471,58408,17630,40778,4.670,15.473,3768,0.998,30.945,2951,3027,12371
2004,8129,21204,32646,234769,233267,5646,17.577,4598,14.314,56844,26636,30208,11.419,24.369,54029,24172,29857,10.362,23.162,2815,1.207,46.324,2950,3003,13538
2004,8131,168103,168335,1652772,1634754,8025,4.872,779,0.473,161864,23280,138584,1.424,9.901,126012,1824,124188,0.112,7.708,35852,2.193,15.417,576,576,1365
2004,8132,12211,14170,141256,141505,1091,7.742,934,6.628,16625,5378,11247,3.801,11.749,17066,4434,12632,3.133,12.060,-441,-0.312,23.497,640,651,2293
2004,8133,10106,12237,112154,111222,1139,9.397,908,7.491,15877,4091,11786,3.678,14.275,13954,3338,10616,3.001,12.546,1923,1.729,25.092,550,556,2051
2004,8134,27664,29711,318157,318752,1383,4.642,1546,5.189,33609,5272,28337,1.654,10.544,34803,6044,28759,1.896,10.919,-1194,-0.375,21.088,1086,1096,3889
2004,8139,59152,61078,528656,522024,2977,4.909,2120,3.495,68885,16046,52839,3.074,13.196,55248,7876,47372,1.509,10.583,13637,2.612,21.167,1470,1483,5586
2005,2111,5551,6610,82921,82362,630,9.582,560,8.517,15474,4361,11113,5.295,18.788,14427,5842,8585,7.093,17.517,1047,1.271,35.033,322,326,1392
2005,2121,619,1018,73092,71286,120,11.811,116,11.417,12587,5670,6917,7.954,17.657,8924,2524,6400,3.541,12.519,3663,5.138,25.037,59,61,979
2005,2122,191,260,26248,25078,39,15.146,34,13.204,3587,1887,1700,7.525,14.303,1305,751,554,2.995,5.204,2282,9.100,10.408,29,29,627
2005,2123,3213,5260,95886,95090,393,7.513,335,6.404,13035,3459,9576,3.638,13.708,11530,4197,7333,4.414,12.125,1505,1.583,24.251,189,189,1526
2005,2131,7423,8846,212433,203913,1071,12.310,780,8.965,42069,9032,33037,4.429,20.631,24559,6523,18036,3.199,12.044,17510,8.587,24.088,456,481,3325
2005,2211,1582,9384,512252,507712,592,6.244,785,8.280,50321,16277,34044,3.206,9.911,41869,16625,25244,3.274,8.247,8452,1.665,16.493,45,54,289
2005,2212,488,2415,78676,80110,130,5.354,156,6.425,5595,1262,4333,1.575,6.984,8368,2067,6301,2.580,10.446,-2773,-3.462,13.968,23,25,185
2005,2213,4180,4971,41305,41723,329,6.548,436,8.677,5604,1803,3801,4.321,13.431,6356,2768,3588,6.634,15.234,-752,-1.802,26.863,164,165,677
2005,2361,156387,157587,903106,880455,30505,19.837,22880,14.879,239754,104589,135165,11.879,27.231,195113,75324,119789,8.555,22.160,44641,5.070,44.321,15672,15674,52534
2005,2362,38679,39691,694857,701474,4597,11.672,3985,10.118,127047,27603,99444,3.935,18.111,139604,39118,100486,5.577,19.902,-12557,-1.790,36.223,2823,2825,23835
2005,2371,18157,19088,449848,451881,1819,9.528,1824,9.554,89105,18840,70265,4.169,19.719,94374,24832,69542,5.495,20.885,-5269,-1.166,39.437,1272,1277,10288
2005,2372,9871,9967,70541,68096,1618,16.443,1364,13.862,17787,6425,11362,9.435,26.120,12717,5883,6834,8.639,18.675,5070,7.445,37.350,1030,1030,4300
2005,2373,9788,10483,310747,312115,769,7.281,927,8.777,45277,6223,39054,1.994,14.507,48124,7332,40792,2.349,15.419,-2847,-0.912,29.013,558,561,4061
2005,2379,4231,4428,80822,80842,620,14.072,576,13.073,18221,5983,12238,7.401,22.539,17920,5029,12891,6.221,22.167,301,0.372,44.333,372,372,2553
2005,2381,94694,95255,1068253,1054978,14315,15.156,12711,13.457,258604,77674,180930,7.363,24.513,232000,66873,165127,6.339,21.991,26604,2.522,43.982,8765,8771,50372
2005,2382,153413,156660,1813460,1798493,19373,12.566,14384,9.330,334587,96613,237974,5.372,18.604,304199,78136,226063,4.345,16.914,30388,1.690,33.828,10442,10461,55347
2005,2383,106213,107267,896155,880817,19098,18.196,14483,13.799,216047,73267,142780,8.318,24.528,185133,57363,127770,6.512,21.018,30914,3.510,42.037,10318,10322,40747
2005,2389,54659,55139,494985,481050,10105,18.890,6815,12.740,118176,43559,74617,9.055,24.566,89841,27348,62493,5.685,18.676,28335,5.890,37.352,4547,4549,19551
2005,3111,1145,1705,47319,47255,119,6.990,114,6.696,5553,1825,3728,3.862,11.751,5300,1967,3333,4.163,11.216,253,0.535,22.432,65,67,971
2005,3112,463,784,54578,54409,42,5.354,43,5.481,3762,1113,2649,2.046,6.914,3368,614,2754,1.128,6.190,394,0.724,12.380,30,30,126
2005,3113,1523,1689,72765,75153,143,8.457,147,8.693,6097,1750,4347,2.329,8.113,10942,4239,6703,5.640,14.560,-4845,-6.447,16.226,111,111,943
2005,3114,1251,1622,162434,163730,106,6.495,126,7.721,14659,2437,12222,1.488,8.953,17225,6012,11213,3.672,10.520,-2566,-1.567,17.906,73,73,2119
2005,3115,1005,1496,132085,132846,74,4.897,104,6.883,9759,1598,8161,1.203,7.346,11440,4270,7170,3.214,8.612,-1681,-1.265,14.692,66,67,1158
2005,3116,3017,3645,495893,493733,224,6.129,244,6.676,32659,8431,24228,1.708,6.615,28375,5176,23199,1.048,5.747,4284,0.868,11.494,184,185,2659
2005,3117,541,638,37929,37759,50,7.794,57,8.885,4467,975,3492,2.582,11.830,4142,714,3428,1.891,10.970,325,0.861,21.939,43,44,553
2005,3118,8982,9781,295465,297696,837,8.429,1135,11.430,32209,8297,23912,2.787,10.819,36600,10292,26308,3.457,12.294,-4391,-1.475,21.639,888,900,6168
2005,3119,2513,2940,161286,160741,289,9.855,274,9.344,17233,5074,12159,3.157,10.721,16028,6054,9974,3.766,9.971,1205,0.750,19.943,205,206,2599
2005,3121,2488,3029,134046,133011,376,12.729,226,7.651,13517,4027,9490,3.028,10.162,11464,2856,8608,2.147,8.619,2053,1.543,17.238,165,167,1457
2005,3122,92,129,20988,21384,17,13.333,14,10.980,1105,123,982,0.575,5.167,1956,234,1722,1.094,9.147,-851,-3.980,10.335,12,12,156
2005,3131,314,470,51905,53325,23,4.742,53,10.928,3271,381,2890,0.714,6.134,6123,3086,3037,5.787,11.483,-2852,-5.348,12.268,29,29,824
2005,3132,1199,1394,105281,109206,84,5.868,159,11.107,8174,1531,6643,1.402,7.485,16080,7061,9019,6.466,14.724,-7906,-7.240,14.970,112,115,1809
2005,3133,1272,1347,51544,52733,88,6.395,146,10.610,5474,1321,4153,2.505,10.381,7906,3103,4803,5.884,14.993,-2432,-4.612,20.761,110,110,1564
2005,3141,2390,2552,87252,89658,176,6.798,250,9.656,8062,1820,6242,2.030,8.992,12684,4515,8169,5.036,14.147,-4622,-5.155,17.984,189,190,1672
2005,3149,4272,4401,81423,82698,344,7.695,483,10.804,9423,1872,7551,2.264,11.394,11946,4420,7526,5.345,14.445,-2523,-3.051,22.789,370,372,3360
2005,3151,489,537,33244,35338,31,5.467,91,16.049,2878,526,2352,1.488,8.144,7037,2122,4915,6.005,19.913,-4159,-11.769,16.288,74,75,1209
2005,3152,7311,7487,181804,188787,1158,14.995,1629,21.094,33642,11680,21962,6.187,17.820,47394,22704,24690,12.026,25.104,-13752,-7.284,35.640,1403,1405,17116
2005,3159,885,913,19288,19962,72,7.631,133,14.096,2010,308,1702,1.543,10.069,3362,1374,1988,6.883,16.842,-1352,-6.773,20.139,102,102,659
2005,3161,212,220,6769,7253,18,8.200,17,7.745,447,96,351,1.324,6.163,1379,352,1027,4.853,19.014,-932,-12.851,12.327,13,13,56
2005,3162,255,286,16228,16525,24,8.247,34,11.684,839,127,712,0.769,5.077,1398,387,1011,2.342,8.460,-559,-3.383,10.154,27,27,198
2005,3169,764,774,15333,15683,77,9.828,96,12.253,1956,434,1522,2.767,12.473,2650,1196,1454,7.626,16.898,-694,-4.425,24.945,76,76,503
2005,3211,3569,3998,115409,114417,311,7.771,319,7.971,12483,3621,8862,3.165,10.910,10376,3101,7275,2.710,9.069,2107,1.842,18.137,245,247,2008
2005,3212,1441,1829,118296,115283,143,7.829,138,7.555,15457,3719,11738,3.226,13.408,9568,4136,5432,3.588,8.300,5889,5.108,16.599,84,86,1542
2005,3219,9163,10048,329656,322163,861,8.543,923,9.158,48374,13855,34519,4.301,15.015,33119,10189,22930,3.163,10.280,15255,4.735,20.560,685,695,6419
2005,3221,289,585,143813,146775,28,4.718,45,7.582,6021,2643,3378,1.801,4.102,12066,5234,6832,3.566,8.221,-6045,-4.119,8.204,18,18,304
2005,3222,3016,4541,309449,313658,176,3.819,311,6.748,21873,4147,17726,1.322,6.974,30284,11917,18367,3.799,9.655,-8411,-2.682,13.947,163,164,2651
2005,3231,31090,32675,658891,666999,1997,6.041,2765,8.364,61398,14822,46576,2.222,9.205,77544,28171,49373,4.224,11.626,-16146,-2.421,18.410,2213,2229,15335
2005,3241,1026,2241,99735,98714,169,7.580,146,6.549,9321,2060,7261,2.087,9.442,7094,2452,4642,2.484,7.186,2227,2.256,14.373,39,39,349
2005,3251,1181,2294,163568,165475,114,4.971,113,4.927,10353,2581,7772,1.560,6.257,14323,3171,11152,1.916,8.656,-3970,-2.399,12.513,49,51,590
2005,3252,729,1060,95869,96456,65,6.170,52,4.936,7259,1099,6160,1.139,7.526,8340,2194,6146,2.275,8.646,-1081,-1.121,15.051,20,20,720
2005,3253,624,868,29820,30048,64,7.365,66,7.595,2857,1017,1840,3.385,9.508,3358,1217,2141,4.050,11.175,-501,-1.667,19.016,29,29,243
2005,3254,1359,1756,255190,248949,126,7.194,117,6.680,32851,5313,27538,2.134,13.196,20211,4291,15920,1.724,8.119,12640,5.077,16.237,70,71,991
2005,3255,1444,1836,63350,63981,76,4.100,111,5.989,4497,964,3533,1.507,7.029,5752,1481,4271,2.315,8.990,-1255,-1.962,14.057,76,77,627
2005,3256,1939,2153,105080,105217,158,7.305,178,8.229,9902,1662,8240,1.580,9.411,10138,3500,6638,3.326,9.635,-236,-0.224,18.822,113,113,1495
2005,3259,2036,2626,108489,111374,175,6.590,234,8.812,8936,2138,6798,1.920,8.023,14577,3902,10675,3.504,13.088,-5641,-5.065,16.047,123,125,944
2005,3261,9469,12005,738155,737991,566,4.681,737,6.096,74456,14075,60381,1.907,10.089,74058,20505,53553,2.778,10.035,398,0.054,20.070,504,508,8786
2005,3262,1693,2180,160943,161811,101,4.585,147,6.673,11733,2002,9731,1.237,7.251,13437,3887,9550,2.402,8.304,-1704,-1.053,14.502,85,89,1321
2005,3271,1263,1464,53936,54809,130,8.844,142,9.660,5312,985,4327,1.797,9.692,6996,1965,5031,3.585,12.764,-1684,-3.073,19.384,109,109,700
2005,3272,1680,2004,102329,105035,153,7.571,187,9.253,7797,1959,5838,1.865,7.423,13039,4223,8816,4.021,12.414,-5242,-4.991,14.847,138,138,1375
2005,3273,4929,9276,216589,212883,576,6.268,402,4.375,31451,8762,22689,4.116,14.774,24070,4510,19560,2.119,11.307,7381,3.467,22.613,212,220,2194
2005,3274,215,337,17818,18201,22,6.557,19,5.663,1476,303,1173,1.665,8.110,2402,100,2302,0.549,13.197,-926,-5.088,16.219,16,16,61
2005,3279,2546,2960,76482,75155,304,10.432,212,7.275,10025,2477,7548,3.296,13.339,7374,2036,5338,2.709,9.812,2651,3.527,19.623,135,144,1235
2005,3311,477,598,108919,110173,78,13.198,64,10.829,4897,974,3923,0.884,4.445,7483,1619,5864,1.470,6.792,-2586,-2.347,8.890,44,45,918
2005,3312,490,624,44748,44395,44,7.051,44,7.051,4212,1749,2463,3.940,9.488,3540,967,2573,2.178,7.974,672,1.514,15.948,25,25,141
2005,3313,410,568,65917,64852,46,8.192,33,5.877,6039,2228,3811,3.436,9.312,4006,796,3210,1.227,6.177,2033,3.135,12.354,20,20,249
2005,3314,708,900,61645,61064,41,4.493,66,7.233,5683,701,4982,1.148,9.307,4603,1306,3297,2.139,7.538,1080,1.769,15.076,48,48,590
2005,3315,1926,2184,166487,169324,87,3.937,139,6.290,16342,2622,13720,1.549,9.651,22731,3800,18931,2.244,13.425,-6389,-3.773,19.303,93,96,1943
2005,3321,2401,2663,126847,124456,116,4.342,133,4.978,14025,3006,11019,2.415,11.269,9357,2435,6922,1.957,7.518,4668,3.751,15.037,86,86,1077
2005,3322,1309,1437,55400,56710,77,5.329,93,6.436,4564,1464,3100,2.582,8.048,7215,1708,5507,3.012,12.723,-2651,-4.675,16.096,62,62,791
2005,3323,11759,12663,373993,370829,888,7.008,906,7.150,48823,13113,35710,3.536,13.166,42634,12970,29664,3.498,11.497,6189,1.669,22.994,641,645,8734
2005,3324,1234,1509,86691,87423,69,4.520,104,6.813,8389,1044,7345,1.194,9.596,9943,2800,7143,3.203,11.374,-1554,-1.778,19.192,61,62,1052
2005,3325,699,774,47367,49507,36,4.580,60,7.634,4157,408,3749,0.824,8.397,8318,4502,3816,9.094,16.802,-4161,-8.405,16.794,40,41,715
2005,3326,1459,1646,56571,57240,52,3.084,132,7.829,5355,700,4655,1.223,9.355,6676,2138,4538,3.735,11.663,-1321,-2.308,18.711,99,99,1400
2005,3327,22996,23421,374494,367324,1450,6.177,1554,6.620,51735,9822,41913,2.674,14.084,37425,11828,25597,3.220,10.189,14310,3.896,20.377,1175,1178,7604
2005,3328,5395,5958,135745,134907,357,5.979,382,6.398,17360,4312,13048,3.196,12.868,15690,4981,10709,3.692,11.630,1670,1.238,23.261,295,296,3522
2005,3329,5468,5998,267316,267567,437,7.254,490,8.133,27590,5976,21614,2.233,10.311,27846,9114,18732,3.406,10.407,-256,-0.096,20.623,338,338,3049
2005,3331,2479,2778,182610,177300,185,6.698,153,5.539,22685,3465,19220,1.954,12.795,11764,4174,7590,2.354,6.635,10921,6.160,13.270,105,107,1885
2005,3332,3552,3768,135768,134802,226,5.952,284,7.480,15990,5158,10832,3.826,11.862,14057,5569,8488,4.131,10.428,1933,1.434,20.856,206,206,2323
2005,3333,2045,2200,98723,100875,147,6.641,174,7.861,8475,1869,6606,1.853,8.401,12408,3057,9351,3.030,12.300,-3933,-3.899,16.803,119,120,1143
2005,3334,1459,1763,149458,148461,125,7.114,113,6.431,14518,3423,11095,2.306,9.779,12426,3847,8579,2.591,8.370,2092,1.409,16.740,68,69,1239
2005,3335,7770,8070,176526,175500,382,4.693,523,6.425,18864,4337,14527,2.471,10.749,16822,4980,11842,2.838,9.585,2042,1.164,19.170,404,404,3084
2005,3336,729,882,97079,93508,50,5.672,49,5.559,10424,2226,8198,2.381,11.148,3415,777,2638,0.831,3.652,7009,7.496,7.304,31,31,295
2005,3339,5445,6094,279044,279005,336,5.485,400,6.530,26901,5732,21169,2.054,9.642,26670,9559,17111,3.426,9.559,231,0.083,19.118,270,271,2901
2005,3341,1167,1236,103524,105422,104,8.254,152,12.063,9987,1427,8560,1.354,9.473,13245,3189,10056,3.025,12.564,-3258,-3.090,18.947,111,111,1565
2005,3342,1539,1735,121175,125523,129,7.336,176,10.009,11793,3137,8656,2.499,9.395,20477,5861,14616,4.669,16.313,-8684,-6.918,18.790,126,131,2893
2005,3343,427,444,19150,19468,43,9.503,60,13.260,1594,180,1414,0.925,8.188,2162,1054,1108,5.414,11.105,-568,-2.918,16.376,46,46,718
2005,3344,4099,4631,359259,361436,244,5.200,366,7.801,32253,4767,27486,1.319,8.924,36418,10738,25680,2.971,10.076,-4165,-1.152,17.847,248,253,3315
2005,3345,4272,4932,399132,394682,307,6.206,336,6.793,42311,6298,36013,1.596,10.720,32997,14533,18464,3.682,8.360,9314,2.360,16.721,210,210,2680
2005,3346,732,780,34854,35550,80,10.095,105,13.249,4156,1087,3069,3.058,11.691,5471,1832,3639,5.153,15.390,-1315,-3.699,23.381,82,83,1639
2005,3351,1055,1147,59702,60408,65,5.635,78,6.762,4539,548,3991,0.907,7.514,5922,1725,4197,2.856,9.803,-1383,-2.289,15.028,62,62,858
2005,3352,288,344,82657,84083,48,14.264,33,9.807,7287,1408,5879,1.675,8.666,9912,2877,7035,3.422,11.788,-2625,-3.122,17.333,22,22,130
2005,3353,1979,2337,138510,137517,142,6.052,161,6.861,13785,3461,10324,2.517,10.024,11762,4232,7530,3.077,8.553,2023,1.471,17.106,111,111,1428
2005,3359,1771,2111,146599,149496,157,7.427,163,7.711,12114,3821,8293,2.556,8.103,17954,5609,12345,3.752,12.010,-5840,-3.906,16.206,111,111,1774
2005,3361,283,357,208610,212877,41,11.631,32,9.078,18634,7207,11427,3.386,8.753,28910,3633,25277,1.707,13.581,-10276,-4.827,17.507,25,25,125
2005,3362,1765,2020,148725,144186,147,7.215,182,8.933,20016,2928,17088,2.031,13.882,11291,4048,7243,2.807,7.831,8725,6.051,15.662,137,138,2201
2005,3363,4325,5434,669994,674273,341,6.254,378,6.933,65176,14245,50931,2.113,9.666,73820,16297,57523,2.417,10.948,-8644,-1.282,19.332,251,255,5479
2005,3364,1169,1511,392992,386114,81,5.332,97,6.386,33524,2397,31127,0.621,8.682,19252,2397,16855,0.621,4.986,14272,3.696,9.972,65,65,813
2005,3365,148,202,28317,26459,13,6.516,8,4.010,4893,335,4558,1.266,18.493,1213,247,966,0.934,4.584,3680,13.908,9.169,6,6,209
2005,3366,1531,1655,144138,143141,150,9.074,146,8.832,13147,2122,11025,1.482,9.185,11312,2824,8488,1.973,7.903,1835,1.282,15.805,111,112,2445
2005,3369,763,792,42479,40629,125,16.308,74,9.654,7621,939,6682,2.311,18.758,3641,1108,2533,2.727,8.962,3980,9.796,17.923,55,55,316
2005,3371,14535,14992,359776,361731,1365,9.062,1506,9.998,42913,12126,30787,3.352,11.863,46789,16862,29927,4.661,12.935,-3876,-1.072,23.726,1147,1151,8359
2005,3372,3799,3994,145032,146569,264,6.570,312,7.765,16436,3724,12712,2.541,11.214,19509,5559,13950,3.793,13.310,-3073,-2.097,22.428,239,239,2743
2005,3379,895,1032,46148,46275,69,6.663,76,7.339,5119,1687,3432,3.646,11.062,5459,1847,3612,3.991,11.797,-340,-0.735,22.124,56,57,874
2005,3391,10650,11424,304275,300698,777,6.792,809,7.072,35506,9481,26025,3.153,11.808,28103,6637,21466,2.207,9.346,7403,2.462,18.692,595,598,3485
2005,3399,17163,17626,376000,380086,1529,8.634,1697,9.582,43288,11830,31458,3.112,11.389,51380,16921,34459,4.452,13.518,-8092,-2.129,22.778,1318,1324,10079
2005,4231,17446,24041,368832,365652,1898,7.896,1894,7.879,46802,16083,30719,4.398,12.800,40678,12539,28139,3.429,11.125,6124,1.675,22.250,1330,1382,7418
2005,4232,10971,12584,161849,161856,1246,9.903,1241,9.864,22798,6609,16189,4.083,14.085,22857,7218,15639,4.460,14.122,-59,-0.036,28.171,952,981,5303
2005,4233,11750,17624,261734,253371,1779,10.251,1241,7.151,42967,14872,28095,5.870,16.958,26318,9738,16580,3.843,10.387,16649,6.571,20.774,812,853,5358
2005,4234,25196,34262,720697,722460,2973,8.599,3594,10.396,99702,28429,71273,3.935,13.800,102929,33681,69248,4.662,14.247,-3227,-0.447,27.601,2234,2298,14756
2005,4235,7367,10076,151207,148708,716,7.129,652,6.491,20043,5505,14538,3.702,13.478,15055,4596,10459,3.091,10.124,4988,3.354,20.248,386,400,2367
2005,4236,19473,28712,467393,469585,2458,8.550,2532,8.807,64962,18454,46508,3.930,13.834,68678,22851,45827,4.866,14.625,-3716,-0.791,27.668,1395,1521,8738
2005,4237,10992,18250,219519,217833,1305,7.206,1023,5.649,28149,9043,19106,4.151,12.922,24667,6146,18521,2.821,11.324,3482,1.598,22.648,605,630,3118
2005,4238,42296,57436,689569,689168,3670,6.365,4117,7.140,84935,23913,61022,3.470,12.324,84784,32699,52085,4.745,12.302,151,0.022,24.605,2631,2771,14587
2005,4239,27928,30898,332512,329586,3464,11.272,3128,10.179,50964,17689,33275,5.367,15.463,45292,14305,30987,4.340,13.742,5672,1.721,27.484,2403,2425,9848
2005,4241,9203,11939,202470,203303,775,6.456,905,7.539,22286,6978,15308,3.432,10.962,23882,5314,18568,2.614,11.747,-1596,-0.785,21.924,627,636,3234
2005,4242,5711,7453,253568,261299,817,11.037,716,9.672,34958,15382,19576,5.887,13.379,50323,24113,26210,9.228,19.259,-15365,-5.880,26.757,491,495,3228
2005,4243,13527,14681,202973,202471,1684,11.437,1770,12.021,31580,9584,21996,4.734,15.597,30471,8778,21693,4.335,15.050,1109,0.548,30.099,1398,1409,6420
2005,4244,25551,31565,768161,769307,2734,8.627,2990,9.434,93825,31273,62552,4.065,12.196,95633,25289,70344,3.287,12.431,-1808,-0.235,24.392,2219,2259,14166
2005,4245,4113,6588,63485,63733,305,4.581,446,6.698,7456,1558,5898,2.445,11.699,7986,1907,6079,2.992,12.530,-530,-0.832,23.398,250,275,1114
2005,4246,8389,12121,143610,143240,864,7.109,928,7.636,19903,6299,13604,4.398,13.895,19259,6850,12409,4.782,13.445,644,0.450,26.891,511,527,2274
2005,4247,5047,7149,105233,106412,429,5.968,508,7.067,13602,3470,10132,3.261,12.782,16044,5157,10887,4.846,15.077,-2442,-2.295,25.565,302,314,3030
2005,4248,3137,3916,171043,170318,269,6.854,286,7.288,15669,3322,12347,1.950,9.200,14193,5231,8962,3.071,8.333,1476,0.867,16.667,197,201,2645
2005,4249,23072,29008,379539,381688,2992,10.335,2877,9.938,48425,14796,33629,3.876,12.687,52849,16662,36187,4.365,13.846,-4424,-1.159,25.374,2140,2176,12010
2005,4251,37725,39757,296571,292825,5324,13.654,3793,9.728,53722,19084,34638,6.517,18.346,45946,15052,30894,5.140,15.691,7776,2.656,31.381,2749,2784,9534
2005,4411,43801,48289,1287463,1292607,4666,9.691,4386,9.109,138166,50645,87521,3.918,10.689,148184,48099,100085,3.721,11.464,-10018,-0.775,21.378,3466,3508,35287
2005,4412,13506,15084,162792,161374,1651,11.080,1285,8.624,26309,11055,15254,6.851,16.303,23483,7704,15779,4.774,14.552,2826,1.751,29.104,980,996,5726
2005,4413,31749,56245,493774,492684,4143,7.397,3677,6.565,64885,24777,40108,5.029,13.170,62764,20716,42048,4.205,12.739,2121,0.430,25.478,2522,2627,11281
2005,4421,19026,26759,273650,273486,2727,10.230,2524,9.468,42255,17745,24510,6.488,15.451,41734,13796,27938,5.045,15.260,521,0.191,30.520,1800,1921,9065
2005,4422,25227,34419,297068,300491,3575,10.441,3216,9.393,45303,19956,25347,6.641,15.076,51850,14045,37805,4.674,17.255,-6547,-2.179,30.153,2304,2377,8816
2005,4431,30079,50316,508056,503101,6862,13.794,5720,11.499,99822,36630,63192,7.281,19.841,87026,27013,60013,5.369,17.298,12796,2.543,34.596,3706,3925,15534
2005,4441,43875,64145,1111721,1088924,4558,7.149,3784,5.935,136519,48955,87564,4.496,12.537,91356,22789,68567,2.093,8.390,45163,4.147,16.779,2772,2915,14708
2005,4442,15546,18693,169522,172638,1272,6.739,1636,8.668,21970,6016,15954,3.485,12.726,28331,8699,19632,5.039,16.411,-6361,-3.685,25.452,1045,1067,4382
2005,4451,59572,85826,2609490,2620038,9627,11.226,9489,11.065,284025,121055,162970,4.620,10.840,304200,103984,200216,3.969,11.611,-20175,-0.770,21.681,6549,6717,38614
2005,4452,17332,20931,144447,144794,3490,16.818,3131,15.088,32370,16407,15963,11.331,22.356,33318,12677,20641,8.755,23.011,-948,-0.655,44.712,2216,2244,9188
2005,4453,23737,27121,136799,139611,2838,10.531,2492,9.247,22312,10041,12271,7.192,15.982,27798,8399,19399,6.016,19.911,-5486,-3.929,31.963,1883,1900,6416
2005,4461,40037,80135,1016813,1023588,6365,7.981,5607,7.030,132393,53523,78870,5.229,12.934,148573,29600,118973,2.892,14.515,-16180,-1.581,25.868,3203,3303,16515
2005,4471,62999,111981,910098,923854,9369,8.348,9881,8.804,141250,55896,85354,6.050,15.289,167392,56645,110747,6.131,18.119,-26142,-2.830,30.578,5988,6539,35469
2005,4481,35257,86560,1180706,1181454,8919,10.363,7931,9.215,185546,66489,119057,5.628,15.705,188266,54506,133760,4.613,15.935,-2720,-0.230,31.410,3941,4276,20035
2005,4482,6093,25287,185642,191402,1478,5.719,2592,10.029,30444,8416,22028,4.397,15.906,42046,16007,26039,8.363,21.967,-11602,-6.062,31.812,634,835,4112
2005,4483,18137,28862,169502,167080,3065,10.776,2225,7.823,27106,11918,15188,7.133,16.223,22455,7707,14748,4.613,13.440,4651,2.784,26.879,1431,1462,4456
2005,4511,28224,38059,413387,411343,4024,10.546,4221,11.062,62344,25353,36991,6.163,15.156,58523,21962,36561,5.339,14.227,3821,0.929,28.455,2808,3002,11996
2005,4512,6122,11706,140763,143707,931,7.908,1064,9.038,14929,5156,9773,3.588,10.389,20316,5771,14545,4.016,14.137,-5387,-3.749,20.777,729,756,3530
2005,4521,202,9040,1434859,1445298,314,3.508,134,1.497,101954,31025,70929,2.147,7.054,125236,10508,114728,0.727,8.665,-23282,-1.611,14.108,23,23,250
2005,4529,8919,33955,1316061,1298585,3410,10.288,1789,5.398,118483,51846,66637,3.993,9.124,84371,9596,74775,0.739,6.497,34112,2.627,12.994,1208,1249,4806
2005,4531,18538,19394,101950,105986,1796,9.151,2259,11.511,15419,5973,9446,5.636,14.548,23535,7308,16227,6.895,22.206,-8116,-7.658,29.096,1857,1874,5700
2005,4532,27062,38308,320245,320927,4447,11.576,4664,12.141,51825,22084,29741,6.881,16.149,53189,19568,33621,6.097,16.574,-1364,-0.425,32.297,3543,3634,12968
2005,4533,12316,16578,128192,128494,1703,10.265,1728,10.416,19224,7408,11816,5.765,14.961,19861,6231,13630,4.849,15.457,-637,-0.496,29.922,1347,1357,3958
2005,4539,31853,40391,258322,257449,4899,12.171,4621,11.480,48444,19114,29330,7.424,18.817,46305,15302,31003,5.944,17.986,2139,0.831,35.972,3286,3575,11539
2005,4541,14528,15460,265746,265115,2513,16.672,1740,11.543,46997,18612,28385,7.020,17.727,45648,16513,29135,6.229,17.218,1349,0.509,34.436,1314,1328,6789
2005,4542,4320,4887,52835,53736,506,10.272,584,11.855,5507,1879,3628,3.497,10.248,7364,2905,4459,5.406,13.704,-1857,-3.456,20.497,448,452,2257
2005,4543,21610,27158,217156,223119,2693,9.825,3199,11.670,32910,14353,18557,6.433,14.750,44602,18422,26180,8.257,19.990,-11692,-5.240,29.500,2147,2201,8041
2005,4811,536,3119,434920,435134,264,8.826,8,0.267,22205,4797,17408,1.102,5.103,22568,56,22512,0.013,5.186,-363,-0.083,10.206,7,7,54
2005,4812,1983,2151,38948,37984,297,13.960,250,11.751,6453,2088,4365,5.497,16.989,4463,2207,2256,5.810,11.750,1990,5.239,23.500,195,199,1620
2005,4831,767,1171,47347,46468,140,12.153,102,8.854,7324,2480,4844,5.337,15.761,5545,872,4673,1.877,11.933,1779,3.828,23.866,73,73,604
2005,4832,469,521,18724,19254,75,14.634,58,11.317,3259,499,2760,2.592,16.926,4499,2948,1551,15.311,23.367,-1240,-6.440,33.853,39,39,2677
2005,4841,44964,54216,1020601,1003227,9614,18.066,7616,14.311,151443,42587,108856,4.245,15.096,115702,40113,75589,3.998,11.533,35741,3.563,23.066,5689,5820,23813
2005,4842,41816,45475,458302,454549,6284,13.890,5814,12.851,82039,30195,51844,6.643,18.048,74172,25450,48722,5.599,16.318,7867,1.731,32.635,4352,4374,17383
2005,4851,606,907,52565,51272,108,11.980,97,10.760,8229,5201,3028,10.144,16.050,5753,2078,3675,4.053,11.221,2476,4.829,22.441,71,71,1184
2005,4852,194,497,17169,17515,71,14.685,44,9.100,1985,1193,792,6.811,11.333,2696,872,1824,4.979,15.393,-711,-4.059,22.666,19,19,377
2005,4853,5873,6000,64070,63785,966,16.212,883,14.819,12316,5196,7120,8.146,19.309,11704,4928,6776,7.726,18.349,612,0.959,36.699,731,731,3626
2005,4854,2979,4111,181487,180978,269,6.512,309,7.480,21330,8071,13259,4.460,11.786,20456,7747,12709,4.281,11.303,874,0.483,22.606,193,193,2415
2005,4855,1055,1158,27609,28345,143,12.291,154,13.236,4350,1473,2877,5.197,15.347,5840,2440,3400,8.608,20.604,-1490,-5.257,30.694,113,116,1423
2005,4859,2581,2812,56989,57232,424,15.135,403,14.385,9577,3822,5755,6.678,16.734,10178,4166,6012,7.279,17.784,-601,-1.050,33.468,303,304,2762
2005,4861,53,407,6103,6445,30,7.500,16,4.000,1138,570,568,8.845,17.658,1892,172,1720,2.669,29.358,-754,-11.700,35.317,4,4,40
2005,4862,121,1571,23451,23334,62,3.927,78,4.940,2028,869,1159,3.724,8.691,1829,546,1283,2.340,7.838,199,0.853,15.677,10,11,90
2005,4869,55,617,6621,6546,72,12.040,34,5.686,1150,684,466,10.450,17.569,995,356,639,5.439,15.201,155,2.368,30.403,4,4,11
2005,4871,461,513,8651,8547,81,16.152,58,11.565,1255,362,893,4.236,14.684,1062,402,660,4.704,12.426,193,2.258,24.852,47,47,249
2005,4872,1162,1197,11228,11289,185,15.385,196,16.299,1755,608,1147,5.386,15.547,1898,547,1351,4.846,16.814,-143,-1.267,31.094,133,133,402
2005,4879,135,140,2239,2152,23,17.100,12,8.922,355,78,277,3.625,16.496,196,20,176,0.929,9.108,159,7.388,18.216,8,8,16
2005,4881,3426,4744,145422,142147,513,10.771,551,11.568,25612,10455,15157,7.355,18.018,19223,7434,11789,5.230,13.523,6389,4.495,27.047,253,260,2253
2005,4882,473,920,26739,26579,106,11.877,51,5.714,4627,2238,2389,8.420,17.409,4286,961,3325,3.616,16.126,341,1.283,32.252,24,31,669
2005,4883,1627,2139,89340,88869,186,8.671,198,9.231,11840,2995,8845,3.370,13.323,10769,2618,8151,2.946,12.118,1071,1.205,24.236,122,122,763
2005,4884,7541,8026,65900,65447,1205,15.287,918,11.646,13658,6158,7500,9.409,20.869,12550,4221,8329,6.449,19.176,1108,1.693,38.352,715,717,3221
2005,4885,11959,16849,192064,188096,2151,13.045,1430,8.673,33563,12910,20653,6.864,17.844,25838,10812,15026,5.748,13.737,7725,4.107,27.473,843,884,4372
2005,4889,1193,1291,28358,28258,279,22.545,172,13.899,3857,1144,2713,4.048,13.649,3606,1053,2553,3.726,12.761,251,0.888,25.522,122,122,596
2005,4921,2858,8046,496225,519355,934,11.290,1388,16.777,57855,32514,25341,6.260,11.140,101409,13869,87540,2.670,19.526,-43554,-8.386,22.280,337,366,1884
2005,4922,4056,4544,45752,46434,640,14.120,617,13.613,7870,2981,4889,6.420,16.949,9266,3233,6033,6.963,19.955,-1396,-3.006,33.898,501,502,2607
2005,4931,6709,12989,590951,589094,1091,8.416,1040,8.023,79159,26448,52711,4.490,13.437,76659,23982,52677,4.071,13.013,2500,0.424,26.026,390,399,4267
2005,5111,15015,20988,699357,699217,1973,9.435,1820,8.703,69495,23446,46049,3.353,9.939,69389,21848,47541,3.125,9.924,106,0.015,19.848,1178,1208,10333
2005,5112,5875,8272,326722,321440,913,10.985,992,11.935,50483,13629,36854,4.240,15.705,40349,17114,23235,5.324,12.553,10134,3.153,25.105,532,569,7746
2005,5121,11981,15462,281340,280452,2230,14.549,1960,12.788,41458,19391,22067,6.914,14.783,39674,13513,26161,4.818,14.146,1784,0.636,28.293,1200,1213,6561
2005,5122,2614,2855,23105,24147,430,14.957,470,16.348,4665,2467,2198,10.217,19.319,6705,4247,2458,17.588,27.767,-2040,-8.448,38.638,288,288,898
2005,5151,4389,8925,242270,242551,679,7.590,720,8.049,25122,10096,15026,4.162,10.357,25489,8991,16498,3.707,10.509,-367,-0.151,20.715,345,371,4556
2005,5152,333,584,38470,38597,111,17.384,220,34.456,6104,3934,2170,10.193,15.815,6206,3461,2745,8.967,16.079,-102,-0.264,31.630,33,38,1057
2005,5171,3992,31203,954583,991042,3040,9.602,3953,12.486,132276,46550,85726,4.697,13.347,205086,68143,136943,6.876,20.694,-72810,-7.347,26.694,531,668,8950
2005,5172,2097,12694,251455,253202,2318,19.235,1032,8.564,32295,9143,23152,3.611,12.755,35746,5825,29921,2.301,14.118,-3451,-1.363,25.509,415,519,2516
2005,5174,466,592,11535,11748,135,23.768,87,15.317,1884,974,910,8.291,16.037,2327,1065,1262,9.065,19.808,-443,-3.771,32.074,47,47,303
2005,5179,4932,5599,73897,72365,1191,21.110,1277,22.634,26992,19907,7085,27.509,37.300,24650,9710,14940,13.418,34.064,2342,3.236,68.127,855,877,5409
2005,5182,7295,13994,384308,384392,2038,14.868,1464,10.681,62971,25777,37194,6.706,16.382,63666,19673,43993,5.118,16.563,-695,-0.181,32.764,678,695,6703
2005,5191,4889,5895,104231,101705,792,13.705,560,9.690,18283,6420,11863,6.312,17.977,13029,4215,8814,4.144,12.811,5254,5.166,25.621,370,371,2302
2005,5211,19,54,20069,20758,(D),(D),6,10.714,565,(D),557,(D),2.722,2031,182,1849,0.877,9.784,-1466,-7.063,5.444,(D),(D),(D)
2005,5221,16113,113551,2058307,2070825,9252,8.131,9718,8.541,262558,99653,162905,4.812,12.679,285966,142572,143394,6.885,13.809,-23408,-1.130,25.358,542,797,8777
2005,5222,19060,51014,787769,774854,8540,17.007,6943,13.826,178727,77402,101325,9.989,23.066,154127,66343,87784,8.562,19.891,24600,3.175,39.782,1981,2071,11999
2005,5223,24467,39286,324842,321551,7684,20.553,3885,10.391,76904,32054,44850,9.969,23.917,69421,21208,48213,6.596,21.589,7483,2.327,43.179,2475,2562,12817
2005,5231,12404,35771,482278,496471,5673,15.303,8275,22.321,123269,87401,35868,17.604,24.829,149405,90708,58697,18.271,30.093,-26136,-5.264,49.658,1055,1092,7151
2005,5232,55,60,6807,6779,12,20.690,8,13.793,327,65,262,0.959,4.824,281,34,247,0.502,4.145,46,0.679,8.291,6,6,31
2005,5239,32290,36312,353971,342658,6571,18.603,4591,12.998,80139,45824,34315,13.373,23.387,57426,24441,32985,7.133,16.759,22713,6.628,33.518,2997,3030,11479
2005,5241,6316,32260,1404165,1440968,6520,20.506,5590,17.581,138067,55455,82612,3.848,9.582,209951,76723,133228,5.324,14.570,-71884,-4.989,19.163,461,492,10356
2005,5242,118444,132072,921647,914904,13581,10.398,10660,8.162,159294,69239,90055,7.568,17.411,144062,48744,95318,5.328,15.746,15232,1.665,31.492,7194,7367,26812
2005,5250,2100,3637,39163,35268,1279,40.584,308,9.773,16100,9555,6545,27.093,45.651,8641,1655,6986,4.693,24.501,7459,21.150,49.003,113,133,555
2005,5311,86059,102915,519835,522964,11403,11.132,10434,10.186,89095,43261,45834,8.272,17.037,96170,38842,57328,7.427,18.389,-7075,-1.353,34.073,7680,8148,28278
2005,5312,71489,80073,340420,331577,16402,21.493,8885,11.643,85806,47811,37995,14.419,25.878,68438,25166,43272,7.590,20.640,17368,5.238,41.280,5575,5642,14143
2005,5313,58227,65910,604670,593312,11314,17.759,6909,10.845,113042,56994,56048,9.606,19.053,90080,31288,58792,5.273,15.183,22962,3.870,30.365,4575,4634,19280
2005,5321,4096,11984,171693,169760,2545,22.698,1002,8.936,30089,18260,11829,10.756,17.724,25611,4918,20693,2.897,15.087,4478,2.638,30.173,547,566,2747
2005,5322,11972,32039,263737,263119,2958,9.245,2872,8.976,40363,16542,23821,6.287,15.340,39298,12703,26595,4.828,14.935,1065,0.405,29.871,1476,1778,6585
2005,5323,3212,4948,32446,32649,374,7.515,431,8.661,4803,1702,3101,5.213,14.711,5141,2093,3048,6.411,15.747,-338,-1.035,29.422,239,276,1253
2005,5324,7449,12301,152941,154737,1349,11.033,1200,9.815,26869,9765,17104,6.311,17.364,30132,10955,19177,7.080,19.473,-3263,-2.109,34.729,624,654,3155
2005,5331,1920,1989,28566,28280,254,12.845,231,11.681,5211,1879,3332,6.644,18.427,4685,1744,2941,6.167,16.567,526,1.860,33.134,169,172,806
2005,5411,162343,171369,1201849,1209005,15363,9.021,13224,7.765,134626,46650,87976,3.859,11.135,148647,42615,106032,3.525,12.295,-14021,-1.160,22.271,9520,9623,30056
2005,5412,93024,106468,1208358,1214459,11197,10.628,8966,8.510,218021,79301,138720,6.530,17.952,226054,66800,159254,5.500,18.614,-8033,-0.661,35.904,5932,6014,36342
2005,5413,85980,98556,1289295,1274011,11125,11.428,8709,8.946,191724,57535,134189,4.516,15.049,161203,54870,106333,4.307,12.653,30521,2.396,25.306,5472,5576,26321
2005,5414,26513,26793,119934,119021,4200,15.869,3546,13.398,23141,9378,13763,7.879,19.443,21444,9092,12352,7.639,18.017,1697,1.426,36.034,2526,2533,6626
2005,5415,77103,87554,1145285,1123109,17611,20.457,14677,17.049,248201,95250,152951,8.481,22.099,203468,83587,119881,7.442,18.116,44733,3.983,36.233,9320,9438,38212
2005,5416,89777,95534,809704,785813,19405,20.816,14778,15.853,192194,77637,114557,9.880,24.458,145146,57411,87735,7.306,18.471,47048,5.987,36.942,10294,10379,36715
2005,5417,11122,14514,644802,638653,1889,13.099,1702,11.803,94543,30013,64530,4.699,14.804,82081,25276,56805,3.958,12.852,12462,1.951,25.704,931,950,9134
2005,5418,30750,33944,414287,401442,4080,12.049,3918,11.570,91039,27942,63097,6.960,22.678,64436,25046,39390,6.239,16.051,26603,6.627,32.102,2630,2648,11363
2005,5419,53086,61340,557091,552162,6820,11.236,5534,9.117,95285,29321,65964,5.310,17.257,85575,23227,62348,4.207,15.498,9710,1.759,30.996,3826,3882,15415
2005,5511,25778,47475,2807540,2817392,4583,9.762,3529,7.517,415571,138422,277149,4.913,14.750,435852,121321,314531,4.306,15.470,-20281,-0.720,29.500,1062,1103,17215
2005,5611,20289,22251,437370,432133,4352,20.281,2766,12.890,94442,44444,49998,10.285,21.855,84232,33555,50677,7.765,19.492,10210,2.363,38.984,2023,2044,21044
2005,5612,1656,4146,173377,170363,539,13.289,359,8.851,29622,12001,17621,7.044,17.388,23706,8605,15101,5.051,13.915,5916,3.473,27.830,140,143,1628
2005,5613,26923,44020,4265149,4035718,6451,14.802,5575,12.792,1192006,321652,870354,7.970,29.536,728199,255870,472329,6.340,18.044,463807,11.493,36.088,2941,3090,156539
2005,5614,26737,32635,776011,778270,4366,13.497,3791,11.720,148936,60054,88882,7.716,19.137,154023,54122,99901,6.954,19.790,-5087,-0.654,38.274,2695,2734,23138
2005,5615,16151,21707,252912,256330,2112,9.551,2923,13.219,42998,21462,21536,8.373,16.774,50259,16970,33289,6.620,19.607,-7261,-2.833,33.549,1564,1608,6543
2005,5616,16889,21344,757538,750084,2561,12.038,2422,11.385,123453,34156,89297,4.554,16.459,108683,35385,73298,4.717,14.489,14770,1.969,28.979,1589,1661,20469
2005,5617,128318,134492,1616814,1606542,21972,16.553,18463,13.909,318255,110724,207531,6.892,19.810,298905,102236,196669,6.364,18.605,19350,1.204,37.211,12733,12775,66479
2005,5619,17001,19149,345788,343772,2131,11.177,1964,10.301,59771,16973,42798,4.937,17.387,56379,18533,37846,5.391,16.400,3392,0.987,32.800,1326,1338,9322
2005,5621,6571,8284,172107,175573,865,10.454,845,10.213,21480,6303,15177,3.590,12.234,27681,17064,10617,9.719,15.766,-6201,-3.532,24.469,463,465,2803
2005,5622,1447,2410,54690,55461,219,9.038,245,10.111,7339,2346,4993,4.230,13.233,8714,4776,3938,8.611,15.712,-1375,-2.479,26.465,89,89,489
2005,5629,6554,7246,107992,109765,832,11.609,674,9.404,22676,7553,15123,6.881,20.659,26020,6303,19717,5.742,23.705,-3344,-3.047,41.318,452,453,2571
2005,6111,17172,19372,783602,781522,1174,6.241,54,0.287,72008,20794,51214,2.661,9.214,69365,191,69174,0.024,8.876,2643,0.338,17.751,34,34,107
2005,6112,471,823,86838,82008,60,7.557,(D),(D),14556,5562,8994,6.782,17.749,4911,(D),4908,(D),5.988,9645,11.761,11.977,(D),(D),(D)
2005,6113,2278,3448,1518683,1511389,454,14.078,8,0.248,105477,30505,74972,2.018,6.979,90755,60,90695,0.004,6.005,14722,0.974,12.009,6,6,57
2005,6114,5935,6459,62064,62086,915,14.126,952,14.697,11807,4905,6902,7.900,19.017,11976,4789,7187,7.714,19.290,-169,-0.272,38.035,655,671,3262
2005,6115,5896,7064,105784,104315,757,10.791,659,9.394,18354,5359,12995,5.137,17.595,15411,4129,11282,3.958,14.774,2943,2.821,29.547,491,501,2877
2005,6116,27379,29473,270878,263535,4558,15.854,3113,10.828,59358,23169,36189,8.792,22.524,45051,13796,31255,5.235,17.095,14307,5.429,34.190,2198,2208,9356
2005,6117,4674,5106,62871,61155,909,18.351,604,12.193,13951,6578,7373,10.756,22.813,10616,3334,7282,5.452,17.359,3335,5.453,34.719,403,406,2102
2005,6211,173097,197409,2025457,2039490,16064,8.196,13219,6.745,249938,84868,165070,4.161,12.255,278336,68998,209338,3.383,13.647,-28398,-1.392,24.510,9518,9725,45274
2005,6212,114828,119930,794002,799689,7743,6.541,4640,3.920,98016,33546,64470,4.195,12.257,109614,21039,88575,2.631,13.707,-11598,-1.450,24.514,3662,3738,17340
2005,6213,92378,101491,545493,544395,10140,10.100,7957,7.925,96969,33438,63531,6.142,17.812,94995,28762,66233,5.283,17.450,1974,0.363,34.899,5478,5563,19571
2005,6214,12686,25481,650275,647840,2352,9.400,1432,5.723,79237,29800,49437,4.600,12.231,74793,17420,57373,2.689,11.545,4444,0.686,23.090,756,788,7933
2005,6215,6940,11002,216825,212519,1745,16.516,872,8.253,33280,12696,20584,5.974,15.660,24548,6761,17787,3.181,11.551,8732,4.109,23.102,541,553,3709
2005,6216,12545,18234,909372,882532,3216,18.404,1696,9.706,163392,48268,115124,5.469,18.514,110453,31529,78924,3.573,12.515,52939,5.999,25.031,1121,1178,17468
2005,6219,5470,8331,247708,240584,784,9.459,699,8.433,42650,12142,30508,5.047,17.728,28629,9432,19197,3.920,11.900,14021,5.828,23.800,360,373,4591
2005,6221,3257,5236,4838639,4815163,129,2.470,103,1.972,199959,33473,166486,0.695,4.153,152783,35026,117757,0.727,3.173,47176,0.980,6.346,43,44,8375
2005,6222,524,666,211683,212540,49,7.458,31,4.718,7930,2732,5198,1.285,3.731,9677,5673,4004,2.669,4.553,-1747,-0.822,7.462,15,16,1995
2005,6223,542,871,203665,200621,120,14.414,43,5.165,16008,4729,11279,2.357,7.979,10250,2804,7446,1.398,5.109,5758,2.870,10.218,22,22,649
2005,6231,8490,16015,1596783,1600934,1354,8.533,1058,6.668,146577,68929,77648,4.306,9.156,155295,70767,84528,4.420,9.700,-8718,-0.545,18.311,505,522,25945
2005,6232,7999,30083,553520,544090,2611,8.861,1375,4.667,75553,25808,49745,4.743,13.886,56823,14439,42384,2.654,10.444,18730,3.442,20.887,383,470,4643
2005,6233,13174,17612,622576,612782,1895,10.842,1629,9.320,84001,38028,45973,6.206,13.708,64327,24370,39957,3.977,10.498,19674,3.211,20.995,1141,1201,15160
2005,6239,3541,6120,156623,157306,453,7.407,444,7.260,16797,4545,12252,2.889,10.678,17999,5417,12582,3.444,11.442,-1202,-0.764,21.356,232,244,2418
2005,6241,36907,51053,1040478,1017071,4599,9.134,3198,6.351,156462,43721,112741,4.299,15.384,109889,25119,84770,2.470,10.804,46573,4.579,21.609,1969,2018,14230
2005,6242,9234,12487,155989,154912,594,4.767,542,4.350,18422,3024,15398,1.952,11.892,16261,3175,13086,2.050,10.497,2161,1.395,20.994,278,282,1793
2005,6243,4861,7910,333297,327992,497,6.286,489,6.185,50426,10999,39427,3.353,15.374,39791,7482,32309,2.281,12.132,10635,3.242,24.263,245,270,3084
2005,6244,53025,66542,800508,794923,7744,11.728,6725,10.184,125037,50605,74432,6.366,15.729,113728,39771,73957,5.003,14.307,11309,1.423,28.614,4899,5004,27711
2005,7111,7434,7584,133959,130157,927,12.185,975,12.815,30705,12980,17725,9.973,23.591,22533,6397,16136,4.915,17.312,8172,6.279,34.624,637,641,3959
2005,7112,3346,3524,117043,113935,552,15.873,459,13.199,21338,6897,14441,6.053,18.728,15192,3502,11690,3.074,13.334,6146,5.394,26.668,341,342,2282
2005,7113,4465,4778,105016,105852,601,12.679,525,11.076,20256,4756,15500,4.493,19.136,21928,3866,18062,3.652,20.716,-1672,-1.580,38.272,369,369,2403
2005,7114,2652,2713,18949,17295,443,16.545,372,13.894,6304,5037,1267,29.125,36.451,3267,1064,2203,6.152,18.890,3037,17.560,37.781,264,268,832
2005,7115,12166,12183,42676,44190,2622,22.023,2068,17.369,13212,6176,7036,13.976,29.899,16190,5531,10659,12.517,36.638,-2978,-6.739,59.797,1227,1230,3246
2005,7121,5933,6354,121059,120649,434,6.895,314,4.989,10679,1524,9155,1.263,8.851,9868,1018,8850,0.844,8.179,811,0.672,16.358,183,183,573
2005,7131,1822,2345,146275,143141,363,15.513,353,15.085,17173,4751,12422,3.319,11.997,10933,2728,8205,1.906,7.638,6240,4.359,15.276,225,228,2100
2005,7132,1701,2191,187844,183637,288,13.464,184,8.602,26410,11279,15131,6.142,14.382,18601,5239,13362,2.853,10.129,7809,4.252,20.258,133,133,3075
2005,7139,50007,55375,1067331,1060704,7375,13.529,5649,10.363,165052,63256,101796,5.964,15.561,152103,47573,104530,4.485,14.340,12949,1.221,28.680,4290,4322,33550
2005,7211,36956,46786,1789164,1786526,4888,10.483,4576,9.813,231351,100097,131254,5.603,12.950,225778,97922,127856,5.481,12.638,5573,0.312,25.276,2937,3125,50895
2005,7212,5027,5488,37814,37706,547,9.983,530,9.672,6926,2373,4553,6.294,18.369,6761,2075,4686,5.503,17.931,165,0.438,35.862,348,351,1379
2005,7213,2165,2234,12447,12887,146,6.449,206,9.099,1699,495,1204,3.841,13.184,2593,1183,1410,9.180,20.122,-894,-6.937,26.369,142,144,998
2005,7223,11256,29352,559088,539769,4407,15.459,2720,9.541,119508,69570,49938,12.889,22.141,82325,28822,53503,5.340,15.252,37183,6.889,30.504,1430,1473,10243
2005,7224,41914,42470,353453,355604,5209,12.191,5723,13.394,78143,42771,35372,12.028,21.975,82093,33116,48977,9.313,23.086,-3950,-1.111,43.949,4630,4645,26691
2005,7225,301477,411119,8277753,8155166,56084,13.858,43237,10.684,1525270,799020,726250,9.798,18.703,1284751,442185,842566,5.422,15.754,240519,2.949,31.508,32675,33550,309912
2005,8111,139376,152408,875020,886470,15399,10.107,15307,10.046,146030,63416,82614,7.154,16.473,168701,56186,112515,6.338,19.031,-22671,-2.557,32.946,11617,11811,42452
2005,8112,10891,12321,129996,129917,1314,10.554,1572,12.627,22547,9798,12749,7.542,17.355,22507,7054,15453,5.430,17.324,40,0.031,34.648,1116,1138,3759
2005,8113,20944,22331,181376,180480,2274,10.265,1919,8.662,28506,8413,20093,4.661,15.795,26933,7909,19024,4.382,14.923,1573,0.872,29.846,1419,1432,5484
2005,8114,20051,21173,103955,105797,2568,12.072,2766,13.003,16828,7047,9781,6.661,15.906,20552,7530,13022,7.117,19.426,-3724,-3.520,31.812,2017,2069,5419
2005,8121,81645,95619,589167,585598,13747,14.583,11039,11.711,108262,57070,51192,9.746,18.487,101044,38963,62081,6.654,17.255,7218,1.233,34.510,8799,8995,31495
2005,8122,14726,20428,136591,140540,961,4.686,1122,5.471,16109,3640,12469,2.590,11.462,24098,4537,19561,3.228,17.147,-7989,-5.685,22.924,484,503,1643
2005,8123,32009,38552,368840,374806,4203,10.877,4383,11.343,49215,19770,29445,5.275,13.131,61055,21323,39732,5.689,16.290,-11840,-3.159,26.262,3120,3226,13719
2005,8129,20801,31852,227389,228368,5197,16.405,4852,15.316,49584,22942,26642,10.046,21.712,51318,21710,29608,9.507,22.472,-1734,-0.759,43.425,2682,2724,10665
2005,8131,164945,165328,1614604,1611354,8521,5.282,497,0.308,156475,27959,128516,1.735,9.711,150565,1106,149459,0.069,9.344,5910,0.367,18.688,282,282,609
2005,8132,13692,15604,150566,150269,1277,8.289,880,5.712,16604,3688,12916,2.454,11.050,16148,3706,12442,2.466,10.746,456,0.303,21.492,556,569,2605
2005,8133,11513,13653,121483,121195,1135,8.407,830,6.148,17007,4189,12818,3.456,14.033,16570,3223,13347,2.659,13.672,437,0.361,27.344,501,501,1959
2005,8134,28138,30204,321136,323423,1419,4.684,1597,5.272,33848,5531,28317,1.710,10.466,38345,6346,31999,1.962,11.856,-4497,-1.390,20.931,1095,1098,4416
2005,8139,60342,62273,528464,533427,2706,4.361,2270,3.658,58673,10006,48667,1.876,10.999,68491,8435,60056,1.581,12.840,-9818,-1.841,21.999,1533,1540,5185
2006,2111,5731,6856,90720,86361,830,12.344,566,8.418,20120,9006,11114,10.428,23.298,11203,5101,6102,5.907,12.972,8917,10.325,25.945,369,372,1844
2006,2121,626,1038,77653,75359,120,11.650,104,10.097,12525,3846,8679,5.104,16.621,7947,2676,5271,3.551,10.546,4578,6.075,21.091,60,65,1294
2006,2122,189,259,27935,27063,31,11.946,32,12.331,2747,185,2562,0.684,10.150,965,319,646,1.179,3.566,1782,6.585,7.132,22,22,51
2006,2123,3292,5452,98892,97608,514,9.569,353,6.572,14226,4714,9512,4.830,14.575,11693,3329,8364,3.411,11.980,2533,2.595,23.959,200,202,1162
2006,2131,8081,9627,254429,234225,1601,17.303,852,9.208,67283,26332,40951,11.242,28.726,26544,12752,13792,5.444,11.333,40739,17.393,22.665,552,566,5138
2006,2211,1594,9401,497005,504655,577,6.151,536,5.714,37388,13674,23714,2.710,7.409,52451,8148,44303,1.615,10.393,-15063,-2.985,14.817,56,58,906
2006,2212,466,2418,79778,79876,248,10.231,260,10.726,9121,3292,5829,4.121,11.419,9199,4261,4938,5.335,11.517,-78,-0.098,22.838,29,32,155
2006,2213,4081,4881,41098,40819,315,6.440,335,6.849,5212,1733,3479,4.246,12.769,4649,1583,3066,3.878,11.389,563,1.379,22.779,194,194,1078
2006,2361,165807,167116,983584,942869,34917,21.502,25459,15.678,276368,120331,156037,12.762,29.311,195801,85798,110003,9.100,20.767,80567,8.545,41.533,19110,19163,64185
2006,2362,37418,38530,724164,701912,4993,13.160,3815,10.055,150604,32426,118178,4.620,21.456,106149,25040,81109,3.567,15.123,44455,6.333,30.246,2902,2913,17843
2006,2371,18634,19637,499247,476156,2053,10.535,1755,9.006,112746,25249,87497,5.303,23.678,67112,18722,48390,3.932,14.095,45634,9.584,28.189,1263,1268,9690
2006,2372,10364,10472,79587,74630,1944,19.033,1428,13.981,22141,8012,14129,10.736,29.668,12199,5632,6567,7.547,16.346,9942,13.322,32.692,1130,1133,4608
2006,2373,9838,10589,324635,317539,955,9.066,844,8.013,58938,11304,47634,3.560,18.561,44916,9318,35598,2.934,14.145,14022,4.416,28.290,558,559,4344
2006,2379,4350,4566,87282,83650,701,15.705,496,11.112,19060,4919,14141,5.880,22.785,11673,2601,9072,3.109,13.955,7387,8.831,27.909,352,353,1718
2006,2381,98342,99016,1170176,1120380,16367,16.832,12815,13.179,304226,90520,213706,8.079,27.154,204654,65208,139446,5.820,18.266,99572,8.887,36.533,9685,9691,51148
2006,2382,160029,163529,1950308,1883676,21803,13.603,15305,9.549,403844,104679,299165,5.557,21.439,271310,79678,191632,4.230,14.403,132534,7.036,28.806,11853,11897,60524
2006,2383,112178,113355,974648,936452,20950,18.935,15521,14.028,253183,85817,167366,9.164,27.036,177657,60512,117145,6.462,18.971,75526,8.065,37.943,11916,11919,47811
2006,2389,59364,59910,556373,525563,12011,20.885,7209,12.535,144467,51740,92727,9.845,27.488,83009,29912,53097,5.691,15.794,61458,11.694,31.589,5383,5384,21783
2006,3111,1159,1722,47820,47283,127,7.429,102,5.967,5305,1328,3977,2.809,11.220,4200,1271,2929,2.688,8.883,1105,2.337,17.766,62,64,605
2006,3112,456,778,55282,55765,43,5.520,45,5.777,3262,612,2650,1.097,5.850,4259,639,3620,1.146,7.637,-997,-1.788,11.699,29,29,251
2006,3113,1497,1667,71509,72332,149,8.911,159,9.510,6181,1031,5150,1.425,8.545,7910,1614,6296,2.231,10.936,-1729,-2.390,17.091,136,136,1075
2006,3114,1219,1587,162630,161854,105,6.538,143,8.904,16012,3838,12174,2.371,9.893,14574,3523,11051,2.177,9.004,1438,0.888,18.009,90,90,1388
2006,3115,993,1483,130514,131243,91,6.124,97,6.528,9145,2652,6493,2.021,6.968,10656,3640,7016,2.773,8.119,-1511,-1.151,13.936,55,55,1283
2006,3116,2953,3562,493885,494821,221,6.151,283,7.876,34010,4806,29204,0.971,6.873,36659,11923,24736,2.410,7.409,-2649,-0.535,13.746,218,218,2264
2006,3117,511,603,35613,36735,43,6.930,78,12.571,3337,675,2662,1.837,9.084,5523,2021,3502,5.502,15.035,-2186,-5.951,18.168,53,53,740
2006,3118,8874,9628,289054,291763,929,9.549,1131,11.625,32814,9173,23641,3.144,11.247,37987,16298,21689,5.586,13.020,-5173,-1.773,22.494,903,916,6838
2006,3119,2527,2957,159697,159463,294,10.015,251,8.551,15918,5108,10810,3.203,9.982,15407,5360,10047,3.361,9.662,511,0.320,19.324,191,193,3410
2006,3121,2617,3167,134700,134099,409,13.296,227,7.380,12839,2580,10259,1.924,9.574,11799,2816,8983,2.100,8.799,1040,0.776,17.597,171,171,1586
2006,3122,84,116,21222,21509,17,14.719,16,13.853,967,225,742,1.046,4.496,1512,214,1298,0.995,7.030,-545,-2.534,8.992,9,9,32
2006,3131,289,432,48580,50293,29,6.480,60,13.408,4344,1314,3030,2.613,8.637,7827,3459,4368,6.878,15.563,-3483,-6.925,17.275,35,35,284
2006,3132,1124,1302,92682,97588,61,4.544,142,10.577,6730,2426,4304,2.486,6.896,16817,5861,10956,6.006,17.233,-10087,-10.336,13.793,96,97,1133
2006,3133,1235,1300,49192,50590,109,8.248,152,11.502,5505,2208,3297,4.365,10.882,8350,3797,4553,7.506,16.505,-2845,-5.624,21.763,112,114,1809
2006,3141,2296,2439,80551,83473,198,7.930,314,12.575,5816,1470,4346,1.761,6.968,11710,5094,6616,6.103,14.029,-5894,-7.061,13.935,257,259,1820
2006,3149,4145,4273,78701,79921,369,8.489,517,11.893,9582,2153,7429,2.694,11.989,12102,4672,7430,5.846,15.143,-2520,-3.153,23.979,431,431,2676
2006,3151,441,484,30480,31821,33,6.496,81,15.945,3462,2130,1332,6.694,10.880,6028,2437,3591,7.659,18.944,-2566,-8.064,21.760,58,58,942
2006,3152,7158,7306,161283,166561,1387,18.799,1531,20.751,29021,14913,14108,8.953,17.424,39475,19937,19538,11.970,23.700,-10454,-6.276,34.847,1366,1370,15781
2006,3159,814,839,16705,17757,75,8.596,142,16.275,1748,670,1078,3.773,9.844,3840,1669,2171,9.399,21.625,-2092,-11.781,19.688,120,120,640
2006,3161,215,222,5722,6242,22,9.977,19,8.617,537,114,423,1.826,8.604,1535,919,616,14.724,24.593,-998,-15.990,17.207,14,14,114
2006,3162,238,262,15325,15647,18,6.667,34,12.593,1230,412,818,2.633,7.861,1849,775,1074,4.953,11.817,-619,-3.956,15.722,21,23,378
2006,3169,750,760,15975,15917,70,9.085,91,11.811,1975,361,1614,2.268,12.409,1872,673,1199,4.228,11.761,103,0.647,23.523,75,75,465
2006,3211,3583,4021,117740,116547,339,8.435,335,8.335,13242,4016,9226,3.446,11.362,10795,3663,7132,3.143,9.262,2447,2.100,18.525,271,271,2502
2006,3212,1476,1886,125215,122971,158,8.481,112,6.012,14485,4375,10110,3.558,11.779,9996,2341,7655,1.904,8.129,4489,3.650,16.257,74,74,1215
2006,3219,9204,10152,342316,335383,1016,10.050,930,9.200,50380,15044,35336,4.486,15.022,36216,12119,24097,3.613,10.798,14164,4.223,21.597,733,739,7048
2006,3221,275,565,138043,140811,30,5.236,46,8.028,3516,983,2533,0.698,2.497,9067,3282,5785,2.331,6.439,-5551,-3.942,4.994,17,17,712
2006,3222,2978,4468,303680,306159,201,4.457,284,6.298,22921,7394,15527,2.415,7.487,28010,9452,18558,3.087,9.149,-5089,-1.662,14.973,155,155,2412
2006,3231,30374,31973,643445,652129,2136,6.584,3070,9.464,62210,19633,42577,3.011,9.540,79609,29221,50388,4.481,12.208,-17399,-2.668,19.079,2554,2559,17737
2006,3241,1031,2268,100027,100339,193,8.606,142,6.332,8258,2622,5636,2.613,8.230,8958,3942,5016,3.929,8.928,-700,-0.698,16.460,52,52,922
2006,3251,1234,2319,163119,163818,172,7.452,150,6.499,10868,3634,7234,2.218,6.634,12369,2673,9696,1.632,7.550,-1501,-0.916,13.268,53,54,424
2006,3252,744,1061,88466,90095,83,7.867,71,6.730,5572,1222,4350,1.356,6.185,8805,2497,6308,2.772,9.773,-3233,-3.588,12.369,42,43,910
2006,3253,631,875,28814,29387,69,7.908,64,7.335,1955,505,1450,1.718,6.653,3059,934,2125,3.178,10.409,-1104,-3.757,13.305,35,35,225
2006,3254,1396,1805,246474,244159,157,8.788,120,6.717,20270,3112,17158,1.275,8.302,15696,3502,12194,1.434,6.429,4574,1.873,12.857,78,78,1595
2006,3255,1446,1844,63824,64003,115,6.230,119,6.446,5631,1652,3979,2.581,8.798,6107,1766,4341,2.759,9.542,-476,-0.744,17.596,79,79,795
2006,3256,1943,2166,103298,103807,149,6.889,143,6.611,8668,2678,5990,2.580,8.350,9676,2530,7146,2.437,9.321,-1008,-0.971,16.700,107,107,1279
2006,3259,2063,2651,107387,108079,216,8.186,191,7.239,9068,1865,7203,1.726,8.390,10391,2538,7853,2.348,9.614,-1323,-1.224,16.780,120,120,938
2006,3261,9376,11934,739775,739767,649,5.407,788,6.565,71200,17937,53263,2.425,9.625,71477,21231,50246,2.870,9.662,-277,-0.037,19.249,537,545,8501
2006,3262,1687,2183,156797,158200,125,5.738,116,5.325,9047,2352,6695,1.487,5.719,11716,2956,8760,1.869,7.406,-2669,-1.687,11.437,76,76,688
2006,3271,1234,1439,53091,53666,135,9.298,161,11.088,4710,1233,3477,2.298,8.777,5848,1635,4213,3.047,10.897,-1138,-2.121,17.553,125,125,563
2006,3272,1656,1979,102169,102387,160,8.036,184,9.242,8968,1228,7740,1.199,8.759,9225,2939,6286,2.870,9.010,-257,-0.251,17.518,144,144,1008
2006,3273,4937,9726,229129,223149,926,9.724,520,5.460,39282,14527,24755,6.510,17.604,27159,6256,20903,2.804,12.171,12123,5.433,24.342,249,266,2786
2006,3274,209,336,17965,17953,19,5.605,25,7.375,1317,272,1045,1.515,7.336,1277,198,1079,1.103,7.113,40,0.223,14.226,18,18,153
2006,3279,2711,3164,81800,79199,383,12.427,219,7.106,12487,4245,8242,5.360,15.767,7198,2478,4720,3.129,9.088,5289,6.678,18.177,167,167,1893
2006,3311,388,504,106362,106770,37,7.177,60,11.639,4613,1008,3605,0.944,4.321,5601,2500,3101,2.341,5.246,-988,-0.925,8.641,43,43,444
2006,3312,468,607,45377,45535,34,5.574,40,6.557,3296,575,2721,1.263,7.238,3570,1153,2417,2.532,7.840,-274,-0.602,14.477,27,27,246
2006,3313,416,570,64185,65105,38,6.684,35,6.157,3671,1000,2671,1.536,5.639,5502,1643,3859,2.524,8.451,-1831,-2.812,11.277,21,21,126
2006,3314,722,917,61476,61742,56,6.164,39,4.293,3469,763,2706,1.236,5.619,4078,494,3584,0.800,6.605,-609,-0.986,11.237,26,26,100
2006,3315,1878,2133,166926,166166,104,4.855,122,5.696,14159,2369,11790,1.426,8.521,12615,3687,8928,2.219,7.592,1544,0.929,15.184,89,90,1530
2006,3321,2391,2644,126840,126864,135,5.112,129,4.885,11938,3337,8601,2.630,9.410,11852,3400,8452,2.680,9.342,86,0.068,18.685,89,91,1899
2006,3322,1297,1414,53835,54866,89,6.246,111,7.789,4051,843,3208,1.536,7.383,6147,2447,3700,4.460,11.204,-2096,-3.820,14.767,77,77,426
2006,3323,12024,12967,396532,385187,1053,8.175,880,6.832,58020,12518,45502,3.250,15.063,35135,9784,25351,2.540,9.122,22885,5.941,18.243,663,664,5354
2006,3324,1243,1504,88281,87171,70,4.631,85,5.624,8468,1252,7216,1.436,9.714,6276,1683,4593,1.931,7.200,2192,2.515,14.399,60,68,862
2006,3325,691,774,44294,45547,45,5.821,43,5.563,2876,775,2101,1.702,6.314,5410,1856,3554,4.075,11.878,-2534,-5.564,12.629,34,34,653
2006,3326,1405,1585,54790,55146,62,3.847,115,7.136,5279,1135,4144,2.058,9.573,6095,1749,4346,3.172,11.052,-816,-1.480,19.146,79,79,768
2006,3327,23207,23640,389167,382710,1652,6.996,1599,6.772,48808,11731,37077,3.065,12.753,35915,11237,24678,2.936,9.384,12893,3.369,18.769,1289,1293,7718
2006,3328,5391,5941,136748,136403,357,5.976,422,7.065,15633,3995,11638,2.929,11.461,15007,4574,10433,3.353,11.002,626,0.459,22.004,331,335,2790
2006,3329,5593,6123,272806,269039,525,8.681,374,6.184,28650,6886,21764,2.559,10.649,21096,6846,14250,2.545,7.841,7554,2.808,15.683,261,261,3329
2006,3331,2503,2819,194719,188795,207,7.405,160,5.723,26263,4110,22153,2.177,13.911,13759,4345,9414,2.301,7.288,12504,6.623,14.576,114,115,1185
2006,3332,3513,3710,133588,133657,224,5.986,288,7.696,12736,3107,9629,2.325,9.529,12774,4785,7989,3.580,9.557,-38,-0.028,19.058,201,202,2176
2006,3333,2043,2195,97489,97983,155,7.049,163,7.412,8226,2557,5669,2.610,8.395,9105,2536,6569,2.588,9.292,-879,-0.897,16.791,126,126,1282
2006,3334,1452,1752,151902,150520,118,6.731,120,6.845,14649,2121,12528,1.409,9.732,11981,4491,7490,2.984,7.960,2668,1.773,15.919,84,86,1561
2006,3335,7572,7863,173797,173391,357,4.495,515,6.485,16685,3035,13650,1.750,9.623,15805,5528,10277,3.188,9.115,880,0.508,18.231,415,415,3474
2006,3336,738,895,101558,100143,62,6.970,51,5.734,8050,1023,7027,1.022,8.039,5060,1557,3503,1.555,5.053,2990,2.986,10.106,32,32,373
2006,3339,5428,6065,284174,282054,372,6.117,404,6.644,27609,5756,21853,2.041,9.789,23457,8665,14792,3.072,8.316,4152,1.472,16.633,285,285,2955
2006,3341,1116,1178,98804,95888,120,10.071,147,12.337,17405,7760,9645,8.093,18.151,10867,2718,8149,2.835,11.333,6538,6.818,22.666,111,113,1335
2006,3342,1526,1727,143529,141392,135,7.790,147,8.482,22676,2934,19742,2.075,16.038,19135,6757,12378,4.779,13.533,3541,2.504,27.067,98,99,1610
2006,3343,433,453,18767,19426,54,12.217,32,7.240,1669,455,1214,2.342,8.592,3004,720,2284,3.706,15.464,-1335,-6.872,17.184,29,29,193
2006,3344,4076,4605,365156,361674,288,6.241,308,6.674,40064,8128,31936,2.247,11.077,32681,10676,22005,2.952,9.036,7383,2.041,18.072,203,203,3634
2006,3345,4334,5026,387632,391737,389,7.796,316,6.333,35650,8372,27278,2.137,9.100,43806,9635,34171,2.460,11.183,-8156,-2.082,18.201,203,205,2585
2006,3346,706,752,32969,33546,72,9.524,80,10.582,2350,697,1653,2.078,7.005,3533,925,2608,2.757,10.532,-1183,-3.527,14.011,57,57,626
2006,3351,1041,1130,57316,58205,70,6.127,95,8.315,4608,842,3766,1.447,7.917,6496,2103,4393,3.613,11.161,-1888,-3.244,15.834,65,65,825
2006,3352,275,327,72157,76456,35,10.558,44,13.273,2558,316,2242,0.413,3.346,11293,3777,7516,4.940,14.771,-8735,-11.425,6.691,33,33,393
2006,3353,1995,2329,139081,138779,119,5.099,129,5.527,11971,1700,10271,1.225,8.626,11139,3537,7602,2.549,8.026,832,0.600,16.053,79,79,876
2006,3359,1757,2106,148692,147343,150,7.128,147,6.985,15118,4399,10719,2.986,10.260,12345,4958,7387,3.365,8.378,2773,1.882,16.757,94,94,1362
2006,3361,261,331,205154,206608,23,6.715,46,13.431,20784,2188,18596,1.059,10.060,24261,6753,17508,3.269,11.743,-3477,-1.683,20.119,32,32,411
2006,3362,1792,2075,157636,153270,203,9.878,163,7.932,21851,4750,17101,3.099,14.257,13316,4694,8622,3.063,8.688,8535,5.569,17.376,125,125,2981
2006,3363,4343,5476,643024,655351,408,7.456,400,7.310,53328,15772,37556,2.407,8.137,77187,18616,58571,2.841,11.778,-23859,-3.641,16.275,278,292,8353
2006,3364,1197,1560,397054,389128,122,7.902,90,5.829,52315,7626,44689,1.960,13.444,36248,3784,32464,0.972,9.315,16067,4.129,18.630,67,68,1598
2006,3365,161,219,29821,29311,10,4.598,7,3.218,3099,273,2826,0.931,10.573,2095,286,1809,0.976,7.148,1004,3.425,14.295,3,3,17
2006,3366,1510,1635,144675,144197,178,10.897,175,10.713,10936,2118,8818,1.469,7.584,9942,3220,6722,2.233,6.895,994,0.689,13.789,139,139,1401
2006,3369,818,847,42959,43072,133,16.131,88,10.673,5100,1921,3179,4.460,11.841,5527,1179,4348,2.737,12.832,-427,-0.991,23.682,72,72,949
2006,3371,14730,15162,355175,357263,1530,10.087,1543,10.172,38281,9563,28718,2.677,10.715,42008,16119,25889,4.512,11.758,-3727,-1.043,21.430,1249,1256,8336
2006,3372,3812,3995,145522,144887,282,7.043,300,7.493,16584,3917,12667,2.703,11.446,15199,4002,11197,2.762,10.490,1385,0.956,20.981,231,232,2367
2006,3379,869,1003,46207,46377,61,5.992,91,8.939,5401,817,4584,1.762,11.646,5579,1566,4013,3.377,12.030,-178,-0.384,23.292,66,69,784
2006,3391,10711,11513,313787,309221,862,7.483,876,7.604,35064,8017,27047,2.593,11.339,25743,7337,18406,2.373,8.325,9321,3.014,16.650,680,683,4941
2006,3399,17322,17797,371952,372533,1862,10.511,1699,9.590,46331,14425,31906,3.872,12.437,47797,14978,32819,4.021,12.830,-1466,-0.394,24.874,1394,1399,10222
2006,4231,17419,24366,376285,373766,2229,9.198,1964,8.104,51770,19145,32625,5.122,13.851,46932,16066,30866,4.298,12.557,4838,1.294,25.113,1349,1421,8534
2006,4232,11123,12860,165689,164234,1407,11.048,1157,9.085,23635,7539,16096,4.590,14.391,20835,6799,14036,4.140,12.686,2800,1.705,25.372,899,924,5051
2006,4233,12103,18317,275137,268132,1802,10.018,1144,6.360,43892,15157,28735,5.653,16.370,30015,8523,21492,3.179,11.194,13877,5.175,22.388,732,753,5098
2006,4234,25101,34364,726727,721897,3609,10.506,3583,10.431,107879,37472,70407,5.191,14.944,99066,35198,63868,4.876,13.723,8813,1.221,27.446,2045,2134,13473
2006,4235,7503,10331,159853,155412,799,7.819,574,5.617,22946,8003,14943,5.150,14.765,13928,3800,10128,2.445,8.962,9018,5.803,17.924,375,380,1930
2006,4236,19708,29032,470221,470761,2816,9.739,2582,8.930,68468,20437,48031,4.341,14.544,69005,29397,39608,6.245,14.658,-537,-0.114,29.088,1346,1444,9780
2006,4237,11027,18953,230313,224585,1877,10.091,1174,6.311,37055,16167,20888,7.199,16.499,24623,9524,15099,4.241,10.964,12432,5.536,21.928,568,629,3479
2006,4238,42308,57992,716350,703812,4166,7.209,3758,6.503,95336,30314,65022,4.307,13.546,70345,24613,45732,3.497,9.995,24991,3.551,19.990,2451,2543,14134
2006,4239,27845,30890,340704,336619,3533,11.482,3295,10.708,53248,18889,34359,5.611,15.818,45150,17309,27841,5.142,13.413,8098,2.406,26.826,2547,2582,12463
2006,4241,8995,11595,180980,191407,823,6.984,1202,10.200,21307,6810,14497,3.558,11.132,41822,12862,28960,6.720,21.850,-20515,-10.718,22.264,651,672,4065
2006,4242,5757,7632,257900,255886,957,12.664,807,10.679,41307,16822,24485,6.574,16.143,36633,10290,26343,4.021,14.316,4674,1.827,28.632,581,587,4522
2006,4243,13627,14880,204829,207360,1902,12.861,1720,11.630,31443,12047,19396,5.810,15.164,36698,9249,27449,4.460,17.698,-5255,-2.534,30.327,1392,1409,6886
2006,4244,25378,31518,775209,769987,2982,9.458,3006,9.534,102002,28368,73634,3.684,13.247,92610,27430,65180,3.562,12.027,9392,1.220,24.055,2246,2270,15231
2006,4245,3939,6447,61358,61956,360,5.542,457,7.036,7916,2480,5436,4.003,12.777,9080,2855,6225,4.608,14.656,-1164,-1.879,25.554,270,296,1454
2006,4246,8331,12264,142518,142691,1007,8.251,888,7.276,18173,5407,12766,3.789,12.736,18412,6188,12224,4.337,12.903,-239,-0.167,25.472,561,569,2754
2006,4247,4915,7013,104133,104216,431,6.093,552,7.804,12925,3548,9377,3.404,12.402,13027,4230,8797,4.059,12.500,-102,-0.098,24.804,295,305,1936
2006,4248,3126,3927,176165,173265,334,8.530,311,7.943,19157,5646,13511,3.259,11.057,13240,6279,6961,3.624,7.641,5917,3.415,15.283,233,235,3707
2006,4249,22698,28803,371671,374489,3224,11.216,3109,10.816,48291,18771,29520,5.012,12.895,53921,17504,36417,4.674,14.399,-5630,-1.503,25.790,2343,2376,11038
2006,4251,38851,41030,298891,298270,5950,14.655,5093,12.544,48106,18293,29813,6.133,16.128,47652,21613,26039,7.246,15.976,454,0.152,31.952,4004,4029,15846
2006,4411,43650,48411,1283721,1285301,4919,10.192,4619,9.571,145141,60768,84373,4.728,11.292,148193,45554,102639,3.544,11.530,-3052,-0.237,22.585,3707,3749,33891
2006,4412,13737,15450,166653,164604,1810,11.863,1425,9.340,26718,10170,16548,6.178,16.232,22402,7222,15180,4.387,13.610,4316,2.622,27.219,1174,1185,5258
2006,4413,31110,56429,490270,491201,4133,7.351,3727,6.629,56465,23085,33380,4.700,11.495,58113,15367,42746,3.128,11.831,-1648,-0.336,22.991,2764,2881,10717
2006,4421,18817,26849,277138,275600,3019,11.258,2954,11.016,47646,21328,26318,7.739,17.288,44787,15189,29598,5.511,16.251,2859,1.037,32.501,2126,2306,11016
2006,4422,24989,34273,296817,297203,3608,10.524,3632,10.594,43716,19262,24454,6.481,14.709,44937,15219,29718,5.121,15.120,-1221,-0.411,29.418,2588,2650,9120
2006,4431,29045,49168,510811,509670,5491,11.073,6332,12.769,89966,29409,60557,5.770,17.652,87107,40686,46421,7.983,17.091,2859,0.561,34.182,4238,4380,20699
2006,4441,43843,65628,1214760,1162185,5721,8.836,3952,6.104,201809,110820,90989,9.535,17.365,98927,25619,73308,2.204,8.512,102882,8.852,17.024,2935,3006,14323
2006,4442,15239,18576,171006,170187,1605,8.650,1561,8.413,25754,9174,16580,5.391,15.133,24074,7550,16524,4.436,14.146,1680,0.987,28.291,1174,1187,5411
2006,4451,58270,84555,2593870,2607265,9491,11.207,9762,11.527,279452,112174,167278,4.302,10.718,308040,100376,207664,3.850,11.815,-28588,-1.096,21.436,7307,7409,44113
2006,4452,17172,20666,144994,144774,3483,16.895,3383,16.410,32632,16861,15771,11.646,22.540,31848,14834,17014,10.246,21.999,784,0.542,43.997,2456,2488,9777
2006,4453,24100,27584,141027,138410,3263,11.947,2721,9.962,26384,11499,14885,8.308,19.062,21162,9345,11817,6.752,15.289,5222,3.773,30.579,2209,2227,7854
2006,4461,40083,82511,1082652,1051068,8173,10.042,5928,7.284,177903,81272,96631,7.732,16.926,117227,35782,81445,3.404,11.153,60676,5.773,22.306,3538,3733,17370
2006,4471,63629,112744,919605,917770,11029,9.786,10950,9.716,161754,70673,91081,7.701,17.625,157918,61104,96814,6.658,17.207,3836,0.418,34.413,7051,7479,39315
2006,4481,35720,89300,1247623,1214634,10975,12.483,8214,9.343,217226,93015,124211,7.658,17.884,154182,44869,109313,3.694,12.694,63044,5.190,25.387,4531,5309,20087
2006,4482,6201,25585,202797,194236,1970,7.744,1681,6.608,50778,12716,38062,6.547,26.142,32751,8393,24358,4.321,16.861,18027,9.281,33.723,586,781,2830
2006,4483,17789,27651,167689,167261,2313,8.263,2998,10.710,28014,8640,19374,5.166,16.749,26397,9957,16440,5.953,15.782,1617,0.967,31.564,1699,1726,4610
2006,4511,27939,38194,432134,422979,4523,11.870,4341,11.393,78247,39837,38410,9.418,18.499,58974,21039,37935,4.974,13.943,19273,4.556,27.885,3351,3437,12783
2006,4512,5780,11521,146868,143480,1034,8.919,1178,10.161,22946,9482,13464,6.609,15.992,15580,5574,10006,3.885,10.859,7366,5.134,21.717,855,877,3547
2006,4521,163,9215,1498344,1466267,349,3.828,155,1.700,139683,38055,101628,2.595,9.526,76066,8046,68020,0.549,5.188,63617,4.339,10.375,46,60,1046
2006,4529,8636,34795,1387683,1353388,3274,9.524,2438,7.092,144181,73850,70331,5.457,10.653,75983,13920,62063,1.029,5.614,68198,5.039,11.229,1554,1648,7090
2006,4531,17753,18620,97559,99715,1920,10.106,2676,14.086,16067,6471,9596,6.490,16.113,20111,8086,12025,8.109,20.169,-4044,-4.056,32.226,2328,2334,7075
2006,4532,26173,37463,315835,318207,4417,11.671,5185,13.700,49685,20717,28968,6.511,15.614,54331,20048,34283,6.300,17.074,-4646,-1.460,31.228,3965,4098,14321
2006,4533,11977,16370,133097,131124,1825,11.053,2109,12.773,22778,8906,13872,6.792,17.371,18706,7282,11424,5.554,14.266,4072,3.105,28.532,1699,1730,5005
2006,4539,31480,40241,259767,258481,5148,12.801,5095,12.670,50087,22125,27962,8.560,19.377,47602,18780,28822,7.266,18.416,2485,0.961,36.832,3929,4043,13521
2006,4541,15668,16646,283534,275125,2985,18.524,1922,11.927,56044,21918,34126,7.967,20.370,39009,15299,23710,5.561,14.179,17035,6.192,28.357,1548,1552,7932
2006,4542,4146,4711,51571,52340,490,10.244,635,13.275,5816,2162,3654,4.131,11.112,7357,2798,4559,5.346,14.056,-1541,-2.944,22.224,523,534,2141
2006,4543,21024,26417,211953,214621,2524,9.464,3029,11.358,28659,9917,18742,4.621,13.353,33878,13547,20331,6.312,15.785,-5219,-2.432,26.707,2194,2231,8505
2006,4811,510,3011,426044,424998,232,8.003,8,0.276,33592,8020,25572,1.887,7.904,32515,9,32506,0.002,7.651,1077,0.253,15.301,6,6,8
2006,4812,1995,2200,41972,40354,337,15.534,276,12.722,7639,2227,5412,5.519,18.930,4306,1093,3213,2.709,10.671,3333,8.260,21.341,217,217,787
2006,4831,771,1151,51786,49405,115,9.965,121,10.485,9723,2257,7466,4.568,19.680,4938,1138,3800,2.303,9.995,4785,9.685,19.990,54,55,386
2006,4832,473,525,19835,19292,74,14.231,64,12.308,2325,301,2024,1.560,12.052,1265,479,786,2.483,6.557,1060,5.495,13.114,47,47,404
2006,4841,47121,56579,1053457,1038005,11007,19.904,8450,15.280,160350,58408,101942,5.627,15.448,129115,49770,79345,4.795,12.439,31235,3.009,24.878,6451,6572,29339
2006,4842,42590,46450,474159,466412,6962,15.125,6120,13.296,89006,33201,55805,7.118,19.083,73585,25443,48142,5.455,15.777,15421,3.306,31.554,4847,4864,18184
2006,4851,592,923,54297,54873,129,14.160,105,11.526,8309,6118,2191,11.149,15.142,9550,3045,6505,5.549,17.404,-1241,-2.262,30.284,55,56,696
2006,4852,197,529,17966,17661,77,14.995,46,8.958,2730,1213,1517,6.868,15.458,2067,476,1591,2.695,11.704,663,3.754,23.408,21,22,141
2006,4853,5793,5888,68134,66424,1013,17.107,1080,18.239,13973,5846,8127,8.801,21.036,10465,5635,4830,8.483,15.755,3508,5.281,31.510,870,907,4177
2006,4854,2924,4122,190855,186906,297,7.210,292,7.088,23539,9023,14516,4.828,12.594,15619,5241,10378,2.804,8.357,7920,4.237,16.713,201,201,2849
2006,4855,1059,1159,28023,27905,142,12.257,141,12.171,3942,1086,2856,3.892,14.127,3744,1309,2435,4.691,13.417,198,0.710,26.834,117,118,1077
2006,4859,2700,2937,58647,58325,491,16.984,399,13.801,11326,5084,6242,8.717,19.419,10615,5223,5392,8.955,18.200,711,1.219,36.399,330,333,4319
2006,4861,45,333,5793,5936,50,13.624,118,32.153,1251,695,556,11.709,21.077,1481,1078,403,18.162,24.952,-230,-3.875,42.153,3,3,306
2006,4862,125,1519,22828,23271,251,16.272,298,19.319,4896,3117,1779,13.395,21.040,5973,4419,1554,18.990,25.668,-1077,-4.628,42.079,8,8,37
2006,4869,63,677,7113,7191,92,13.876,64,9.653,971,533,438,7.412,13.503,1108,313,795,4.353,15.408,-137,-1.905,27.006,(D),(D),(D)
2006,4871,469,523,8755,8540,72,13.886,63,12.150,1541,479,1062,5.609,18.046,1066,278,788,3.255,12.483,475,5.562,24.966,46,46,224
2006,4872,1202,1236,11347,11287,241,19.819,201,16.530,2098,732,1366,6.486,18.589,1978,690,1288,6.113,17.525,120,1.063,35.051,142,144,476
2006,4879,139,147,2294,2266,22,15.278,16,11.111,406,189,217,8.343,17.921,358,125,233,5.518,15.802,48,2.119,31.605,12,12,51
2006,4881,3541,4885,157205,151660,652,13.514,531,11.006,31550,11222,20328,7.399,20.803,20458,5895,14563,3.887,13.489,11092,7.314,26.979,289,297,2425
2006,4882,472,944,27553,26833,115,12.372,86,9.252,4876,1980,2896,7.379,18.172,3438,1546,1892,5.762,12.813,1438,5.359,25.625,36,43,753
2006,4883,1643,2135,92110,90625,189,8.852,189,8.852,13122,2363,10759,2.607,14.479,10402,2953,7449,3.258,11.478,2720,3.001,22.956,106,106,918
2006,4884,7735,8242,67480,66938,1333,16.381,1124,13.813,13763,6810,6953,10.174,20.561,12813,4689,8124,7.005,19.142,950,1.419,38.283,889,905,3416
2006,4885,12599,18192,218089,206497,2724,15.509,1467,8.353,51476,28338,23138,13.723,24.928,27270,11512,15758,5.575,13.206,24206,11.722,26.412,884,936,5983
2006,4889,1174,1280,27990,28124,230,18.334,179,14.269,3151,946,2205,3.364,11.204,3331,1348,1983,4.793,11.844,-180,-0.640,22.408,138,140,1031
2006,4921,2895,8054,521772,509321,961,11.940,950,11.803,54079,9998,44081,1.963,10.618,29431,12404,17027,2.435,5.778,24648,4.839,11.557,368,384,2381
2006,4922,3989,4489,43588,44605,629,13.976,652,14.487,8112,3068,5044,6.878,18.187,10174,4979,5195,11.163,22.809,-2062,-4.623,36.373,551,556,3988
2006,4931,6775,13374,624506,613908,1358,10.234,1149,8.659,112382,50098,62284,8.161,18.306,91966,23649,68317,3.852,14.980,20416,3.326,29.961,406,429,4891
2006,5111,15101,21481,691544,694833,2334,10.963,1951,9.164,67959,25997,41962,3.741,9.781,74366,23352,51014,3.361,10.703,-6407,-0.922,19.561,1294,1311,9640
2006,5112,5720,8241,339728,333693,948,11.468,999,12.085,57332,18588,38744,5.570,17.181,46326,22744,23582,6.816,13.883,11006,3.298,27.766,513,540,7494
2006,5121,12508,15967,312345,304154,2592,16.532,2015,12.852,62231,24798,37433,8.153,20.460,45806,15895,29911,5.226,15.060,16425,5.400,30.120,1250,1261,5684
2006,5122,2669,2921,23326,23215,502,17.328,454,15.671,5183,2303,2880,9.920,22.326,4846,2568,2278,11.062,20.874,337,1.452,41.749,306,314,860
2006,5151,4325,9431,254582,248806,1148,12.499,656,7.142,41090,16978,24112,6.824,16.515,29208,8095,21113,3.254,11.739,11882,4.776,23.479,342,354,3082
2006,5152,338,613,42006,40587,126,20.983,101,16.819,8343,2888,5455,7.116,20.556,5612,2847,2765,7.015,13.827,2731,6.729,27.654,37,40,453
2006,5171,3747,32284,908832,931336,5054,15.936,3914,12.342,141342,70753,70589,7.597,15.176,190445,45099,145346,4.842,20.449,-49103,-5.272,30.353,415,570,10861
2006,5172,1885,11421,245358,250275,870,7.225,2112,17.539,30038,7096,22942,2.835,12.002,40310,19917,20393,7.958,16.106,-10272,-4.104,24.004,388,421,3333
2006,5174,500,616,11355,11395,113,18.786,84,13.965,1637,478,1159,4.195,14.367,1712,697,1015,6.117,15.025,-75,-0.658,28.733,58,58,305
2006,5179,4674,5208,73050,73135,986,18.489,1236,23.176,17084,5823,11261,7.962,23.360,17286,7451,9835,10.188,23.636,-202,-0.276,46.719,869,886,4460
2006,5182,7374,15336,397419,389085,2740,18.712,1354,9.247,72438,26585,45853,6.833,18.618,56479,18042,38437,4.637,14.516,15959,4.102,29.032,725,740,6689
2006,5191,5183,6459,118545,111239,1196,19.351,639,10.339,27023,8918,18105,8.017,24.293,12504,5027,7477,4.519,11.241,14519,13.052,22.481,423,428,1921
2006,5211,21,55,19862,19962,5,9.346,(D),(D),1158,43,1115,0.215,5.801,1365,(D),1352,(D),6.838,-207,-1.037,11.602,(D),(D),(D)
2006,5221,15825,119038,2134473,2092250,13971,12.031,8142,7.012,380206,173043,207163,8.271,18.172,299992,115876,184116,5.538,14.338,80214,3.834,28.676,511,621,6661
2006,5222,19385,52665,794442,793121,9448,18.255,7631,14.744,201807,94857,106950,11.960,25.445,200112,97197,102915,12.255,25.231,1695,0.214,50.462,2144,2262,11688
2006,5223,26142,43091,338208,331930,8340,20.182,4806,11.630,83771,35202,48569,10.605,25.238,70756,28990,41766,8.734,21.317,13015,3.921,42.633,3060,3133,14508
2006,5231,12531,38465,511031,496692,6763,18.225,4051,10.916,95538,53564,41974,10.784,19.235,64958,26363,38595,5.308,13.078,30580,6.157,26.156,1161,1184,5370
2006,5232,41,122,7323,7123,82,93.182,14,15.909,852,578,274,8.115,11.962,435,44,391,0.618,6.107,417,5.855,12.215,13,13,41
2006,5239,33562,38157,384823,368008,7389,19.944,5172,13.960,91407,41536,49871,11.287,24.838,57453,27897,29556,7.581,15.612,33954,9.226,31.224,3531,3554,12596
2006,5241,6463,33058,1432329,1420318,3685,11.279,2913,8.916,171666,68962,102704,4.855,12.086,145920,45972,99948,3.237,10.274,25746,1.813,20.548,523,533,3074
2006,5242,120412,135274,940872,931192,15149,11.337,11844,8.864,155190,67636,87554,7.263,16.666,134328,55267,79061,5.935,14.425,20862,2.240,28.851,8373,8483,27072
2006,5250,2193,3402,36563,34790,1113,37.697,214,7.248,9532,6504,3028,18.695,27.399,6243,1534,4709,4.409,17.945,3289,9.454,35.890,124,138,559
2006,5311,84121,103093,530859,525058,12912,12.541,12641,12.278,103697,53455,50242,10.181,19.750,92384,45626,46758,8.690,17.595,11313,2.155,35.190,9490,9584,31649
2006,5312,78938,88454,371284,356565,19472,23.086,11253,13.342,90633,47065,43568,13.200,25.418,60702,28156,32546,7.896,17.024,29931,8.394,34.048,8032,8094,19344
2006,5313,61592,70787,630033,615656,12715,18.611,7779,11.386,125833,61497,64336,9.989,20.439,96736,35536,61200,5.772,15.713,29097,4.726,31.425,5526,5552,23598
2006,5321,4116,12336,171628,171442,1618,13.316,1248,10.271,24194,6533,17661,3.811,14.112,23592,10863,12729,6.336,13.761,602,0.351,27.522,498,522,2749
2006,5322,11358,32230,254278,260188,3191,9.924,3040,9.454,38752,15847,22905,6.091,14.894,50572,14852,35720,5.708,19.437,-11820,-4.543,29.788,1736,1925,7806
2006,5323,3125,5001,34364,33368,552,11.110,487,9.802,7402,3138,4264,9.404,22.183,5277,2195,3082,6.578,15.815,2125,6.368,31.630,276,305,1393
2006,5324,7540,12702,158510,153710,1649,13.265,1108,8.913,30710,11109,19601,7.227,19.979,20821,7909,12912,5.145,13.546,9889,6.434,27.091,701,717,4050
2006,5331,1914,1995,29283,28609,282,14.344,224,11.394,5316,2439,2877,8.525,18.582,4145,1356,2789,4.740,14.489,1171,4.093,28.977,167,168,872
2006,5411,163975,173438,1216786,1209715,16784,9.735,14720,8.538,149576,54251,95325,4.485,12.365,134488,45719,88769,3.779,11.117,15088,1.247,22.235,11108,11235,35254
2006,5412,93958,109058,1284579,1252395,13841,12.841,11308,10.491,273815,102809,171006,8.209,21.863,211337,67963,143374,5.427,16.875,62478,4.989,33.749,7393,7424,38088
2006,5413,88640,102324,1377501,1329968,12991,12.940,9137,9.101,249914,75857,174057,5.704,18.791,154938,53534,101404,4.025,11.650,94976,7.141,23.300,6143,6210,26638
2006,5414,27702,27976,127380,123665,4834,17.626,3732,13.608,28010,11167,16843,9.030,22.650,20429,10257,10172,8.294,16.520,7581,6.130,33.039,2803,2810,7211
2006,5415,81443,94334,1230139,1187696,21064,23.158,14313,15.736,285376,102977,182399,8.670,24.028,200147,87181,112966,7.340,16.852,85229,7.176,33.703,9618,9744,44134
2006,5416,97629,103535,857944,832681,23095,23.142,15616,15.648,203526,88625,114901,10.643,24.442,153009,71748,81261,8.617,18.375,50517,6.067,36.751,11083,11141,42426
2006,5417,11567,15074,660019,659605,2111,14.249,1594,10.759,93080,26563,66517,4.027,14.111,92517,25825,66692,3.915,14.026,563,0.085,28.052,942,955,6440
2006,5418,31631,34992,452148,433441,4766,13.777,3972,11.481,97574,27947,69627,6.448,22.512,59720,23782,35938,5.487,13.778,37854,8.733,27.556,2886,2897,15013
2006,5419,53273,61840,570602,561123,7515,12.279,6237,10.191,102667,36478,66189,6.501,18.297,84552,31224,53328,5.565,15.068,18115,3.228,30.137,4473,4503,19932
2006,5511,26141,48931,2908676,2892104,5492,11.365,4280,8.857,488562,153568,334994,5.310,16.893,457452,110543,346909,3.822,15.817,31110,1.076,31.635,1089,1122,14602
2006,5611,21236,23948,451400,441714,4577,19.804,2903,12.561,95503,40372,55131,9.140,21.621,76451,34335,42116,7.773,17.308,19052,4.313,34.616,2160,2174,21825
2006,5612,1690,5116,196728,184028,1458,31.799,396,8.637,50522,30659,19863,16.660,27.454,26065,9212,16853,5.006,14.164,24457,13.290,28.327,109,112,1518
2006,5613,27488,46425,4771111,4529594,7816,17.291,5373,11.886,1280022,347683,932339,7.676,28.259,800235,243377,556858,5.373,17.667,479787,10.592,35.334,2908,2992,138964
2006,5614,27073,33508,799259,785090,4857,14.660,4102,12.381,166354,64067,102287,8.160,21.189,138355,56487,81868,7.195,17.623,27999,3.566,35.246,2981,3059,21651
2006,5615,15776,21605,257284,255071,2259,10.431,2362,10.907,39162,14585,24577,5.718,15.353,34788,11995,22793,4.703,13.639,4374,1.715,27.277,1535,1565,6751
2006,5616,17275,22361,785240,770371,3480,15.898,2536,11.586,163176,72771,90405,9.446,21.181,134568,39569,94999,5.136,17.468,28608,3.714,34.936,1721,1746,17349
2006,5617,134601,141086,1707882,1668430,25871,18.766,19415,14.083,366209,129626,236583,7.769,21.949,287772,108370,179402,6.495,17.248,78437,4.701,34.496,14483,14517,67936
2006,5619,16947,19120,347362,347490,2325,12.175,2277,11.924,64727,18235,46492,5.248,18.627,64428,22289,42139,6.414,18.541,299,0.086,37.082,1651,1685,9938
2006,5621,6865,8591,177736,175402,934,11.012,715,8.430,21643,7708,13935,4.394,12.339,16814,6957,9857,3.966,9.586,4829,2.753,19.172,515,522,3475
2006,5622,1449,2593,56966,57150,252,9.805,206,8.016,8465,3237,5228,5.664,14.812,8926,3592,5334,6.285,15.619,-461,-0.807,29.624,130,133,1783
2006,5629,6898,7663,112634,110771,1034,13.796,698,9.313,25330,9117,16213,8.230,22.867,21419,6005,15414,5.421,19.336,3911,3.531,38.673,499,509,3623
2006,6111,17360,19716,801309,784358,1267,6.629,62,0.324,78701,24587,54114,3.135,10.034,44907,340,44567,0.043,5.725,33794,4.308,11.451,43,43,181
2006,6112,460,851,85867,84012,73,8.952,(D),(D),10091,2404,7687,2.861,12.011,6521,(D),6516,(D),7.762,3570,4.249,15.524,(D),(D),(D)
2006,6113,2226,3634,1538065,1523712,365,10.549,17,0.491,98760,12735,86025,0.836,6.482,69528,30,69498,0.002,4.563,29232,1.918,9.126,13,13,26
2006,6114,5976,6521,66669,64471,907,13.947,871,13.394,15332,5390,9942,8.360,23.781,10951,4556,6395,7.067,16.986,4381,6.795,33.972,627,651,3201
2006,6115,6044,7361,118239,112094,989,13.699,706,9.779,26368,10414,15954,9.290,23.523,14155,4891,9264,4.363,12.628,12213,10.895,25.256,514,526,2926
2006,6116,28901,31125,294521,282978,5096,16.783,3575,11.774,67668,25913,41755,9.157,23.913,44769,16048,28721,5.671,15.821,22899,8.092,31.641,2752,2779,12624
2006,6117,5009,5668,75134,70833,1209,22.319,707,13.052,19397,6755,12642,9.537,27.384,10615,3497,7118,4.937,14.986,8782,12.398,29.972,533,533,1994
2006,6211,175492,201676,2111485,2070371,17930,8.974,14190,7.102,305763,115036,190727,5.556,14.769,222342,70974,151368,3.428,10.739,83421,4.029,21.478,10315,10543,47395
2006,6212,117801,123355,826859,810564,9314,7.659,5806,4.775,122171,44221,77950,5.456,15.072,89701,27537,62164,3.397,11.066,32470,4.006,22.133,4733,4766,21924
2006,6213,93249,103587,577523,562741,11453,11.166,9415,9.179,112510,45852,66658,8.148,19.993,82435,32014,50421,5.689,14.649,30075,5.344,29.298,6795,6908,21525
2006,6214,13170,27143,677600,663845,3143,11.932,1539,5.843,102990,43770,59220,6.593,15.514,75026,22097,52929,3.329,11.302,27964,4.212,22.603,730,789,7946
2006,6215,7068,11361,224033,220823,1543,13.821,1150,10.301,37600,15585,22015,7.058,17.027,30715,13855,16860,6.274,13.909,6885,3.118,27.819,654,685,4819
2006,6216,13325,19722,971521,941299,3485,18.438,1843,9.751,178169,62257,115912,6.614,18.928,118088,37598,80490,3.994,12.545,60081,6.383,25.090,1259,1293,19364
2006,6219,5528,8482,254362,250966,866,10.316,692,8.243,40747,12430,28317,4.953,16.236,33854,11219,22635,4.470,13.489,6893,2.747,26.979,401,437,5457
2006,6221,3130,5133,4907900,4875789,103,2.005,112,2.180,202836,28005,174831,0.574,4.160,138608,40398,98210,0.829,2.843,64228,1.317,5.686,53,53,14936
2006,6222,450,604,215859,215325,27,4.463,29,4.793,7355,1962,5393,0.911,3.416,6268,3099,3169,1.439,2.911,1087,0.505,5.822,16,16,2003
2006,6223,380,791,212934,209715,142,18.758,74,9.775,27059,15666,11393,7.470,12.903,20020,8867,11153,4.228,9.546,7039,3.356,19.093,37,37,2683
2006,6231,8379,15976,1613308,1608898,1023,6.406,1009,6.318,150110,62477,87633,3.883,9.330,141597,59660,81937,3.708,8.801,8513,0.529,17.602,558,591,31057
2006,6232,8091,31145,565035,557700,2758,9.005,1726,5.635,81285,32310,48975,5.793,14.575,66342,17604,48738,3.157,11.896,14943,2.679,23.791,411,485,7037
2006,6233,13684,18355,649583,637763,2272,12.586,1667,9.234,85946,39877,46069,6.253,13.476,62054,22007,40047,3.451,9.730,23892,3.746,19.460,1246,1261,16294
2006,6239,3607,6263,156925,156344,563,9.087,429,6.924,21264,6888,14376,4.406,13.601,20340,5496,14844,3.515,13.010,924,0.591,26.020,202,212,2662
2006,6241,38134,53428,1090297,1063900,5964,11.405,3693,7.062,176757,61408,115349,5.772,16.614,124576,30013,94563,2.821,11.709,52181,4.905,23.419,2275,2340,16574
2006,6242,9483,13047,160967,159584,1019,7.938,598,4.659,20240,6153,14087,3.856,12.683,17232,3386,13846,2.122,10.798,3008,1.885,21.596,343,349,1568
2006,6243,4785,8069,338297,336227,701,8.786,521,6.530,50243,13908,36335,4.136,14.943,45610,8412,37198,2.502,13.565,4633,1.378,27.130,253,266,2771
2006,6244,53325,67884,832514,817442,8814,13.125,7350,10.945,141837,63417,78420,7.758,17.351,111913,43448,68465,5.315,13.691,29924,3.661,27.381,5736,5838,33919
2006,7111,7473,7631,132957,133087,994,13.071,941,12.374,21944,6615,15329,4.970,16.489,22280,6470,15810,4.861,16.741,-336,-0.252,32.977,620,621,4773
2006,7112,3434,3606,121765,119413,628,17.680,520,14.640,19086,4879,14207,4.086,15.983,14376,2920,11456,2.445,12.039,4710,3.944,24.078,389,390,2060
2006,7113,4726,5065,109667,107126,780,15.820,511,10.364,20977,5474,15503,5.110,19.582,15644,4500,11144,4.201,14.603,5333,4.978,29.207,380,381,3242
2006,7114,2637,2691,15512,15237,411,15.282,408,15.170,3155,1443,1712,9.470,20.706,2619,1448,1171,9.503,17.188,536,3.518,34.377,294,294,929
2006,7115,12967,12986,46543,44386,3036,24.114,2244,17.824,15383,7756,7627,17.474,34.658,11120,4958,6162,11.170,25.053,4263,9.604,50.106,1466,1466,3301
2006,7121,5989,6467,122958,122131,531,8.287,412,6.430,11911,2387,9524,1.954,9.753,10234,1468,8766,1.202,8.380,1677,1.373,16.759,250,251,780
2006,7131,1926,2470,142987,144744,502,20.817,385,15.965,13676,5283,8393,3.650,9.448,17051,5937,11114,4.102,11.780,-3375,-2.332,18.897,256,262,2925
2006,7132,1773,2341,190599,189204,313,13.683,206,9.005,22277,8422,13855,4.451,11.774,19345,5399,13946,2.854,10.224,2932,1.550,20.449,157,160,4506
2006,7139,50746,56406,1097758,1082823,7806,13.983,6645,11.903,177963,71119,106844,6.568,16.435,148277,51528,96749,4.759,13.694,29686,2.742,27.387,5355,5390,40386
2006,7211,37483,47383,1826607,1813882,5880,12.473,5399,11.453,261977,120132,141845,6.623,14.443,237791,104657,133134,5.770,13.110,24186,1.333,26.219,3913,3982,58589
2006,7212,5152,5613,38363,38376,722,12.994,609,10.960,7146,2503,4643,6.522,18.621,7071,2598,4473,6.770,18.426,75,0.195,36.851,399,401,1504
2006,7213,2101,2171,11884,12100,151,6.873,203,9.240,1702,531,1171,4.389,14.067,2137,855,1282,7.066,17.662,-435,-3.595,28.133,144,144,566
2006,7223,11458,29584,556137,559262,3470,11.795,3140,10.673,101316,34511,66805,6.171,18.116,106841,36143,70698,6.463,19.104,-5525,-0.988,36.232,1580,1596,10666
2006,7224,41543,42145,361417,357071,5721,13.499,6193,14.613,82716,45254,37462,12.674,23.165,73410,34351,39059,9.620,20.559,9306,2.606,41.118,5242,5247,29589
2006,7225,310716,426082,8619152,8452980,62565,14.939,48007,11.463,1616505,874655,741850,10.347,19.123,1285578,481534,804044,5.697,15.209,330927,3.915,30.417,38502,39412,358354
2006,8111,138948,152160,882781,880475,16493,10.820,17038,11.177,156251,68158,88093,7.741,17.746,151981,60862,91119,6.912,17.261,4270,0.485,34.523,13390,13686,48584
2006,8112,10760,12206,127627,129280,1386,11.279,1550,12.614,19890,7132,12758,5.517,15.385,23104,8348,14756,6.457,17.871,-3214,-2.486,30.771,1189,1217,5767
2006,8113,20997,22424,192216,186454,2417,10.816,2260,10.114,35853,11144,24709,5.977,19.229,24240,9035,15205,4.846,13.001,11613,6.228,26.001,1708,1717,6207
2006,8114,19570,20667,96532,100111,2597,12.442,3009,14.416,16968,6726,10242,6.719,16.949,24257,12041,12216,12.028,24.230,-7289,-7.281,33.899,2322,2337,5825
2006,8121,83052,98137,616869,603635,15307,15.791,12909,13.317,126284,69859,56425,11.573,20.921,100414,45708,54706,7.572,16.635,25870,4.286,33.270,10674,10988,39622
2006,8122,14751,20208,135926,136345,1032,5.078,1261,6.205,13528,4019,9509,2.948,9.922,14509,4868,9641,3.570,10.641,-981,-0.719,19.844,638,651,2223
2006,8123,31523,37893,358000,363677,4307,11.265,4985,13.039,48743,20417,28326,5.614,13.403,59254,26201,33053,7.204,16.293,-10511,-2.890,26.806,3800,3882,16429
2006,8129,20561,30936,230910,227494,4774,15.393,4932,15.902,49382,22242,27140,9.777,21.707,42439,21340,21099,9.380,18.655,6943,3.052,37.310,2843,2880,11115
2006,8131,165024,165437,1628893,1608338,9047,5.600,1276,0.790,167498,27878,139620,1.733,10.414,126687,3005,123682,0.187,7.877,40811,2.537,15.754,780,780,1802
2006,8132,13571,15547,155209,153010,1285,8.329,1047,6.786,18340,4257,14083,2.782,11.986,13944,4048,9896,2.646,9.113,4396,2.873,18.226,657,690,2288
2006,8133,11672,13765,123413,121967,1327,9.743,1037,7.614,18263,4891,13372,4.010,14.974,15397,3607,11790,2.957,12.624,2866,2.350,25.248,598,600,1784
2006,8134,26365,28557,321365,320353,1548,5.308,2764,9.477,36277,7830,28447,2.444,11.324,34349,7968,26381,2.487,10.722,1928,0.602,21.444,2108,2108,5544
2006,8139,58656,60785,541979,531937,3574,5.913,2882,4.768,72782,15624,57158,2.937,13.682,52538,8641,43897,1.624,9.877,20244,3.806,19.753,2046,2054,5894
2007,2111,5798,6928,141153,114418,856,12.547,645,9.454,66441,11836,54605,10.345,58.069,13029,7669,5360,6.703,11.387,53412,46.681,22.774,352,354,1897
2007,2121,622,1002,78214,77203,121,11.951,142,14.025,12381,2528,9853,3.275,16.037,10159,3601,6558,4.664,13.159,2222,2.878,26.318,68,71,1854
2007,2122,205,270,35207,31530,56,21.918,27,10.568,8646,1958,6688,6.210,27.422,1212,269,943,0.853,3.844,7434,23.578,7.688,10,10,44
2007,2123,3230,5319,102435,99041,430,8.101,408,7.687,21750,7009,14741,7.077,21.961,15324,2899,12425,2.927,15.472,6426,6.488,30.945,204,204,1399
2007,2131,8778,10573,346402,299858,1897,18.902,823,8.200,125065,34909,90156,11.642,41.708,31584,14478,17106,4.828,10.533,93481,31.175,21.066,504,516,5515
2007,2211,1598,9498,520188,511727,641,6.771,580,6.126,55306,13137,42169,2.567,10.808,38879,9458,29421,1.848,7.598,16427,3.210,15.195,66,73,859
2007,2212,421,2255,81293,81117,107,4.595,254,10.908,7962,1891,6071,2.331,9.816,7529,3225,4304,3.976,9.282,433,0.534,18.563,25,25,220
2007,2213,3590,4439,41654,40504,291,6.602,229,5.195,6690,2160,4530,5.333,16.517,4264,1094,3170,2.701,10.527,2426,5.990,21.055,142,147,505
2007,2361,161595,162922,901055,930884,29069,17.877,28438,17.489,198047,86678,111369,9.311,21.275,258677,97037,161640,10.424,27.788,-60630,-6.513,42.550,21408,21411,65991
2007,2362,40105,41181,701596,694445,4734,11.650,3643,8.965,130491,29755,100736,4.285,18.791,116531,24511,92020,3.530,16.780,13960,2.010,33.561,2692,2697,16611
2007,2371,18252,19263,541595,521085,1651,8.555,1722,8.923,119758,18795,100963,3.607,22.982,79106,19530,59576,3.748,15.181,40652,7.801,30.362,1137,1145,11257
2007,2372,10561,10717,103685,102115,1519,14.173,1520,14.182,21996,7758,14238,7.597,21.540,18701,5886,12815,5.764,18.314,3295,3.227,36.627,1239,1240,4706
2007,2373,9728,10471,318738,317377,743,7.065,835,7.940,48730,7416,41314,2.337,15.354,45942,9067,36875,2.857,14.476,2788,0.878,28.951,538,539,4659
2007,2379,4008,4122,69583,69600,586,14.235,575,13.968,14316,3781,10535,5.433,20.569,14449,4885,9564,7.019,20.760,-133,-0.191,41.138,368,370,2000
2007,2381,97870,98642,1110728,1145391,12997,13.110,13993,14.114,220964,62554,158410,5.461,19.292,291307,69049,222258,6.028,25.433,-70343,-6.141,38.583,10368,10371,53537
2007,2382,165517,169160,1986458,1983676,18677,11.161,15042,8.989,345431,77327,268104,3.898,17.414,339962,76302,263660,3.846,17.138,5469,0.276,34.276,11378,11398,51991
2007,2383,114034,115166,939601,955197,17670,15.433,16334,14.266,197784,61916,135868,6.482,20.706,229376,60138,169238,6.296,24.013,-31592,-3.307,41.412,12329,12336,45627
2007,2389,63799,64489,614277,613505,10088,15.888,8098,12.754,119968,38938,81030,6.347,19.555,118700,32058,86642,5.225,19.348,1268,0.207,38.696,5909,5911,24134
2007,3111,1128,1699,45710,46504,82,4.802,99,5.798,4599,1178,3421,2.533,9.890,6101,1644,4457,3.535,13.119,-1502,-3.230,19.779,55,57,710
2007,3112,426,752,54036,53584,21,2.780,28,3.706,3911,438,3473,0.817,7.299,3022,560,2462,1.045,5.640,889,1.659,11.280,16,16,183
2007,3113,1503,1712,71733,71943,138,8.035,149,8.675,8503,1139,7364,1.583,11.819,8890,3603,5287,5.008,12.357,-387,-0.538,23.638,108,108,1152
2007,3114,1199,1560,159690,159532,89,5.660,114,7.250,16075,2901,13174,1.818,10.076,15768,4650,11118,2.915,9.884,307,0.192,19.768,66,67,1519
2007,3115,991,1506,131747,132219,94,6.246,92,6.113,11369,2349,9020,1.777,8.599,12090,2813,9277,2.128,9.144,-721,-0.545,17.197,58,60,1167
2007,3116,2930,3545,489664,494175,201,5.637,243,6.814,33246,7941,25305,1.607,6.728,42555,7930,34625,1.605,8.611,-9309,-1.884,13.455,175,176,2346
2007,3117,516,610,32666,33841,46,7.535,47,7.699,3129,634,2495,1.873,9.246,5433,1107,4326,3.271,16.055,-2304,-6.808,18.493,29,29,354
2007,3118,8980,9749,290545,292533,793,8.046,1006,10.207,35955,10169,25786,3.476,12.291,39771,12277,27494,4.197,13.595,-3816,-1.304,24.582,759,770,5983
2007,3119,2648,3088,163763,162438,301,9.854,234,7.661,19010,5434,13576,3.345,11.703,16197,5510,10687,3.392,9.971,2813,1.732,19.942,172,177,2387
2007,3121,2781,3342,135048,134139,388,11.896,227,6.960,14180,3382,10798,2.521,10.571,12654,3268,9386,2.436,9.433,1526,1.138,18.867,145,145,1750
2007,3122,71,102,20107,20629,5,4.651,16,14.884,1185,756,429,3.665,5.744,2395,1195,1200,5.793,11.610,-1210,-5.866,11.489,8,8,47
2007,3131,280,407,43873,46570,23,5.483,48,11.442,2217,371,1846,0.797,4.761,7516,2832,4684,6.081,16.139,-5299,-11.379,9.521,23,24,779
2007,3132,1043,1195,75374,82267,59,4.748,154,12.394,5995,1745,4250,2.121,7.287,19865,10921,8944,13.275,24.147,-13870,-16.860,14.574,100,101,2704
2007,3133,1125,1185,44864,48141,75,6.122,155,12.653,3378,1372,2006,2.850,7.017,9862,4020,5842,8.350,20.486,-6484,-13.469,14.034,113,113,1773
2007,3141,2252,2391,74828,76859,147,6.013,254,10.391,6669,2167,4502,2.819,8.677,10791,2293,8498,2.983,14.040,-4122,-5.363,17.354,207,207,1181
2007,3149,3754,3870,71000,72555,285,7.216,444,11.242,7547,2070,5477,2.853,10.402,10783,3735,7048,5.148,14.862,-3236,-4.460,20.804,348,354,2461
2007,3151,368,400,23777,25468,31,7.320,78,18.418,2228,555,1673,2.179,8.748,5602,2279,3323,8.948,21.996,-3374,-13.248,17.496,56,57,861
2007,3152,6528,6646,138249,143764,939,13.747,1308,19.149,23602,9918,13684,6.899,16.417,34434,18496,15938,12.866,23.952,-10832,-7.535,32.834,1123,1126,12974
2007,3159,686,704,13380,13891,51,7.118,76,10.607,1175,253,922,1.821,8.459,2226,832,1394,5.990,16.025,-1051,-7.566,16.918,61,61,597
2007,3161,220,226,4963,5439,25,10.989,28,12.308,424,238,186,4.376,7.796,1383,679,704,12.485,25.430,-959,-17.634,15.593,21,21,195
2007,3162,214,237,13014,13590,13,5.383,22,9.110,657,36,621,0.265,4.835,1743,454,1289,3.341,12.826,-1086,-7.991,9.669,16,16,65
2007,3169,760,770,16182,16436,70,9.061,75,9.709,1853,499,1354,3.036,11.274,2390,843,1547,5.129,14.542,-537,-3.267,22.549,60,60,534
2007,3211,3460,3880,109655,112790,252,6.423,339,8.640,8903,3092,5811,2.741,7.893,15071,4985,10086,4.420,13.362,-6168,-5.469,15.787,244,246,2339
2007,3212,1490,1889,109332,116728,102,5.374,120,6.322,7018,2218,4800,1.900,6.012,21888,4476,17412,3.835,18.751,-14870,-12.739,12.025,73,73,1065
2007,3219,9381,10425,318708,334442,904,8.674,899,8.626,28912,10192,18720,3.047,8.645,60575,15958,44617,4.772,18.112,-31663,-9.467,17.290,660,690,10384
2007,3221,231,476,125626,130067,8,1.594,60,11.952,2904,211,2693,0.162,2.233,11776,4738,7038,3.643,9.054,-8872,-6.821,4.465,22,22,415
2007,3222,2963,4388,293628,297212,162,3.655,250,5.641,21667,5297,16370,1.782,7.290,28510,10096,18414,3.397,9.592,-6843,-2.302,14.580,114,117,2569
2007,3231,30429,32040,644516,652607,1876,5.779,2719,8.376,59180,17791,41389,2.726,9.068,75357,27967,47390,4.285,11.547,-16177,-2.479,18.136,2150,2162,14484
2007,3241,1049,2220,101131,100085,160,7.189,171,7.684,9558,2629,6929,2.627,9.550,7715,1782,5933,1.780,7.708,1843,1.841,15.417,50,58,683
2007,3251,1367,2484,160058,160591,195,7.966,123,5.025,10649,2688,7961,1.674,6.631,11486,2756,8730,1.716,7.152,-837,-0.521,13.262,50,52,575
2007,3252,952,1285,99045,99952,51,3.943,68,5.257,6475,1333,5142,1.334,6.478,8367,2676,5691,2.677,8.371,-1892,-1.893,12.956,32,32,808
2007,3253,624,853,29089,29227,51,5.849,89,10.206,3330,853,2477,2.919,11.394,3654,1405,2249,4.807,12.502,-324,-1.109,22.787,49,49,373
2007,3254,1435,1905,244414,245968,148,7.812,127,6.704,27802,6780,21022,2.756,11.303,31875,5848,26027,2.378,12.959,-4073,-1.656,22.606,69,70,2000
2007,3255,1480,1880,64881,65459,110,5.845,114,6.057,6389,1845,4544,2.819,9.760,7569,2242,5327,3.425,11.563,-1180,-1.803,19.521,65,65,689
2007,3256,1914,2130,104665,104449,133,6.180,177,8.225,10462,3414,7048,3.269,10.016,10002,3167,6835,3.032,9.576,460,0.440,19.152,112,113,1666
2007,3259,2065,2638,99187,103321,204,7.773,177,6.744,9163,2123,7040,2.055,8.868,17160,2526,14634,2.445,16.608,-7997,-7.740,17.737,111,112,1132
2007,3261,9255,11723,704526,720088,584,4.937,797,6.737,58661,11324,47337,1.573,8.146,90039,25941,64098,3.602,12.504,-31378,-4.358,16.293,492,500,10172
2007,3262,1652,2139,148957,153789,81,3.736,139,6.411,8162,1136,7026,0.739,5.307,17945,5145,12800,3.346,11.669,-9783,-6.361,10.615,84,85,1510
2007,3271,1183,1381,50543,51198,94,6.707,135,9.633,5046,861,4185,1.682,9.856,6295,1906,4389,3.723,12.296,-1249,-2.440,19.712,105,105,743
2007,3272,1642,1954,98204,99890,115,5.833,150,7.608,6488,540,5948,0.541,6.495,9805,2225,7580,2.227,9.816,-3317,-3.321,12.990,105,105,557
2007,3273,4872,9768,226342,229146,520,5.307,582,5.939,27962,8009,19953,3.495,12.203,33782,8211,25571,3.583,14.743,-5820,-2.540,24.405,289,308,4320
2007,3274,199,332,17337,17781,19,5.689,23,6.886,919,377,542,2.120,5.169,1857,77,1780,0.433,10.444,-938,-5.275,10.337,18,18,55
2007,3279,2887,3331,84317,84171,305,9.255,234,7.101,9555,2488,7067,2.956,11.352,9290,2290,7000,2.721,11.037,265,0.315,22.074,165,165,1285
2007,3311,312,431,103514,105094,39,9.049,39,9.049,4817,369,4448,0.351,4.584,8245,3360,4885,3.197,7.845,-3428,-3.262,9.167,33,33,2753
2007,3312,446,586,44702,45882,21,3.526,40,6.717,3142,392,2750,0.854,6.848,5522,1630,3892,3.553,12.035,-2380,-5.187,13.696,22,23,381
2007,3313,418,564,62795,63206,38,6.762,34,6.050,4108,1115,2993,1.764,6.499,4930,1116,3814,1.766,7.800,-822,-1.301,12.999,23,23,401
2007,3314,766,981,67053,66965,42,4.253,55,5.570,5305,752,4553,1.123,7.922,5073,1488,3585,2.222,7.576,232,0.346,15.151,34,34,229
2007,3315,1827,2067,158397,162329,93,4.443,145,6.928,11384,2595,8789,1.599,7.013,19408,5648,13760,3.479,11.956,-8024,-4.943,14.026,103,104,2082
2007,3321,2457,2705,128134,129224,94,3.446,140,5.132,10123,1610,8513,1.246,7.834,12342,3403,8939,2.633,9.551,-2219,-1.717,15.667,87,87,1420
2007,3322,1320,1432,50748,52296,84,5.843,95,6.609,3492,1107,2385,2.117,6.677,6496,1939,4557,3.708,12.422,-3004,-5.744,13.355,64,64,522
2007,3323,12570,13563,410399,409845,909,6.715,855,6.316,49841,11191,38650,2.731,12.161,48829,12511,36318,3.053,11.914,1012,0.247,23.828,645,645,7830
2007,3324,1211,1484,92269,88992,66,4.443,69,4.645,12600,1546,11054,1.737,14.159,5915,1659,4256,1.864,6.647,6685,7.512,13.293,39,39,386
2007,3325,668,744,40898,42070,45,6.040,47,6.309,2267,418,1849,0.994,5.389,4691,804,3887,1.911,11.151,-2424,-5.762,10.777,28,28,374
2007,3326,1363,1537,51183,51997,68,4.397,87,5.626,4326,1034,3292,1.989,8.320,5954,1282,4672,2.466,11.451,-1628,-3.131,16.640,57,57,447
2007,3327,23592,24048,399162,395961,1530,6.366,1505,6.262,45862,10566,35296,2.668,11.582,39384,10922,28462,2.758,9.946,6478,1.636,19.893,1135,1138,7284
2007,3328,5428,5975,139000,139352,303,5.045,364,6.061,15608,2965,12643,2.128,11.200,16269,5560,10709,3.990,11.675,-661,-0.474,22.401,265,265,2315
2007,3329,5904,6440,280898,280602,574,9.023,417,6.555,29041,7459,21582,2.658,10.350,28743,8232,20511,2.934,10.243,298,0.106,20.487,300,300,3644
2007,3331,2531,2853,200858,196620,188,6.613,168,5.909,21023,3826,17197,1.946,10.692,12615,4374,8241,2.225,6.416,8408,4.276,12.832,119,119,1983
2007,3332,3579,3772,135837,136550,212,5.600,239,6.314,11810,2624,9186,1.922,8.649,13187,4846,8341,3.549,9.657,-1377,-1.008,17.298,172,174,2730
2007,3333,1947,2088,88012,89246,132,6.257,175,8.296,7694,1493,6201,1.673,8.621,10201,4829,5372,5.411,11.430,-2507,-2.809,17.242,114,115,2153
2007,3334,1467,1768,148738,149291,98,5.537,102,5.763,15773,1958,13815,1.312,10.565,16951,2984,13967,1.999,11.354,-1178,-0.789,21.131,70,70,1342
2007,3335,7343,7591,166705,170030,300,3.899,507,6.589,13536,2872,10664,1.689,7.961,20230,6457,13773,3.798,11.898,-6694,-3.937,15.922,377,379,3729
2007,3336,786,959,105865,104630,44,4.617,32,3.358,8974,1069,7905,1.022,8.577,6409,409,6000,0.391,6.125,2565,2.452,12.251,22,22,163
2007,3339,5561,6197,296242,293487,335,5.402,344,5.547,28126,4378,23748,1.492,9.583,22590,6076,16514,2.070,7.697,5536,1.886,15.394,225,225,1916
2007,3341,1099,1154,96807,94893,106,9.130,120,10.336,11357,879,10478,0.926,11.968,7918,1937,5981,2.041,8.344,3439,3.624,16.688,87,87,662
2007,3342,1479,1677,147324,147568,128,7.538,170,10.012,15254,2776,12478,1.881,10.337,15659,4359,11300,2.954,10.611,-405,-0.274,20.674,108,110,1595
2007,3343,447,462,16421,17046,63,13.953,42,9.302,1624,789,835,4.629,9.527,2837,721,2116,4.230,16.643,-1213,-7.116,19.054,29,29,198
2007,3344,4050,4565,363642,363286,282,6.133,348,7.569,36566,7159,29407,1.971,10.065,36200,13692,22508,3.769,9.965,366,0.101,19.929,221,225,4324
2007,3345,4367,5077,393991,393086,291,5.700,348,6.816,35875,7240,28635,1.842,9.127,34144,14161,19983,3.603,8.686,1731,0.440,17.372,198,198,2245
2007,3346,701,739,27153,29535,70,9.290,99,13.139,1812,558,1254,1.889,6.135,6376,3788,2588,12.825,21.588,-4564,-15.453,12.270,71,71,1172
2007,3351,1055,1144,57008,57006,77,6.737,75,6.562,4294,734,3560,1.288,7.533,4477,786,3691,1.379,7.854,-183,-0.321,15.065,53,53,567
2007,3352,269,321,66514,68994,30,9.274,35,10.819,5008,389,4619,0.564,7.259,10109,4857,5252,7.040,14.652,-5101,-7.393,14.517,25,25,2379
2007,3353,1987,2306,139039,139180,96,4.122,142,6.097,12077,1646,10431,1.183,8.677,12546,4565,7981,3.280,9.014,-469,-0.337,17.355,78,78,698
2007,3359,1838,2199,153883,154819,112,5.055,145,6.545,12961,1738,11223,1.123,8.372,14881,6088,8793,3.932,9.612,-1920,-1.240,16.743,81,81,1276
2007,3361,268,332,196051,200446,34,10.287,31,9.380,13536,232,13304,0.116,6.753,23463,6640,16823,3.313,11.705,-9927,-4.952,13.506,18,18,110
2007,3362,1826,2108,151821,155520,158,7.499,156,7.404,13716,2950,10766,1.897,8.819,20984,4812,16172,3.094,13.493,-7268,-4.673,17.639,114,115,2582
2007,3363,4413,5490,599195,619568,318,5.737,423,7.632,52480,12672,39808,2.045,8.470,93432,26872,66560,4.337,15.080,-40952,-6.610,16.941,228,232,6223
2007,3364,1225,1600,408784,402465,121,7.627,94,5.925,35873,12017,23856,2.986,8.913,23542,4171,19371,1.036,5.849,12331,3.064,11.699,65,65,1576
2007,3365,167,230,30054,30652,13,5.640,14,6.074,2212,177,2035,0.577,7.217,3421,187,3234,0.610,11.161,-1209,-3.944,14.433,9,9,111
2007,3366,1512,1644,151736,149862,160,9.674,180,10.883,16123,2490,13633,1.662,10.759,12325,3524,8801,2.351,8.224,3798,2.534,16.448,134,134,1114
2007,3369,854,884,44939,43678,126,14.491,97,11.156,6528,1911,4617,4.375,14.946,4173,1570,2603,3.594,9.554,2355,5.392,19.108,79,79,454
2007,3371,14483,14931,330959,341323,1298,8.653,1436,9.573,31215,7776,23439,2.278,9.145,52001,14400,37601,4.219,15.235,-20786,-6.090,18.291,1119,1121,7738
2007,3372,3991,4165,139119,140996,260,6.205,311,7.422,14154,3200,10954,2.270,10.039,17768,5123,12645,3.633,12.602,-3614,-2.563,20.077,237,238,2444
2007,3379,862,995,43613,45247,67,6.697,78,7.796,3913,1340,2573,2.962,8.648,7201,2001,5200,4.422,15.915,-3288,-7.267,17.296,58,59,1252
2007,3391,10673,11481,309948,307171,755,6.546,860,7.457,33948,6413,27535,2.088,11.052,28215,9574,18641,3.117,9.185,5733,1.866,18.371,636,639,3553
2007,3399,17351,17828,349418,350910,2037,11.569,1597,9.070,42355,14433,27922,4.113,12.070,45381,15502,29879,4.418,12.932,-3026,-0.862,24.140,1247,1255,9458
2007,4231,18019,25230,391531,395927,2038,8.071,2081,8.241,47697,14242,33455,3.597,12.047,56484,16966,39518,4.285,14.266,-8787,-2.219,24.094,1248,1310,7352
2007,4232,11493,13308,172090,174011,1287,9.697,1215,9.155,24069,6962,17107,4.001,13.832,27863,8408,19455,4.832,16.012,-3794,-2.180,27.664,845,868,5077
2007,4233,11567,18434,275183,279549,1819,9.985,1386,7.608,39620,15258,24362,5.458,14.173,48298,13036,35262,4.663,17.277,-8678,-3.104,28.346,795,814,6096
2007,4234,23891,33051,737076,735077,2958,8.887,3428,10.299,120387,35083,85304,4.773,16.377,115468,41032,74436,5.582,15.708,4919,0.669,31.417,1951,2017,11772
2007,4235,7784,10676,167686,165455,701,6.580,657,6.167,23401,5830,17571,3.524,14.143,18874,5749,13125,3.475,11.407,4527,2.736,22.815,328,336,1976
2007,4236,19700,28971,489755,492182,2465,8.486,2617,9.010,72621,20583,52038,4.182,14.755,77891,32416,45475,6.586,15.826,-5270,-1.071,29.510,1169,1242,8557
2007,4237,10928,19785,243055,243082,1448,7.404,994,5.082,30583,7814,22769,3.215,12.581,30777,8272,22505,3.403,12.661,-194,-0.080,25.163,560,586,3604
2007,4238,41804,57224,721797,716518,3802,6.641,3848,6.722,98732,26966,71766,3.763,13.779,88218,30132,58086,4.205,12.312,10514,1.467,24.624,2128,2205,13424
2007,4239,27766,30614,336870,334652,3314,10.881,3001,9.853,54627,18039,36588,5.390,16.324,49934,16445,33489,4.914,14.921,4693,1.402,29.842,2261,2275,10489
2007,4241,8764,11304,173829,179247,664,5.766,1088,9.448,17818,4514,13304,2.518,9.940,28457,12586,15871,7.022,15.876,-10639,-5.935,19.881,540,603,3893
2007,4242,5571,7821,262673,266585,843,10.841,753,9.684,42194,12051,30143,4.521,15.828,49954,19468,30486,7.303,18.739,-7760,-2.911,31.655,469,470,2903
2007,4243,13977,15278,218471,217654,1836,12.090,1651,10.872,36899,12181,24718,5.596,16.953,35441,11714,23727,5.382,16.283,1458,0.670,32.566,1241,1257,6368
2007,4244,24968,31134,779685,781127,3032,9.729,3095,9.931,99884,36684,63200,4.696,12.787,102751,34302,68449,4.391,13.154,-2867,-0.367,25.574,2036,2068,14925
2007,4245,3719,6265,59944,60371,304,4.798,447,7.054,8464,1798,6666,2.978,14.020,9449,2818,6631,4.668,15.652,-985,-1.632,28.040,206,213,1351
2007,4246,8522,12677,152634,151641,954,7.513,995,7.836,22364,5794,16570,3.821,14.748,20594,6235,14359,4.112,13.581,1770,1.167,27.162,477,494,2604
2007,4247,5114,7348,104947,107827,518,7.016,588,7.964,16259,3911,12348,3.627,15.079,22162,5979,16183,5.545,20.553,-5903,-5.475,30.158,271,295,2387
2007,4248,3063,3879,176818,176378,321,8.291,306,7.904,19054,4685,14369,2.656,10.803,18055,5780,12275,3.277,10.237,999,0.566,20.473,184,189,2601
2007,4249,21867,28053,365870,367377,2751,9.758,3031,10.751,53115,16382,36733,4.459,14.458,56421,20017,36404,5.449,15.358,-3306,-0.900,28.916,2039,2070,10351
2007,4251,37694,39882,276990,282806,5114,12.725,5729,14.255,50694,22090,28604,7.811,17.925,63621,30719,32902,10.862,22.496,-12927,-4.571,35.851,4237,4267,15458
2007,4411,42789,47450,1262285,1269439,4299,9.008,4848,10.158,143201,46086,97115,3.630,11.281,157411,65308,92103,5.145,12.400,-14210,-1.119,22.561,3671,3710,46751
2007,4412,13941,15705,171642,171030,1469,9.355,1464,9.323,25264,8552,16712,5.000,14.772,23981,8165,15816,4.774,14.022,1283,0.750,28.043,1078,1104,5962
2007,4413,29990,56043,483657,482155,3781,6.754,3662,6.541,63662,21260,42402,4.409,13.204,61682,17297,44385,3.587,12.793,1980,0.411,25.586,2364,2458,10187
2007,4421,18068,26936,266542,271006,3385,12.642,3065,11.447,45624,22721,22903,8.384,16.835,54276,18599,35677,6.863,20.028,-8652,-3.193,33.670,2016,2279,12960
2007,4422,24588,34031,316622,304203,3537,10.390,3562,10.463,70646,24978,45668,8.211,23.223,47207,16317,30890,5.364,15.518,23439,7.705,31.037,2209,2445,8774
2007,4431,27719,50649,500571,500915,8590,17.344,6345,12.811,97265,50689,46576,10.119,19.417,95801,38965,56836,7.779,19.125,1464,0.292,38.250,3703,3972,20417
2007,4441,44495,67750,1198427,1202764,5441,8.109,4135,6.163,127053,62415,64638,5.189,10.563,136915,27872,109043,2.317,11.383,-9862,-0.820,21.127,2695,2827,15052
2007,4442,15173,18458,164076,165042,1351,7.299,1452,7.845,24581,7018,17563,4.252,14.894,26386,6600,19786,3.999,15.987,-1805,-1.094,29.788,993,1004,4474
2007,4451,55961,82138,2544042,2558523,8962,10.922,8789,10.712,285407,112267,173140,4.388,11.155,316399,101106,215293,3.952,12.366,-30992,-1.211,22.310,6082,6165,37657
2007,4452,17080,20576,137853,137168,3560,17.522,3043,14.977,33379,16735,16644,12.200,24.334,32086,14518,17568,10.584,23.392,1293,0.943,46.784,2270,2279,10463
2007,4453,24685,28172,140925,140307,2915,10.423,2506,8.960,24607,9227,15380,6.576,17.538,23478,7973,15505,5.683,16.733,1129,0.805,33.467,1772,1798,5834
2007,4461,40052,84084,1022455,1044054,7972,9.600,5879,7.080,149881,59618,90263,5.710,14.356,190991,40380,150611,3.868,18.293,-41110,-3.938,28.711,3166,3275,14983
2007,4471,62226,110596,898353,909926,9714,8.741,10793,9.712,150167,62764,87403,6.898,16.503,174161,62239,111922,6.840,19.140,-23994,-2.637,33.006,6107,6565,33363
2007,4481,35475,91741,1269409,1256834,11262,12.460,8555,9.465,261830,101921,159909,8.109,20.833,231957,54804,177153,4.360,18.456,29873,2.377,36.911,4202,4418,17851
2007,4482,6255,27160,210568,207997,2736,10.309,1497,5.640,40869,16686,24183,8.022,19.649,36127,7931,28196,3.813,17.369,4742,2.280,34.738,575,671,2291
2007,4483,17572,27046,161286,163900,2211,8.106,2669,9.786,26035,8653,17382,5.279,15.885,31019,11500,19519,7.016,18.926,-4984,-3.041,31.769,1424,1470,4189
2007,4511,27480,37899,438269,432843,4404,11.655,4180,11.062,81288,37061,44227,8.562,18.780,70221,21328,48893,4.927,16.223,11067,2.557,32.446,2856,2958,11308
2007,4512,5339,10748,148145,147310,785,7.111,1367,12.383,23118,5410,17708,3.673,15.693,21299,7513,13786,5.100,14.459,1819,1.235,28.917,668,778,3253
2007,4521,40,8499,1290772,1287449,429,5.049,425,5.002,116586,38054,78532,2.956,9.056,111814,30318,81496,2.355,8.685,4772,0.371,17.370,49,49,288
2007,4529,7835,35816,1590848,1592467,3213,9.075,2393,6.759,139321,49887,89434,3.133,8.749,142264,13059,129205,0.820,8.934,-2943,-0.185,17.498,1425,1455,5214
2007,4531,17314,18074,92999,95342,1600,8.704,2215,12.050,15142,5174,9968,5.427,15.882,19907,6979,12928,7.320,20.880,-4765,-4.998,31.764,1760,1789,5197
2007,4532,25556,36794,307318,310150,4223,11.400,4721,12.745,53361,21358,32003,6.886,17.205,58330,22534,35796,7.266,18.807,-4969,-1.602,34.410,3292,3419,12244
2007,4533,11934,16481,132839,132487,1677,10.134,1810,10.938,21962,8632,13330,6.515,16.577,21112,6319,14793,4.770,15.935,850,0.642,31.870,1398,1427,4451
2007,4539,30585,38701,256061,254679,4811,12.294,5672,14.495,52052,21513,30539,8.447,20.438,47793,19912,27881,7.818,18.766,4259,1.672,37.532,3479,3565,11664
2007,4541,17926,19088,332790,325137,2981,16.080,1883,10.157,62299,22602,39697,6.952,19.161,47143,16173,30970,4.974,14.499,15156,4.661,28.999,1444,1454,8442
2007,4542,4131,4644,48755,50129,478,10.188,574,12.234,6475,1608,4867,3.208,12.917,9023,4320,4703,8.618,18.000,-2548,-5.083,25.834,424,434,2139
2007,4543,23617,29691,218467,219648,3090,10.517,2469,8.404,32902,12831,20071,5.842,14.979,35310,10012,25298,4.558,16.076,-2408,-1.096,29.959,1681,1697,5849
2007,4811,529,3041,443498,438710,337,11.183,282,9.358,62549,11306,51243,2.577,14.257,52986,18875,34111,4.302,12.078,9563,2.180,24.155,35,35,267
2007,4812,2032,2244,41068,41242,326,14.685,278,12.523,4985,1175,3810,2.849,12.087,5338,1933,3405,4.687,12.943,-353,-0.856,24.175,201,204,1187
2007,4831,710,1027,54207,53863,97,9.318,125,12.008,8527,1963,6564,3.644,15.831,7432,3227,4205,5.991,13.798,1095,2.033,27.596,67,68,901
2007,4832,475,518,18411,18244,73,14.093,73,14.093,2625,1045,1580,5.728,14.388,2247,1031,1216,5.651,12.316,378,2.072,24.633,36,36,476
2007,4841,48557,57382,973598,978459,9742,17.139,8662,15.239,149053,41307,107746,4.222,15.233,160021,58112,101909,5.939,16.354,-10968,-1.121,30.467,6532,6608,27959
2007,4842,41728,46193,491994,488391,6631,14.437,6104,13.290,92723,33783,58940,6.917,18.985,85987,27519,58468,5.635,17.606,6736,1.379,35.212,4632,4647,19585
2007,4851,607,953,53033,53502,81,8.486,84,8.800,6077,2192,3885,4.097,11.359,7096,3683,3413,6.884,13.263,-1019,-1.905,22.717,51,51,961
2007,4852,177,520,17953,17061,82,15.891,74,14.341,4628,2040,2588,11.957,27.126,2768,1206,1562,7.069,16.224,1860,10.902,32.448,20,20,310
2007,4853,5985,6084,72113,70387,1026,17.126,840,14.021,13811,4814,8997,6.839,19.622,10394,3662,6732,5.203,14.767,3417,4.855,29.534,683,683,3144
2007,4854,2889,4386,205830,199848,577,13.584,300,7.063,35191,17197,17994,8.605,17.609,22570,10223,12347,5.115,11.294,12621,6.315,22.587,166,167,2354
2007,4855,1103,1215,30618,30508,107,8.749,123,10.057,4502,1243,3259,4.074,14.757,4318,1165,3153,3.819,14.154,184,0.603,28.307,87,88,620
2007,4859,2638,2848,55688,55747,392,13.754,396,13.895,8807,2720,6087,4.879,15.798,9025,4132,4893,7.412,16.189,-218,-0.391,31.597,311,317,3044
2007,4861,45,398,6537,6473,81,21.981,22,5.970,1388,306,1082,4.728,21.445,1270,514,756,7.941,19.621,118,1.823,39.243,(D),(D),(D)
2007,4862,116,1577,24832,24048,160,10.376,90,5.837,4092,1248,2844,5.190,17.016,2467,735,1732,3.056,10.259,1625,6.757,20.518,6,6,66
2007,4869,55,610,6270,6359,32,5.079,72,11.429,1004,384,620,6.039,15.790,1242,756,486,11.890,19.533,-238,-3.743,31.580,6,22,220
2007,4871,462,509,9068,8708,81,16.119,68,13.532,2015,661,1354,7.591,23.140,1317,625,692,7.177,15.124,698,8.016,30.248,49,49,287
2007,4872,1175,1213,10784,10869,221,18.579,174,14.628,2018,799,1219,7.352,18.567,2174,591,1583,5.438,20.003,-156,-1.435,37.135,131,131,481
2007,4879,124,131,1837,1857,20,15.209,21,15.970,178,45,133,2.424,9.588,216,68,148,3.663,11.635,-38,-2.047,19.176,15,15,31
2007,4881,3698,5163,166226,163814,694,13.534,624,12.168,28342,10451,17891,6.380,17.301,23282,8201,15081,5.006,14.212,5060,3.089,28.425,290,290,1988
2007,4882,444,937,28223,28252,118,12.688,104,11.183,4367,1216,3151,4.304,15.458,4361,2089,2272,7.394,15.436,6,0.021,30.873,40,41,505
2007,4883,1693,2209,86156,85191,189,8.624,154,7.027,11420,2685,8735,3.152,13.405,9546,2188,7358,2.568,11.205,1874,2.200,22.411,97,97,661
2007,4884,8175,8748,72558,71084,1293,15.017,1018,11.823,14476,6261,8215,8.808,20.365,11595,4564,7031,6.421,16.312,2881,4.053,32.624,769,773,3161
2007,4885,14055,20772,260222,250617,2858,14.148,1715,8.490,58272,28610,29662,11.416,23.251,38992,14043,24949,5.603,15.558,19280,7.693,31.117,842,855,4313
2007,4889,1189,1278,15941,15742,219,17.416,178,14.155,2878,904,1974,5.743,18.283,2487,1016,1471,6.454,15.799,391,2.484,31.598,132,135,691
2007,4921,2991,8120,517410,516822,987,12.282,819,10.192,46062,19775,26287,3.826,8.913,45447,11262,34185,2.179,8.794,615,0.119,17.587,325,332,1991
2007,4922,3511,3767,36988,38544,543,13.914,814,20.858,7270,2433,4837,6.312,18.862,10412,5695,4717,14.776,27.014,-3142,-8.152,37.724,492,506,2098
2007,4931,6669,13434,718465,710607,1144,8.473,1280,9.480,113771,33563,80208,4.723,16.010,97450,30666,66784,4.315,13.714,16321,2.297,27.427,342,360,3653
2007,5111,14751,20974,681661,684156,1856,8.791,2134,10.108,78173,20346,57827,2.974,11.426,84011,24390,59621,3.565,12.280,-5838,-0.853,22.852,1194,1216,9464
2007,5112,5246,7483,359744,361159,729,9.423,1236,15.976,51407,12832,38575,3.553,14.234,54620,19930,34690,5.518,15.124,-3213,-0.890,28.468,438,472,7785
2007,5121,12526,15910,317824,316555,2383,15.110,2104,13.341,54609,15279,39330,4.827,17.251,52651,20333,32318,6.423,16.632,1958,0.619,33.265,1334,1352,13003
2007,5122,2880,3099,25516,25606,501,16.290,454,14.762,3999,1528,2471,5.967,15.618,4133,1681,2452,6.565,16.141,-134,-0.523,31.235,303,304,844
2007,5151,4205,9070,246714,250600,944,10.205,1305,14.107,33955,13722,20233,5.476,13.549,43039,12119,30920,4.836,17.174,-9084,-3.625,27.099,289,298,3087
2007,5152,426,694,43012,43365,90,13.072,79,11.474,7405,2173,5232,5.011,17.076,8162,1556,6606,3.588,18.822,-757,-1.746,34.152,28,28,200
2007,5171,3260,32820,886983,895784,4746,14.641,3937,12.145,148306,83534,64772,9.325,16.556,164960,91594,73366,10.225,18.415,-16654,-1.859,33.112,380,418,4134
2007,5172,1490,11372,281934,263712,2038,17.995,1945,17.174,71115,25784,45331,9.777,26.967,33305,13440,19865,5.096,12.629,37810,14.338,25.259,332,400,1739
2007,5174,597,695,9427,9438,170,26.439,66,10.264,3135,927,2208,9.823,33.219,3085,788,2297,8.350,32.689,50,0.530,65.377,38,38,321
2007,5179,4267,4682,62686,65182,922,19.210,1157,24.107,14499,4675,9824,7.172,22.244,19246,7968,11278,12.224,29.527,-4747,-7.283,44.488,832,864,4449
2007,5182,8068,14557,409970,409779,1864,12.228,3237,21.235,93531,30829,62702,7.523,22.825,93369,39250,54119,9.578,22.785,162,0.040,45.570,635,656,6137
2007,5191,5391,6658,121548,118551,1030,15.913,659,10.182,20947,5738,15209,4.840,17.669,14976,4164,10812,3.512,12.633,5971,5.037,25.265,450,452,2257
2007,5211,16,51,19537,19762,(D),(D),6,11.321,820,(D),801,(D),4.149,1220,75,1145,0.380,6.174,-400,-2.024,8.299,5,5,43
2007,5221,15311,124991,2153027,2152482,12584,10.275,7538,6.155,304302,126661,177641,5.884,14.137,301088,103793,197295,4.822,13.988,3214,0.149,27.976,512,621,15101
2007,5222,18591,51849,776488,788420,8526,16.366,9017,17.309,172277,69612,102665,8.829,21.851,197069,82692,114377,10.488,24.995,-24792,-3.145,43.702,2582,2974,21307
2007,5223,26453,45555,339041,343087,8336,18.752,6135,13.801,86964,36518,50446,10.644,25.348,94248,37280,56968,10.866,27.471,-7284,-2.123,50.695,3830,4055,19769
2007,5231,12435,38033,501242,508081,5969,15.618,6339,16.586,106079,37214,68865,7.324,20.878,121343,52397,68946,10.313,23.883,-15264,-3.004,41.757,1049,1103,4706
2007,5232,19,47,7899,7592,7,8.696,74,91.925,1825,414,1411,5.453,24.040,1126,733,393,9.656,14.832,699,9.208,29.665,10,10,544
2007,5239,36491,40958,408457,402306,6852,17.053,5297,13.183,78848,34311,44537,8.529,19.599,66860,27069,39791,6.728,16.619,11988,2.980,33.238,3253,3267,11277
2007,5241,6061,32521,1446744,1448794,4294,13.134,4639,14.189,198190,76631,121559,5.289,13.680,201614,71310,130304,4.922,13.916,-3424,-0.236,27.359,567,574,3299
2007,5242,121842,137377,940474,946163,13843,10.159,11627,8.532,158345,62568,95777,6.613,16.735,170307,67400,102907,7.124,18.000,-11962,-1.264,33.471,7430,7565,26924
2007,5250,2163,5297,49803,45572,1706,37.277,265,5.790,15264,10221,5043,22.428,33.495,7519,1761,5758,3.864,16.499,7745,16.995,32.999,138,147,746
2007,5311,84216,102573,509796,517732,12712,12.419,12282,11.999,97576,47297,50279,9.135,18.847,113789,48156,65633,9.301,21.978,-16213,-3.132,37.694,7917,7993,28105
2007,5312,77594,87871,359754,363483,16125,18.414,15518,17.721,85948,44683,41265,12.293,23.646,93854,38416,55438,10.569,25.821,-7906,-2.175,47.291,11052,11152,24723
2007,5313,63721,73637,643481,637922,10951,15.098,8746,12.058,118744,49983,68761,7.835,18.614,107509,42152,65357,6.608,16.853,11235,1.761,33.706,5906,5959,24266
2007,5321,4188,12309,186352,179592,1400,11.294,1575,12.705,42600,8109,34491,4.515,23.720,29247,12675,16572,7.058,16.285,13353,7.435,32.571,470,499,2333
2007,5322,10819,31475,246240,251105,2133,6.667,3174,9.920,32020,10315,21705,4.108,12.752,41712,15841,25871,6.309,16.611,-9692,-3.860,25.503,1414,1553,6313
2007,5323,2931,4487,29617,30189,319,7.023,430,9.466,4215,1310,2905,4.339,13.962,5367,1930,3437,6.393,17.778,-1152,-3.816,27.924,212,219,981
2007,5324,7456,13090,168643,164302,1532,11.869,1168,9.049,31236,9029,22207,5.495,19.011,22847,8398,14449,5.111,13.905,8389,5.106,27.811,618,627,4124
2007,5331,1940,2036,30305,29694,299,14.850,254,12.615,7493,3865,3628,13.016,25.234,6410,2469,3941,8.315,21.587,1083,3.647,43.174,173,173,776
2007,5411,164524,173892,1193284,1202633,15108,8.703,14495,8.350,140361,47108,93253,3.917,11.671,159661,48873,110788,4.064,13.276,-19300,-1.605,23.342,10289,10359,29752
2007,5412,95330,110063,1278439,1292620,10856,9.912,9776,8.926,214250,66470,147780,5.142,16.575,240219,77579,162640,6.002,18.584,-25969,-2.009,33.150,6149,6191,44927
2007,5413,89500,103347,1428036,1407106,11065,10.800,9271,9.049,223229,65351,157878,4.644,15.864,181720,58284,123436,4.142,12.914,41509,2.950,25.829,5905,5996,24775
2007,5414,27654,27910,125549,124746,4362,15.835,3635,13.196,24462,9973,14489,7.995,19.610,22837,9583,13254,7.682,18.307,1625,1.303,36.614,2659,2665,6879
2007,5415,84448,98476,1305012,1259892,18666,19.390,14248,14.801,313750,107347,206403,8.520,24.903,226727,86707,140020,6.882,17.996,87023,6.907,35.991,9403,9468,38274
2007,5416,99937,105103,761558,758710,21253,20.644,16952,16.466,172550,72644,99906,9.575,22.743,166928,78240,88688,10.312,22.002,5622,0.741,44.003,11834,11891,42787
2007,5417,11446,14796,654316,657136,2064,14.108,1731,11.832,99178,19255,79923,2.930,15.092,106225,33855,72370,5.152,16.165,-7047,-1.072,30.185,941,959,9396
2007,5418,32136,35494,455118,460241,4499,12.769,3976,11.285,83777,28145,55632,6.115,18.203,95455,29288,66167,6.364,20.740,-11678,-2.537,36.406,2715,2745,12432
2007,5419,54435,63888,586840,579734,7595,12.084,5524,8.789,100304,34584,65720,5.965,17.302,86794,27119,59675,4.678,14.971,13510,2.330,29.943,3876,3898,15815
2007,5511,26043,49425,2846634,2823432,5784,11.744,5439,11.043,564901,171984,392917,6.091,20.008,512951,192575,320376,6.821,18.168,51950,1.840,36.335,870,904,10848
2007,5611,23180,25304,398322,401771,4314,17.457,3130,12.666,81543,34253,47290,8.526,20.296,88183,39114,49069,9.735,21.949,-6640,-1.653,40.592,2268,2288,22297
2007,5612,1730,5746,284150,261028,704,12.650,342,6.146,73699,15832,57867,6.065,28.234,27508,8467,19041,3.244,10.538,46191,17.696,21.077,104,105,1104
2007,5613,27622,47606,4870015,4850181,7157,15.263,5726,12.211,1047560,291594,755966,6.012,21.598,1015580,268970,746610,5.546,20.939,31980,0.659,41.878,2729,2889,153145
2007,5614,26437,33033,790440,801871,4037,12.183,4243,12.805,135835,45564,90271,5.682,16.940,156695,49956,106739,6.230,19.541,-20860,-2.601,33.880,2756,2783,19400
2007,5615,15437,20746,261247,263237,1718,8.118,2552,12.059,37250,9560,27690,3.632,14.151,41449,14059,27390,5.341,15.746,-4199,-1.595,28.301,1360,1403,6707
2007,5616,17392,22763,774500,777483,2866,12.709,2443,10.833,131023,37268,93755,4.793,16.852,137925,53881,84044,6.930,17.740,-6902,-0.888,33.704,1516,1541,20521
2007,5617,136980,143282,1678378,1671227,23082,16.299,19753,13.948,331982,114857,217125,6.873,19.865,316861,109746,207115,6.567,18.960,15121,0.905,37.920,13763,13786,66914
2007,5619,16305,18290,314139,323719,1955,10.647,2099,11.431,49625,13615,36010,4.206,15.330,67900,23325,44575,7.205,20.975,-18275,-5.645,30.659,1401,1409,9119
2007,5621,7324,9367,194050,188074,1221,13.336,798,8.716,43290,22116,21174,11.759,23.018,31753,11905,19848,6.330,16.883,11537,6.134,33.766,490,490,2849
2007,5622,1379,2518,59146,60949,255,10.163,237,9.446,7870,3320,4550,5.447,12.913,11288,4242,7046,6.960,18.521,-3418,-5.608,25.825,107,107,880
2007,5629,7262,8139,122184,121326,1007,12.637,666,8.358,27215,9503,17712,7.833,22.431,25893,7526,18367,6.203,21.342,1322,1.090,42.684,440,446,4110
2007,6111,17613,19920,821533,806314,981,5.044,42,0.216,69859,15658,54201,1.942,8.664,39027,243,38784,0.030,4.840,30832,3.824,9.680,30,30,204
2007,6112,435,822,80022,80924,34,4.218,(D),(D),5474,887,4587,1.096,6.764,7485,(D),7478,(D),9.249,-2011,-2.485,13.529,(D),(D),(D)
2007,6113,2261,3773,1560845,1542575,236,6.445,13,0.355,89347,9981,79366,0.647,5.792,53775,83,53692,0.005,3.486,35572,2.306,6.972,8,8,15
2007,6114,6636,7285,73279,72460,1006,13.989,819,11.388,15629,6456,9173,8.910,21.569,13953,5431,8522,7.495,19.256,1676,2.313,38.512,538,547,2910
2007,6115,6126,7579,124964,123888,884,11.840,658,8.813,23273,6934,16339,5.597,18.786,21547,4013,17534,3.239,17.392,1726,1.393,34.785,462,464,2240
2007,6116,30526,32822,305617,300989,4972,15.515,3419,10.669,67861,25803,42058,8.573,22.546,58666,18998,39668,6.312,19.491,9195,3.055,38.982,2455,2469,11164
2007,6117,4961,5667,76901,76315,845,15.127,683,12.227,13876,4352,9524,5.703,18.183,12662,2815,9847,3.689,16.592,1214,1.591,33.184,473,481,1714
2007,6211,176669,203150,2099134,2084532,16051,7.925,14803,7.309,300528,103034,197494,4.943,14.417,273920,88929,184991,4.266,13.141,26608,1.276,26.281,9784,10013,45177
2007,6212,121977,127810,842259,836866,8600,6.816,5315,4.213,113624,37358,76266,4.464,13.577,102912,24593,78319,2.939,12.297,10712,1.280,24.595,3897,4021,18169
2007,6213,93577,105538,604174,597776,11099,10.632,8812,8.441,111731,42110,69621,7.044,18.691,98337,34841,63496,5.828,16.450,13394,2.241,32.901,5881,5965,18097
2007,6214,13586,28607,650370,645772,3500,12.585,1906,6.854,100509,39274,61235,6.082,15.564,90777,26851,63926,4.158,14.057,9732,1.507,28.114,752,824,8936
2007,6215,7137,12193,237961,235795,1918,16.248,1141,9.666,37940,15248,22692,6.467,16.090,33793,15450,18343,6.552,14.332,4147,1.759,28.663,636,682,6285
2007,6216,14184,20726,969320,948166,3602,18.122,1903,9.574,170154,56514,113640,5.960,17.946,126833,32998,93835,3.480,13.377,43321,4.569,26.753,1102,1154,15447
2007,6219,5642,9011,278172,270799,1052,11.908,699,7.912,51958,16568,35390,6.118,19.187,37249,12507,24742,4.619,13.755,14709,5.432,27.510,373,381,4675
2007,6221,3014,5066,5040459,4979665,57,1.122,88,1.732,306171,32951,273220,0.662,6.148,183429,30633,152796,0.615,3.684,122742,2.465,7.367,41,41,13638
2007,6222,417,558,207403,209060,17,3.020,27,4.796,16624,2310,14314,1.105,7.952,20041,2596,17445,1.242,9.586,-3417,-1.634,15.904,9,9,822
2007,6223,369,807,231085,228310,62,7.745,49,6.121,25613,7009,18604,3.070,11.219,20068,3592,16476,1.573,8.790,5545,2.429,17.580,32,34,2044
2007,6231,7900,15358,1571615,1562389,1336,8.743,1181,7.729,160396,70938,89458,4.540,10.266,141913,68601,73312,4.391,9.083,18483,1.183,18.166,551,605,39483
2007,6232,8584,32239,590869,590029,2592,8.090,2190,6.836,80516,22639,57877,3.837,13.646,80179,21925,58254,3.716,13.589,337,0.057,27.178,359,417,5395
2007,6233,13760,19519,740511,722518,2284,11.876,1709,8.886,108484,54261,54223,7.510,15.015,71943,29177,42766,4.038,9.957,36541,5.057,19.915,1208,1233,18951
2007,6239,3381,5871,151123,151737,436,7.406,468,7.950,19518,5188,14330,3.419,12.863,20831,6061,14770,3.994,13.728,-1313,-0.865,25.726,213,223,2794
2007,6241,38121,53618,1171346,1147122,5519,10.464,3771,7.150,179062,45324,133738,3.951,15.610,129945,29635,100310,2.583,11.328,49117,4.282,22.656,2170,2239,15847
2007,6242,9351,13592,165816,165382,707,5.213,646,4.763,22204,4759,17445,2.878,13.426,21224,5011,16213,3.030,12.833,980,0.593,25.667,289,295,1925
2007,6243,4356,7363,321618,323072,425,5.686,648,8.669,44649,6479,38170,2.005,13.820,47928,9753,38175,3.019,14.835,-3279,-1.015,27.640,221,248,1703
2007,6244,53838,68716,858807,848573,7615,11.156,6706,9.824,134101,51334,82767,6.049,15.803,113669,38932,74737,4.588,13.395,20432,2.408,26.791,4782,4873,26507
2007,7111,7368,7504,126675,126603,960,12.861,881,11.803,21084,5864,15220,4.632,16.654,21148,5140,16008,4.060,16.704,-64,-0.051,33.307,600,603,3413
2007,7112,3411,3583,122108,119229,576,16.251,499,14.078,20592,5090,15502,4.269,17.271,14751,4552,10199,3.818,12.372,5841,4.899,24.744,354,354,2064
2007,7113,5113,5470,122315,119362,767,14.314,544,10.152,23195,7373,15822,6.177,19.433,17610,3260,14350,2.731,14.754,5585,4.679,29.507,384,385,1819
2007,7114,2759,2838,18623,18020,455,16.299,362,12.968,3989,1331,2658,7.386,22.137,2839,1214,1625,6.737,15.755,1150,6.382,31.509,266,266,960
2007,7115,13470,13491,43268,44457,2641,19.790,2349,17.602,13067,6626,6441,14.904,29.392,15362,6288,9074,14.144,34.555,-2295,-5.162,58.785,1489,1490,4122
2007,7121,6152,6636,128449,126005,441,6.702,329,5.000,13321,1924,11397,1.527,10.572,8495,1508,6987,1.197,6.742,4826,3.830,13.484,187,189,898
2007,7131,2086,2579,131667,138313,399,15.444,408,15.793,14134,3842,10292,2.778,10.219,27395,5631,21764,4.071,19.807,-13261,-9.588,20.438,275,293,2795
2007,7132,1742,2305,169255,167175,308,13.444,280,12.222,21648,6010,15638,3.595,12.949,17156,7446,9710,4.454,10.262,4492,2.687,20.525,176,176,2998
2007,7139,50740,57003,1170728,1159737,7265,12.846,6372,11.267,177275,61252,116023,5.282,15.286,156212,50265,105947,4.334,13.470,21063,1.816,26.939,4943,4968,35737
2007,7211,37874,47660,1881861,1876610,5334,11.233,4988,10.504,266318,116111,150207,6.187,14.191,255273,123625,131648,6.588,13.603,11045,0.589,27.206,3116,3159,51497
2007,7212,5341,5877,40010,39456,678,11.696,518,8.936,7959,2781,5178,7.048,20.172,6865,1825,5040,4.625,17.399,1094,2.773,34.798,337,337,1239
2007,7213,2037,2099,11338,11355,123,5.820,152,7.192,1475,422,1053,3.717,12.990,1501,486,1015,4.280,13.219,-26,-0.229,25.981,107,107,372
2007,7223,12076,32274,607473,597844,7138,22.924,4866,15.627,170697,80767,89930,13.510,28.552,144400,54026,90374,9.037,24.153,26297,4.399,48.307,1398,1418,8463
2007,7224,41554,42233,358380,358677,5005,11.804,5341,12.596,78799,40056,38743,11.168,21.969,78876,32108,46768,8.952,21.991,-77,-0.021,43.939,4402,4406,26560
2007,7225,317030,438325,8706276,8656426,58273,13.494,45316,10.494,1544941,794408,750533,9.177,17.847,1443800,471268,972532,5.444,16.679,101141,1.168,33.358,34038,34936,322706
2007,8111,139301,152389,875721,878742,14199,9.297,14879,9.742,145932,57064,88868,6.494,16.607,151466,53223,98243,6.057,17.237,-5534,-0.630,33.214,10898,11119,38533
2007,8112,10337,11635,124329,124856,1274,10.803,1589,13.475,23115,8161,14954,6.536,18.513,24197,8687,15510,6.958,19.380,-1082,-0.867,37.027,1034,1038,3695
2007,8113,19841,21266,191402,186175,2193,10.363,1986,9.385,36790,14016,22774,7.528,19.761,25796,9324,16472,5.008,13.856,10994,5.905,27.712,1422,1424,5456
2007,8114,18295,19321,80963,83804,2255,11.602,2484,12.781,14417,5407,9010,6.452,17.203,19932,7357,12575,8.779,23.784,-5515,-6.581,34.406,1798,1809,4267
2007,8121,84025,99843,611212,612822,14171,14.350,11996,12.147,116356,58032,58324,9.470,18.987,120008,46471,73537,7.583,19.583,-3652,-0.596,37.974,9256,9398,32920
2007,8122,14711,20274,136540,136095,930,4.604,785,3.886,18395,3710,14685,2.726,13.516,17532,2756,14776,2.025,12.882,863,0.634,25.764,443,451,1474
2007,8123,30847,36657,345722,348803,3644,9.822,4530,12.210,51575,16564,35011,4.749,14.786,57668,23428,34240,6.717,16.533,-6093,-1.747,29.573,3102,3186,12998
2007,8129,20914,31307,238965,232689,6038,19.520,5290,17.101,65334,29824,35510,12.817,28.078,52775,25032,27743,10.758,22.680,12559,5.397,45.361,2458,2508,9175
2007,8131,169053,169368,1678306,1667245,9157,5.541,933,0.565,163586,28470,135116,1.708,9.812,141639,2217,139422,0.133,8.495,21947,1.316,16.991,615,615,1270
2007,8132,13776,15749,185221,178500,1273,8.184,885,5.689,28981,4381,24600,2.454,16.236,14995,3699,11296,2.072,8.401,13986,7.835,16.801,543,546,2491
2007,8133,12342,14610,132778,129940,1396,9.718,907,6.314,20311,4740,15571,3.648,15.631,14669,3087,11582,2.376,11.289,5642,4.342,22.578,517,521,1769
2007,8134,26229,28009,256139,256021,1611,5.758,1549,5.536,33082,6512,26570,2.544,12.922,32839,7019,25820,2.742,12.827,243,0.095,25.653,1018,1022,3959
2007,8139,55958,58096,507947,506652,2915,5.047,2233,3.866,59393,12613,46780,2.489,11.723,56896,7902,48994,1.560,11.230,2497,0.493,22.460,1542,1545,5108
2008,2111,5776,7038,102400,122244,796,11.486,580,8.369,18507,7110,11397,5.816,15.139,57874,10045,47829,8.217,47.343,-39367,-32.204,30.279,367,367,3191
2008,2121,577,971,78297,78927,98,9.949,126,12.792,11355,2132,9223,2.701,14.387,12629,4009,8620,5.079,16.001,-1274,-1.614,28.774,74,74,1319
2008,2122,211,269,33103,33974,44,16.698,33,12.524,3774,664,3110,1.954,11.108,5549,174,5375,0.512,16.333,-1775,-5.225,22.217,21,21,101
2008,2123,3136,5201,89720,96409,267,5.066,406,7.703,10925,2787,8138,2.891,11.332,24081,3057,21024,3.171,24.978,-13156,-13.646,22.664,235,239,1493
2008,2131,9000,11045,316305,330024,1573,14.595,1039,9.640,59708,17820,41888,5.400,18.092,87846,15945,71901,4.831,26.618,-28138,-8.526,36.184,705,708,6909
2008,2211,1600,9567,508633,511997,683,7.169,604,6.340,45202,13353,31849,2.608,8.829,51609,13708,37901,2.677,10.080,-6407,-1.251,17.657,56,59,642
2008,2212,431,2230,80407,80346,156,6.975,169,7.556,9717,3922,5795,4.881,12.094,9724,2053,7671,2.555,12.103,-7,-0.009,24.188,22,22,262
2008,2213,3542,4574,43065,42596,470,10.424,340,7.540,9095,6041,3054,14.182,21.352,8172,3267,4905,7.670,19.185,923,2.167,38.370,146,146,511
2008,2361,154080,155479,800890,850626,24613,15.430,32686,20.491,167242,72677,94565,8.544,19.661,266577,99477,167100,11.695,31.339,-99335,-11.678,39.322,24513,24513,72477
2008,2362,39620,40747,705086,704014,3902,9.516,4418,10.774,129394,27554,101840,3.914,18.379,128356,29521,98835,4.193,18.232,1038,0.147,36.464,3252,3265,17945
2008,2371,17995,19077,544825,541301,1506,7.833,1803,9.378,98352,16009,82343,2.958,18.170,91363,19042,72321,3.518,16.878,6989,1.291,33.757,1250,1250,7835
2008,2372,9683,9825,94894,98639,941,9.139,1884,18.297,14359,3552,10807,3.601,14.557,21875,6224,15651,6.310,22.177,-7516,-7.620,29.114,1579,1580,4920
2008,2373,9387,10157,307069,311955,626,6.074,924,8.966,42225,8723,33502,2.796,13.536,52320,7388,44932,2.368,16.772,-10095,-3.236,27.071,605,605,4383
2008,2379,3922,4062,67299,68156,463,11.290,541,13.192,13647,3534,10113,5.185,20.023,15422,4283,11139,6.284,22.628,-1775,-2.604,40.047,361,361,1884
2008,2381,91306,92121,1014718,1066338,10179,10.674,16662,17.472,188108,44970,143138,4.217,17.641,291581,70122,221459,6.576,27.344,-103473,-9.704,35.281,12124,12125,51680
2008,2382,164635,168386,1989646,1989822,16416,9.722,17346,10.273,338914,70774,268140,3.557,17.032,338576,75829,262747,3.811,17.015,338,0.017,34.031,13107,13123,57017
2008,2383,108641,109765,880395,910343,14029,12.454,19799,17.576,176000,51567,124433,5.665,19.333,235649,64430,171219,7.078,25.886,-59649,-6.552,38.667,14986,14988,48266
2008,2389,61661,62401,580420,597173,8100,12.740,10458,16.449,104567,32696,71871,5.475,17.510,137954,37702,100252,6.313,23.101,-33387,-5.591,35.021,7597,7600,28850
2008,3111,1123,1706,50360,48100,98,5.739,101,5.915,8474,1247,7227,2.593,17.617,4268,1163,3105,2.418,8.873,4206,8.744,17.746,70,70,693
2008,3112,433,758,55729,55198,42,5.559,37,4.897,4158,788,3370,1.428,7.533,3082,1094,1988,1.982,5.584,1076,1.949,11.167,25,25,447
2008,3113,1447,1596,67821,69356,126,7.877,133,8.315,6474,1510,4964,2.177,9.334,9456,2661,6795,3.837,13.634,-2982,-4.300,18.669,93,93,1259
2008,3114,1176,1540,159821,159446,86,5.538,112,7.212,14148,3519,10629,2.207,8.873,13524,2905,10619,1.822,8.482,624,0.391,16.964,78,78,1481
2008,3115,992,1497,131982,131054,80,5.357,73,4.888,11627,1561,10066,1.191,8.872,9788,2381,7407,1.817,7.469,1839,1.403,14.937,48,48,1192
2008,3116,2857,3466,498535,493435,176,5.049,216,6.196,36069,5229,30840,1.060,7.310,26254,7944,18310,1.610,5.321,9815,1.989,10.641,164,164,4204
2008,3117,507,600,33406,32931,36,5.926,51,8.395,5026,367,4659,1.114,15.262,4031,1162,2869,3.529,12.241,995,3.021,24.481,36,36,504
2008,3118,8602,9320,280506,283262,785,8.380,879,9.384,27281,7022,20259,2.479,9.631,32341,8445,23896,2.981,11.417,-5060,-1.786,19.262,688,693,4896
2008,3119,2597,3045,164629,163890,237,7.791,231,7.594,17981,5058,12923,3.086,10.971,16638,4277,12361,2.610,10.152,1343,0.819,20.304,166,167,2436
2008,3121,2958,3530,134863,134298,456,13.281,263,7.660,15582,4470,11112,3.328,11.603,14274,3317,10957,2.470,10.629,1308,0.974,21.257,189,194,1601
2008,3122,69,97,18803,19433,5,5.102,7,7.143,430,56,374,0.288,2.213,1673,215,1458,1.106,8.609,-1243,-6.397,4.426,(D),(D),(D)
2008,3131,258,373,39309,41418,16,4.145,42,10.881,1841,241,1600,0.582,4.445,6109,2178,3931,5.259,14.750,-4268,-10.305,8.890,24,26,462
2008,3132,1005,1134,66482,71012,62,5.317,126,10.806,4913,1295,3618,1.824,6.919,14111,7077,7034,9.966,19.871,-9198,-12.953,13.837,82,85,3034
2008,3133,1088,1143,41429,42767,90,7.755,125,10.771,4516,890,3626,2.081,10.560,7080,3596,3484,8.408,16.555,-2564,-5.995,21.119,97,98,1484
2008,3141,2092,2227,69039,72442,139,6.142,211,9.324,5810,2181,3629,3.011,8.020,12742,4677,8065,6.456,17.589,-6932,-9.569,16.040,165,165,1280
2008,3149,3907,4025,71064,71191,366,9.127,336,8.379,9256,2370,6886,3.329,13.002,9629,3142,6487,4.413,13.526,-373,-0.524,26.003,260,260,1981
2008,3151,337,356,20160,21959,29,7.662,74,19.551,1761,708,1053,3.224,8.020,5301,3456,1845,15.739,24.141,-3540,-16.121,16.039,55,56,1180
2008,3152,6141,6239,130578,133371,832,12.941,1212,18.852,24369,8707,15662,6.528,18.272,29705,14968,14737,11.223,22.272,-5336,-4.001,36.543,1006,1007,11112
2008,3159,679,697,12974,13368,58,8.067,102,14.186,1039,200,839,1.496,7.772,1842,467,1375,3.493,13.779,-803,-6.007,15.545,89,89,376
2008,3161,204,211,4732,4750,13,6.019,23,10.648,853,269,584,5.663,17.958,873,278,595,5.853,18.379,-20,-0.421,35.916,18,18,104
2008,3162,221,243,13004,13262,18,7.347,22,8.980,694,81,613,0.611,5.233,1221,425,796,3.205,9.207,-527,-3.974,10.466,16,16,90
2008,3169,755,768,15551,15863,75,9.690,87,11.240,1826,539,1287,3.398,11.511,2385,1510,875,9.519,15.035,-559,-3.524,23.023,61,61,226
2008,3211,3256,3662,101537,104991,228,6.094,387,10.343,8416,3217,5199,3.064,8.016,15288,4886,10402,4.654,14.561,-6872,-6.545,16.032,294,300,3051
2008,3212,1416,1817,93610,101029,122,6.621,173,9.389,7266,2777,4489,2.749,7.192,22334,5756,16578,5.697,22.107,-15068,-14.915,14.384,98,100,1696
2008,3219,9021,10052,292044,304429,695,6.818,978,9.594,28193,9112,19081,2.993,9.261,53169,13461,39708,4.422,17.465,-24976,-8.204,18.522,756,763,8459
2008,3221,238,479,120942,123875,17,3.516,26,5.377,2780,435,2345,0.351,2.244,8521,2478,6043,2.000,6.879,-5741,-4.635,4.488,11,11,271
2008,3222,2871,4260,287209,291178,138,3.197,251,5.815,16611,3826,12785,1.314,5.705,24565,7763,16802,2.666,8.436,-7954,-2.732,11.410,143,144,2278
2008,3231,29229,30774,617102,628063,1624,5.191,2643,8.449,48780,12577,36203,2.003,7.767,70968,24221,46747,3.856,11.300,-22188,-3.533,15.533,2143,2155,14254
2008,3241,1043,2218,103042,101602,163,7.371,150,6.783,9341,1375,7966,1.353,9.194,6416,1716,4700,1.689,6.315,2925,2.879,12.630,60,60,416
2008,3251,1424,2491,161803,160851,157,6.296,162,6.497,12593,3028,9565,1.882,7.829,10731,2597,8134,1.615,6.671,1862,1.158,13.343,65,65,391
2008,3252,953,1285,97637,98218,66,5.166,51,3.992,6820,2261,4559,2.302,6.944,8079,1137,6942,1.158,8.226,-1259,-1.282,13.888,31,31,295
2008,3253,605,843,29647,29616,68,8.129,55,6.575,2632,852,1780,2.877,8.887,2585,805,1780,2.718,8.729,47,0.159,17.457,29,29,215
2008,3254,1409,1828,255420,248256,117,6.413,110,6.029,32063,2958,29105,1.192,12.915,16849,5177,11672,2.085,6.787,15214,6.128,13.574,56,56,995
2008,3255,1444,1829,62551,63596,87,4.708,125,6.764,5506,1212,4294,1.906,8.658,7611,2008,5603,3.157,11.968,-2105,-3.310,17.316,79,81,1036
2008,3256,1881,2086,104999,105452,133,6.356,146,6.977,10097,2260,7837,2.143,9.575,10936,3735,7201,3.542,10.371,-839,-0.796,19.150,94,94,1101
2008,3259,1957,2470,92506,95146,137,5.476,201,8.034,7672,2086,5586,2.192,8.063,12785,3368,9417,3.540,13.437,-5113,-5.374,16.127,128,131,1245
2008,3261,8905,11315,669668,685283,452,3.942,752,6.559,52387,9716,42671,1.418,7.645,83758,24072,59686,3.513,12.222,-31371,-4.578,15.289,490,501,11412
2008,3262,1588,2063,145322,146509,98,4.727,118,5.692,10805,2072,8733,1.414,7.375,13268,2941,10327,2.007,9.056,-2463,-1.681,14.750,77,77,661
2008,3271,1134,1329,45072,47311,100,7.424,136,10.097,3400,1242,2158,2.625,7.187,7823,1912,5911,4.041,16.535,-4423,-9.349,14.373,82,82,416
2008,3272,1563,1867,97603,97790,104,5.471,172,9.048,7612,1172,6440,1.198,7.784,8039,2518,5521,2.575,8.221,-427,-0.437,15.568,119,119,581
2008,3273,4681,9592,209266,216705,541,5.616,623,6.467,21889,6283,15606,2.899,10.101,37006,7572,29434,3.494,17.077,-15117,-6.976,20.202,286,329,4255
2008,3274,204,342,16407,16675,21,6.122,23,6.706,1229,566,663,3.394,7.370,1785,164,1621,0.984,10.705,-556,-3.334,14.741,17,17,64
2008,3279,2815,3297,79800,82072,281,8.545,264,8.028,7158,2053,5105,2.501,8.722,11606,3261,8345,3.973,14.141,-4448,-5.420,17.443,193,193,1682
2008,3311,579,719,113591,111577,88,12.653,41,5.895,9026,2769,6257,2.482,8.089,4924,1320,3604,1.183,4.413,4102,3.676,8.826,24,24,517
2008,3312,535,664,41008,41007,52,7.933,35,5.339,3228,791,2437,1.929,7.872,3236,917,2319,2.236,7.891,-8,-0.020,15.744,21,21,360
2008,3313,429,568,62294,62669,28,4.899,35,6.124,4570,2628,1942,4.193,7.292,5348,1445,3903,2.306,8.534,-778,-1.241,14.585,17,17,246
2008,3314,739,953,67700,67308,52,5.431,61,6.371,5422,934,4488,1.388,8.056,4710,1546,3164,2.297,6.998,712,1.058,13.995,38,38,285
2008,3315,1762,1988,150921,154431,78,3.874,129,6.407,8802,1328,7474,0.860,5.700,15942,3239,12703,2.097,10.323,-7140,-4.623,11.399,95,97,1776
2008,3321,2399,2648,126097,126859,81,3.029,133,4.974,9856,1664,8192,1.312,7.769,11371,2973,8398,2.344,8.964,-1515,-1.194,15.539,100,100,1808
2008,3322,1311,1421,49043,49931,77,5.386,94,6.576,3604,447,3157,0.895,7.218,5441,2136,3305,4.278,10.897,-1837,-3.679,14.436,72,72,890
2008,3323,12357,13392,399525,403102,800,5.959,866,6.451,40609,9447,31162,2.344,10.074,48090,12383,35707,3.072,11.930,-7481,-1.856,20.148,656,658,7043
2008,3324,1180,1464,93463,92197,75,5.130,71,4.856,13307,6647,6660,7.210,14.433,11446,6516,4930,7.068,12.415,1861,2.019,24.830,52,52,5402
2008,3325,631,706,38395,39355,31,4.315,56,7.794,2295,730,1565,1.855,5.832,4149,1450,2699,3.684,10.543,-1854,-4.711,11.663,43,43,406
2008,3326,1300,1468,49970,50960,42,2.806,100,6.680,4044,861,3183,1.690,7.936,6087,1508,4579,2.959,11.945,-2043,-4.009,15.871,73,73,727
2008,3327,23173,23609,398093,397537,1272,5.362,1496,6.307,41538,8421,33117,2.118,10.449,40379,14114,26265,3.550,10.157,1159,0.292,20.315,1157,1159,8409
2008,3328,5314,5838,135721,136670,275,4.669,378,6.418,12916,3124,9792,2.286,9.451,14823,4117,10706,3.012,10.846,-1907,-1.395,18.901,286,292,2440
2008,3329,5570,6109,274046,275238,423,6.922,427,6.987,25033,4983,20050,1.810,9.095,27284,9126,18158,3.316,9.913,-2251,-0.818,18.190,312,314,3772
2008,3331,2519,2836,204340,201727,199,7.057,167,5.922,20731,3150,17581,1.562,10.277,15504,3619,11885,1.794,7.686,5227,2.591,15.371,123,123,2412
2008,3332,3452,3634,128127,131301,170,4.626,252,6.857,11752,2788,8964,2.123,8.950,17817,3823,13994,2.912,13.570,-6065,-4.619,17.901,181,182,1928
2008,3333,1897,2032,85927,85956,130,6.360,154,7.534,7730,1763,5967,2.051,8.993,7851,2098,5753,2.441,9.134,-121,-0.141,17.986,111,111,945
2008,3334,1457,1753,146656,147880,103,5.894,92,5.265,10576,1452,9124,0.982,7.152,13168,2093,11075,1.415,8.905,-2592,-1.753,14.303,54,54,792
2008,3335,7161,7399,163511,164814,285,3.808,455,6.080,13903,3858,10045,2.341,8.436,16425,5203,11222,3.157,9.966,-2522,-1.530,16.871,348,353,2930
2008,3336,796,971,108667,107287,62,6.425,50,5.181,9744,1431,8313,1.334,9.082,7102,1815,5287,1.692,6.620,2642,2.463,13.239,34,34,171
2008,3339,5374,5988,294595,293796,283,4.695,363,6.022,27385,4728,22657,1.609,9.321,25658,7898,17760,2.688,8.733,1727,0.588,17.467,250,251,2915
2008,3341,1082,1121,88593,91519,101,8.922,123,10.866,7035,2449,4586,2.676,7.687,12774,3572,9202,3.903,13.958,-5739,-6.271,15.374,87,87,1018
2008,3342,1369,1532,128622,128111,95,6.084,154,9.862,16258,2147,14111,1.676,12.691,14611,5750,8861,4.488,11.405,1647,1.286,22.810,106,107,1855
2008,3343,440,456,14043,15176,52,11.454,48,10.573,1333,157,1176,1.035,8.784,3475,572,2903,3.769,22.898,-2142,-14.114,17.567,41,41,408
2008,3344,3917,4401,343197,352446,247,5.572,311,7.016,25748,5889,19859,1.671,7.306,44294,14842,29452,4.211,12.568,-18546,-5.262,14.611,219,219,3622
2008,3345,4240,4903,396733,392559,321,6.518,364,7.392,43151,11788,31363,3.003,10.992,34907,13248,21659,3.375,8.892,8244,2.100,17.784,206,206,2329
2008,3346,660,683,24486,25762,71,10.245,91,13.131,2134,427,1707,1.658,8.284,4727,1993,2734,7.736,18.349,-2593,-10.065,16.567,62,63,604
2008,3351,1013,1107,54741,55800,71,6.345,95,8.490,3396,865,2531,1.550,6.086,5532,1532,4000,2.746,9.914,-2136,-3.828,12.172,78,78,802
2008,3352,268,317,59035,62799,26,8.087,35,10.886,2061,428,1633,0.682,3.282,9789,2719,7070,4.330,15.588,-7728,-12.306,6.564,23,23,278
2008,3353,1922,2231,136239,136501,110,4.905,133,5.931,15958,5427,10531,3.976,11.691,16415,7563,8852,5.541,12.026,-457,-0.335,23.382,89,89,1178
2008,3359,1814,2127,154145,153189,127,5.968,129,6.062,13598,1906,11692,1.244,8.877,12077,4283,7794,2.796,7.884,1521,0.993,15.767,81,82,1043
2008,3361,285,351,177380,185393,48,14.035,30,8.772,8992,952,8040,0.514,4.850,24677,274,24403,0.148,13.311,-15685,-8.460,9.701,22,22,180
2008,3362,1768,2038,134362,142998,112,5.407,179,8.641,10686,3005,7681,2.101,7.473,27679,5177,22502,3.620,19.356,-16993,-11.883,14.946,134,134,2003
2008,3363,4249,5215,549688,574711,293,5.523,474,8.934,38218,12302,25916,2.141,6.650,87489,27083,60406,4.712,15.223,-49271,-8.573,13.300,280,287,6794
2008,3364,1220,1599,412860,410363,99,6.209,90,5.644,28476,2760,25716,0.673,6.939,23689,3989,19700,0.972,5.773,4787,1.167,11.545,66,66,1886
2008,3365,157,220,30433,30037,13,5.950,10,4.577,2827,142,2685,0.473,9.412,2058,135,1923,0.449,6.852,769,2.560,13.703,8,8,87
2008,3366,1472,1601,156933,154556,134,8.287,166,10.266,18288,1570,16718,1.016,11.833,13434,3602,9832,2.331,8.692,4854,3.141,17.384,117,117,1433
2008,3369,837,863,44140,43895,110,12.687,118,13.610,6244,963,5281,2.194,14.225,5935,2452,3483,5.586,13.521,309,0.704,27.042,98,98,767
2008,3371,13531,13839,297062,311859,1002,7.070,1670,11.783,24153,7246,16907,2.323,7.745,53568,18202,35366,5.837,17.177,-29415,-9.432,15.490,1329,1337,8712
2008,3372,3881,4079,138941,139532,232,5.637,305,7.411,15083,3244,11839,2.325,10.810,16437,5086,11351,3.645,11.780,-1354,-0.970,21.619,231,232,3036
2008,3379,835,965,41152,42354,49,5.005,77,7.865,3534,298,3236,0.704,8.344,5937,1582,4355,3.735,14.018,-2403,-5.674,16.688,65,65,988
2008,3391,10430,11253,308189,306895,686,6.061,817,7.218,28281,5530,22751,1.802,9.215,25496,7006,18490,2.283,8.308,2785,0.907,16.615,628,630,3834
2008,3399,16233,16690,334194,340691,1344,7.917,1916,11.287,34680,9352,25328,2.745,10.179,47899,15340,32559,4.503,14.059,-13219,-3.880,20.359,1558,1561,8804
2008,4231,17472,24750,390726,390444,1785,7.168,2093,8.404,46356,14339,32017,3.672,11.873,45862,13599,32263,3.483,11.746,494,0.127,23.492,1342,1377,6672
2008,4232,10935,12719,166821,168639,1128,8.798,1333,10.397,22946,8080,14866,4.791,13.607,26809,8234,18575,4.883,15.897,-3863,-2.291,27.213,928,948,4621
2008,4233,11273,18272,252918,264355,1557,8.519,1566,8.568,29782,11300,18482,4.275,11.266,52788,17141,35647,6.484,19.969,-23006,-8.703,22.532,892,937,6515
2008,4234,23035,32472,710525,728364,3480,10.680,3702,11.362,104323,30555,73768,4.195,14.323,141951,42852,99099,5.883,19.489,-37628,-5.166,28.646,1895,1959,11870
2008,4235,7722,10572,168293,168306,632,5.944,754,7.091,20024,4154,15870,2.468,11.897,20231,6237,13994,3.706,12.020,-207,-0.123,23.795,417,447,3334
2008,4236,18983,28447,514745,507934,2387,8.366,2559,8.969,82076,24976,57100,4.917,16.159,69894,22569,47325,4.443,13.760,12182,2.398,27.521,1445,1489,9741
2008,4237,10671,19189,240699,241819,1050,5.406,1519,7.820,29917,6815,23102,2.818,12.372,32537,12610,19927,5.215,13.455,-2620,-1.083,24.743,635,694,3663
2008,4238,40409,56703,733972,724955,4054,7.158,3927,6.933,101987,34956,67031,4.822,14.068,83243,28773,54470,3.969,11.483,18744,2.586,22.965,2377,2488,14391
2008,4239,27439,30342,342578,341228,3150,10.382,3146,10.369,54442,16926,37516,4.960,15.955,51797,18733,33064,5.490,15.180,2645,0.775,30.359,2375,2450,13067
2008,4241,8336,10898,170855,171599,666,6.044,909,8.249,17117,4146,12971,2.416,9.975,18620,5887,12733,3.431,10.851,-1503,-0.876,19.950,621,643,3994
2008,4242,5535,8053,267373,263548,1020,12.882,750,9.472,46493,19551,26942,7.418,17.641,39411,15407,24004,5.846,14.954,7082,2.687,29.908,471,474,3233
2008,4243,13638,14904,207257,210929,1607,10.740,1725,11.528,30116,8106,22010,3.843,14.278,37414,11792,25622,5.591,17.738,-7298,-3.460,28.556,1320,1340,5932
2008,4244,24526,30738,788339,782598,2627,8.519,2824,9.158,93401,22051,71350,2.818,11.935,82190,26786,55404,3.423,10.502,11211,1.433,21.004,1972,1990,14580
2008,4245,3497,6037,60156,59895,347,5.719,409,6.740,8128,2106,6022,3.516,13.570,7608,2448,5160,4.087,12.702,520,0.868,25.404,216,237,1434
2008,4246,8148,12159,148782,149630,813,6.599,1135,9.213,19477,4729,14748,3.160,13.017,21133,8479,12654,5.667,14.124,-1656,-1.107,26.034,552,567,2764
2008,4247,4894,7045,104707,104427,363,5.063,612,8.536,14504,4056,10448,3.884,13.889,14009,4457,9552,4.268,13.415,495,0.474,26.830,289,299,1778
2008,4248,3061,3902,177719,177449,356,9.181,307,7.917,16698,2533,14165,1.427,9.410,16218,6509,9709,3.668,9.140,480,0.271,18.279,196,203,2880
2008,4249,21163,27119,358654,362397,2373,8.633,3112,11.321,49110,13465,35645,3.716,13.551,56416,18824,37592,5.194,15.567,-7306,-2.016,27.103,2071,2241,9150
2008,4251,41928,44070,302664,300201,5164,11.738,5015,11.399,47602,17873,29729,5.954,15.857,42259,18383,23876,6.124,14.077,5343,1.780,28.154,3722,3734,12913
2008,4411,41524,46390,1243907,1253155,3852,8.226,4724,10.088,133513,50273,83240,4.012,10.654,151708,52879,98829,4.220,12.106,-18195,-1.452,21.308,3764,3800,40808
2008,4412,13733,15541,164408,167571,1325,8.488,1464,9.378,20131,7349,12782,4.386,12.013,26436,7296,19140,4.354,15.776,-6305,-3.763,24.027,1118,1150,5282
2008,4413,29091,55257,475676,479398,2847,5.125,3438,6.189,51889,14200,37689,2.962,10.824,58603,15099,43504,3.150,12.224,-6714,-1.401,21.648,2283,2371,8608
2008,4421,17200,26075,251642,259925,2359,8.863,3441,12.928,35410,14492,20918,5.575,13.623,51359,20817,30542,8.009,19.759,-15949,-6.136,27.246,2254,2639,15138
2008,4422,23620,32457,279992,298624,2248,6.765,3791,11.409,35218,10068,25150,3.371,11.793,70693,19771,50922,6.621,23.673,-35475,-11.880,23.587,2399,2639,10647
2008,4431,27035,49532,489486,493862,4528,9.074,5264,10.549,68518,23419,45099,4.742,13.874,78052,26743,51309,5.415,15.804,-9534,-1.930,27.748,3486,3635,14057
2008,4441,43249,66574,1168006,1181947,3672,5.480,4534,6.767,109065,33510,75555,2.835,9.228,137362,26602,110760,2.251,11.622,-28297,-2.394,18.455,2945,3102,14124
2008,4442,14745,18130,161678,163027,1126,6.157,1443,7.890,22257,5891,16366,3.614,13.652,24686,6591,18095,4.043,15.142,-2429,-1.490,27.305,1004,1041,4775
2008,4451,55739,81606,2564389,2552972,8092,9.908,8216,10.060,248813,78638,170175,3.080,9.746,225604,73770,151834,2.890,8.837,23209,0.909,17.674,5896,6006,33362
2008,4452,17514,21413,148694,144123,3373,15.990,2736,12.970,36456,15320,21136,10.630,25.295,27592,11768,15824,8.165,19.145,8864,6.150,38.290,2082,2096,8952
2008,4453,24812,28328,144354,142393,2674,9.490,2370,8.411,25468,8181,17287,5.745,17.886,21427,7830,13597,5.499,15.048,4041,2.838,30.096,1792,1815,6100
2008,4461,39592,84809,1020600,1023490,6711,7.961,5693,6.753,138217,56922,81295,5.562,13.504,145864,40638,105226,3.971,14.252,-7647,-0.747,27.009,3144,3299,15867
2008,4471,61253,108221,891804,895209,7976,7.290,10353,9.463,144383,47832,96551,5.343,16.128,150980,55214,95766,6.168,16.865,-6597,-0.737,32.257,6111,6578,31716
2008,4481,35214,93334,1285751,1278144,9619,10.390,8118,8.768,231022,75413,155609,5.900,18.075,216889,49008,167881,3.834,16.969,14133,1.106,33.938,4374,4601,16885
2008,4482,6137,27137,207995,206705,1685,6.213,1654,6.098,35154,9639,25515,4.663,17.007,32746,8010,24736,3.875,15.842,2408,1.165,31.684,587,593,1733
2008,4483,16958,26125,152142,156334,1704,6.435,2418,9.131,21504,6810,14694,4.356,13.755,30277,9959,20318,6.370,19.367,-8773,-5.612,27.510,1451,1528,4623
2008,4511,26818,37277,428289,433129,3796,10.097,4433,11.791,72827,34569,38258,7.981,16.814,82707,25573,57134,5.904,19.095,-9880,-2.281,33.628,2939,3149,12764
2008,4512,5119,10470,145148,145756,778,7.331,1064,10.025,18705,6568,12137,4.506,12.833,19457,4744,14713,3.255,13.349,-752,-0.516,25.666,657,763,2762
2008,4521,99,8649,1287923,1290116,221,2.574,97,1.130,72610,18515,54095,1.435,5.628,77596,12094,65502,0.937,6.015,-4986,-0.386,11.256,3,4,16
2008,4529,7396,35407,1684496,1636750,1827,5.130,2244,6.301,171490,75199,96291,4.594,10.477,79446,12857,66589,0.786,4.854,92044,5.624,9.708,1325,1380,5349
2008,4531,16464,17166,89006,90957,1361,7.734,2226,12.649,15046,5788,9258,6.363,16.542,18960,6995,11965,7.690,20.845,-3914,-4.303,33.084,1801,1811,5468
2008,4532,24255,35440,303700,305170,3348,9.305,4429,12.309,43914,14923,28991,4.890,14.390,46727,17411,29316,5.705,15.312,-2813,-0.922,28.780,3238,3336,11576
2008,4533,11625,16235,135601,134162,1510,9.233,1748,10.689,23686,8435,15251,6.287,17.655,20748,7278,13470,5.425,15.465,2938,2.190,30.930,1291,1306,4308
2008,4539,29939,38102,248549,252705,4007,10.427,4664,12.136,39051,16818,22233,6.655,15.453,47343,15926,31417,6.302,18.734,-8292,-3.281,30.906,3434,3532,11223
2008,4541,18211,19214,325552,328002,2892,15.203,2508,13.185,55640,15860,39780,4.835,16.963,61647,25137,36510,7.664,18.795,-6007,-1.831,33.927,1875,1885,8106
2008,4542,3967,4447,47221,47893,410,9.042,585,12.901,5645,1965,3680,4.103,11.787,7049,3361,3688,7.018,14.718,-1404,-2.932,23.574,421,427,1401
2008,4543,22706,28739,213624,216239,2462,8.485,3015,10.391,29954,8805,21149,4.072,13.852,35222,12401,22821,5.735,16.288,-5268,-2.436,27.705,1995,2015,7678
2008,4811,487,2934,447129,443936,189,6.342,281,9.430,29227,2270,26957,0.511,6.584,22890,4756,18134,1.071,5.156,6337,1.427,10.312,73,97,3194
2008,4812,2021,2217,41466,41327,265,11.846,305,13.634,5658,1711,3947,4.140,13.691,5267,1648,3619,3.988,12.745,391,0.946,25.489,210,213,739
2008,4831,716,1017,48251,49915,93,9.122,98,9.613,4797,1010,3787,2.023,9.610,8116,1772,6344,3.550,16.260,-3319,-6.649,19.221,53,53,706
2008,4832,481,530,19361,18932,69,12.921,77,14.419,2430,748,1682,3.951,12.836,1605,800,805,4.226,8.478,825,4.358,16.956,49,49,591
2008,4841,47713,56634,940837,952463,8717,15.293,9452,16.582,121160,34926,86234,3.667,12.721,143546,45565,97981,4.784,15.071,-22386,-2.350,25.441,7264,7281,30369
2008,4842,39755,43926,472164,479545,5133,11.427,7121,15.853,71062,22993,48069,4.795,14.819,85999,30334,55665,6.326,17.933,-14937,-3.115,29.637,5101,5116,19891
2008,4851,606,894,52501,53013,71,7.655,138,14.879,5756,1809,3947,3.412,10.858,7103,4567,2536,8.615,13.399,-1347,-2.541,21.716,56,56,371
2008,4852,201,468,15509,16646,37,7.497,88,17.832,2084,146,1938,0.877,12.520,4453,1732,2721,10.405,26.751,-2369,-14.232,25.039,14,14,58
2008,4853,6159,6258,70151,70767,1059,17.192,863,14.010,11068,4316,6752,6.099,15.640,12271,4045,8226,5.716,17.340,-1203,-1.700,31.280,698,698,3124
2008,4854,2816,4300,217805,210766,349,8.057,412,9.512,34965,8828,26137,4.189,16.589,20794,10734,10060,5.093,9.866,14171,6.724,19.732,191,194,2759
2008,4855,1122,1237,30297,30586,121,9.798,117,9.474,3592,856,2736,2.799,11.744,4131,1196,2935,3.910,13.506,-539,-1.762,23.488,91,92,805
2008,4859,2776,3019,61743,59258,504,16.981,402,13.544,12865,4486,8379,7.570,21.710,7925,4163,3762,7.025,13.374,4940,8.336,26.748,296,296,2093
2008,4861,53,376,6278,6326,32,8.333,48,12.500,968,617,351,9.754,15.303,1085,286,799,4.521,17.153,-117,-1.850,30.606,(D),(D),(D)
2008,4862,120,1771,28350,27009,338,20.042,169,10.021,6707,3006,3701,11.130,24.833,3805,1812,1993,6.709,14.088,2902,10.745,28.176,8,8,186
2008,4869,62,720,8020,7235,151,22.255,68,10.022,2352,1524,828,21.064,32.509,716,339,377,4.686,9.896,1636,22.612,19.793,(D),(D),(D)
2008,4871,476,524,9609,9268,76,14.772,57,11.079,1830,732,1098,7.898,19.745,1218,317,901,3.420,13.142,612,6.603,26.284,40,40,168
2008,4872,1171,1213,11277,11082,185,15.183,196,16.085,2129,504,1625,4.548,19.211,1728,445,1283,4.016,15.593,401,3.618,31.186,124,124,275
2008,4879,140,147,1720,1832,24,16.901,14,9.859,257,45,212,2.457,14.032,469,23,446,1.256,25.607,-212,-11.575,28.064,10,10,17
2008,4881,3696,5269,176901,175199,613,11.766,495,9.501,25353,7454,17899,4.255,14.471,21635,5333,16302,3.044,12.349,3718,2.122,24.698,315,315,2187
2008,4882,439,923,25619,26055,114,12.507,91,9.984,2939,1217,1722,4.671,11.280,3682,2316,1366,8.889,14.132,-743,-2.852,22.560,36,38,435
2008,4883,1659,2223,93512,93833,208,9.376,199,8.970,11681,2483,9198,2.646,12.449,12043,2347,9696,2.501,12.835,-362,-0.386,24.898,127,128,1338
2008,4884,8438,9060,77182,75797,1309,14.668,1037,11.620,15534,7209,8325,9.511,20.494,12668,4545,8123,5.996,16.713,2866,3.781,33.426,747,748,2659
2008,4885,13949,20317,248266,249527,1889,9.264,2038,9.994,37687,10448,27239,4.187,15.103,40190,15306,24884,6.134,16.106,-2503,-1.003,30.207,1051,1065,5591
2008,4889,1232,1343,27801,27313,223,16.868,181,13.691,4254,1123,3131,4.112,15.575,3172,1344,1828,4.921,11.614,1082,3.962,23.227,138,140,789
2008,4921,3169,8746,552631,538651,1420,16.786,847,10.012,59895,15921,43974,2.956,11.119,30006,10907,19099,2.025,5.571,29889,5.549,11.141,353,364,2832
2008,4922,3696,3966,36314,36255,758,19.574,571,14.745,7534,3387,4147,9.342,20.781,7395,2414,4981,6.658,20.397,139,0.383,40.795,480,489,2195
2008,4931,6853,13962,704575,716696,1259,9.012,1274,9.120,95422,28876,66546,4.029,13.314,120298,34590,85708,4.826,16.785,-24876,-3.471,26.628,376,404,4437
2008,5111,14494,20609,657596,664699,1878,9.043,2196,10.574,70195,25490,44705,3.835,10.560,85239,22891,62348,3.444,12.824,-15044,-2.263,21.121,1259,1277,8268
2008,5112,5116,7374,366122,361493,840,11.325,926,12.485,55449,16708,38741,4.622,15.339,46271,24708,21563,6.835,12.800,9178,2.539,25.600,412,442,6788
2008,5121,12789,16142,321327,319117,2409,15.019,2205,13.747,57004,19373,37631,6.071,17.863,53488,26602,26886,8.336,16.761,3516,1.102,33.523,1350,1359,16615
2008,5122,2890,3145,25444,25738,474,15.081,470,14.954,3333,1256,2077,4.880,12.950,3867,1629,2238,6.329,15.024,-534,-2.075,25.899,346,346,1070
2008,5151,4221,8840,243116,244445,981,10.944,1228,13.700,28888,13679,15209,5.596,11.818,31358,12532,18826,5.127,12.828,-2470,-1.010,23.636,273,284,1907
2008,5152,402,624,41650,42366,56,8.589,112,17.178,5238,1925,3313,4.544,12.364,6564,2784,3780,6.571,15.494,-1326,-3.130,24.728,36,36,432
2008,5171,2996,31938,841383,848877,3787,11.720,4536,14.038,142400,56141,86259,6.614,16.775,162167,39817,122350,4.691,19.104,-19767,-2.329,33.550,262,269,2787
2008,5172,1424,12476,275350,272357,2223,18.389,1449,11.986,45520,24448,21072,8.976,16.713,39351,10459,28892,3.840,14.448,6169,2.265,28.897,258,265,2186
2008,5174,488,603,10124,10164,140,23.007,151,24.815,2638,1584,1054,15.585,25.956,2841,862,1979,8.481,27.953,-203,-1.997,51.911,102,104,358
2008,5179,4548,4987,59430,61509,957,19.273,914,18.407,12432,5323,7109,8.654,20.212,16569,7080,9489,11.511,26.938,-4137,-6.726,40.423,682,683,3902
2008,5182,8099,14548,405269,407406,1283,8.820,1279,8.793,75439,19091,56348,4.686,18.517,78612,26560,52052,6.519,19.296,-3173,-0.779,37.034,702,712,7812
2008,5191,5503,6890,138681,131201,955,14.035,784,11.522,28611,11650,16961,8.880,21.807,13159,5526,7633,4.212,10.030,15452,11.777,20.059,520,522,2199
2008,5211,13,48,19006,19261,0,0.000,0,0.000,319,0,319,0.000,1.656,839,0,839,0.000,4.356,-520,-2.700,3.312,0,0,0
2008,5221,14823,127991,2143253,2148936,9650,7.654,5808,4.607,261761,80919,180842,3.766,12.181,272757,69477,203280,3.233,12.693,-10996,-0.512,24.362,490,603,6437
2008,5222,17034,47446,631964,698728,5220,10.504,9715,19.550,109975,43164,66811,6.178,15.739,244305,113685,130620,16.270,34.964,-134330,-19.225,31.479,3214,4104,37342
2008,5223,21277,40023,283835,309916,4257,9.958,9707,22.707,50150,18017,32133,5.814,16.182,101025,47381,53644,15.288,32.598,-50875,-16.416,32.364,6885,7171,35039
2008,5231,12227,40528,528688,516823,5762,14.557,3869,9.775,86290,44497,41793,8.610,16.696,62016,24452,37564,4.731,11.999,24274,4.697,23.999,1097,1119,4860
2008,5232,37,65,5405,6653,17,28.333,7,11.667,760,154,606,2.315,11.424,3290,1323,1967,19.887,49.455,-2530,-38.031,22.849,3,3,90
2008,5239,37139,42071,411404,406821,6358,15.322,5209,12.553,76154,27984,48170,6.879,18.719,67482,30262,37220,7.439,16.588,8672,2.132,33.175,3628,3644,14488
2008,5241,5955,32978,1490689,1469354,5630,17.154,5314,16.191,236263,113978,122285,7.757,16.079,191400,68419,122981,4.656,13.026,44863,3.053,26.052,637,674,4780
2008,5242,121018,135922,900145,909484,11673,8.556,12691,9.302,142143,54474,87669,5.990,15.629,160946,70040,90906,7.701,17.696,-18803,-2.067,31.258,8059,8166,25715
2008,5250,1865,4293,47618,45114,657,14.983,841,19.179,12100,6301,5799,13.967,26.821,6895,3369,3526,7.468,15.284,5205,11.538,30.567,115,118,964
2008,5311,83267,102438,508177,511312,11542,11.255,11767,11.474,95236,45520,49716,8.903,18.626,101235,46819,54416,9.157,19.799,-5999,-1.173,37.252,7963,8079,29329
2008,5312,69729,80294,334948,347644,11346,13.460,19349,22.954,69355,27983,41372,8.049,19.950,95126,44617,50509,12.834,27.363,-25771,-7.413,39.900,13485,13567,29491
2008,5313,61575,72422,638028,635240,9746,13.402,10344,14.224,112459,43743,68716,6.886,17.703,106772,41019,65753,6.457,16.808,5687,0.895,33.616,7057,7099,25913
2008,5321,4074,13041,185580,185040,2114,16.687,1369,10.806,29723,16385,13338,8.855,16.063,28603,11008,17595,5.949,15.458,1120,0.605,30.915,525,553,1926
2008,5322,10144,30784,242805,247811,2334,7.394,3901,12.358,37562,9220,28342,3.721,15.158,47531,21504,26027,8.678,19.180,-9969,-4.023,30.315,1439,1503,6738
2008,5323,2800,3524,23147,23799,192,5.330,349,9.688,2979,748,2231,3.143,12.517,4226,1499,2727,6.299,17.757,-1247,-5.240,25.035,226,257,1113
2008,5324,7415,13156,169060,167416,1181,9.010,1084,8.270,28236,8524,19712,5.092,16.866,25337,9024,16313,5.390,15.134,2899,1.732,30.268,661,666,3614
2008,5331,1953,2054,31491,31135,273,13.346,256,12.515,6208,1679,4529,5.393,19.939,5568,1515,4053,4.866,17.884,640,2.056,35.767,189,192,1274
2008,5411,162529,171788,1184276,1188495,13239,7.665,15107,8.746,134310,41192,93118,3.466,11.301,143068,43653,99415,3.673,12.038,-8758,-0.737,22.602,10882,10981,30788
2008,5412,95750,110576,1288129,1276973,10016,9.078,9540,8.646,193788,54020,139768,4.230,15.176,172206,63107,109099,4.942,13.485,21582,1.690,26.971,6401,6442,44400
2008,5413,88216,103145,1456787,1440424,10357,10.047,10236,9.930,224728,63164,161564,4.385,15.602,191478,59237,132241,4.112,13.293,33250,2.308,26.586,6815,6883,26434
2008,5414,28047,28317,132962,130699,4183,14.829,3964,14.053,26958,10152,16806,7.767,20.626,22563,9627,12936,7.366,17.263,4395,3.363,34.527,3054,3056,7494
2008,5415,86971,99346,1330459,1323746,17774,17.910,17558,17.693,309960,127800,182160,9.654,23.415,293405,146431,146974,11.062,22.165,16555,1.251,44.330,9983,10065,38808
2008,5416,102612,108818,837181,819897,20401,18.974,17805,16.560,189037,74654,114383,9.105,23.056,154030,60032,93998,7.322,18.787,35007,4.270,37.573,12998,13050,39333
2008,5417,11829,14542,579849,583869,2013,14.010,1666,11.595,79626,22891,56735,3.921,13.638,86013,22825,63188,3.909,14.732,-6387,-1.094,27.275,996,1020,8973
2008,5418,32281,35922,469347,462402,4235,11.831,3984,11.130,80473,23653,56820,5.115,17.403,66180,21731,44449,4.700,14.312,14293,3.091,28.624,2952,2962,13099
2008,5419,54296,63583,621197,614130,6252,9.811,6530,10.248,99801,27864,71937,4.537,16.251,85004,29464,55540,4.798,13.841,14797,2.409,27.683,4192,4267,16012
2008,5511,26358,49885,2894220,2947688,4455,8.904,4751,9.496,463294,132405,330889,4.492,15.717,572397,141844,430553,4.812,19.419,-109103,-3.701,31.434,981,1026,16283
2008,5611,23217,25407,409143,404339,3838,15.279,3262,12.986,79040,30133,48907,7.452,19.548,69257,29288,39969,7.243,17.128,9783,2.420,34.257,2507,2515,20720
2008,5612,1748,5759,270404,279034,786,13.679,760,13.227,34905,13418,21487,4.809,12.509,51248,19732,31516,7.072,18.366,-16343,-5.857,25.019,113,135,1660
2008,5613,27087,48547,4712634,4776025,7826,16.314,6674,13.913,990281,287981,702300,6.030,20.734,1131513,334375,797138,7.001,23.692,-141232,-2.957,41.469,3167,3281,150669
2008,5614,26140,32826,818907,801089,3819,11.592,4060,12.323,176592,74474,102118,9.297,22.044,140312,45175,95137,5.639,17.515,36280,4.529,35.030,2712,2804,21226
2008,5615,15039,20175,255183,256495,1858,9.107,2313,11.337,34191,8488,25703,3.309,13.330,36986,12206,24780,4.759,14.420,-2795,-1.090,26.660,1306,1360,5619
2008,5616,17576,23230,820897,797140,2782,12.079,2386,10.359,174052,56491,117561,7.087,21.835,125881,46162,79719,5.791,15.792,48171,6.043,31.583,1621,1679,20321
2008,5617,136703,143331,1681033,1677004,21263,14.853,20917,14.611,296940,113790,183150,6.785,17.707,291636,93112,198524,5.552,17.390,5304,0.316,34.781,14753,14768,59139
2008,5619,16403,18332,300347,292157,2106,11.580,1816,9.985,61127,15020,46107,5.141,20.923,44443,18157,26286,6.215,15.212,16684,5.711,30.424,1333,1343,12456
2008,5621,7359,9440,195305,194279,885,9.404,827,8.788,24013,6951,17062,3.578,12.360,22028,8055,13973,4.146,11.338,1985,1.022,22.677,573,582,3995
2008,5622,1343,2459,49026,50132,174,7.037,201,8.129,5669,1656,4013,3.303,11.308,7869,3350,4519,6.682,15.697,-2200,-4.388,22.617,104,106,678
2008,5629,7399,8348,122148,121955,893,10.797,738,8.923,21255,6646,14609,5.450,17.429,20965,5182,15783,4.249,17.191,290,0.238,34.382,505,506,3093
2008,6111,17832,20134,840456,825030,962,4.893,17,0.086,68614,13951,54663,1.691,8.317,37850,118,37732,0.014,4.588,30764,3.729,9.175,8,8,39
2008,6112,441,834,82462,80029,40,4.908,(D),(D),8280,630,7650,0.787,10.346,3467,(D),3462,(D),4.332,4813,6.014,8.664,(D),(D),(D)
2008,6113,2337,4033,1613149,1590008,301,7.744,9,0.232,93276,5525,87751,0.347,5.866,46959,15,46944,0.001,2.953,46317,2.913,5.907,4,4,9
2008,6114,6382,6967,71355,71448,802,11.374,970,13.757,11428,3246,8182,4.543,15.995,11640,4667,6973,6.532,16.292,-212,-0.297,31.990,677,730,3730
2008,6115,6112,7553,120863,118581,749,9.917,748,9.904,20279,4868,15411,4.105,17.101,15854,5455,10399,4.600,13.370,4425,3.732,26.740,528,535,3378
2008,6116,31587,33951,314408,308674,4803,14.390,3658,10.959,64754,22468,42286,7.279,20.978,53400,16513,36887,5.350,17.300,11354,3.678,34.600,2717,2735,12345
2008,6117,5081,5856,81194,78221,890,15.550,625,10.920,17829,6556,11273,8.381,22.793,11658,5021,6637,6.419,14.904,6171,7.889,29.808,460,460,3007
2008,6211,175708,203489,2147022,2120849,15249,7.504,14697,7.232,303597,92342,211255,4.354,14.315,251211,81174,170037,3.827,11.845,52386,2.470,23.690,10244,10448,48384
2008,6212,115410,121651,832486,829575,6509,5.364,5887,4.852,100232,31453,68779,3.791,12.082,94468,25273,69195,3.046,11.388,5764,0.695,22.775,4556,4610,19649
2008,6213,103092,114642,640989,631041,11373,10.026,8959,7.898,118093,40916,77177,6.484,18.714,98549,31592,66957,5.006,15.617,19544,3.097,31.234,5358,5437,16864
2008,6214,14015,29733,684313,669391,2896,9.933,1742,5.975,107318,35419,71899,5.291,16.032,77519,24300,53219,3.630,11.581,29799,4.452,23.161,757,790,8359
2008,6215,7211,12618,241935,239377,1391,11.198,999,8.042,33664,10060,23604,4.203,14.063,28918,8637,20281,3.608,12.081,4746,1.983,24.161,595,628,4607
2008,6216,15097,22098,1037076,1007656,3368,15.759,1917,8.969,180191,46865,133326,4.651,17.882,121350,38327,83023,3.804,12.043,58841,5.839,24.086,1129,1152,17045
2008,6219,5727,9040,279994,280678,882,9.753,889,9.830,39900,10542,29358,3.756,14.216,41704,13690,28014,4.877,14.858,-1804,-0.643,28.431,394,416,4632
2008,6221,3020,5226,5121890,5080650,198,3.835,71,1.375,260793,29870,230923,0.588,5.133,183258,44349,138909,0.873,3.607,77535,1.526,7.214,20,20,10790
2008,6222,445,598,208509,208781,43,7.338,19,3.242,12479,2815,9664,1.348,5.977,12927,9075,3852,4.347,6.192,-448,-0.215,11.954,5,5,4115
2008,6223,407,853,234383,231539,81,9.695,46,5.506,19799,4322,15477,1.867,8.551,14171,5983,8188,2.584,6.120,5628,2.431,12.241,10,10,823
2008,6231,7826,15517,1571895,1572544,1146,7.430,961,6.230,137961,53594,84367,3.408,8.773,139381,61142,78239,3.888,8.863,-1420,-0.090,17.546,490,554,36244
2008,6232,8633,32668,607424,597104,2487,7.669,2008,6.192,93403,22872,70531,3.830,15.643,72495,19647,52848,3.290,12.141,20908,3.502,24.282,368,394,4122
2008,6233,13932,19826,776650,760715,1992,10.087,1837,9.302,109298,32107,77191,4.221,14.368,78291,41249,37042,5.422,10.292,31007,4.076,20.584,1199,1230,21000
2008,6239,3401,5803,152134,151325,386,6.604,470,8.041,19782,4425,15357,2.924,13.073,18058,5803,12255,3.835,11.933,1724,1.139,23.867,210,220,2522
2008,6241,39256,54973,1209209,1182416,5259,9.681,3958,7.286,182987,42198,140789,3.569,15.476,129493,33609,95884,2.842,10.952,53494,4.524,21.903,2262,2302,15190
2008,6242,10048,13593,168887,167281,656,4.823,674,4.955,22727,4353,18374,2.602,13.586,19356,4051,15305,2.422,11.571,3371,2.015,23.142,307,327,1750
2008,6243,4233,7259,323910,320975,492,6.742,570,7.810,50078,9016,41062,2.809,15.602,44426,11991,32435,3.736,13.841,5652,1.761,27.682,197,228,2395
2008,6244,54611,69235,881619,871749,7679,11.148,6976,10.127,143261,57553,85708,6.602,16.434,123367,46654,76713,5.352,14.152,19894,2.282,28.303,4600,4681,27713
2008,7111,7377,7513,133834,131998,870,11.581,868,11.555,23246,5612,17634,4.252,17.611,19622,5082,14540,3.850,14.865,3624,2.746,29.731,592,592,3087
2008,7112,3424,3604,126383,124473,512,14.153,539,14.900,20121,4329,15792,3.478,16.165,16287,4945,11342,3.973,13.085,3834,3.080,26.170,422,423,3550
2008,7113,5254,5568,125802,122340,683,12.329,627,11.318,23329,4683,18646,3.828,19.069,16537,3587,12950,2.932,13.517,6792,5.552,27.035,440,440,2079
2008,7114,2759,2840,19016,18909,424,14.940,420,14.799,3420,1497,1923,7.917,18.087,3207,1132,2075,5.987,16.961,213,1.126,33.921,297,298,891
2008,7115,13373,13405,42881,42788,2512,18.674,2606,19.373,12199,5465,6734,12.772,28.510,11982,5773,6209,13.492,28.003,217,0.507,56.006,1620,1620,3545
2008,7121,6274,6757,132922,130775,401,5.967,328,4.881,12741,1669,11072,1.276,9.743,8544,1085,7459,0.830,6.533,4197,3.209,13.067,186,186,582
2008,7131,2122,2577,140080,135245,405,15.728,401,15.573,19437,5955,13482,4.403,14.372,10065,3579,6486,2.646,7.442,9372,6.930,14.884,295,297,2918
2008,7132,1799,2423,177713,174049,282,11.809,212,8.878,19976,7665,12311,4.404,11.477,12536,2910,9626,1.672,7.203,7440,4.275,14.405,146,148,1942
2008,7139,50035,56304,1163171,1161837,6484,11.466,6973,12.331,163104,53928,109176,4.642,14.038,159120,60070,99050,5.170,13.696,3984,0.343,27.391,5319,5374,37766
2008,7211,38061,47906,1906764,1897616,5126,10.730,4863,10.179,243898,119590,124308,6.302,12.853,226625,96963,129662,5.110,11.943,17273,0.910,23.885,3145,3210,55726
2008,7212,5286,5802,38771,38921,520,8.908,591,10.124,6774,1954,4820,5.020,17.405,7046,2001,5045,5.141,18.104,-272,-0.699,34.809,363,365,1207
2008,7213,1990,2074,11083,11265,118,5.649,148,7.085,1421,434,987,3.853,12.614,1796,486,1310,4.314,15.943,-375,-3.329,25.229,106,106,289
2008,7223,12190,34720,657052,630717,6463,19.329,3896,11.652,170286,62101,108185,9.846,26.999,120474,33313,87161,5.282,19.101,49812,7.898,38.202,1592,1603,10006
2008,7224,40730,41367,359131,361333,4356,10.401,5383,12.853,72166,35099,37067,9.714,19.972,76555,30739,45816,8.507,21.187,-4389,-1.215,39.944,4298,4310,25309
2008,7225,321157,443993,8896544,8806673,53467,12.114,48189,10.918,1557352,725711,831641,8.240,17.684,1383232,508094,875138,5.769,15.707,174120,1.977,31.413,35997,36858,337786
2008,8111,137305,150028,864373,871989,12592,8.319,15259,10.081,133516,48105,85411,5.517,15.312,148861,53665,95196,6.154,17.071,-15345,-1.760,30.623,11236,11518,40165
2008,8112,10178,11482,122792,121416,1055,9.071,1351,11.617,20820,5336,15484,4.395,17.148,18096,6613,11483,5.447,14.904,2724,2.244,29.808,985,992,3345
2008,8113,19776,21295,202398,199753,1840,8.599,2046,9.562,32786,8314,24472,4.162,16.413,27722,9856,17866,4.934,13.878,5064,2.535,27.756,1481,1491,5673
2008,8114,18071,18979,81481,82632,2051,10.670,2537,13.198,12536,4520,8016,5.470,15.171,14758,7049,7709,8.531,17.860,-2222,-2.689,30.342,1829,1834,4073
2008,8121,85109,101238,632123,621344,13723,13.645,12384,12.314,139961,63343,76618,10.195,22.526,117303,49481,67822,7.964,18.879,22658,3.647,37.758,9050,9250,33441
2008,8122,14651,19861,134910,135760,832,4.145,1256,6.257,14939,3678,11261,2.709,11.004,16920,5099,11821,3.756,12.463,-1981,-1.459,22.008,516,604,2118
2008,8123,30317,36147,328669,337591,3640,9.995,4181,11.481,46556,18800,27756,5.569,13.791,63134,22757,40377,6.741,18.701,-16578,-4.911,27.581,2973,3109,13245
2008,8129,21572,32788,265932,252943,5714,17.861,4121,12.882,78143,27695,50448,10.949,30.894,52471,21464,31007,8.486,20.744,25672,10.149,41.488,2412,2443,10946
2008,8131,171038,171341,1693901,1676264,8474,5.067,247,0.148,165446,24424,141022,1.457,9.870,130558,1043,129515,0.062,7.789,34888,2.081,15.577,141,141,467
2008,8132,14038,15994,188278,184932,1267,8.000,955,6.030,18749,3805,14944,2.058,10.138,12053,3286,8767,1.777,6.518,6696,3.621,13.035,633,646,2094
2008,8133,12380,14681,141770,136499,1253,8.614,982,6.751,23642,4380,19262,3.209,17.320,13020,3621,9399,2.653,9.539,10622,7.782,19.077,565,568,1762
2008,8134,24728,26555,260601,259257,1109,4.132,1673,6.234,33961,5369,28592,2.071,13.099,31126,7608,23518,2.935,12.006,2835,1.094,24.012,1107,1124,5170
2008,8139,56030,58153,518895,511816,2866,4.970,1898,3.291,62828,10392,52436,2.030,12.276,48396,6569,41827,1.283,9.456,14432,2.820,18.912,1288,1291,4943
2009,2111,5792,7119,107448,105428,748,10.598,626,8.869,17899,6345,11554,6.018,16.977,13931,5280,8651,5.008,13.214,3968,3.764,26.428,364,369,2384
2009,2121,617,1029,82979,80737,146,14.571,92,9.182,14483,4878,9605,6.042,17.938,9900,2804,7096,3.473,12.262,4583,5.676,24.524,48,48,833
2009,2122,205,265,34524,34058,28,10.351,39,14.418,4071,354,3717,1.039,11.953,3037,564,2473,1.656,8.917,1034,3.036,17.834,26,26,375
2009,2123,2979,4982,81201,85490,305,5.992,521,10.236,9083,3517,5566,4.114,10.625,17575,3857,13718,4.512,20.558,-8492,-9.933,21.249,255,260,1975
2009,2131,9253,11352,295550,307286,1364,12.129,1151,10.235,43383,13282,30101,4.322,14.118,67148,15345,51803,4.994,21.852,-23765,-7.734,28.236,734,752,7843
2009,2211,1559,9885,514657,510602,794,8.181,435,4.482,51569,17260,34309,3.380,10.100,43924,12888,31036,2.524,8.602,7645,1.497,17.205,66,107,3216
2009,2212,420,2298,83510,83856,117,5.046,158,6.815,7445,2996,4449,3.573,8.878,8198,2553,5645,3.045,9.776,-753,-0.898,17.757,27,69,1430
2009,2213,3430,4620,43993,43437,377,8.250,276,6.040,6765,2760,4005,6.354,15.574,5682,1304,4378,3.002,13.081,1083,2.493,26.162,142,145,552
2009,2361,135723,137096,638709,723365,19758,13.422,39968,27.152,120687,53161,67526,7.349,16.684,290538,111736,178802,15.447,40.165,-169851,-23.481,33.368,27600,27613,77460
2009,2362,37558,38850,637107,685829,3008,7.520,5305,13.263,81810,17902,63908,2.610,11.929,179120,30219,148901,4.406,26.117,-97310,-14.189,23.857,3840,3846,21521
2009,2371,17287,18450,503858,526843,1314,6.952,2218,11.734,74571,22442,52129,4.260,14.154,119784,20290,99494,3.851,22.736,-45213,-8.582,28.309,1511,1520,11745
2009,2372,7691,7759,49554,56950,570,6.658,2174,25.394,5290,1822,3468,3.199,9.289,20043,7326,12717,12.864,35.194,-14753,-25.905,18.578,1811,1814,6181
2009,2373,9133,9926,280574,296966,546,5.376,1007,9.915,30196,5750,24446,1.936,10.168,62864,10157,52707,3.420,21.169,-32668,-11.001,20.336,640,642,6715
2009,2379,3704,3862,63394,65978,386,9.725,600,15.117,12052,2574,9478,3.901,18.267,17024,3092,13932,4.686,25.803,-4972,-7.536,36.533,395,396,2334
2009,2381,79845,80649,804267,910122,8013,9.273,19532,22.604,122963,35245,87718,3.873,13.511,334810,79837,254973,8.772,36.787,-211847,-23.277,27.021,12903,12905,56168
2009,2382,156818,160552,1769781,1885787,12843,7.803,20916,12.708,221464,60279,161185,3.196,11.744,453196,91784,361412,4.867,24.032,-231732,-12.288,23.488,14812,14835,61983
2009,2383,96514,97591,716101,798608,10799,10.407,23155,22.314,112834,34436,78398,4.312,14.129,278336,77713,200623,9.731,34.853,-165502,-20.724,28.258,15860,15861,55186
2009,2389,54975,55741,479564,529452,6174,10.501,12278,20.883,76276,29632,46644,5.597,14.407,175716,46387,129329,8.761,33.188,-99440,-18.782,28.813,8243,8246,33679
2009,3111,1077,1654,50376,50485,75,4.482,114,6.812,4539,737,3802,1.460,8.991,4808,815,3993,1.614,9.524,-269,-0.533,17.982,77,77,489
2009,3112,434,760,55735,55113,37,4.904,26,3.446,4361,1227,3134,2.226,7.913,3109,921,2188,1.671,5.641,1252,2.272,11.282,13,15,460
2009,3113,1426,1570,64840,66133,113,7.132,142,8.962,4718,697,4021,1.054,7.134,7491,1198,6293,1.812,11.327,-2773,-4.193,14.268,109,109,772
2009,3114,1169,1530,158467,159757,102,6.656,107,6.982,12830,3244,9586,2.031,8.031,15406,2823,12583,1.767,9.643,-2576,-1.612,16.062,63,63,747
2009,3115,973,1468,136458,135413,89,6.005,117,7.895,11455,1360,10095,1.004,8.459,9450,2909,6541,2.148,6.979,2005,1.481,13.957,73,73,749
2009,3116,2798,3419,498106,500626,167,4.846,221,6.413,28780,5225,23555,1.044,5.749,34190,7793,26397,1.557,6.829,-5410,-1.081,11.498,157,159,3687
2009,3117,486,578,30928,32017,40,6.855,51,8.740,2557,730,1827,2.280,7.986,4689,1283,3406,4.007,14.645,-2132,-6.659,15.973,39,39,849
2009,3118,8524,9236,271528,275349,824,8.874,923,9.940,23700,6958,16742,2.527,8.607,31077,9297,21780,3.376,11.286,-7377,-2.679,17.215,734,744,5230
2009,3119,2522,2957,161871,162601,226,7.578,277,9.288,16420,4161,12259,2.559,10.098,17855,3968,13887,2.440,10.981,-1435,-0.883,20.197,198,199,1643
2009,3121,3082,3649,126350,130321,407,11.380,262,7.326,11398,3692,7706,2.833,8.746,19400,3781,15619,2.901,14.886,-8002,-6.140,17.492,174,175,1216
2009,3122,67,95,17145,18081,4,4.167,6,6.250,388,66,322,0.365,2.146,2249,39,2210,0.216,12.438,-1861,-10.293,4.292,(D),(D),(D)
2009,3131,250,348,32081,35657,18,5.000,42,11.667,1087,382,705,1.071,3.049,8121,3147,4974,8.826,22.776,-7034,-19.727,6.097,25,25,459
2009,3132,933,1049,54884,60283,49,4.520,119,10.978,3948,1619,2329,2.686,6.549,14334,3497,10837,5.801,23.778,-10386,-17.229,13.098,82,83,1159
2009,3133,1057,1106,33899,37474,81,7.200,119,10.578,2788,1308,1480,3.490,7.440,9907,2185,7722,5.831,26.437,-7119,-18.997,14.880,90,90,1299
2009,3141,1925,2045,57408,63054,107,5.018,282,13.224,2845,1233,1612,1.955,4.512,14206,2804,11402,4.447,22.530,-11361,-18.018,9.024,211,211,1154
2009,3149,3979,4089,61088,66683,375,9.067,469,11.339,4736,1767,2969,2.650,7.102,16002,3341,12661,5.010,23.997,-11266,-16.895,14.205,335,339,2243
2009,3151,301,320,15916,18054,27,8.072,56,16.741,1237,521,716,2.886,6.852,5551,1691,3860,9.367,30.748,-4314,-23.896,13.704,45,45,761
2009,3152,5359,5439,103493,113992,693,12.101,1269,22.158,14983,6877,8106,6.033,13.144,36020,13891,22129,12.186,31.599,-21037,-18.455,26.288,1053,1055,10710
2009,3159,625,640,10808,11797,50,7.593,87,13.212,756,170,586,1.441,6.408,2722,632,2090,5.357,23.074,-1966,-16.665,12.817,65,65,351
2009,3161,194,198,3500,4004,12,5.911,22,10.837,375,224,151,5.595,9.367,1365,458,907,11.440,34.095,-990,-24.728,18.734,16,16,112
2009,3162,199,220,11834,12208,21,9.396,28,12.528,701,161,540,1.319,5.742,1434,245,1189,2.007,11.746,-733,-6.004,11.484,22,22,234
2009,3169,714,726,14071,14632,62,8.339,97,13.046,1696,724,972,4.948,11.591,2883,881,2002,6.021,19.704,-1187,-8.113,23.183,77,77,630
2009,3211,3047,3464,83725,92811,198,5.544,413,11.564,5553,2833,2720,3.052,5.983,23798,6168,17630,6.646,25.641,-18245,-19.658,11.966,282,286,2921
2009,3212,1330,1681,71587,82807,77,4.394,220,12.553,4679,1941,2738,2.344,5.650,27485,4811,22674,5.810,33.192,-22806,-27.541,11.301,126,130,2249
2009,3219,8441,9430,231719,263072,517,5.296,1181,12.098,14661,4558,10103,1.733,5.573,77030,15050,61980,5.721,29.281,-62369,-23.708,11.146,843,849,7438
2009,3221,237,458,115882,119155,14,2.985,36,7.676,4596,2119,2477,1.778,3.857,11159,5351,5808,4.491,9.365,-6563,-5.508,7.714,9,10,1619
2009,3222,2759,4116,263457,275773,121,2.888,269,6.420,13688,4000,9688,1.450,4.964,38258,8402,29856,3.047,13.873,-24570,-8.910,9.927,163,171,3014
2009,3231,27676,29086,546709,581699,1368,4.567,3101,10.353,34624,10830,23794,1.862,5.952,104794,29091,75703,5.001,18.015,-70170,-12.063,11.904,2480,2492,16836
2009,3241,994,2140,99649,101334,147,6.776,206,9.495,5714,1156,4558,1.141,5.639,9037,2974,6063,2.935,8.918,-3323,-3.279,11.278,74,74,622
2009,3251,1371,2412,150343,152133,155,6.373,195,8.018,11005,3322,7683,2.184,7.234,14542,3429,11113,2.254,9.559,-3537,-2.325,14.468,86,88,438
2009,3252,972,1293,88986,93966,65,4.996,81,6.226,5621,1890,3731,2.011,5.982,15438,4288,11150,4.563,16.429,-9817,-10.447,11.964,37,39,904
2009,3253,611,839,29509,29564,61,7.292,56,6.695,2456,476,1980,1.610,8.307,2503,383,2120,1.295,8.466,-47,-0.159,16.615,39,40,220
2009,3254,1421,1839,240886,247076,136,7.409,129,7.028,16844,3023,13821,1.224,6.817,29526,7081,22445,2.866,11.950,-12682,-5.133,13.635,69,69,1142
2009,3255,1377,1742,55813,59272,64,3.594,141,7.919,2828,530,2298,0.894,4.771,9721,2480,7241,4.184,16.401,-6893,-11.629,9.542,85,87,992
2009,3256,1848,2043,94388,99662,113,5.447,176,8.484,8043,2825,5218,2.835,8.070,18675,5806,12869,5.826,18.738,-10632,-10.668,16.141,116,116,1586
2009,3259,1892,2453,90671,92730,193,7.826,219,8.881,10491,5331,5160,5.749,11.314,14197,3142,11055,3.388,15.310,-3706,-3.997,22.627,155,156,1418
2009,3261,8552,10876,560774,611792,392,3.529,853,7.680,29016,8777,20239,1.435,4.743,131717,29193,102524,4.772,21.530,-102701,-16.787,9.486,543,562,12326
2009,3262,1531,1998,125103,135143,73,3.600,133,6.558,3874,903,2971,0.668,2.867,23844,3863,19981,2.858,17.644,-19970,-14.777,5.733,78,81,1615
2009,3271,1076,1267,35532,40230,81,6.226,149,11.453,1998,714,1284,1.775,4.966,11389,2175,9214,5.406,28.310,-9391,-23.343,9.933,95,96,935
2009,3272,1472,1769,88168,93491,101,5.534,213,11.671,4950,1239,3711,1.325,5.295,15454,3737,11717,3.997,16.530,-10504,-11.235,10.589,153,153,962
2009,3273,4484,9117,172365,190333,430,4.609,856,9.175,17452,6664,10788,3.501,9.169,53473,10410,43063,5.469,28.094,-36021,-18.925,18.338,280,290,3034
2009,3274,179,314,14021,15354,15,4.552,46,13.961,668,266,402,1.733,4.351,3402,646,2756,4.208,22.158,-2734,-17.807,8.702,26,26,169
2009,3279,2659,3123,66915,72641,198,6.185,355,11.089,4954,2038,2916,2.806,6.820,16469,3192,13277,4.394,22.672,-11515,-15.852,13.640,266,266,2240
2009,3311,372,504,102221,104345,65,12.859,68,13.452,5882,3052,2830,2.925,5.637,10250,1025,9225,0.982,9.823,-4368,-4.186,11.274,53,53,455
2009,3312,474,615,39167,41939,35,5.650,44,7.103,2279,483,1796,1.152,5.434,7802,689,7113,1.643,18.603,-5523,-13.169,10.868,32,32,320
2009,3313,424,553,50820,56479,29,5.165,46,8.192,1180,392,788,0.694,2.089,12370,1970,10400,3.488,21.902,-11190,-19.813,4.179,26,26,933
2009,3314,721,922,59016,62048,52,5.609,62,6.688,3730,810,2920,1.305,6.012,9809,3035,6774,4.891,15.809,-6079,-9.797,12.023,32,34,1184
2009,3315,1714,1933,125739,138444,64,3.267,116,5.921,4254,1187,3067,0.857,3.073,29829,2637,27192,1.905,21.546,-25575,-18.473,6.145,82,83,1280
2009,3321,2375,2624,110398,119333,94,3.553,138,5.215,5306,1884,3422,1.579,4.446,23228,2958,20270,2.479,19.465,-17922,-15.019,8.893,90,90,1056
2009,3322,1251,1351,42281,45412,56,4.045,123,8.884,2129,511,1618,1.125,4.688,8330,1929,6401,4.248,18.343,-6201,-13.655,9.376,83,83,378
2009,3323,11978,13034,352612,376927,600,4.533,1004,7.585,25644,8196,17448,2.174,6.803,74188,11512,62676,3.054,19.682,-48544,-12.879,13.607,702,709,6629
2009,3324,1157,1444,86554,90746,58,3.975,88,6.032,5595,1847,3748,2.035,6.166,14101,2549,11552,2.809,15.539,-8506,-9.373,12.331,50,50,999
2009,3325,599,668,31541,34517,27,3.959,55,8.065,1104,251,853,0.727,3.198,7063,1506,5557,4.363,20.463,-5959,-17.264,6.397,38,38,594
2009,3326,1246,1409,41010,44838,41,2.849,101,7.019,2399,615,1784,1.372,5.350,10048,1787,8261,3.986,22.410,-7649,-17.059,10.701,66,67,1205
2009,3327,22481,22927,352243,373964,997,4.279,1738,7.460,26522,7528,18994,2.013,7.092,69996,12219,57777,3.267,18.717,-43474,-11.625,14.184,1278,1282,8257
2009,3328,5200,5706,118812,127211,261,4.511,420,7.260,9325,3129,6196,2.460,7.330,26099,5886,20213,4.627,20.516,-16774,-13.186,14.661,292,294,3306
2009,3329,5784,6342,261951,272806,413,6.481,473,7.423,19188,6688,12500,2.452,7.034,41078,6683,34395,2.450,15.058,-21890,-8.024,14.067,322,322,2693
2009,3331,2474,2830,199343,204786,164,5.744,214,7.496,17837,5386,12451,2.630,8.710,28619,4746,23873,2.318,13.975,-10782,-5.265,17.420,151,151,2246
2009,3332,3300,3474,111923,119248,150,4.240,278,7.858,8306,2652,5654,2.224,6.965,23159,4559,18600,3.823,19.421,-14853,-12.456,13.931,193,195,2063
2009,3333,1824,1960,77289,81506,108,5.408,182,9.114,4897,1764,3133,2.164,6.008,13254,3451,9803,4.234,16.261,-8357,-10.253,12.016,126,126,1428
2009,3334,1444,1725,131840,139721,106,6.095,134,7.706,8058,2460,5598,1.761,5.767,24150,5670,18480,4.058,17.284,-16092,-11.517,11.534,75,78,1994
2009,3335,6870,7090,141665,152239,231,3.184,559,7.706,8292,1324,6968,0.870,5.447,29319,5850,23469,3.843,19.259,-21027,-13.812,10.893,409,411,3189
2009,3336,817,1004,104745,107819,57,5.717,43,4.313,7628,2282,5346,2.117,7.075,13956,1921,12035,1.782,12.944,-6328,-5.869,14.150,28,28,413
2009,3339,5290,5900,269488,282250,286,4.800,402,6.747,17825,5176,12649,1.834,6.315,43418,7383,36035,2.616,15.383,-25593,-9.068,12.631,270,274,3459
2009,3341,999,1078,84493,86946,115,10.555,138,12.666,7660,4120,3540,4.739,8.810,12450,2856,9594,3.285,14.319,-4790,-5.509,17.620,104,104,1395
2009,3342,1282,1420,139348,131383,94,6.505,144,9.965,27625,2568,25057,1.955,21.026,13451,3879,9572,2.952,10.238,14174,10.788,20.476,88,88,1884
2009,3343,413,425,12448,13221,28,6.385,55,12.543,826,139,687,1.051,6.248,2412,1032,1380,7.806,18.244,-1586,-11.996,12.495,45,45,333
2009,3344,3774,4249,299688,322414,190,4.386,355,8.196,15468,4949,10519,1.535,4.798,61407,12351,49056,3.831,19.046,-45939,-14.248,9.595,233,236,4496
2009,3345,4273,4958,394163,399793,276,5.521,358,7.161,28978,6302,22676,1.576,7.248,39990,9580,30410,2.396,10.003,-11012,-2.754,14.497,214,215,2304
2009,3346,578,598,21501,22967,44,6.990,107,16.998,2143,387,1756,1.685,9.331,5062,2472,2590,10.763,22.040,-2919,-12.710,18.662,77,77,907
2009,3351,986,1086,49317,52216,51,4.664,66,6.036,2918,686,2232,1.314,5.588,8631,1331,7300,2.549,16.530,-5713,-10.941,11.177,46,46,311
2009,3352,235,279,48480,53100,22,7.521,49,16.752,1057,61,996,0.115,1.991,10131,1578,8553,2.972,19.079,-9074,-17.089,3.981,38,38,690
2009,3353,1895,2202,124998,130521,94,4.224,141,6.336,8478,1613,6865,1.236,6.496,19497,5086,14411,3.897,14.938,-11019,-8.442,12.991,80,81,1335
2009,3359,1785,2088,137470,145473,115,5.472,142,6.757,8094,2847,5247,1.957,5.564,24039,4514,19525,3.103,16.525,-15945,-10.961,11.128,85,85,1424
2009,3361,269,336,135715,154490,40,11.869,42,12.463,6395,1571,4824,1.017,4.139,44747,7119,37628,4.608,28.964,-38352,-24.825,8.279,32,32,810
2009,3362,1661,1919,94054,113333,112,5.667,227,11.485,5489,2740,2749,2.418,4.843,43897,6299,37598,5.558,38.733,-38408,-33.890,9.687,161,162,3228
2009,3363,4159,5096,427860,487854,286,5.529,439,8.487,22105,9686,12419,1.985,4.531,141810,23475,118335,4.812,29.068,-119705,-24.537,9.062,258,261,4678
2009,3364,1241,1634,395885,406437,95,5.823,90,5.516,30960,3904,27056,0.961,7.617,51145,7993,43152,1.967,12.584,-20185,-4.966,15.235,59,63,2491
2009,3365,153,229,27619,28508,22,9.821,12,5.357,1565,388,1177,1.361,5.490,3305,846,2459,2.968,11.593,-1740,-6.104,10.980,6,7,264
2009,3366,1366,1487,136647,147198,123,7.969,236,15.290,10406,1504,8902,1.022,7.069,32010,4806,27204,3.265,21.746,-21604,-14.677,14.139,164,164,1962
2009,3369,751,781,43767,45690,71,8.733,135,16.605,3182,810,2372,1.773,6.964,7082,1013,6069,2.217,15.500,-3900,-8.536,13.929,114,114,700
2009,3371,12272,12539,235937,265381,721,5.459,2060,15.596,14235,5858,8377,2.207,5.364,73031,18612,54419,7.013,27.519,-58796,-22.155,10.728,1578,1583,9500
2009,3372,3680,3882,114849,127250,180,4.523,376,9.447,7155,2095,5060,1.646,5.623,31786,6649,25137,5.225,24.979,-24631,-19.356,11.246,292,292,3161
2009,3379,787,900,34179,37642,37,3.978,97,10.430,2050,313,1737,0.832,5.446,9105,2165,6940,5.752,24.189,-7055,-18.743,10.892,59,59,761
2009,3391,10336,11156,300759,304722,685,6.096,848,7.546,25125,4697,20428,1.541,8.245,33616,8540,25076,2.803,11.032,-8491,-2.786,16.490,625,626,3621
2009,3399,15424,15871,292484,312164,1106,6.795,1916,11.772,22692,8079,14613,2.588,7.269,62340,13536,48804,4.336,19.970,-39648,-12.701,14.539,1481,1484,8524
2009,4231,16815,24107,360954,376190,1453,5.924,2295,9.357,32045,12126,19919,3.223,8.518,62519,15674,46845,4.167,16.619,-30474,-8.101,17.037,1481,1535,7912
2009,4232,10424,12103,146780,157862,812,6.506,1567,12.556,13463,4225,9238,2.676,8.528,35628,10108,25520,6.403,22.569,-22165,-14.041,17.057,1132,1192,7380
2009,4233,10898,17691,212982,233508,1100,6.076,1925,10.633,18023,6863,11160,2.939,7.718,59305,15269,44036,6.539,25.397,-41282,-17.679,15.437,1017,1041,5913
2009,4234,22745,32511,695870,706062,3133,9.578,3535,10.806,88210,25606,62604,3.627,12.493,108895,36667,72228,5.193,15.423,-20685,-2.930,24.986,1879,1918,11575
2009,4235,7619,10535,153482,161654,596,5.612,765,7.204,12688,3828,8860,2.368,7.849,29188,6451,22737,3.991,18.056,-16500,-10.207,15.698,499,511,4356
2009,4236,18610,28027,513533,522302,1869,6.583,2594,9.137,68362,17262,51100,3.305,13.089,86064,30273,55791,5.796,16.478,-17702,-3.389,26.177,1434,1492,9590
2009,4237,10599,19237,221709,232190,1136,5.882,1288,6.669,18407,6676,11731,2.875,7.928,39090,8475,30615,3.650,16.835,-20683,-8.908,15.855,577,617,3983
2009,4238,39833,56387,704349,722903,2991,5.263,3878,6.824,65727,22577,43150,3.123,9.092,102864,25539,77325,3.533,14.229,-37137,-5.137,18.184,2360,2501,14167
2009,4239,26605,29632,315926,330476,2741,9.111,3647,12.122,35856,12302,23554,3.723,10.850,64928,18386,46542,5.563,19.647,-29072,-8.797,21.700,2667,2703,11923
2009,4241,8013,10615,155534,162814,551,5.096,947,8.758,11006,4032,6974,2.476,6.760,25406,6660,18746,4.091,15.604,-14400,-8.844,13.520,590,604,3748
2009,4242,5586,8441,269693,268093,1052,12.679,765,9.220,49404,11551,37853,4.309,18.428,45048,13920,31128,5.192,16.803,4356,1.625,33.606,478,492,3978
2009,4243,13182,14345,185779,197508,1435,9.771,2119,14.428,21248,6999,14249,3.544,10.758,44426,15368,29058,7.781,22.493,-23178,-11.735,21.516,1588,1624,7888
2009,4244,24158,30839,762740,778717,2708,8.774,2756,8.930,73447,21973,51474,2.822,9.432,105917,24515,81402,3.148,13.601,-32470,-4.170,18.864,1917,1945,13222
2009,4245,3400,5968,60247,60562,269,4.471,367,6.099,7028,1339,5689,2.211,11.605,7626,2256,5370,3.725,12.592,-598,-0.987,23.209,199,214,1464
2009,4246,7977,11949,144856,147226,792,6.532,1143,9.427,15805,5800,10005,3.940,10.735,20837,7301,13536,4.959,14.153,-5032,-3.418,21.470,520,550,2821
2009,4247,4829,7091,103303,104481,297,4.169,364,5.109,9792,2581,7211,2.470,9.372,12050,3118,8932,2.984,11.533,-2258,-2.161,18.744,247,251,2371
2009,4248,3047,3926,177184,178859,325,8.260,342,8.692,17176,6902,10274,3.859,9.603,20270,7376,12894,4.124,11.333,-3094,-1.730,19.206,258,272,4561
2009,4249,20535,26599,335642,346136,2209,8.209,2833,10.527,35698,10727,24971,3.099,10.313,56709,16176,40533,4.673,16.383,-21011,-6.070,20.627,2011,2046,9773
2009,4251,39935,42039,288735,292618,4557,10.637,6162,14.383,41617,17051,24566,5.827,14.222,49329,20176,29153,6.895,16.858,-7712,-2.636,28.445,4544,4564,14045
2009,4411,39281,44065,1046921,1147526,3111,6.869,5556,12.268,62286,28287,33999,2.465,5.428,263225,69560,193665,6.062,22.938,-200939,-17.511,10.856,4380,4432,53906
2009,4412,12900,14658,136055,150148,1001,6.648,1798,11.942,11925,5387,6538,3.588,7.942,39984,9578,30406,6.379,26.630,-28059,-18.688,15.884,1304,1329,6702
2009,4413,28042,54740,460614,468438,2870,5.215,3456,6.280,43147,15557,27590,3.321,9.211,58910,17698,41212,3.778,12.576,-15763,-3.365,18.422,2308,2367,8825
2009,4421,15965,24580,216686,234661,1654,6.515,3271,12.884,20597,10994,9603,4.685,8.777,56618,17393,39225,7.412,24.128,-36021,-15.350,17.555,2166,2524,13379
2009,4422,21782,29729,229298,254967,1805,5.799,4603,14.787,24688,9094,15594,3.567,9.683,77303,34172,43131,13.403,30.319,-52615,-20.636,19.366,2735,3370,25879
2009,4431,25898,48041,466024,478120,4357,8.941,5739,11.777,56978,25621,31357,5.359,11.917,81705,35876,45829,7.504,17.089,-24727,-5.172,23.834,3508,4161,18179
2009,4441,41307,64444,1068759,1118062,2973,4.536,5177,7.898,70694,31450,39244,2.813,6.323,170523,32103,138420,2.871,15.252,-99829,-8.929,12.646,3413,3559,17911
2009,4442,14127,17548,149206,155349,871,4.882,1454,8.150,15144,3970,11174,2.556,9.748,26989,7194,19795,4.631,17.373,-11845,-7.625,19.497,1059,1072,5591
2009,4451,56308,82281,2557767,2560925,8499,10.385,7613,9.303,251317,119730,131587,4.675,9.814,258928,83746,175182,3.270,10.111,-7611,-0.297,19.627,5390,5441,30999
2009,4452,16929,20912,142377,145289,2473,11.700,2923,13.829,27205,11318,15887,7.790,18.725,32980,13016,19964,8.959,22.700,-5775,-3.975,37.449,2258,2269,9449
2009,4453,25262,28959,147063,146073,2610,9.076,2206,7.671,24665,9048,15617,6.194,16.885,22601,6961,15640,4.765,15.472,2064,1.413,30.945,1643,1673,5559
2009,4461,39083,85746,984906,1003049,6321,7.409,5457,6.396,95117,37939,57178,3.782,9.483,131519,28641,102878,2.855,13.112,-36402,-3.629,18.966,3159,3288,14038
2009,4471,61099,107805,854993,874791,7667,7.077,8741,8.068,108714,41382,67332,4.731,12.427,148079,47319,100760,5.409,16.927,-39365,-4.500,24.855,5674,5920,28556
2009,4481,33960,91696,1200406,1245664,7997,8.638,9757,10.539,152176,76230,75946,6.120,12.216,238710,69941,168769,5.615,19.163,-86534,-6.947,24.433,4722,4985,18386
2009,4482,5904,26100,195559,202267,1660,6.213,2900,10.853,26879,13513,13366,6.681,13.289,39775,11883,27892,5.875,19.665,-12896,-6.376,26.578,684,756,2998
2009,4483,16334,24401,137189,144583,1727,6.837,3445,13.638,19100,8224,10876,5.688,13.210,33843,14433,19410,9.983,23.407,-14743,-10.197,26.421,1458,2136,7290
2009,4511,25980,36027,399602,414613,2982,8.123,4347,11.842,47242,20509,26733,4.947,11.394,78302,21348,56954,5.149,18.886,-31060,-7.491,22.789,2891,2973,11364
2009,4512,4806,10084,136193,140907,655,6.370,1051,10.222,10085,4985,5100,3.538,7.157,19349,5990,13359,4.251,13.732,-9264,-6.575,14.314,648,663,2718
2009,4521,93,8496,1187810,1237060,274,3.200,408,4.765,56903,18960,37943,1.533,4.600,155992,43263,112729,3.497,12.610,-99089,-8.010,9.200,22,198,27560
2009,4529,7043,35150,1722567,1704113,1779,5.040,2072,5.870,129606,31476,98130,1.847,7.605,94948,17284,77664,1.014,5.572,34658,2.034,11.143,1189,1234,6428
2009,4531,15290,15990,75372,82303,1039,6.257,2270,13.670,7798,2850,4948,3.463,9.475,21573,6419,15154,7.799,26.212,-13775,-16.737,18.949,1898,1904,5373
2009,4532,22662,33637,276659,289955,2424,7.015,4263,12.336,25323,9636,15687,3.323,8.733,52537,16586,35951,5.720,18.119,-27214,-9.386,17.467,3225,3278,10821
2009,4533,11384,16179,140889,138532,1451,8.913,1651,10.142,21324,7988,13336,5.766,15.393,16605,5269,11336,3.803,11.986,4719,3.406,23.973,1274,1292,3553
2009,4539,28789,37533,237995,243217,3918,10.358,4507,11.915,35244,16163,19081,6.646,14.491,44997,15058,29939,6.191,18.501,-9753,-4.010,28.982,3422,3496,11527
2009,4541,18656,19728,322908,327369,2787,14.168,2674,13.593,51942,21917,30025,6.695,15.866,61034,19407,41627,5.928,18.644,-9092,-2.777,31.733,2090,2102,10434
2009,4542,3774,4237,38409,43033,374,8.585,613,14.071,3826,1238,2588,2.877,8.891,12822,3571,9251,8.298,29.796,-8996,-20.905,17.782,459,468,1797
2009,4543,21536,27532,198666,205646,2029,7.229,3102,11.052,23573,8151,15422,3.964,11.463,37802,13529,24273,6.579,18.382,-14229,-6.919,22.926,2265,2305,8793
2009,4811,452,2813,402617,422865,176,6.150,274,9.574,12290,2500,9790,0.591,2.906,52327,4850,47477,1.147,12.374,-40037,-9.468,5.813,53,63,1585
2009,4812,1967,2150,35488,37745,291,13.404,333,15.339,4459,1528,2931,4.048,11.813,8905,4309,4596,11.416,23.593,-4446,-11.779,23.627,233,239,3439
2009,4831,699,1017,48077,48101,109,10.830,88,8.743,5117,1603,3514,3.333,10.638,5256,717,4539,1.491,10.927,-139,-0.289,21.276,65,65,584
2009,4832,474,522,19208,19923,64,12.190,70,13.333,1680,551,1129,2.766,8.432,3104,1249,1855,6.269,15.580,-1424,-7.148,16.865,47,47,547
2009,4841,45286,54541,879412,916478,8209,14.776,10241,18.433,105571,47402,58169,5.172,11.519,180246,59778,120468,6.523,19.667,-74675,-8.148,23.038,7450,7550,35171
2009,4842,37599,41790,442831,460801,4197,9.722,6956,16.113,59856,20950,38906,4.546,12.990,96519,32114,64405,6.969,20.946,-36663,-7.956,25.979,4832,4873,21186
2009,4851,575,820,48059,48143,73,8.870,79,9.599,5166,1422,3744,2.954,10.731,5370,2766,2604,5.745,11.154,-204,-0.424,21.461,47,47,1489
2009,4852,204,405,13056,14369,65,14.874,129,29.519,2004,1025,979,7.133,13.947,4762,2202,2560,15.325,33.141,-2758,-19.194,27.893,19,19,104
2009,4853,6067,6176,64715,67536,952,15.272,1067,17.117,8914,3975,4939,5.886,13.199,14565,4002,10563,5.926,21.566,-5651,-8.367,26.398,830,830,2949
2009,4854,2802,4387,214226,217183,348,7.985,290,6.654,23455,9572,13883,4.407,10.800,30144,7020,23124,3.232,13.880,-6689,-3.080,21.599,167,169,3385
2009,4855,1129,1243,29112,29857,110,8.814,120,9.615,2940,739,2201,2.475,9.847,4459,1394,3065,4.669,14.935,-1519,-5.088,19.694,84,85,866
2009,4859,2908,3223,67729,66461,536,17.095,361,11.513,12391,4226,8165,6.359,18.644,9862,4050,5812,6.094,14.839,2529,3.805,29.678,295,295,2705
2009,4861,49,389,7178,6721,32,8.322,23,5.982,1215,352,863,5.237,18.078,356,86,270,1.280,5.297,859,12.781,10.594,4,4,12
2009,4862,112,1671,25346,25522,96,5.707,118,7.015,2619,1107,1512,4.338,10.262,2936,972,1964,3.809,11.504,-317,-1.242,20.524,12,12,69
2009,4869,59,711,8241,8251,45,6.316,48,6.737,758,179,579,2.170,9.187,789,224,565,2.715,9.563,-31,-0.376,18.375,4,4,9
2009,4871,469,512,8701,9178,51,9.668,82,15.545,1109,243,866,2.648,12.084,2034,513,1521,5.590,22.163,-925,-10.079,24.168,64,66,469
2009,4872,1157,1196,10399,10951,153,12.510,207,16.926,1260,406,854,3.708,11.506,2370,674,1696,6.155,21.643,-1110,-10.137,23.013,142,142,434
2009,4879,137,150,2197,2110,28,18.729,27,18.060,802,601,201,28.483,38.009,601,88,513,4.171,28.483,201,9.526,56.967,16,16,67
2009,4881,3743,5377,164197,172535,568,10.616,515,9.625,23936,9734,14202,5.642,13.873,40797,12026,28771,6.970,23.646,-16861,-9.773,27.746,294,302,8900
2009,4882,464,1055,24975,26218,141,13.756,81,7.902,3371,2235,1136,8.525,12.858,5937,1603,4334,6.114,22.645,-2566,-9.787,25.715,29,29,832
2009,4883,1633,2214,85140,89181,172,7.720,200,8.977,9384,1928,7456,2.162,10.522,17251,2817,14434,3.159,19.344,-7867,-8.821,21.045,114,118,1252
2009,4884,8428,9137,75898,76839,1204,13.218,1148,12.603,13753,5903,7850,7.682,17.898,15405,5950,9455,7.743,20.048,-1652,-2.150,35.797,829,880,3841
2009,4885,13436,19427,225721,231563,1555,7.867,2234,11.302,29303,8128,21175,3.510,12.654,40656,14223,26433,6.142,17.557,-11353,-4.903,25.309,1214,1303,6604
2009,4889,1197,1313,24818,26185,200,15.320,185,14.171,2795,1082,1713,4.132,10.674,5673,980,4693,3.743,21.665,-2878,-10.991,21.348,147,147,727
2009,4921,3261,8703,517219,538735,805,9.175,947,10.793,24918,10004,14914,1.857,4.625,70109,6652,63457,1.235,13.014,-45191,-8.388,9.251,397,404,2405
2009,4922,3761,4015,31002,33203,661,16.558,615,15.406,5347,2549,2798,7.677,16.104,9897,3261,6636,9.822,29.808,-4550,-13.704,32.208,501,503,2404
2009,4931,6844,14060,681265,696576,1301,9.251,1309,9.307,84508,35863,48645,5.148,12.132,115399,37834,77565,5.431,16.567,-30891,-4.435,24.264,419,464,7954
2009,5111,13913,20098,588616,629856,1640,8.033,2278,11.157,43613,18866,24747,2.995,6.924,125561,28093,97468,4.460,19.935,-81948,-13.011,13.849,1332,1376,13177
2009,5112,5146,7489,375494,381020,762,10.064,927,12.243,47158,13966,33192,3.665,12.377,58634,22744,35890,5.969,15.389,-11476,-3.012,24.754,399,428,9738
2009,5121,12575,15954,313427,318382,2066,12.813,2406,14.922,41362,17146,24216,5.385,12.991,50793,12093,38700,3.798,15.953,-9431,-2.962,25.983,1517,1565,7011
2009,5122,2802,3041,23563,24083,441,14.325,516,16.761,3204,1600,1604,6.644,13.304,4278,1396,2882,5.797,17.764,-1074,-4.460,26.608,372,372,840
2009,5151,4155,8707,228614,237964,841,9.552,1035,11.756,17408,7674,9734,3.225,7.315,36183,10314,25869,4.334,15.205,-18775,-7.890,14.631,272,286,2167
2009,5152,397,668,40997,41433,118,18.380,66,10.280,5141,2510,2631,6.058,12.408,6040,2290,3750,5.527,14.578,-899,-2.170,24.816,28,28,427
2009,5171,3340,32949,836016,841652,3864,11.803,3442,10.514,109650,42837,66813,5.090,13.028,122696,30263,92433,3.596,14.578,-13046,-1.550,26.056,240,281,5498
2009,5172,1007,11744,279119,278977,2999,25.004,3499,29.173,53897,32550,21347,11.668,19.320,53732,35233,18499,12.629,19.260,165,0.059,38.521,228,274,3320
2009,5174,398,510,8048,8379,69,13.043,107,20.227,1254,315,939,3.760,14.967,1874,962,912,11.482,22.367,-620,-7.400,29.934,75,75,507
2009,5179,4289,4760,57385,59276,790,16.222,1010,20.739,10798,4246,6552,7.163,18.217,14533,5650,8883,9.532,24.518,-3735,-6.301,36.433,762,769,3168
2009,5182,7954,11831,394691,396972,1852,14.031,4589,34.766,67578,33705,33873,8.491,17.023,71678,30482,41196,7.679,18.056,-4100,-1.033,34.047,810,823,8138
2009,5191,5981,7387,139069,139291,1183,16.374,859,11.889,25335,11181,14154,8.027,18.189,25544,7011,18533,5.033,18.339,-209,-0.150,36.377,534,542,3368
2009,5211,13,48,18775,18894,(D),(D),(D),(D),994,(D),972,(D),5.261,1164,(D),1034,(D),6.161,-170,-0.900,10.522,0,0,0
2009,5221,14451,126870,2027789,2061133,6447,5.070,7034,5.531,202386,78784,123602,3.822,9.819,269388,72908,196480,3.537,13.070,-67002,-3.251,19.638,470,743,11440
2009,5222,14715,41234,555568,595130,4030,9.124,9899,22.412,95198,32011,63187,5.379,15.996,174132,67613,106519,11.361,29.260,-78934,-13.263,31.992,2671,3036,16288
2009,5223,16450,34199,268828,283569,3092,8.276,9419,25.210,50344,18818,31526,6.636,17.754,79451,35932,43519,12.671,28.018,-29107,-10.265,35.507,6453,7167,25160
2009,5231,11633,42121,484124,504881,7120,17.272,5325,12.917,80430,42997,37433,8.516,15.931,120509,22963,97546,4.548,23.869,-40079,-7.938,31.861,1152,1171,4828
2009,5232,29,83,5430,5924,58,94.309,15,24.390,417,238,179,4.018,7.039,1398,171,1227,2.887,23.599,-981,-16.560,14.078,8,8,38
2009,5239,37257,42607,428828,431858,5547,12.987,5758,13.481,71027,31956,39071,7.400,16.447,77712,23324,54388,5.401,17.995,-6685,-1.548,32.894,3784,3818,14019
2009,5241,5547,32611,1477379,1485136,3687,11.231,4123,12.559,153685,63486,90199,4.275,10.348,169131,52910,116221,3.563,11.388,-15446,-1.040,20.696,631,666,4964
2009,5242,119573,134228,873564,880147,10703,7.913,12763,9.436,117850,42381,75469,4.815,13.390,131596,52515,79081,5.967,14.952,-13746,-1.562,26.780,8435,8548,28429
2009,5250,1083,1103,21236,16442,445,46.114,169,17.513,13801,9463,4338,57.554,83.937,3770,1009,2761,6.137,22.929,10031,61.008,45.858,97,97,509
2009,5311,82700,104375,517715,528302,9117,8.683,10358,9.865,77328,32676,44652,6.185,14.637,98756,38571,60185,7.301,18.693,-21428,-4.056,29.274,7135,7212,25029
2009,5312,60772,70609,289025,313888,9818,13.008,19556,25.910,56007,27452,28555,8.746,17.843,105485,51558,53927,16.426,33.606,-49478,-15.763,35.686,12111,12259,25668
2009,5313,59602,71950,619207,629270,9200,12.726,9884,13.672,98127,42940,55187,6.824,15.594,118238,45299,72939,7.199,18.790,-20111,-3.196,31.188,6619,6645,27095
2009,5321,3838,10740,154969,169931,871,7.353,3082,26.018,10408,4956,5452,2.916,6.125,40837,21735,19102,12.791,24.032,-30429,-17.907,12.250,539,558,2929
2009,5322,9364,28149,207364,221531,1343,4.620,3186,10.960,21617,7894,13723,3.563,9.758,50834,14014,36820,6.326,22.947,-29217,-13.189,19.516,1268,1329,5859
2009,5323,2675,4105,25789,26838,174,4.172,305,7.313,2721,659,2062,2.456,10.139,4717,1190,3527,4.434,17.576,-1996,-7.437,20.278,224,234,887
2009,5324,7269,13019,153703,158774,1099,8.392,1252,9.561,19225,6015,13210,3.788,12.108,29365,8956,20409,5.641,18.495,-10140,-6.386,24.217,647,716,4501
2009,5331,1975,2067,31077,31710,259,12.443,288,13.836,5231,2303,2928,7.263,16.497,6424,3869,2555,12.201,20.259,-1193,-3.762,32.993,198,198,996
2009,5411,160558,170057,1168667,1179794,12641,7.381,15075,8.802,124953,40160,84793,3.404,10.591,147291,46099,101192,3.907,12.484,-22338,-1.893,21.182,10748,10823,33125
2009,5412,96139,111402,1281975,1295370,10485,9.435,9934,8.939,198005,60656,137349,4.683,15.286,224066,72214,151852,5.575,17.297,-26061,-2.012,30.571,6165,6205,42258
2009,5413,83619,99683,1353929,1400741,9075,8.946,12601,12.421,174697,62315,112382,4.449,12.472,267085,69577,197508,4.967,19.067,-92388,-6.596,24.944,7864,7959,30728
2009,5414,26003,26265,113993,123044,3109,11.428,4989,18.339,16673,7410,9263,6.022,13.550,34801,12023,22778,9.771,28.283,-18128,-14.733,27.101,3574,3575,8479
2009,5415,86142,101154,1333693,1315954,18072,18.049,16021,16.000,277187,141682,135505,10.766,21.064,243829,99941,143888,7.595,18.529,33358,2.535,37.057,10300,10386,42756
2009,5416,102467,109671,849488,856869,19659,17.901,19955,18.171,178228,80533,97695,9.399,20.800,191423,80725,110698,9.421,22.340,-13195,-1.540,41.600,14055,14162,46578
2009,5417,11841,14550,636672,631572,1785,12.321,1660,11.458,90275,23202,67073,3.674,14.294,80316,25546,54770,4.045,12.717,9959,1.577,25.434,991,1007,9786
2009,5418,31047,34519,429439,449017,3499,9.926,4964,14.082,56077,22891,33186,5.098,12.489,95535,29442,66093,6.557,21.277,-39458,-8.788,24.978,3532,3558,16840
2009,5419,52426,61915,603787,610012,5525,8.867,6314,10.133,80052,27828,52224,4.562,13.123,92517,28525,63992,4.676,15.166,-12465,-2.043,26.246,4441,4492,20048
2009,5511,26668,49946,2803042,2842381,4278,8.523,4779,9.521,403513,136340,267173,4.797,14.196,482335,129109,353226,4.542,16.969,-78822,-2.773,28.393,986,1116,18080
2009,5611,22974,25063,402239,399057,3335,13.301,3357,13.388,78181,30474,47707,7.637,19.591,71446,27637,43809,6.926,17.904,6735,1.688,35.807,2473,2501,20071
2009,5612,1686,4769,230495,242343,573,10.937,1513,28.880,44005,12663,31342,5.225,18.158,69752,22768,46984,9.395,28.782,-25747,-10.624,36.316,120,127,2967
2009,5613,26043,46838,3879426,4312936,5789,12.070,8040,16.763,613762,195525,418237,4.533,14.231,1488236,311804,1176432,7.230,34.506,-874474,-20.276,28.461,3547,3682,157136
2009,5614,25797,32517,814029,823193,3343,10.166,4080,12.407,159993,74114,85879,9.003,19.436,178462,49549,128913,6.019,21.679,-18469,-2.244,38.871,2787,2842,23454
2009,5615,14094,19880,232193,243045,2373,11.834,2717,13.550,27069,13549,13520,5.575,11.137,49322,15451,33871,6.357,20.293,-22253,-9.156,22.275,1576,1597,7396
2009,5616,17556,23573,792943,809899,2720,11.565,2611,11.102,101649,35350,66299,4.365,12.551,135514,38390,97124,4.740,16.732,-33865,-4.181,25.102,1661,1733,21067
2009,5617,134843,141724,1614480,1654739,19290,13.495,21718,15.194,245353,87957,157396,5.315,14.827,325318,104507,220811,6.316,19.660,-79965,-4.832,29.655,14429,14461,63954
2009,5619,16119,18172,278937,291116,1691,9.217,2041,11.124,45508,12710,32798,4.366,15.632,68993,17988,51005,6.179,23.699,-23485,-8.067,31.265,1460,1463,11520
2009,5621,7178,9315,187421,190955,727,7.747,865,9.218,17307,6319,10988,3.309,9.063,24380,6677,17703,3.497,12.767,-7073,-3.704,18.127,598,612,4596
2009,5622,1317,2428,46773,48101,141,5.768,174,7.118,5709,2346,3363,4.877,11.869,8398,2205,6193,4.584,17.459,-2689,-5.590,23.738,108,109,936
2009,5629,7415,8479,115003,118928,778,9.153,819,9.636,19804,7047,12757,5.925,16.652,27379,7262,20117,6.106,23.021,-7575,-6.369,33.304,536,539,3023
2009,6111,17984,20316,853271,841758,971,4.891,48,0.242,64701,13854,50847,1.646,7.686,41546,229,41317,0.027,4.936,23155,2.751,9.871,39,39,200
2009,6112,457,880,87781,85134,53,6.206,(D),(D),10388,1406,8982,1.652,12.202,5096,(D),5095,(D),5.986,5292,6.216,11.972,(D),(D),(D)
2009,6113,2350,4132,1664340,1637316,209,5.186,5,0.124,96370,4207,92163,0.257,5.886,43767,5,43762,0.000,2.673,52603,3.213,5.346,3,3,3
2009,6114,6257,6776,63154,64479,717,10.440,900,13.105,9511,2959,6552,4.589,14.751,12142,4750,7392,7.367,18.831,-2631,-4.080,29.501,603,614,3187
2009,6115,6024,7422,118020,119219,801,10.732,885,11.857,18929,6889,12040,5.778,15.878,21163,8793,12370,7.376,17.751,-2234,-1.874,31.755,603,621,6409
2009,6116,32435,34941,324310,319252,4671,13.530,3835,11.109,67117,21824,45293,6.836,21.023,56473,19287,37186,6.041,17.689,10644,3.334,35.378,2819,2834,14477
2009,6117,5136,5930,77142,76210,808,13.717,729,12.376,13341,4169,9172,5.470,17.506,11605,4659,6946,6.113,15.228,1736,2.278,30.455,524,525,2552
2009,6211,175293,204958,2198726,2179798,15282,7.472,14421,7.051,301638,100731,200907,4.621,13.838,263643,87738,175905,4.025,12.095,37995,1.743,24.190,10173,10397,56625
2009,6212,116595,123200,839897,836685,6109,4.985,4793,3.911,94506,30098,64408,3.597,11.295,88231,21472,66759,2.566,10.545,6275,0.750,21.091,3870,3912,17700
2009,6213,105779,117813,652708,642640,11558,9.932,8668,7.449,111776,37488,74288,5.833,17.393,91718,30225,61493,4.703,14.272,20058,3.121,28.544,5733,5810,19059
2009,6214,14307,31165,695720,687399,2967,9.708,1759,5.756,90998,34524,56474,5.022,13.238,73818,26875,46943,3.910,10.739,17180,2.499,21.477,817,895,11718
2009,6215,7150,12466,246043,243922,1390,11.123,1451,11.611,34030,12814,21216,5.253,13.951,29806,10286,19520,4.217,12.220,4224,1.732,24.439,627,663,5833
2009,6216,15999,23391,1106201,1072257,3321,14.590,2063,9.063,199077,57516,141561,5.364,18.566,131435,43641,87794,4.070,12.258,67642,6.308,24.516,1276,1346,19891
2009,6219,5718,9013,283090,279832,951,10.612,848,9.463,40027,13738,26289,4.909,14.304,33632,12096,21536,4.323,12.019,6395,2.285,24.037,412,483,5778
2009,6221,3104,5283,5162838,5139190,217,4.141,132,2.519,226510,34451,192059,0.670,4.408,177945,51114,126831,0.995,3.463,48565,0.945,6.925,60,63,27918
2009,6222,461,624,214830,213520,32,5.216,11,1.793,7438,2435,5003,1.140,3.484,4710,516,4194,0.242,2.206,2728,1.278,4.412,5,5,239
2009,6223,462,934,249276,244680,89,9.748,47,5.148,20995,6855,14140,2.802,8.581,11730,4657,7073,1.903,4.794,9265,3.787,9.588,10,10,1007
2009,6231,7908,15614,1600680,1588420,807,5.176,763,4.894,133633,46458,87175,2.925,8.413,108187,38909,69278,2.450,6.811,25446,1.602,13.622,393,430,25101
2009,6232,8725,32938,631993,624814,1768,5.366,1787,5.424,81271,16915,64356,2.707,13.007,67117,22356,44761,3.578,10.742,14154,2.265,21.484,403,452,10400
2009,6233,14358,20281,791974,783067,1720,8.553,1376,6.843,81053,23848,57205,3.045,10.351,61631,24820,36811,3.170,7.870,19422,2.480,15.741,980,1005,17670
2009,6239,3483,5860,147829,149368,408,6.976,386,6.599,15000,3552,11448,2.378,10.042,18205,6634,11571,4.441,12.188,-3205,-2.146,20.085,203,218,4288
2009,6241,40688,56732,1277776,1259114,4918,8.761,3729,6.643,169884,35520,134364,2.821,13.492,132695,38003,94692,3.018,10.539,37189,2.954,21.078,2397,2436,28078
2009,6242,10195,13686,172424,170738,659,4.827,590,4.322,20083,4646,15437,2.721,11.763,16626,3851,12775,2.256,9.738,3457,2.025,19.476,278,307,2003
2009,6243,4231,7441,327478,327945,406,5.446,434,5.822,43993,9827,34166,2.997,13.415,44498,7432,37066,2.266,13.569,-505,-0.154,26.829,181,194,2778
2009,6244,55506,70479,870806,876959,7430,10.624,6350,9.079,113562,46465,67097,5.298,12.950,125228,42623,82605,4.860,14.280,-11666,-1.330,25.899,4687,4748,30191
2009,7111,7099,7226,119307,123832,762,10.444,902,12.363,16591,4105,12486,3.315,13.398,25810,7305,18505,5.899,20.843,-9219,-7.445,26.796,623,626,4729
2009,7112,3294,3474,123721,125055,473,13.409,580,16.442,15284,4061,11223,3.247,12.222,18043,4260,13783,3.407,14.428,-2759,-2.206,24.444,444,446,3130
2009,7113,5266,5574,124122,127435,590,10.532,646,11.532,17031,4136,12895,3.246,13.364,23637,5455,18182,4.281,18.548,-6606,-5.184,26.729,451,456,2701
2009,7114,2738,2834,18436,18582,438,15.439,444,15.650,3366,1453,1913,7.820,18.115,3621,1307,2314,7.034,19.487,-255,-1.372,36.230,324,324,961
2009,7115,13244,13281,41671,42672,2452,18.309,2675,19.974,11521,5378,6143,12.603,26.999,13572,5662,7910,13.269,31.806,-2051,-4.806,53.999,1615,1617,3624
2009,7121,6311,6800,128680,131136,342,5.031,338,4.972,8696,1771,6925,1.351,6.631,13381,1309,12072,0.998,10.204,-4685,-3.573,13.263,223,224,949
2009,7131,2097,2527,138945,140578,379,14.886,417,16.379,14753,4496,10257,3.198,10.495,18144,4053,14091,2.883,12.907,-3391,-2.412,20.989,312,314,3181
2009,7132,1696,2373,171327,170766,261,11.118,210,8.946,19271,5672,13599,3.322,11.285,18001,3160,14841,1.850,10.541,1270,0.744,21.083,157,158,1931
2009,7139,49464,56036,1141394,1158982,5652,10.008,6524,11.553,138845,50570,88275,4.363,11.980,175045,50715,124330,4.376,15.103,-36200,-3.123,23.960,5052,5093,38935
2009,7211,38318,48827,1793698,1857008,4808,9.920,4089,8.437,173628,94837,78791,5.107,9.350,300771,64131,236640,3.453,16.197,-127143,-6.847,18.700,2782,2824,39402
2009,7212,5175,5723,37873,38678,447,7.745,544,9.426,5285,1398,3887,3.615,13.664,6965,1708,5257,4.416,18.008,-1680,-4.344,27.329,329,332,1214
2009,7213,1902,1975,10435,10631,114,5.687,173,8.631,1382,401,981,3.772,13.000,1783,695,1088,6.538,16.772,-401,-3.772,26.001,121,127,597
2009,7223,11944,35032,640762,649339,4828,13.828,4592,13.152,142160,58381,83779,8.991,21.893,158726,55985,102741,8.622,24.444,-16566,-2.551,43.786,1674,1694,11212
2009,7224,39921,40606,347460,352179,4077,9.920,5062,12.317,64993,31113,33880,8.834,18.455,74736,29549,45187,8.390,21.221,-9743,-2.766,36.909,4123,4130,24750
2009,7225,323006,447591,8603173,8761894,50178,11.238,47986,10.747,1215570,646992,568578,7.384,13.873,1531777,503206,1028571,5.743,17.482,-316207,-3.609,27.747,36818,37949,358137
2009,8111,134210,146798,803998,834075,11422,7.676,15438,10.375,101404,40047,61357,4.801,12.158,161937,49904,112033,5.983,19.415,-60533,-7.258,24.315,10959,11182,35476
2009,8112,10107,11431,117290,121277,1178,10.173,1476,12.746,16242,5580,10662,4.601,13.393,24352,9033,15319,7.448,20.080,-8110,-6.687,26.785,953,964,3867
2009,8113,18937,20487,192075,197281,1530,7.343,2226,10.684,23997,8184,15813,4.148,12.164,34442,9263,25179,4.695,17.458,-10445,-5.294,24.328,1568,1571,5890
2009,8114,17093,17886,74039,77670,1815,9.915,2653,14.493,11384,4502,6882,5.796,14.657,18578,6244,12334,8.039,23.919,-7194,-9.262,29.314,1859,1861,4281
2009,8121,85789,101934,619035,627898,12232,12.014,11994,11.780,93118,45311,47807,7.216,14.830,110169,44005,66164,7.008,17.546,-17051,-2.716,29.660,9391,9572,36152
2009,8122,14568,19912,134454,134848,765,3.842,765,3.842,14414,3221,11193,2.389,10.689,15137,2579,12558,1.913,11.225,-723,-0.536,21.378,461,473,1716
2009,8123,29815,35265,315757,322825,3046,8.505,4145,11.574,43185,15458,27727,4.788,13.377,57848,20023,37825,6.202,17.919,-14663,-4.542,26.754,2821,3215,15477
2009,8129,21421,31436,244467,252691,3942,12.350,4906,15.371,46214,18090,28124,7.159,18.289,61404,29503,31901,11.676,24.300,-15190,-6.011,36.577,2419,2518,9903
2009,8131,172910,173258,1690342,1686786,8189,4.835,379,0.224,144349,23737,120612,1.407,8.558,137349,929,136420,0.055,8.143,7000,0.415,16.285,236,236,519
2009,8132,14504,16501,169571,180893,1231,7.530,927,5.670,18309,3670,14639,2.029,10.121,42436,2837,39599,1.568,23.459,-24127,-13.338,20.243,647,649,2000
2009,8133,12756,15113,139756,138816,1256,8.400,933,6.240,19062,4196,14866,3.023,13.732,17340,3231,14109,2.328,12.491,1722,1.240,24.983,554,557,2270
2009,8134,24413,26229,244713,248107,1221,4.643,1363,5.183,27411,6002,21409,2.419,11.048,34224,6966,27258,2.808,13.794,-6813,-2.746,22.096,923,931,5082
2009,8139,55768,57977,507026,509760,2711,4.707,1956,3.396,53482,10692,42790,2.097,10.492,59185,7927,51258,1.555,11.610,-5703,-1.119,20.983,1369,1370,5714
2010,2111,5751,7043,108741,108311,591,8.373,622,8.812,14044,5006,9038,4.622,12.966,13313,4751,8562,4.386,12.292,731,0.675,24.583,394,398,2037
2010,2121,556,970,80842,81674,80,8.004,139,13.907,11341,2939,8402,3.598,13.886,13079,3371,9708,4.127,16.014,-1738,-2.128,27.771,90,95,1741
2010,2122,209,271,32073,33192,47,17.636,38,14.259,2253,887,1366,2.672,6.788,4612,193,4419,0.581,13.895,-2359,-7.107,13.576,27,27,116
2010,2123,2908,4950,79187,80545,313,6.288,368,7.393,9885,2851,7034,3.540,12.273,12518,2248,10270,2.791,15.542,-2633,-3.269,24.545,180,180,820
2010,2131,9125,11372,285548,292336,1288,11.272,1398,12.234,49659,20251,29408,6.927,16.987,63136,15189,47947,5.196,21.597,-13477,-4.610,33.974,873,875,7387
2010,2211,1622,10132,512467,511792,667,6.687,353,3.539,31712,10745,20967,2.099,6.196,30035,6177,23858,1.207,5.869,1677,0.328,11.737,48,50,568
2010,2212,427,2423,84815,85303,164,6.898,73,3.070,5876,2582,3294,3.027,6.888,6914,2085,4829,2.444,8.105,-1038,-1.217,13.777,16,16,144
2010,2213,3427,4589,41882,42142,254,5.550,229,5.004,3688,1708,1980,4.053,8.751,4275,982,3293,2.330,10.144,-587,-1.393,17.503,114,114,562
2010,2361,125179,126477,575617,604679,21689,16.480,31954,24.279,135500,63383,72117,10.482,22.409,193746,84956,108790,14.050,32.041,-58246,-9.633,44.817,20539,20570,56262
2010,2362,35650,37175,570133,606645,3536,9.271,5463,14.324,87447,30364,57083,5.005,14.415,161232,27371,133861,4.512,26.578,-73785,-12.163,28.830,3601,3605,18335
2010,2371,16580,17805,470004,487744,1373,7.549,2138,11.755,71510,20044,51466,4.110,14.661,107595,17074,90521,3.501,22.060,-36085,-7.398,29.323,1328,1336,9333
2010,2372,6534,6613,39773,44773,576,8.062,1639,22.941,6026,2231,3795,4.983,13.459,16283,7126,9157,15.916,36.368,-10257,-22.909,26.918,1303,1310,5946
2010,2373,8866,9694,269457,274733,664,6.760,920,9.367,36909,6315,30594,2.299,13.434,47485,6237,41248,2.270,17.284,-10576,-3.850,26.869,590,590,4194
2010,2379,3636,3791,62125,63363,444,11.535,560,14.549,12628,3583,9045,5.655,19.930,15309,2290,13019,3.614,24.161,-2681,-4.231,39.860,333,334,1410
2010,2381,73434,74272,688429,747097,9531,12.327,15628,20.212,131448,40879,90569,5.472,17.595,248913,64181,184732,8.591,33.317,-117465,-15.723,35.189,9550,9565,40805
2010,2382,150221,154135,1610256,1688776,13233,8.419,19339,12.303,217071,56524,160547,3.347,12.854,374262,76762,297500,4.545,22.162,-157191,-9.308,25.707,12921,12936,53619
2010,2383,89261,90264,626534,671122,11822,12.582,19207,20.442,117862,38916,78946,5.799,17.562,207028,58957,148071,8.785,30.848,-89166,-13.286,35.124,12374,12386,40753
2010,2389,50580,51290,436469,451773,6534,12.345,9811,18.536,84488,24620,59868,5.450,18.701,115352,35416,79936,7.839,25.533,-30864,-6.832,37.403,6161,6176,22884
2010,3111,1081,1663,49886,50222,77,4.640,70,4.218,3581,576,3005,1.147,7.130,4215,1184,3031,2.358,8.393,-634,-1.262,14.261,37,37,379
2010,3112,428,765,54628,54969,40,5.242,36,4.718,2710,417,2293,0.759,4.930,3396,654,2742,1.190,6.178,-686,-1.248,9.860,18,18,227
2010,3113,1434,1571,66130,65496,129,8.217,127,8.089,6241,1250,4991,1.909,9.529,5011,1530,3481,2.336,7.651,1230,1.878,15.302,88,88,466
2010,3114,1225,1584,157828,158397,121,7.749,76,4.867,11610,3002,8608,1.895,7.330,12766,1890,10876,1.193,8.059,-1156,-0.730,14.659,51,51,1031
2010,3115,985,1484,136899,136723,88,5.960,73,4.944,8901,1380,7521,1.009,6.510,8549,2437,6112,1.782,6.253,352,0.257,12.506,48,48,592
2010,3116,2810,3401,490805,494120,167,4.902,178,5.225,23466,3428,20038,0.694,4.749,29686,11390,18296,2.305,6.008,-6220,-1.259,9.498,107,108,1418
2010,3117,472,563,31492,31121,33,5.800,45,7.909,4093,919,3174,2.953,13.152,3369,1014,2355,3.258,10.826,724,2.326,21.651,30,30,550
2010,3118,8521,9236,273630,272749,839,9.119,768,8.347,26237,7663,18574,2.810,9.619,24215,6322,17893,2.318,8.878,2022,0.741,17.756,590,593,3311
2010,3119,2513,2961,163148,162366,229,7.765,205,6.952,14156,2733,11423,1.683,8.719,12564,3660,8904,2.254,7.738,1592,0.981,15.476,148,148,1845
2010,3121,3228,3793,125092,125688,413,11.137,244,6.579,10062,2622,7440,2.086,8.006,11343,2263,9080,1.800,9.025,-1281,-1.019,16.011,171,171,1038
2010,3122,76,101,14064,15597,14,14.359,7,7.179,458,73,385,0.468,2.937,3480,1844,1636,11.823,22.313,-3022,-19.376,5.873,(D),(D),(D)
2010,3131,238,314,27548,29036,11,3.354,39,11.890,1441,281,1160,0.968,4.963,4265,2416,1849,8.321,14.689,-2824,-9.726,9.926,17,17,244
2010,3132,891,995,51536,53918,54,5.284,108,10.568,3766,917,2849,1.701,6.985,8557,2286,6271,4.240,15.870,-4791,-8.886,13.969,80,83,917
2010,3133,1011,1056,30526,31790,87,8.127,116,10.836,3358,1038,2320,3.265,10.563,5717,2205,3512,6.936,17.984,-2359,-7.421,21.126,82,82,753
2010,3141,1788,1903,54361,56459,110,5.577,249,12.624,4438,863,3575,1.529,7.861,8485,1979,6506,3.505,15.029,-4047,-7.168,15.721,178,178,725
2010,3149,3812,3918,57562,58499,342,8.546,510,12.744,6977,2154,4823,3.682,11.927,8843,2457,6386,4.200,15.116,-1866,-3.190,23.853,386,386,1596
2010,3151,274,290,14227,14864,19,6.323,40,13.311,1236,294,942,1.978,8.315,2440,945,1495,6.358,16.416,-1204,-8.100,16.631,32,33,470
2010,3152,5002,5062,94151,96985,723,13.878,1018,19.541,18036,5962,12074,6.147,18.597,23693,9852,13841,10.158,24.430,-5657,-5.833,37.194,833,837,7454
2010,3159,587,602,9630,10150,47,7.624,76,12.328,865,178,687,1.754,8.523,1906,511,1395,5.035,18.779,-1041,-10.257,17.045,57,57,303
2010,3161,176,181,3498,3504,10,5.291,26,13.757,275,27,248,0.771,7.849,297,88,209,2.512,8.477,-22,-0.628,15.699,21,21,77
2010,3162,181,203,11070,11566,12,5.755,23,11.031,468,46,422,0.398,4.047,1435,88,1347,0.761,12.408,-967,-8.361,8.093,15,15,56
2010,3169,684,692,12259,12950,59,8.435,74,10.579,1013,170,843,1.313,7.822,2335,611,1724,4.718,18.031,-1322,-10.208,15.645,53,53,277
2010,3211,2904,3313,78281,80658,205,6.046,360,10.618,7339,1994,5345,2.472,9.099,12155,4375,7780,5.424,15.070,-4816,-5.971,18.198,234,234,1863
2010,3212,1222,1532,64267,68212,55,3.434,194,12.114,6484,1514,4970,2.220,9.506,14218,4202,10016,6.160,20.844,-7734,-11.338,19.011,122,124,1937
2010,3219,7925,8852,209286,219784,548,5.998,1118,12.236,21026,6063,14963,2.759,9.567,41893,12734,29159,5.794,19.061,-20867,-9.494,19.133,733,739,5831
2010,3221,231,444,111275,113494,24,5.351,33,7.358,3247,1139,2108,1.004,2.861,7768,2550,5218,2.247,6.844,-4521,-3.983,5.722,18,18,219
2010,3222,2705,4043,254326,258701,139,3.404,219,5.364,14813,2508,12305,0.969,5.726,23635,5823,17812,2.251,9.136,-8822,-3.410,11.452,133,133,1530
2010,3231,26331,27680,499728,524406,1374,4.836,2834,9.975,33612,11095,22517,2.116,6.410,83287,26010,57277,4.960,15.882,-49675,-9.473,12.819,2264,2270,15366
2010,3241,993,2133,98775,100388,141,6.610,141,6.610,6033,2509,3524,2.499,6.010,9531,2835,6696,2.824,9.494,-3498,-3.484,12.019,53,54,333
2010,3251,1334,2377,147420,149109,119,4.983,141,5.905,9335,2487,6848,1.668,6.261,12612,2472,10140,1.658,8.458,-3277,-2.198,12.521,80,80,1129
2010,3252,973,1276,85600,86964,54,4.206,70,5.452,6354,1494,4860,1.718,7.307,9081,1501,7580,1.726,10.442,-2727,-3.136,14.613,37,40,667
2010,3253,604,834,28692,28945,54,6.479,53,6.359,2395,456,1939,1.575,8.274,2989,754,2235,2.605,10.326,-594,-2.052,16.549,35,35,220
2010,3254,1439,1849,232014,233777,133,7.197,131,7.089,16049,4734,11315,2.025,6.865,19465,2875,16590,1.230,8.326,-3416,-1.461,13.730,71,71,877
2010,3255,1332,1673,51457,53263,71,4.165,134,7.862,3384,757,2627,1.421,6.353,7040,1892,5148,3.552,13.217,-3656,-6.864,12.707,82,82,639
2010,3256,1873,2064,91734,92885,140,6.801,129,6.267,9030,3872,5158,4.169,9.722,11140,2446,8694,2.633,11.993,-2110,-2.272,19.444,89,89,1114
2010,3259,1850,2371,85404,87547,136,5.674,188,7.843,6376,1280,5096,1.462,7.283,10693,2662,8031,3.041,12.214,-4317,-4.931,14.566,121,124,1183
2010,3261,8314,10590,547808,555359,433,4.027,756,7.032,49136,11247,37889,2.025,8.848,64561,21253,43308,3.827,11.625,-15425,-2.777,17.695,476,482,7605
2010,3262,1494,1913,117917,121629,76,3.891,156,7.988,7635,1333,6302,1.096,6.277,15165,5365,9800,4.411,12.468,-7530,-6.191,12.555,77,79,864
2010,3271,1037,1223,33871,34618,86,6.891,136,10.897,2928,728,2200,2.103,8.458,4345,920,3425,2.658,12.551,-1417,-4.093,16.916,96,96,406
2010,3272,1419,1694,80128,85004,109,6.286,189,10.900,3705,566,3139,0.666,4.359,13795,3230,10565,3.800,16.229,-10090,-11.870,8.717,125,125,876
2010,3273,4376,8930,153954,163075,377,4.170,600,6.636,14940,3976,10964,2.438,9.161,33150,6314,26836,3.872,20.328,-18210,-11.167,18.323,228,233,2283
2010,3274,179,309,13029,13425,20,6.462,21,6.785,1067,527,540,3.926,7.948,1866,262,1604,1.952,13.900,-799,-5.952,15.896,12,12,45
2010,3279,2558,2996,62688,65187,166,5.386,338,10.967,5096,1330,3766,2.040,7.818,10189,2546,7643,3.906,15.630,-5093,-7.813,15.635,236,238,1302
2010,3311,368,497,97452,100217,47,9.353,58,11.542,4487,1218,3269,1.215,4.477,10035,1228,8807,1.225,10.013,-5548,-5.536,8.955,45,45,252
2010,3312,473,602,36002,37173,33,5.410,49,8.033,2533,359,2174,0.966,6.814,4820,959,3861,2.580,12.966,-2287,-6.152,13.628,28,28,465
2010,3313,403,524,48785,49657,15,2.786,44,8.171,3488,439,3049,0.884,7.024,5279,815,4464,1.641,10.631,-1791,-3.607,14.048,28,28,359
2010,3314,719,913,55722,57083,57,6.206,68,7.403,3939,831,3108,1.456,6.901,6745,1522,5223,2.666,11.816,-2806,-4.916,13.801,42,42,612
2010,3315,1641,1845,110489,117880,56,2.970,137,7.266,6418,934,5484,0.792,5.445,21092,5022,16070,4.260,17.893,-14674,-12.448,10.889,83,84,2228
2010,3321,2271,2509,102946,106454,68,2.659,165,6.452,7509,1568,5941,1.473,7.054,14553,3000,11553,2.818,13.671,-7044,-6.617,14.108,103,104,1295
2010,3322,1202,1299,39075,40448,62,4.695,105,7.952,3495,754,2741,1.864,8.641,6241,958,5283,2.369,15.430,-2746,-6.789,17.282,62,62,417
2010,3323,11442,12440,309717,331491,536,4.193,1225,9.582,22775,5045,17730,1.522,6.870,66322,14099,52223,4.253,20.007,-43547,-13.137,13.741,817,822,6404
2010,3324,1128,1424,80710,83948,65,4.514,97,6.736,5640,2255,3385,2.686,6.718,12026,2591,9435,3.086,14.326,-6386,-7.607,13.437,68,68,691
2010,3325,570,633,27370,29296,29,4.475,59,9.105,1032,136,896,0.464,3.523,4873,1082,3791,3.693,16.634,-3841,-13.111,7.045,39,39,208
2010,3326,1191,1347,38909,39892,51,3.720,99,7.221,3191,773,2418,1.938,7.999,5253,942,4311,2.361,13.168,-2062,-5.169,15.998,68,69,443
2010,3327,21524,21938,325410,339009,907,4.037,1964,8.742,27627,5845,21782,1.724,8.149,54852,12156,42696,3.586,16.180,-27225,-8.031,16.299,1289,1291,7198
2010,3328,5006,5492,109633,114100,203,3.629,407,7.276,9086,1773,7313,1.554,7.963,17977,4139,13838,3.628,15.755,-8891,-7.792,15.926,297,298,2501
2010,3329,5566,6105,243963,252499,314,5.053,532,8.561,18022,3706,14316,1.468,7.137,35210,7421,27789,2.939,13.945,-17188,-6.807,14.275,367,367,3902
2010,3331,2395,2719,172351,185027,133,4.813,222,8.033,8041,2332,5709,1.260,4.346,33531,5905,27626,3.191,18.122,-25490,-13.776,8.692,155,156,1379
2010,3332,3140,3308,98450,104472,160,4.737,300,8.881,7217,1841,5376,1.762,6.908,19202,3864,15338,3.699,18.380,-11985,-11.472,13.816,209,209,2160
2010,3333,1776,1908,73392,76063,108,5.576,166,8.570,5241,1292,3949,1.699,6.890,10538,2869,7669,3.772,13.854,-5297,-6.964,13.781,106,106,668
2010,3334,1461,1728,118219,125135,96,5.525,115,6.619,10144,3329,6815,2.660,8.106,23542,5469,18073,4.370,18.813,-13398,-10.707,16.213,64,65,1943
2010,3335,6516,6718,129584,135977,253,3.669,607,8.803,10352,2738,7614,2.014,7.613,23226,4475,18751,3.291,17.081,-12874,-9.468,15.226,422,423,2767
2010,3336,806,984,91154,96794,46,4.661,52,5.268,4846,1737,3109,1.795,5.007,15921,1937,13984,2.001,16.448,-11075,-11.442,10.013,29,29,342
2010,3339,5126,5760,245428,256640,267,4.581,404,6.931,13883,3446,10437,1.343,5.410,36037,5207,30830,2.029,14.042,-22154,-8.632,10.819,261,262,2033
2010,3341,969,1017,69205,75007,89,8.620,120,11.622,6463,1568,4895,2.090,8.617,18752,4794,13958,6.391,25.000,-12289,-16.384,17.233,81,82,371
2010,3342,1259,1395,110304,124392,90,6.369,126,8.917,4566,1338,3228,1.076,3.671,31371,3302,28069,2.655,25.219,-26805,-21.549,7.341,77,77,971
2010,3343,423,427,8288,9683,51,11.930,52,12.164,600,292,308,3.016,6.197,3406,1264,2142,13.054,35.177,-2806,-28.980,12.393,32,33,273
2010,3344,3682,4142,279087,288483,231,5.515,324,7.735,23840,5288,18552,1.833,8.264,42562,11983,30579,4.154,14.754,-18722,-6.490,16.528,216,216,3065
2010,3345,4250,4919,385762,390769,306,6.184,364,7.357,27616,5200,22416,1.331,7.067,37130,6971,30159,1.784,9.502,-9514,-2.435,14.134,217,217,1932
2010,3346,540,559,19175,20155,57,9.887,92,15.958,1482,711,771,3.528,7.353,3401,1150,2251,5.706,16.875,-1919,-9.521,14.706,71,73,605
2010,3351,979,1065,45044,47416,74,6.874,97,9.011,2645,794,1851,1.675,5.578,7453,1095,6358,2.309,15.718,-4808,-10.140,11.157,69,69,511
2010,3352,226,268,44790,46608,21,7.650,34,12.386,2101,333,1768,0.714,4.508,5771,1823,3948,3.911,12.382,-3670,-7.874,9.016,22,22,138
2010,3353,1858,2157,111768,117749,82,3.747,145,6.626,5542,1103,4439,0.937,4.707,17540,3696,13844,3.139,14.896,-11998,-10.190,9.413,82,82,479
2010,3359,1774,2057,123502,129024,127,6.131,156,7.531,8215,1997,6218,1.548,6.367,19089,6312,12777,4.892,14.795,-10874,-8.428,12.734,87,93,1233
2010,3361,270,332,131442,133659,43,12.991,41,12.387,15634,3125,12509,2.338,11.697,19778,4528,15250,3.388,14.797,-4144,-3.100,23.394,22,22,201
2010,3362,1576,1815,93056,93999,118,6.349,205,11.030,14094,2607,11487,2.773,14.994,16411,6553,9858,6.971,17.459,-2317,-2.465,29.988,131,133,2949
2010,3363,4021,4926,399843,414489,276,5.507,447,8.919,41915,10381,31534,2.505,10.112,70962,22110,48852,5.334,17.120,-29047,-7.008,20.225,268,278,6416
2010,3364,1208,1644,384668,390735,123,7.479,124,7.540,25606,3330,22276,0.852,6.553,38631,5013,33618,1.283,9.887,-13025,-3.333,13.107,75,76,1677
2010,3365,147,217,23913,25817,13,5.963,15,6.881,1767,770,997,2.983,6.844,5612,732,4880,2.835,21.738,-3845,-14.894,13.689,8,8,146
2010,3366,1325,1440,129275,132947,124,8.470,172,11.749,7981,2231,5750,1.678,6.003,15559,2687,12872,2.021,11.703,-7578,-5.700,12.006,130,131,1230
2010,3369,739,769,38152,41098,85,10.897,107,13.718,2340,523,1817,1.273,5.694,8223,1216,7007,2.959,20.008,-5883,-14.315,11.387,78,78,290
2010,3371,11312,11562,210764,222476,775,6.416,1810,14.984,17602,5123,12479,2.303,7.912,41082,13457,27625,6.049,18.466,-23480,-10.554,15.824,1299,1300,7366
2010,3372,3474,3657,100886,108101,176,4.666,406,10.764,7979,1521,6458,1.407,7.381,22270,4741,17529,4.386,20.601,-14291,-13.220,14.762,303,306,2712
2010,3379,759,858,32208,33356,63,7.143,111,12.585,3088,692,2396,2.075,9.258,5441,2508,2933,7.519,16.312,-2353,-7.054,18.516,76,76,883
2010,3391,10171,11041,284455,291145,674,6.066,815,7.335,21516,4412,17104,1.515,7.390,34957,11141,23816,3.827,12.007,-13441,-4.617,14.780,572,572,3420
2010,3399,14894,15306,271825,281458,1138,7.305,1682,10.797,22423,5663,16760,2.012,7.967,41652,11338,30314,4.028,14.799,-19229,-6.832,15.933,1281,1286,6894
2010,4231,16471,23883,349290,354425,1686,7.031,1878,7.832,33571,12212,21359,3.446,9.472,44208,13329,30879,3.761,12.473,-10637,-3.001,18.944,1230,1314,7328
2010,4232,9971,11639,135911,141371,848,7.139,1328,11.179,13676,4060,9616,2.872,9.674,24667,7558,17109,5.346,17.448,-10991,-7.775,19.348,989,1039,5460
2010,4233,10316,16850,195899,204968,1033,5.977,1901,10.999,20043,6658,13385,3.248,9.779,38412,11761,26651,5.738,18.741,-18369,-8.962,19.557,1050,1110,6032
2010,4234,22309,32308,666559,680547,2820,8.696,3065,9.451,85474,30324,55150,4.456,12.560,112988,29191,83797,4.289,16.603,-27514,-4.043,25.119,1681,1765,9757
2010,4235,7420,10269,139359,145651,528,5.077,789,7.587,10519,3255,7264,2.235,7.222,23112,5627,17485,3.863,15.868,-12593,-8.646,14.444,444,483,3146
2010,4236,17775,27490,483098,496229,2321,8.434,2377,8.638,45993,16837,29156,3.393,9.269,72600,20615,51985,4.154,14.630,-26607,-5.362,18.537,1397,1448,8926
2010,4237,9850,18358,202648,209420,899,4.848,1268,6.838,17143,5585,11558,2.667,8.186,30766,8007,22759,3.823,14.691,-13623,-6.505,16.372,613,653,3037
2010,4238,38954,55531,653376,678254,3142,5.607,4158,7.420,55475,19629,35846,2.894,8.179,104593,25204,79389,3.716,15.421,-49118,-7.242,16.358,2287,2384,11997
2010,4239,26383,29518,308774,313091,3068,10.382,3137,10.615,42143,13781,28362,4.402,13.460,50768,16410,34358,5.241,16.215,-8625,-2.755,26.921,2328,2361,11040
2010,4241,7782,10395,149474,152398,656,6.251,853,8.129,12662,5009,7653,3.287,8.309,18738,5048,13690,3.312,12.295,-6076,-3.987,16.617,531,552,2278
2010,4242,5595,8615,267244,268075,842,9.837,731,8.540,29878,8083,21795,3.015,11.145,31983,8267,23716,3.084,11.931,-2105,-0.785,22.291,454,463,2542
2010,4243,13000,14160,179698,183814,1603,11.242,1802,12.637,23656,7462,16194,4.060,12.870,32163,9300,22863,5.059,17.498,-8507,-4.628,25.739,1397,1429,6566
2010,4244,24109,30833,757726,760497,2443,7.921,2463,7.986,77879,18262,59617,2.401,10.241,82201,23764,58437,3.125,10.809,-4322,-0.568,20.481,1740,1758,13850
2010,4245,3348,5992,62668,61433,362,6.067,312,5.229,8720,2854,5866,4.646,14.194,6326,1739,4587,2.831,10.297,2394,3.897,20.595,157,170,951
2010,4246,7854,11884,137797,140832,756,6.339,840,7.043,12425,3844,8581,2.730,8.823,18490,5089,13401,3.614,13.129,-6065,-4.307,17.645,425,440,1963
2010,4247,4740,7030,106336,108964,331,4.684,404,5.717,8955,2149,6806,1.972,8.218,14405,2743,11662,2.517,13.220,-5450,-5.002,16.437,220,233,1292
2010,4248,3048,3977,175336,175966,336,8.503,285,7.212,13034,4186,8848,2.379,7.407,14481,4136,10345,2.350,8.229,-1447,-0.822,14.814,198,202,2477
2010,4249,20170,26189,323635,328995,2341,8.874,2723,10.322,39103,12158,26945,3.696,11.886,49108,15441,33667,4.693,14.927,-10005,-3.041,23.771,1847,1885,8151
2010,4251,39130,41322,297316,293937,4767,11.411,5673,13.580,66133,32174,33959,10.946,22.499,57771,21564,36207,7.336,19.654,8362,2.845,39.308,4113,4144,15316
2010,4411,37682,42403,1034636,1040670,3195,7.400,4744,10.987,110366,32487,77879,3.122,10.605,122202,53828,68374,5.172,11.743,-11836,-1.137,21.211,3613,3692,41142
2010,4412,12259,13811,121742,129251,947,6.665,1742,12.260,12097,4088,8009,3.163,9.359,27444,8270,19174,6.398,21.233,-15347,-11.874,18.719,1186,1241,5786
2010,4413,27530,54707,471302,465923,2867,5.240,2878,5.260,51946,16663,35283,3.576,11.149,42003,11803,30200,2.533,9.015,9943,2.134,18.030,1839,1919,6644
2010,4421,15039,23531,204554,210571,1586,6.594,2626,10.918,22843,9197,13646,4.368,10.848,35033,12340,22693,5.860,16.637,-12190,-5.789,21.696,1746,1942,9072
2010,4422,20280,28056,221907,226058,1712,5.924,3398,11.758,27805,8036,19769,3.555,12.300,35913,12468,23445,5.515,15.887,-8108,-3.587,24.600,2303,2463,7793
2010,4431,25362,46237,424931,445501,5284,11.225,6961,14.787,65485,27793,37692,6.239,14.699,102728,69512,33216,15.603,23.059,-37243,-8.360,29.398,2991,4382,57905
2010,4441,39648,62330,1060730,1064995,2503,3.949,4610,7.273,83981,16897,67084,1.587,7.886,94384,24801,69583,2.329,8.862,-10403,-0.977,15.771,2871,2993,12438
2010,4442,13752,17243,145286,147282,960,5.515,1290,7.410,16738,5001,11737,3.396,11.365,20859,4957,15902,3.366,14.163,-4121,-2.798,22.729,808,832,2863
2010,4451,57459,83473,2525104,2540589,8319,10.065,6672,8.073,202063,81205,120858,3.196,7.953,233214,54682,178532,2.152,9.180,-31151,-1.226,15.907,4751,4834,24616
2010,4452,16839,20775,142269,141979,2366,11.386,2376,11.434,25022,10534,14488,7.419,17.624,24449,9401,15048,6.621,17.220,573,0.404,34.440,1747,1777,6781
2010,4453,25629,29382,147543,147239,2468,8.463,2031,6.964,20957,8081,12876,5.488,14.233,20428,6250,14178,4.245,13.874,529,0.359,27.748,1527,1555,4868
2010,4461,39062,85935,990792,986451,5475,6.381,5221,6.085,96407,28818,67589,2.921,9.773,87265,25496,61769,2.585,8.846,9142,0.927,17.693,2791,2951,13073
2010,4471,61811,107773,853246,853961,7292,6.760,7499,6.951,115304,40664,74640,4.762,13.502,116821,41100,75721,4.813,13.680,-1517,-0.178,27.005,4496,4805,22020
2010,4481,33006,90798,1204605,1202767,7301,8.003,8154,8.938,175655,67858,107797,5.642,14.604,170603,57281,113322,4.762,14.184,5052,0.420,28.368,4292,5150,25040
2010,4482,5711,25488,196911,196248,1068,4.151,1545,6.005,23210,6869,16341,3.500,11.827,21708,6670,15038,3.399,11.062,1502,0.765,22.123,584,758,2106
2010,4483,16024,23177,127444,132284,1517,6.387,2666,11.225,16250,5184,11066,3.919,12.284,25817,12944,12873,9.785,19.516,-9567,-7.232,24.568,1254,1400,5319
2010,4511,25463,35350,402585,400829,2796,7.836,3459,9.694,51977,14235,37742,3.551,12.967,47997,14493,33504,3.616,11.974,3980,0.993,23.949,2433,2719,10300
2010,4512,4570,9547,120942,128509,538,5.480,1078,10.981,14368,3305,11063,2.572,11.181,29197,6453,22744,5.021,22.720,-14829,-11.539,22.361,550,574,2017
2010,4521,35,8406,1156075,1171661,98,1.164,128,1.520,51151,8582,42569,0.732,4.366,82898,6970,75928,0.595,7.075,-31747,-2.710,8.731,13,13,62
2010,4529,7069,35994,1633553,1678177,2229,6.264,1404,3.946,66467,32835,33632,1.957,3.961,152881,8141,144740,0.485,9.110,-86414,-5.149,7.921,867,904,2935
2010,4531,14359,15018,70317,72773,999,6.449,1943,12.544,9457,3740,5717,5.139,12.995,14471,5014,9457,6.890,19.885,-5014,-6.890,25.991,1555,1591,4146
2010,4532,21367,32035,269209,273146,2258,6.884,3789,11.552,30452,8751,21701,3.204,11.149,38361,13874,24487,5.079,14.044,-7909,-2.896,22.297,2693,2903,9372
2010,4533,11560,16566,147194,144157,1714,10.457,1364,8.322,22239,9681,12558,6.716,15.427,16411,4293,12118,2.978,11.384,5828,4.043,22.768,1023,1043,2810
2010,4539,28126,36939,230988,234623,3626,9.730,4279,11.482,32329,14621,17708,6.232,13.779,39651,13164,26487,5.611,16.900,-7322,-3.121,27.558,2999,3110,9412
2010,4541,19140,20202,314829,315003,3089,15.501,2541,12.751,47126,17508,29618,5.558,14.961,47795,15548,32247,4.936,15.173,-669,-0.212,29.921,1962,1976,8982
2010,4542,3585,4060,36569,37480,377,9.099,544,13.129,4382,2118,2264,5.651,11.692,6241,1790,4451,4.776,16.652,-1859,-4.960,23.383,397,421,1268
2010,4543,20995,26878,190830,194983,1997,7.352,2563,9.436,20680,6807,13873,3.491,10.606,28908,9974,18934,5.115,14.826,-8228,-4.220,21.212,1819,1854,6999
2010,4811,423,2629,384443,394432,223,8.209,398,14.651,40433,5186,35247,1.315,10.251,60620,31489,29131,7.983,15.369,-20187,-5.118,20.502,53,55,376
2010,4812,1923,2100,32531,33606,262,12.441,274,13.010,4136,2144,1992,6.380,12.308,6320,2451,3869,7.293,18.806,-2184,-6.499,24.615,200,206,859
2010,4831,671,1031,46140,47343,105,10.204,101,9.815,4473,1587,2886,3.352,9.448,6997,1320,5677,2.788,14.779,-2524,-5.331,18.896,67,68,676
2010,4832,432,493,17228,17957,45,9.000,59,11.800,800,263,537,1.465,4.455,2278,434,1844,2.417,12.686,-1478,-8.231,8.910,41,41,399
2010,4841,43737,52817,841907,860474,7202,13.445,8701,16.243,105824,33997,71827,3.951,12.298,141292,44560,96732,5.179,16.420,-35468,-4.122,24.597,6075,6131,23942
2010,4842,36280,40401,420583,431263,4311,10.484,5748,13.979,59183,20242,38941,4.694,13.723,80245,24358,55887,5.648,18.607,-21062,-4.884,27.446,3847,3880,15740
2010,4851,551,788,47945,48074,66,8.260,88,11.014,5163,3100,2063,6.448,10.740,5446,2016,3430,4.194,11.328,-283,-0.589,21.480,59,59,358
2010,4852,190,372,12425,12007,34,8.995,46,12.169,2955,389,2566,3.240,24.611,2015,969,1046,8.070,16.782,940,7.829,33.564,17,17,212
2010,4853,6025,6151,63624,63951,970,15.792,953,15.515,9469,4466,5003,6.983,14.807,10219,3755,6464,5.872,15.979,-750,-1.173,29.613,734,734,3030
2010,4854,2752,4322,212047,212675,277,6.371,328,7.545,20909,7702,13207,3.621,9.831,22468,6765,15703,3.181,10.564,-1559,-0.733,19.663,146,146,2195
2010,4855,1137,1255,29914,29663,129,10.291,126,10.052,4118,1279,2839,4.312,13.883,3608,901,2707,3.037,12.163,510,1.719,24.327,96,96,697
2010,4859,3090,3499,73345,71555,568,16.718,365,10.743,12081,5004,7077,6.993,16.884,8571,3262,5309,4.559,11.978,3510,4.905,23.956,276,280,2271
2010,4861,53,428,7910,7595,57,13.801,27,6.538,1351,420,931,5.530,17.789,739,93,646,1.225,9.731,612,8.058,19.461,(D),(D),(D)
2010,4862,115,1834,29221,28772,133,7.387,66,3.666,5575,605,4970,2.103,19.377,4715,400,4315,1.390,16.388,860,2.989,32.775,8,8,51
2010,4869,57,695,7572,7973,29,4.108,51,7.224,1429,127,1302,1.593,17.924,2196,538,1658,6.748,27.545,-767,-9.621,35.848,4,4,49
2010,4871,474,512,8758,8840,75,14.677,73,14.286,1235,338,897,3.824,13.971,1415,621,794,7.025,16.007,-180,-2.036,27.941,51,51,366
2010,4872,1110,1154,9939,10159,155,13.180,199,16.922,1573,506,1067,4.981,15.485,2047,580,1467,5.710,20.151,-474,-4.666,30.969,123,123,373
2010,4879,139,150,1924,2058,21,14.141,18,12.121,302,103,199,5.006,14.678,588,432,156,20.996,28.578,-286,-13.900,29.356,9,9,362
2010,4881,3736,5411,159957,162787,582,10.791,547,10.142,22840,11556,11284,7.099,14.031,28452,7716,20736,4.740,17.478,-5612,-3.447,28.061,291,304,2486
2010,4882,470,1126,25921,26135,146,13.243,99,8.980,3873,2169,1704,8.299,14.819,4402,1324,3078,5.066,16.844,-529,-2.024,29.639,37,38,331
2010,4883,1644,2188,84137,84363,176,8.064,165,7.560,9636,2216,7420,2.627,11.422,10089,1498,8591,1.776,11.959,-453,-0.537,22.844,105,106,662
2010,4884,8422,9239,73075,74214,1164,12.696,1022,11.147,12380,5332,7048,7.185,16.681,14755,6147,8608,8.283,19.882,-2375,-3.200,33.363,757,761,4135
2010,4885,13164,19219,214783,221210,1852,9.562,2152,11.111,28183,10023,18160,4.531,12.740,41017,12916,28101,5.839,18.542,-12834,-5.802,25.481,1159,1234,5884
2010,4889,1173,1293,23848,24268,149,11.418,173,13.257,2385,970,1415,3.997,9.828,3242,1133,2109,4.669,13.359,-857,-3.531,19.656,133,133,592
2010,4921,3157,8193,486631,500771,684,8.100,1186,14.045,22376,5857,16519,1.170,4.468,50304,16500,33804,3.295,10.045,-27928,-5.577,8.937,435,460,3044
2010,4922,3679,3943,30076,30850,502,12.600,584,14.659,5442,2285,3157,7.407,17.640,7016,2345,4671,7.601,22.742,-1574,-5.102,35.280,470,479,2003
2010,4931,6817,14066,666792,674397,1102,7.811,1187,8.413,75566,26061,49505,3.864,11.205,89894,23669,66225,3.510,13.330,-14328,-2.125,22.410,416,450,5603
2010,5111,13399,19335,528448,556203,1277,6.478,2033,10.313,40122,13479,26643,2.423,7.214,95556,25617,69939,4.606,17.180,-55434,-9.967,14.427,1181,1205,7252
2010,5112,5061,7314,371831,374084,633,8.538,832,11.223,41639,20630,21009,5.515,11.131,46452,18294,28158,4.890,12.418,-4813,-1.287,22.262,364,389,4964
2010,5121,12360,15760,293534,298206,2097,13.219,2304,14.524,36192,13490,22702,4.524,12.137,45715,11864,33851,3.978,15.330,-9523,-3.193,24.273,1421,1450,6443
2010,5122,2783,3062,23136,23334,433,14.185,414,13.563,4109,2557,1552,10.958,17.610,4614,1272,3342,5.451,19.774,-505,-2.164,35.220,283,284,905
2010,5151,4102,8949,218654,223458,693,7.854,441,4.998,16027,6094,9933,2.727,7.172,24971,6614,18357,2.960,11.175,-8944,-4.003,14.345,242,245,3292
2010,5152,398,686,41591,41498,76,11.119,71,10.388,6390,2983,3407,7.188,15.398,5906,2208,3698,5.321,14.232,484,1.166,28.464,35,35,218
2010,5171,3259,32752,798402,817239,3175,9.667,3360,10.230,83683,36262,47421,4.437,10.240,120159,39574,80585,4.842,14.703,-36476,-4.463,20.479,268,279,2624
2010,5172,1004,11138,256535,267952,1309,11.442,1913,16.722,22009,9577,12432,3.574,8.214,43327,26699,16628,9.964,16.170,-21318,-7.956,16.428,111,118,486
2010,5174,390,505,7577,7793,83,16.468,81,16.071,1296,749,547,9.611,16.630,1736,938,798,12.036,22.276,-440,-5.646,33.261,52,53,387
2010,5179,3928,4378,52422,53885,626,13.992,818,18.283,8822,3128,5694,5.805,16.372,11785,3953,7832,7.336,21.871,-2963,-5.499,32.744,657,666,2701
2010,5182,7911,11893,391337,394600,1469,12.350,1473,12.383,77091,26585,50506,6.737,19.536,83322,26133,57189,6.623,21.116,-6231,-1.579,39.073,685,704,6708
2010,5191,6238,7792,137068,139134,1313,17.251,951,12.495,28919,15187,13732,10.915,20.785,32883,6898,25985,4.958,23.634,-3964,-2.849,41.570,638,639,2813
2010,5211,12,46,17380,18078,(D),(D),3,6.383,344,(D),339,(D),1.903,1811,871,940,4.818,10.018,-1467,-8.115,3.806,(D),(D),(D)
2010,5221,13998,124157,1982077,2005622,5000,3.984,7675,6.116,206066,47079,158987,2.347,10.274,251402,69601,181801,3.470,12.535,-45336,-2.260,20.549,377,729,10566
2010,5222,13959,39261,518830,537907,4513,11.214,6480,16.102,105009,50747,54262,9.434,19.522,142429,50012,92417,9.298,26.478,-37420,-6.957,39.044,1805,2099,12016
2010,5223,14023,30715,252593,261536,2653,8.178,6102,18.810,39428,14963,24465,5.721,15.076,57219,26659,30560,10.193,21.878,-17791,-6.803,30.151,3566,3852,15434
2010,5231,11582,41006,423984,454126,5996,14.454,6953,16.760,77096,26398,50698,5.813,16.977,136411,43186,93225,9.510,30.038,-59315,-13.061,33.954,969,1018,3495
2010,5232,16,75,4957,5193,(D),(D),16,20.645,172,(D),104,(D),3.312,628,45,583,0.867,12.094,-456,-8.782,6.625,8,8,16
2010,5239,37624,43199,436150,433685,5877,13.698,5286,12.321,81732,42651,39081,9.835,18.846,76436,28199,48237,6.502,17.625,5296,1.221,35.250,3505,3549,13160
2010,5241,5464,30979,1409109,1443066,4150,13.051,5789,18.205,145800,63026,82774,4.368,10.103,213681,68410,145271,4.741,14.807,-67881,-4.704,20.207,453,516,3919
2010,5242,118812,133299,849512,861500,10435,7.808,11117,8.319,106360,39338,67022,4.566,12.346,131035,47233,83802,5.483,15.210,-24675,-2.864,24.692,7432,7510,20913
2010,5250,1316,1344,18032,13520,522,47.802,18,1.648,10282,6704,3578,49.588,76.053,1028,100,928,0.740,7.604,9254,68.449,15.208,9,9,11
2010,5311,82538,105161,512447,512211,9466,9.047,8405,8.033,78828,39017,39811,7.617,15.390,78234,27719,50515,5.412,15.274,594,0.116,30.548,5947,6019,17938
2010,5312,59389,69733,274210,281304,11486,16.371,12340,17.588,57202,30439,26763,10.821,20.335,70700,32657,38043,11.609,25.133,-13498,-4.798,40.669,7720,7890,16417
2010,5313,59383,73124,607552,612665,9500,13.097,8321,11.472,91393,42576,48817,6.949,14.917,101289,39093,62196,6.381,16.533,-9896,-1.615,29.835,5305,5360,21869
2010,5321,3670,10472,147731,150449,1128,10.666,1335,12.624,17416,8985,8431,5.972,11.576,22852,12788,10064,8.500,15.189,-5436,-3.613,23.152,441,459,1671
2010,5322,8752,25805,191607,199577,1337,4.965,3589,13.327,22724,6255,16469,3.134,11.386,39028,19992,19036,10.017,19.555,-16304,-8.169,22.772,1201,1294,5627
2010,5323,2590,4001,24636,25195,179,4.428,262,6.481,2067,706,1361,2.802,8.204,3159,926,2233,3.675,12.538,-1092,-4.334,16.408,160,164,519
2010,5324,7077,12696,141477,147725,968,7.517,1330,10.328,16841,5904,10937,3.997,11.400,29474,8355,21119,5.656,19.952,-12633,-8.552,22.800,636,646,3209
2010,5331,1983,2066,28663,29367,237,11.480,234,11.334,4117,1587,2530,5.404,14.019,5451,2129,3322,7.250,18.562,-1334,-4.543,28.039,171,171,1548
2010,5411,161049,170892,1148740,1159019,13673,8.023,12738,7.474,120464,45639,74825,3.938,10.394,141740,36233,105507,3.126,12.229,-21276,-1.836,20.787,9014,9094,25228
2010,5412,97331,112842,1266123,1278326,11533,10.283,10151,9.051,201665,80320,121345,6.283,15.776,226026,68491,157535,5.358,17.681,-24361,-1.906,31.551,5850,5904,33486
2010,5413,80146,96468,1276881,1309767,9208,9.411,11955,12.219,156513,53336,103177,4.072,11.950,222389,53126,169263,4.056,16.979,-65876,-5.030,23.899,7017,7128,25464
2010,5414,24476,24737,104514,109700,3107,12.170,4691,18.375,15004,6948,8056,6.334,13.677,25296,10636,14660,9.696,23.059,-10292,-9.382,27.355,3241,3245,7621
2010,5415,86047,103042,1409851,1380990,17681,17.285,16179,15.817,274509,96550,177959,6.991,19.878,217141,74921,142220,5.425,15.724,57368,4.154,31.447,9774,9931,36478
2010,5416,103478,111129,861985,856073,20453,18.514,19139,17.325,176624,78050,98574,9.117,20.632,165322,65032,100290,7.597,19.312,11302,1.320,38.623,13181,13234,39012
2010,5417,12012,14815,643239,645707,1895,12.875,1703,11.570,76913,22474,54439,3.481,11.911,81220,22250,58970,3.446,12.578,-4307,-0.667,23.823,1030,1044,7325
2010,5418,29905,33381,410405,419364,3591,10.571,4771,14.044,57283,25298,31985,6.032,13.659,75999,28379,47620,6.767,18.122,-18716,-4.463,27.319,3400,3442,19909
2010,5419,51771,61064,581944,590191,5484,8.940,6042,9.850,75270,23992,51278,4.065,12.754,91924,32212,59712,5.458,15.575,-16654,-2.822,25.507,3935,3990,16108
2010,5511,26631,49750,2823941,2828514,4056,8.112,4562,9.123,390771,122493,268278,4.331,13.815,398040,103400,294640,3.656,14.072,-7269,-0.257,27.631,907,976,15777
2010,5611,22846,24939,402356,398661,3245,13.044,3120,12.542,69726,25593,44133,6.420,17.490,61643,22566,39077,5.660,15.463,8083,2.028,30.925,2296,2302,15615
2010,5612,1692,5478,240742,235033,1291,25.183,588,11.470,55099,28263,26836,12.025,23.443,42094,14369,27725,6.114,17.910,13005,5.533,35.820,104,104,1338
2010,5613,24359,43484,3979752,3936751,4909,10.897,8037,17.841,906308,194583,711725,4.943,23.022,818819,250575,568244,6.365,20.799,87489,2.222,41.599,3562,3821,112452
2010,5614,25330,32113,766593,792411,3224,9.978,3617,11.195,110774,42379,68395,5.348,13.979,164411,47319,117092,5.972,20.748,-53637,-6.769,27.959,2573,2610,22607
2010,5615,13433,18882,227586,229746,1938,10.007,2905,15.001,32538,9831,22707,4.279,14.163,36685,13508,23177,5.880,15.968,-4147,-1.805,28.325,1370,1426,5550
2010,5616,17377,23401,778831,786165,2525,10.752,2692,11.463,107137,33377,73760,4.246,13.628,121692,36645,85047,4.661,15.479,-14555,-1.851,27.256,1586,1730,12374
2010,5617,134912,142009,1613530,1615206,19466,13.710,19422,13.679,267260,95098,172162,5.888,16.547,272203,87699,184504,5.430,16.853,-4943,-0.306,33.093,12620,12639,56477
2010,5619,15802,17812,256273,266257,1714,9.519,2102,11.674,33341,9816,23525,3.687,12.522,54092,20603,33489,7.738,20.316,-20751,-7.794,25.044,1376,1385,14735
2010,5621,7141,9488,187014,188438,915,9.713,780,8.280,19667,9044,10623,4.799,10.437,22509,7474,15035,3.966,11.945,-2842,-1.508,20.874,524,528,3581
2010,5622,1326,2457,51243,52522,203,8.315,172,7.045,5976,2611,3365,4.971,11.378,8855,3129,5726,5.958,16.860,-2879,-5.482,22.756,85,85,522
2010,5629,7537,8630,116791,117283,777,8.992,799,9.247,20388,6089,14299,5.192,17.384,21540,6203,15337,5.289,18.366,-1152,-0.982,34.767,499,520,4581
2010,6111,17911,20256,851461,846368,854,4.301,52,0.262,59847,13198,46649,1.559,7.071,49688,319,49369,0.038,5.871,10159,1.200,11.741,39,39,299
2010,6112,452,903,86244,81102,66,7.582,(D),(D),12903,3096,9807,3.817,15.910,2743,(D),2742,(D),3.382,10160,12.528,6.764,(D),(D),(D)
2010,6113,2145,3983,1717260,1691880,184,4.725,7,0.180,97063,5436,91627,0.321,5.737,46354,13,46341,0.001,2.740,50709,2.997,5.480,6,6,10
2010,6114,6145,6679,62711,62975,755,11.208,870,12.915,10357,4411,5946,7.004,16.446,10862,3612,7250,5.736,17.248,-505,-0.802,32.893,586,596,2508
2010,6115,6048,7649,130520,126179,823,10.891,638,8.443,24394,7554,16840,5.987,19.333,15586,4837,10749,3.833,12.352,8808,6.981,24.705,470,476,3132
2010,6116,33174,36025,336480,330453,5037,14.210,3880,10.946,72502,31596,40906,9.561,21.940,60298,19227,41071,5.818,18.247,12204,3.693,36.494,2765,2782,12727
2010,6117,5352,6126,80442,78981,1051,17.323,933,15.378,15988,6980,9008,8.838,20.243,13141,3562,9579,4.510,16.638,2847,3.605,33.276,524,528,1820
2010,6211,175276,207302,2203813,2202393,15421,7.479,13221,6.412,262137,98238,163899,4.461,11.902,258999,72597,186402,3.296,11.760,3138,0.142,23.520,9259,9471,46258
2010,6212,117696,124661,845825,841893,5981,4.829,4356,3.517,91714,29389,62325,3.491,10.894,83858,19696,64162,2.339,9.961,7856,0.933,19.921,3342,3386,14806
2010,6213,108212,121890,678051,666362,11870,9.894,8037,6.699,109954,41226,68728,6.187,16.501,86872,26152,60720,3.925,13.037,23082,3.464,26.074,5418,5470,16176
2010,6214,14537,32237,712856,706329,2793,8.822,1641,5.183,92210,33776,58434,4.782,13.055,78510,22386,56124,3.169,11.115,13700,1.940,22.230,804,847,8724
2010,6215,7099,12548,248803,247259,1279,10.225,1201,9.601,28412,9195,19217,3.719,11.491,25301,9613,15688,3.888,10.233,3111,1.258,20.465,636,693,5113
2010,6216,17462,25429,1171995,1138397,3711,15.133,1898,7.740,195633,63673,131960,5.593,17.185,128476,34090,94386,2.995,11.286,67157,5.899,22.571,1253,1308,18797
2010,6219,5822,9274,284598,285059,947,10.348,702,7.671,36206,12200,24006,4.280,12.701,37352,12867,24485,4.514,13.103,-1146,-0.402,25.403,336,347,3809
2010,6221,2954,5077,5144442,5142537,89,1.757,68,1.342,158904,27787,131117,0.540,3.090,156505,23504,133001,0.457,3.043,2399,0.047,6.087,35,35,12839
2010,6222,436,612,219541,218379,27,4.459,14,2.312,8101,1813,6288,0.830,3.710,5849,1038,4811,0.475,2.678,2252,1.031,5.357,9,9,886
2010,6223,404,894,263382,258341,64,7.293,31,3.533,18273,6391,11882,2.474,7.073,8352,1570,6782,0.608,3.233,9921,3.840,6.466,20,20,405
2010,6231,8068,15642,1624949,1614934,761,4.864,771,4.927,119814,43439,76375,2.690,7.419,99511,30537,68974,1.891,6.162,20303,1.257,12.324,306,321,16615
2010,6232,8779,34594,643386,638174,3045,9.019,1381,4.090,86387,40266,46121,6.310,13.537,75546,13196,62350,2.068,11.838,10841,1.699,23.676,359,416,3740
2010,6233,14813,21160,819589,806882,2063,9.940,1252,6.032,93101,43303,49798,5.367,11.538,67464,23160,44304,2.870,8.361,25637,3.177,16.722,771,784,9656
2010,6239,3359,5676,142280,144660,342,5.949,488,8.488,14622,5125,9497,3.543,10.108,19289,5904,13385,4.081,13.334,-4667,-3.226,20.216,278,293,3171
2010,6241,41243,57831,1334703,1310247,5629,9.821,4603,8.031,193594,54802,138792,4.183,14.775,143564,32875,110689,2.509,10.957,50030,3.818,21.914,2925,3054,17581
2010,6242,10096,13781,177262,175288,859,6.249,788,5.733,22859,6476,16383,3.695,13.041,18695,5545,13150,3.163,10.665,4164,2.376,21.331,524,531,3755
2010,6243,4226,7859,347903,337923,853,11.162,419,5.483,59849,16321,43528,4.830,17.711,39993,6635,33358,1.963,11.835,19856,5.876,23.670,175,189,1632
2010,6244,55701,70927,861147,865634,6929,9.810,6336,8.971,107632,44890,62742,5.186,12.434,115937,36813,79124,4.253,13.393,-8305,-0.959,24.868,4521,4635,25491
2010,7111,6911,7043,116166,117779,720,10.119,864,12.143,16788,4859,11929,4.126,14.254,19879,5302,14577,4.502,16.878,-3091,-2.624,28.508,585,586,3841
2010,7112,3302,3469,121172,121975,478,13.757,489,14.074,12999,3301,9698,2.706,10.657,14778,3117,11661,2.555,12.116,-1779,-1.459,21.314,369,372,2248
2010,7113,5187,5509,127294,126389,575,10.387,629,11.362,19125,5047,14078,3.993,15.132,17421,3815,13606,3.018,13.784,1704,1.348,27.567,446,449,2774
2010,7114,2726,2820,17419,17828,415,14.722,413,14.651,2365,1027,1338,5.761,13.266,3228,1115,2113,6.254,18.106,-863,-4.841,26.531,282,283,795
2010,7115,13201,13235,43380,43338,2384,17.973,2443,18.418,12271,6523,5748,15.052,28.315,12042,5058,6984,11.671,27.787,229,0.528,55.573,1468,1468,3221
2010,7121,6320,6800,126086,127322,327,4.817,304,4.478,9895,2859,7036,2.245,7.772,12513,2512,10001,1.973,9.828,-2618,-2.056,15.543,186,186,1696
2010,7131,2110,2526,147111,143076,368,14.545,376,14.862,19230,3757,15473,2.626,13.440,10906,2955,7951,2.065,7.623,8324,5.818,15.245,272,276,2423
2010,7132,1718,2533,170275,171065,333,13.534,188,7.641,13798,7168,6630,4.190,8.066,15404,3668,11736,2.144,9.005,-1606,-0.939,16.132,146,152,3098
2010,7139,48705,55504,1126183,1133918,5516,9.907,5868,10.539,136338,56011,80327,4.940,12.024,152662,42173,110489,3.719,13.463,-16324,-1.440,24.047,4451,4506,31579
2010,7211,38527,49236,1768939,1782792,3945,8.051,3474,7.090,178986,82156,96830,4.608,10.040,206066,52280,153786,2.932,11.559,-27080,-1.519,20.079,2186,2225,28022
2010,7212,5208,5755,38598,38330,481,8.385,444,7.740,5980,1517,4463,3.958,15.602,5417,1266,4151,3.303,14.133,563,1.469,28.265,265,265,771
2010,7213,1884,1993,10548,10692,153,7.721,130,6.561,1283,496,787,4.639,12.000,1560,303,1257,2.834,14.590,-277,-2.591,23.999,97,97,220
2010,7223,11947,35705,631165,635797,4612,13.050,3885,10.993,101426,50459,50967,7.936,15.953,109712,37388,72324,5.880,17.256,-8286,-1.303,31.905,1491,1587,9852
2010,7224,39431,40161,346932,347415,3967,9.818,4453,11.021,63561,30486,33075,8.775,18.295,64493,26222,38271,7.548,18.564,-932,-0.268,36.591,3570,3575,21745
2010,7225,328793,454485,8498860,8551800,49242,10.921,42092,9.335,1141684,588907,552777,6.886,13.350,1240243,400682,839561,4.685,14.503,-98559,-1.152,26.700,31802,32726,279662
2010,8111,133061,145807,790416,797219,11721,8.012,12686,8.672,107017,41840,65177,5.248,13.424,120375,38511,81864,4.831,15.099,-13358,-1.676,26.848,8838,8984,27176
2010,8112,9981,11348,112806,114579,1126,9.854,1283,11.228,17064,5861,11203,5.115,14.893,20737,9132,11605,7.970,18.098,-3673,-3.206,29.786,888,896,3422
2010,8113,18367,19996,181648,186875,1515,7.470,2084,10.276,23846,9378,14468,5.018,12.760,34420,9122,25298,4.881,18.419,-10574,-5.658,25.521,1397,1398,4309
2010,8114,16829,17600,69945,71238,1878,10.575,2195,12.360,10779,4710,6069,6.612,15.131,13292,5518,7774,7.746,18.659,-2513,-3.528,30.262,1527,1527,3577
2010,8121,86298,102543,625916,621849,12050,11.789,11397,11.150,109540,47898,61642,7.703,17.615,101722,41114,60608,6.612,16.358,7818,1.257,32.716,8663,8780,31167
2010,8122,14560,19873,133859,134168,720,3.621,746,3.751,11815,2974,8841,2.217,8.806,12582,2506,10076,1.868,9.378,-767,-0.572,17.612,403,412,1373
2010,8123,29389,34868,305353,310616,2722,7.764,3102,8.848,31806,12279,19527,3.953,10.240,42254,13187,29067,4.245,13.603,-10448,-3.364,20.479,2296,2352,8767
2010,8129,21704,32232,240694,241524,4831,15.220,3849,12.126,47184,23937,23247,9.911,19.536,48173,24059,24114,9.961,19.945,-989,-0.409,39.072,2143,2161,9842
2010,8131,174478,174824,1686389,1677630,8767,5.138,383,0.224,153946,27480,126466,1.638,9.176,137246,1083,136163,0.065,8.181,16700,0.995,16.362,229,229,583
2010,8132,14847,16818,167588,169181,1219,7.293,1013,6.060,16339,5228,11111,3.090,9.658,19626,3763,15863,2.224,11.601,-3287,-1.943,19.315,672,683,2414
2010,8133,13069,15448,141678,141625,1226,7.988,1027,6.691,17782,4294,13488,3.032,12.556,17664,3924,13740,2.771,12.472,118,0.083,24.945,660,697,2844
2010,8134,24101,25940,238406,240989,1135,4.355,1379,5.291,25833,6204,19629,2.574,10.720,30959,5781,25178,2.399,12.847,-5126,-2.127,21.439,917,918,3668
2010,8139,56001,58238,497844,499912,2973,5.156,1808,3.136,49703,11849,37854,2.370,9.942,53920,6143,47777,1.229,10.786,-4217,-0.844,19.885,1268,1275,4117
2011,2111,5787,7162,114588,111429,706,9.951,571,8.048,19535,6815,12720,6.116,17.531,13196,3911,9285,3.510,11.843,6339,5.689,23.685,374,381,1534
2011,2121,542,982,84990,83500,107,10.930,101,10.317,10642,3135,7507,3.755,12.745,7603,1828,5775,2.189,9.105,3039,3.640,18.211,63,69,1018
2011,2122,238,300,34868,33476,48,16.725,22,7.666,4697,457,4240,1.365,14.031,1861,158,1703,0.472,5.559,2836,8.472,11.118,18,18,145
2011,2123,2859,4910,79187,79311,299,6.067,335,6.798,8528,1665,6863,2.099,10.753,8749,2302,6447,2.903,11.031,-221,-0.279,21.505,198,199,1227
2011,2131,9505,11883,334867,310225,1641,14.115,1127,9.694,90407,21726,68681,7.003,29.142,40799,12277,28522,3.957,13.151,49608,15.991,26.303,738,741,6196
2011,2211,1669,10057,514577,514818,646,6.411,686,6.808,38335,14282,24053,2.774,7.446,39131,13816,25315,2.684,7.601,-796,-0.155,14.893,49,51,317
2011,2212,432,2497,85050,84987,132,5.300,119,4.778,6469,2081,4388,2.449,7.612,6273,1601,4672,1.884,7.381,196,0.231,14.762,21,21,253
2011,2213,3402,4574,41878,42002,207,4.517,225,4.909,2884,819,2065,1.950,6.866,3070,801,2269,1.907,7.309,-186,-0.443,13.733,121,127,404
2011,2361,118568,119820,530588,547552,22266,18.214,27118,22.183,124497,57227,67270,10.451,22.737,158402,70791,87611,12.929,28.929,-33905,-6.192,45.474,17169,17209,46097
2011,2362,36147,37571,555150,568361,4207,11.057,5162,13.567,99010,23574,75436,4.148,17.420,124924,29019,95905,5.106,21.980,-25914,-4.559,34.841,3373,3390,16795
2011,2371,16309,17754,475341,474909,1736,9.727,1924,10.780,89787,18247,71540,3.842,18.906,87968,16729,71239,3.523,18.523,1819,0.383,37.046,1238,1243,8691
2011,2372,5897,5977,34578,36643,569,9.051,1188,18.898,4960,1677,3283,4.577,13.536,9114,3685,5429,10.056,24.872,-4154,-11.336,27.072,919,922,2716
2011,2373,8650,9489,259768,265181,664,6.903,924,9.606,35792,5084,30708,1.917,13.497,46512,7433,39079,2.803,17.540,-10720,-4.043,26.994,559,564,4263
2011,2379,3563,3704,62912,62551,417,11.126,505,13.474,14391,2363,12028,3.778,23.007,13689,3674,10015,5.874,21.885,702,1.122,43.769,302,302,1825
2011,2381,69877,70726,642937,665201,9907,13.662,13484,18.595,137958,36241,101717,5.448,20.739,181602,55020,126582,8.271,27.300,-43644,-6.561,41.479,8227,8235,36554
2011,2382,147980,151923,1580282,1596491,14566,9.518,16798,10.976,245987,51780,194207,3.243,15.408,278871,65576,213295,4.108,17.468,-32884,-2.060,30.816,11458,11489,46325
2011,2383,86017,87026,592634,609297,12636,14.242,16027,18.064,123700,36485,87215,5.988,20.302,156903,47717,109186,7.831,25.752,-33203,-5.449,40.604,10259,10276,32965
2011,2389,49174,49878,432696,435018,6921,13.665,8460,16.704,91599,22898,68701,5.264,21.056,96416,29903,66513,6.874,22.164,-4817,-1.107,42.113,5207,5220,20475
2011,3111,1075,1662,49953,50063,76,4.569,79,4.749,3795,727,3068,1.452,7.581,3970,726,3244,1.450,7.930,-175,-0.350,15.161,48,48,262
2011,3112,427,757,53194,53206,36,4.762,34,4.497,3252,592,2660,1.113,6.112,3285,710,2575,1.334,6.174,-33,-0.062,12.224,24,24,212
2011,3113,1442,1577,68661,68385,124,7.891,113,7.191,5962,1009,4953,1.475,8.718,5361,883,4478,1.291,7.839,601,0.879,15.679,80,80,561
2011,3114,1208,1566,154811,154433,87,5.552,89,5.680,11357,1326,10031,0.859,7.354,10465,1905,8560,1.234,6.776,892,0.578,13.553,56,56,1293
2011,3115,982,1485,135864,136118,90,6.075,83,5.602,8271,1528,6743,1.123,6.076,8798,1566,7232,1.150,6.464,-527,-0.387,12.153,62,62,560
2011,3116,2809,3400,486141,488347,185,5.440,187,5.498,28841,4757,24084,0.974,5.906,33274,7640,25634,1.564,6.814,-4433,-0.908,11.812,133,134,3040
2011,3117,454,546,31295,31437,32,5.750,53,9.524,2783,463,2320,1.473,8.853,3047,834,2213,2.653,9.692,-264,-0.840,17.705,35,35,485
2011,3118,8839,9562,279224,277962,979,10.361,752,7.959,26904,7008,19896,2.521,9.679,24332,6201,18131,2.231,8.754,2572,0.925,17.507,577,577,4298
2011,3119,2635,3077,162258,162940,288,9.536,174,5.762,12945,3171,9774,1.946,7.945,14317,3792,10525,2.327,8.787,-1372,-0.842,15.889,124,124,1516
2011,3121,3486,4071,128964,127038,539,13.696,268,6.810,16230,4356,11874,3.429,12.776,12236,3493,8743,2.750,9.632,3994,3.144,19.264,187,189,1103
2011,3122,94,117,15020,14550,23,21.005,8,7.306,1823,173,1650,1.189,12.529,912,118,794,0.811,6.268,911,6.261,12.536,6,6,32
2011,3131,243,319,27168,27350,21,6.625,17,5.363,2264,703,1561,2.570,8.278,2657,778,1879,2.845,9.715,-393,-1.437,16.556,13,13,93
2011,3132,871,964,51915,51517,52,5.325,77,7.885,5183,646,4537,1.254,10.061,4393,1309,3084,2.541,8.527,790,1.533,17.055,55,55,544
2011,3133,988,1031,30657,30798,74,7.112,93,8.938,3023,647,2376,2.101,9.816,3231,986,2245,3.202,10.491,-208,-0.675,19.631,71,71,568
2011,3141,1717,1839,53151,53577,140,7.507,192,10.295,4432,956,3476,1.784,8.272,5362,1616,3746,3.016,10.008,-930,-1.736,16.545,139,139,1044
2011,3149,3739,3849,59184,58849,323,8.289,418,10.728,7782,1688,6094,2.868,13.224,7127,2096,5031,3.562,12.111,655,1.113,24.221,317,317,1324
2011,3151,269,284,13162,13349,21,7.343,25,8.741,1048,108,940,0.809,7.851,1418,233,1185,1.745,10.623,-370,-2.772,15.702,20,20,201
2011,3152,4897,4952,87898,90481,767,15.338,864,17.278,14530,6047,8483,6.683,16.059,19670,8613,11057,9.519,21.739,-5140,-5.681,32.117,728,729,6968
2011,3159,565,577,9121,9396,45,7.627,71,12.034,923,189,734,2.012,9.824,1473,620,853,6.599,15.678,-550,-5.854,19.648,53,53,245
2011,3161,180,188,3729,3728,15,8.086,10,5.391,356,43,313,1.153,9.549,339,132,207,3.541,9.093,17,0.456,18.187,7,7,26
2011,3162,186,207,11557,11297,21,10.194,19,9.223,1323,118,1205,1.045,11.712,823,190,633,1.682,7.285,500,4.426,14.571,14,14,57
2011,3169,646,654,13140,12579,57,8.488,92,13.701,2404,430,1974,3.418,19.111,1218,490,728,3.895,9.683,1186,9.428,19.366,74,74,288
2011,3211,2859,3249,79388,78746,215,6.561,271,8.270,8946,1699,7247,2.158,11.361,7633,2821,4812,3.582,9.693,1313,1.667,19.387,182,182,1267
2011,3212,1149,1440,61498,62864,61,4.101,156,10.487,5292,915,4377,1.456,8.418,7840,3131,4709,4.981,12.471,-2548,-4.053,16.836,95,96,1268
2011,3219,7659,8581,204874,207064,566,6.497,828,9.504,22408,5229,17179,2.525,10.822,26794,8637,18157,4.171,12.940,-4386,-2.118,21.644,603,614,5167
2011,3221,212,429,110928,111081,9,2.059,25,5.721,4209,952,3257,0.857,3.789,4629,2025,2604,1.823,4.167,-420,-0.378,7.578,15,15,372
2011,3222,2646,3958,250373,252062,139,3.472,231,5.769,17619,3935,13684,1.561,6.990,20928,9325,11603,3.699,8.303,-3309,-1.313,13.980,134,136,2163
2011,3231,25337,26646,481199,490773,1465,5.391,2527,9.298,36625,8182,28443,1.667,7.463,55592,20929,34663,4.265,11.327,-18967,-3.865,14.925,1998,2011,12430
2011,3241,971,2107,98038,98118,110,5.202,125,5.912,5687,1450,4237,1.478,5.796,5925,927,4998,0.945,6.039,-238,-0.243,11.592,65,65,403
2011,3251,1310,2380,155301,152694,134,5.627,137,5.753,12146,3096,9050,2.028,7.954,6825,1797,5028,1.177,4.470,5321,3.485,8.939,80,81,862
2011,3252,961,1272,86432,86141,54,4.235,60,4.706,7462,1452,6010,1.686,8.663,6891,1388,5503,1.611,8.000,571,0.663,15.999,40,42,774
2011,3253,613,851,27912,28391,69,8.142,62,7.316,1995,585,1410,2.061,7.027,2997,716,2281,2.522,10.556,-1002,-3.529,14.054,39,41,306
2011,3254,1481,1928,228106,229681,165,8.686,108,5.686,16397,4472,11925,1.947,7.139,19557,1514,18043,0.659,8.515,-3160,-1.376,14.278,83,83,636
2011,3255,1300,1637,52577,52202,72,4.350,108,6.526,4627,1022,3605,1.958,8.864,3851,1265,2586,2.423,7.377,776,1.487,14.754,73,76,589
2011,3256,1902,2089,91262,91455,153,7.350,138,6.630,6845,982,5863,1.074,7.485,7379,1897,5482,2.074,8.068,-534,-0.584,14.969,103,103,1195
2011,3259,1806,2320,83242,84567,149,6.365,191,8.159,7248,1258,5990,1.488,8.571,9813,3358,6455,3.971,11.604,-2565,-3.033,17.141,115,124,882
2011,3261,8250,10480,561769,554551,453,4.296,581,5.510,57850,9112,48738,1.643,10.432,43379,13957,29422,2.517,7.822,14471,2.609,15.645,365,371,5797
2011,3262,1478,1894,122922,120192,79,4.156,93,4.892,11177,920,10257,0.765,9.299,5733,1698,4035,1.413,4.770,5444,4.529,9.540,68,68,730
2011,3271,992,1175,33847,33711,81,6.775,122,10.205,3303,640,2663,1.898,9.798,3105,428,2677,1.270,9.211,198,0.587,18.421,90,90,332
2011,3272,1387,1660,80569,80339,106,6.330,135,8.062,6594,865,5729,1.077,8.208,6075,1677,4398,2.087,7.562,519,0.646,15.123,92,92,426
2011,3273,4240,8682,148059,151235,337,3.824,598,6.786,13988,2409,11579,1.593,9.249,20358,4513,15845,2.984,13.461,-6370,-4.212,18.498,234,265,2172
2011,3274,174,298,12147,12561,16,5.281,26,8.581,517,71,446,0.565,4.116,1348,371,977,2.954,10.732,-831,-6.616,8.232,14,14,96
2011,3279,2518,2953,64137,63723,194,6.505,253,8.483,6754,1138,5616,1.786,10.599,5860,1871,3989,2.936,9.196,894,1.403,18.392,177,177,1229
2011,3311,338,473,102099,99732,38,8.000,42,8.842,6596,550,6046,0.551,6.614,1867,332,1535,0.333,1.872,4729,4.742,3.744,35,35,249
2011,3312,509,641,40304,38664,56,8.924,29,4.622,5733,1609,4124,4.161,14.828,2473,473,2000,1.223,6.396,3260,8.432,12.792,16,16,154
2011,3313,402,525,51248,50066,32,6.107,30,5.725,5619,794,4825,1.586,11.223,3329,459,2870,0.917,6.649,2290,4.574,13.299,24,25,395
2011,3314,729,917,57807,56715,54,5.921,44,4.825,5391,657,4734,1.158,9.505,3155,841,2314,1.483,5.563,2236,3.943,11.126,26,26,500
2011,3315,1621,1825,120149,115545,67,3.645,93,5.060,15377,802,14575,0.694,13.308,6231,1678,4553,1.452,5.393,9146,7.916,10.785,66,67,826
2011,3321,2239,2474,107358,104455,88,3.541,111,4.466,12338,1089,11249,1.043,11.812,6520,1863,4657,1.784,6.242,5818,5.570,12.484,73,73,760
2011,3322,1186,1284,40549,39948,71,5.510,80,6.209,3833,891,2942,2.230,9.595,2628,619,2009,1.550,6.579,1205,3.016,13.157,62,64,405
2011,3323,11189,12149,310149,309893,645,5.237,978,7.941,37482,7754,29728,2.502,12.095,36968,8828,28140,2.849,11.929,514,0.166,23.859,689,691,5750
2011,3324,1151,1442,79468,80135,62,4.324,46,3.208,8679,1892,6787,2.361,10.831,9937,810,9127,1.011,12.400,-1258,-1.570,21.661,24,24,321
2011,3325,548,608,26300,26384,20,3.231,42,6.785,1826,230,1596,0.872,6.921,2047,477,1570,1.808,7.759,-221,-0.838,13.842,25,25,171
2011,3326,1169,1317,39602,38808,43,3.240,63,4.748,4618,668,3950,1.721,11.900,2977,959,2018,2.471,7.671,1641,4.229,15.342,37,37,458
2011,3327,21713,22132,357448,342714,1283,5.804,1231,5.569,54326,8276,46050,2.415,15.852,24905,8624,16281,2.516,7.267,29421,8.585,14.534,883,885,5611
2011,3328,4970,5475,117665,113509,273,4.974,299,5.448,16601,2597,14004,2.288,14.625,8246,2309,5937,2.034,7.265,8355,7.361,14.529,223,225,1593
2011,3329,5567,6096,251187,247037,399,6.546,397,6.514,26140,3570,22570,1.445,10.581,17678,4199,13479,1.700,7.156,8462,3.425,14.312,271,272,1911
2011,3331,2437,2792,183222,176987,204,7.394,138,5.002,22753,3345,19408,1.890,12.856,10002,2825,7177,1.596,5.651,12751,7.205,11.303,92,92,901
2011,3332,3110,3274,100326,98835,169,5.135,203,6.168,11204,1347,9857,1.363,11.336,8217,2644,5573,2.675,8.314,2987,3.022,16.628,140,142,1420
2011,3333,1785,1915,75106,74660,144,7.553,127,6.661,6362,1363,4999,1.826,8.521,5504,1511,3993,2.024,7.372,858,1.149,14.744,94,95,564
2011,3334,1454,1714,122482,120288,94,5.470,103,5.994,12907,1563,11344,1.299,10.730,8519,3526,4993,2.931,7.082,4388,3.648,14.164,67,71,1111
2011,3335,6422,6622,136450,132228,301,4.522,371,5.573,17805,2339,15466,1.769,13.465,9277,3206,6071,2.425,7.016,8528,6.449,14.032,278,280,2279
2011,3336,788,971,93574,92160,59,6.048,68,6.971,12157,2099,10058,2.278,13.191,9159,4005,5154,4.346,9.938,2998,3.253,19.876,48,48,557
2011,3339,5112,5716,258982,253661,287,5.007,319,5.565,27717,2781,24936,1.096,10.927,17016,4995,12021,1.969,6.708,10701,4.219,13.416,210,211,2047
2011,3341,940,987,66506,68387,76,7.650,89,8.958,3644,519,3125,0.759,5.329,7452,1885,5567,2.756,10.897,-3808,-5.568,10.657,66,66,538
2011,3342,1290,1421,110226,108379,120,8.487,106,7.496,11529,932,10597,0.860,10.638,7554,1702,5852,1.570,6.970,3975,3.668,13.940,72,72,531
2011,3343,424,428,8068,8152,44,10.329,40,9.390,724,235,489,2.883,8.882,873,461,412,5.655,10.710,-149,-1.828,17.764,33,33,353
2011,3344,3640,4103,283314,280265,248,6.028,270,6.563,28734,4795,23939,1.711,10.252,23327,7001,16326,2.498,8.323,5407,1.929,16.646,189,189,2504
2011,3345,4258,4905,386452,384802,316,6.437,325,6.620,31617,6564,25053,1.706,8.216,28194,7937,20257,2.063,7.327,3423,0.890,14.654,206,206,2444
2011,3346,491,507,14164,15294,39,7.365,84,15.864,917,486,431,3.178,5.996,3313,1562,1751,10.213,21.663,-2396,-15.667,11.992,64,65,807
2011,3351,962,1042,45452,45410,78,7.407,100,9.497,3832,1053,2779,2.319,8.439,3789,1600,2189,3.523,8.344,43,0.095,16.688,70,70,867
2011,3352,232,272,43581,44395,26,9.630,22,8.148,2087,526,1561,1.185,4.701,3656,1610,2046,3.627,8.235,-1569,-3.534,9.402,11,11,72
2011,3353,1820,2097,111320,111318,104,4.900,155,7.303,9159,1386,7773,1.245,8.228,8965,3733,5232,3.353,8.054,194,0.174,16.107,99,99,724
2011,3359,1782,2075,130607,126761,136,6.581,119,5.759,15467,3835,11632,3.025,12.202,7932,1965,5967,1.550,6.257,7535,5.944,12.515,76,76,822
2011,3361,258,319,137348,132032,29,9.020,34,10.575,17199,252,16947,0.191,13.026,6980,4211,2769,3.189,5.287,10219,7.740,10.573,26,26,94
2011,3362,1527,1769,102485,97080,104,5.807,148,8.264,17341,2774,14567,2.857,17.863,6708,2266,4442,2.334,6.910,10633,10.953,13.820,104,109,1482
2011,3363,3968,4846,425362,413339,258,5.267,362,7.391,56415,9869,46546,2.388,13.649,32449,14020,18429,3.392,7.850,23966,5.798,15.701,221,230,3271
2011,3364,1231,1640,350216,355860,112,6.836,109,6.652,21310,5837,15473,1.640,5.988,33422,2969,30453,0.834,9.392,-12112,-3.404,11.977,58,58,417
2011,3365,148,215,25276,24846,14,6.512,14,6.512,3260,376,2884,1.513,13.121,2317,132,2185,0.531,9.325,943,3.795,18.651,7,7,64
2011,3366,1276,1388,127075,127614,108,7.651,155,10.981,10226,1278,8948,1.001,8.013,11172,2552,8620,2.000,8.755,-946,-0.741,16.027,111,112,1295
2011,3369,756,785,36081,36716,93,11.946,80,10.276,3837,1839,1998,5.009,10.451,4933,669,4264,1.822,13.436,-1096,-2.985,20.901,59,60,279
2011,3371,10816,11050,202410,206509,844,7.441,1430,12.607,18945,4179,14766,2.024,9.174,27228,8589,18639,4.159,13.185,-8283,-4.011,18.348,1017,1020,4967
2011,3372,3301,3476,100346,100982,176,4.933,360,10.090,10534,1343,9191,1.330,10.432,11751,3785,7966,3.748,11.637,-1217,-1.205,20.863,276,280,2541
2011,3379,714,808,30798,31288,38,4.565,87,10.450,2518,492,2026,1.572,8.048,3511,1444,2067,4.615,11.222,-993,-3.174,16.096,71,72,948
2011,3391,10083,10943,286454,284797,678,6.150,839,7.611,26685,5301,21384,1.861,9.370,23495,7553,15942,2.652,8.250,3190,1.120,16.499,621,622,3131
2011,3399,14711,15114,270665,270989,1298,8.539,1471,9.677,29408,7360,22048,2.716,10.852,29934,9014,20920,3.326,11.046,-526,-0.194,21.704,1109,1111,5700
2011,4231,16342,23709,356462,352563,1569,6.607,1643,6.919,37957,10376,27581,2.943,10.766,30320,9558,20762,2.711,8.600,7637,2.166,17.200,1124,1186,5796
2011,4232,9767,11555,134402,135108,1004,8.641,1132,9.743,15333,5071,10262,3.753,11.349,16748,5388,11360,3.988,12.396,-1415,-1.047,22.697,838,870,4021
2011,4233,9937,16267,186419,190860,935,5.644,1531,9.242,18856,5045,13811,2.643,9.879,27457,9692,17765,5.078,14.386,-8601,-4.506,19.759,896,940,4925
2011,4234,22276,33671,655385,666120,3734,11.227,2911,8.752,86905,31273,55632,4.695,13.046,107593,49138,58455,7.377,16.152,-20688,-3.106,26.093,1565,1606,10582
2011,4235,7274,10160,144385,142716,522,5.100,674,6.585,16355,3230,13125,2.263,11.460,13193,3923,9270,2.749,9.244,3162,2.216,18.489,378,402,2047
2011,4236,17768,27556,500472,491865,2058,7.468,2064,7.489,68897,21477,47420,4.366,14.007,51305,16011,35294,3.255,10.431,17592,3.577,20.861,1219,1274,7821
2011,4237,9754,18493,210387,206881,1121,6.076,1033,5.599,24266,6381,17885,3.084,11.729,17461,4965,12496,2.400,8.440,6805,3.289,16.880,578,615,2636
2011,4238,38656,55325,666945,658706,3187,5.750,3385,6.107,80117,19586,60531,2.973,12.163,63971,19384,44587,2.943,9.712,16146,2.451,19.423,2017,2124,10742
2011,4239,26705,29970,316233,312821,3369,11.323,2936,9.868,47128,15028,32100,4.804,15.065,40112,15227,24885,4.868,12.823,7016,2.243,25.645,2137,2165,8422
2011,4241,7561,10077,148472,148617,563,5.492,913,8.906,13982,3906,10076,2.628,9.408,14291,5122,9169,3.446,9.616,-309,-0.208,18.816,540,558,2479
2011,4242,5653,8963,266279,266063,1030,11.709,698,7.935,29266,7249,22017,2.725,11.000,29140,8241,20899,3.097,10.952,126,0.047,21.905,445,447,3171
2011,4243,12899,14088,182525,181861,1590,11.247,1688,11.940,27336,7621,19715,4.191,15.031,26034,8774,17260,4.825,14.315,1302,0.716,28.631,1275,1291,6311
2011,4244,24121,31068,756504,755039,2923,9.453,2631,8.509,82557,29152,53405,3.861,10.934,80765,22161,58604,2.935,10.697,1792,0.237,21.394,1714,1752,10597
2011,4245,3265,6007,63224,63381,295,4.899,324,5.381,7162,1680,5482,2.651,11.300,7487,1863,5624,2.939,11.813,-325,-0.513,22.600,181,195,1019
2011,4246,7737,11856,142835,140107,784,6.614,778,6.564,21598,8807,12791,6.286,15.415,15827,6219,9608,4.439,11.296,5771,4.119,22.593,408,425,1848
2011,4247,4627,6952,104573,105706,312,4.458,406,5.801,11051,2214,8837,2.094,10.454,13304,2842,10462,2.689,12.586,-2253,-2.131,20.909,226,230,1293
2011,4248,3093,4033,178467,177318,310,7.735,259,6.463,12924,2897,10027,1.634,7.289,10576,3075,7501,1.734,5.964,2348,1.324,11.929,184,192,2216
2011,4249,19911,25938,319335,320358,2232,8.574,2422,9.304,38641,12798,25843,3.995,12.062,40611,14221,26390,4.439,12.677,-1970,-0.615,24.124,1731,1757,7325
2011,4251,38389,40688,298958,297145,4672,11.414,5159,12.604,48427,14397,34030,4.845,16.297,44060,16419,27641,5.526,14.828,4367,1.470,29.656,3907,3939,12686
2011,4411,37111,42130,1055982,1044863,3600,8.523,3819,9.041,120783,37442,83341,3.583,11.560,98938,34860,64078,3.336,9.469,21845,2.091,18.938,2976,3057,27451
2011,4412,11857,13426,120606,121371,961,7.058,1339,9.835,15498,4857,10641,4.002,12.769,16920,6345,10575,5.228,13.941,-1422,-1.172,25.538,1005,1033,4879
2011,4413,27048,54369,480775,475805,2438,4.475,2658,4.879,48147,11542,36605,2.426,10.119,38077,10664,27413,2.241,8.003,10070,2.116,16.005,1732,1808,6367
2011,4421,14243,22682,196702,199627,1711,7.442,2330,10.134,22800,9148,13652,4.583,11.421,28537,9996,18541,5.007,14.295,-5737,-2.874,22.843,1458,1672,6432
2011,4422,19243,27065,226432,224421,1839,6.671,2841,10.306,32782,8043,24739,3.584,14.607,28845,9562,19283,4.261,12.853,3937,1.754,25.706,2014,2061,5597
2011,4431,24677,47487,437293,430994,6133,13.114,4692,10.033,71029,34285,36744,7.955,16.480,57474,20475,36999,4.751,13.335,13555,3.145,26.670,2963,3279,12040
2011,4441,38100,60779,1047165,1053165,2566,4.176,3913,6.368,67318,15479,51839,1.470,6.392,79678,17541,62137,1.666,7.566,-12360,-1.174,12.784,2630,2790,11782
2011,4442,13501,16979,146494,145659,1041,6.094,1248,7.306,19077,4209,14868,2.890,13.097,17126,4659,12467,3.199,11.758,1951,1.339,23.515,826,850,3038
2011,4451,58263,84407,2541015,2532891,8381,9.994,7294,8.697,204768,83693,121075,3.304,8.084,188163,54748,133415,2.161,7.429,16605,0.656,14.858,5235,5335,24815
2011,4452,16665,20489,143863,143115,2380,11.556,2591,12.581,25807,11424,14383,7.982,18.032,24172,9768,14404,6.825,16.890,1635,1.142,33.780,1811,1842,7028
2011,4453,25900,29749,148289,147900,2501,8.460,2131,7.208,20725,7963,12762,5.384,14.013,19913,6786,13127,4.588,13.464,812,0.549,26.928,1577,1594,4971
2011,4461,39386,88068,964833,977242,7801,8.969,5623,6.465,115619,45600,70019,4.666,11.831,142408,40650,101758,4.160,14.572,-26789,-2.741,23.662,2828,2895,12689
2011,4471,62060,107913,852641,853419,7530,6.979,7491,6.943,114032,41836,72196,4.902,13.362,114834,37464,77370,4.390,13.456,-802,-0.094,26.724,4796,5124,23892
2011,4481,32491,92168,1320339,1263640,8562,9.347,7434,8.115,265534,73625,191909,5.826,21.013,152615,54142,98473,4.285,12.077,112919,8.936,24.155,3988,4397,16171
2011,4482,5577,24970,207990,202454,1099,4.356,1618,6.413,31995,8011,23984,3.957,15.804,21259,7631,13628,3.769,10.501,10736,5.303,21.001,547,609,1977
2011,4483,15872,22822,127536,127357,1561,6.797,1852,8.064,16964,4941,12023,3.880,13.320,16425,6062,10363,4.760,12.897,539,0.423,25.794,1112,1177,3257
2011,4511,24994,35200,406408,404500,3073,8.715,3198,9.069,47430,16575,30855,4.098,11.726,42964,12102,30862,2.992,10.622,4466,1.104,21.243,2325,2416,8146
2011,4512,4281,9098,112454,116607,458,4.921,876,9.412,9452,1993,7459,1.709,8.106,17979,5631,12348,4.829,15.419,-8527,-7.313,16.212,505,520,1655
2011,4521,31,8359,1185538,1170763,70,0.835,111,1.325,78008,5274,72734,0.450,6.663,48203,3499,44704,0.299,4.117,29805,2.546,8.234,4,4,9
2011,4529,7187,37160,1649758,1641715,2534,6.924,1404,3.837,101928,35242,66686,2.147,6.209,85916,7960,77956,0.485,5.233,16012,0.975,10.467,882,937,3302
2011,4531,13608,14232,65920,67787,994,6.796,1782,12.184,8854,2583,6271,3.810,13.062,12562,4758,7804,7.019,18.532,-3708,-5.470,26.123,1414,1428,3762
2011,4532,20249,31059,259172,264304,2640,8.378,3543,11.244,30338,10534,19804,3.986,11.478,41246,16775,24471,6.347,15.606,-10908,-4.127,22.957,2442,2549,8234
2011,4533,11837,17039,156564,151831,1854,11.028,1400,8.327,25373,10441,14932,6.877,16.711,15789,4589,11200,3.022,10.399,9584,6.312,20.798,1057,1083,3015
2011,4539,27849,36483,232950,231827,3941,10.743,4345,11.844,36505,15734,20771,6.787,15.747,33661,13556,20105,5.847,14.520,2844,1.227,29.040,2854,2951,9109
2011,4541,20450,21502,327914,321744,3619,17.271,2523,12.041,57644,19353,38291,6.015,17.916,45035,17174,27861,5.338,13.997,12609,3.919,27.994,1917,1936,7970
2011,4542,3444,3914,35457,36283,329,8.245,482,12.079,2845,877,1968,2.417,7.841,4532,1827,2705,5.035,12.491,-1687,-4.650,15.682,382,384,1541
2011,4543,20543,26369,187416,188664,2168,8.171,2494,9.400,22797,7018,15779,3.720,12.083,25247,8348,16899,4.425,13.382,-2450,-1.299,24.167,1795,1832,6050
2011,4811,414,2636,389475,384895,142,5.368,161,6.086,25659,3064,22595,0.796,6.666,16178,2374,13804,0.617,4.203,9481,2.463,8.406,37,41,715
2011,4812,1916,2101,34148,33442,228,10.844,231,10.987,5091,1726,3365,5.161,15.223,3627,1060,2567,3.170,10.846,1464,4.378,21.691,176,176,660
2011,4831,660,999,45595,45285,96,9.552,108,10.746,5148,2234,2914,4.933,11.368,4406,1460,2946,3.224,9.730,742,1.639,19.459,55,55,937
2011,4832,414,469,17798,17375,44,9.283,54,11.392,2293,265,2028,1.525,13.197,1433,498,935,2.866,8.247,860,4.950,16.495,44,44,438
2011,4841,45169,54100,870766,853186,9477,17.795,7791,14.629,137932,46153,91779,5.409,16.167,102787,38112,64675,4.467,12.047,35145,4.119,24.095,5557,5608,21640
2011,4842,36219,40306,442684,435494,5010,12.400,5205,12.883,75527,21185,54342,4.865,17.343,61125,22034,39091,5.060,14.036,14402,3.307,28.072,3533,3558,13885
2011,4851,535,794,49146,48805,76,9.596,72,9.091,3628,1272,2356,2.606,7.434,2984,789,2195,1.617,6.114,644,1.320,12.228,49,49,246
2011,4852,202,420,15820,14615,77,19.107,43,10.670,4130,1437,2693,9.832,28.259,1654,898,756,6.144,11.317,2476,16.941,22.634,17,21,360
2011,4853,6133,6266,66314,65012,1033,16.647,912,14.697,11102,4440,6662,6.830,17.077,8424,3673,4751,5.650,12.958,2678,4.119,25.915,705,705,3055
2011,4854,2720,4278,214045,213590,237,5.499,300,6.961,18973,6082,12891,2.848,8.883,18305,7192,11113,3.367,8.570,668,0.313,17.140,162,163,1829
2011,4855,1118,1219,27423,27183,117,9.551,129,10.531,3365,865,2500,3.182,12.379,2888,973,1915,3.579,10.624,477,1.755,21.249,86,87,472
2011,4859,3163,3582,75684,74085,544,15.398,446,12.624,12031,4395,7636,5.932,16.240,8777,3492,5285,4.714,11.847,3254,4.392,23.695,353,355,2502
2011,4861,48,648,9593,8803,244,44.977,33,6.083,2978,2319,659,26.343,33.829,1163,755,408,8.577,13.211,1815,20.618,26.423,(D),(D),(D)
2011,4862,108,1939,28913,28765,185,9.745,104,5.478,4774,1193,3581,4.147,16.597,4487,767,3720,2.666,15.599,287,0.998,31.198,9,9,39
2011,4869,45,650,6745,6496,69,10.798,47,7.355,1757,401,1356,6.173,27.047,1257,360,897,5.542,19.350,500,7.697,38.701,0,0,0
2011,4871,484,530,9473,9365,64,12.156,57,10.826,1281,360,921,3.844,13.679,1059,189,870,2.018,11.308,222,2.371,22.616,47,47,165
2011,4872,1121,1162,10895,10541,170,14.580,178,15.266,2070,537,1533,5.094,19.638,1313,470,843,4.459,12.456,757,7.181,24.912,103,106,289
2011,4879,150,170,2076,2012,38,23.676,19,11.838,464,269,195,13.373,23.067,342,97,245,4.822,17.002,122,6.065,34.004,12,12,79
2011,4881,3707,5456,155380,156325,597,10.983,556,10.229,22316,6592,15724,4.217,14.275,24545,9472,15073,6.059,15.701,-2229,-1.426,28.551,302,307,2022
2011,4882,481,1189,28598,27526,118,10.142,67,5.758,4267,1191,3076,4.327,15.502,2065,436,1629,1.584,7.502,2202,8.000,15.004,27,32,220
2011,4883,1661,2238,87950,87000,195,8.742,180,8.070,12607,5802,6805,6.669,14.491,10880,4331,6549,4.978,12.506,1727,1.985,25.012,89,90,419
2011,4884,8508,9463,75873,74931,1191,12.674,1059,11.270,13306,5175,8131,6.906,17.758,11371,4120,7251,5.498,15.175,1935,2.582,30.351,742,747,2801
2011,4885,13376,19031,229969,225973,1753,9.217,1729,9.091,33383,9145,24238,4.047,14.773,25085,9956,15129,4.406,11.101,8298,3.672,22.202,959,1005,4054
2011,4889,1151,1255,15797,15568,155,12.258,174,13.760,3136,846,2290,5.434,20.144,2678,995,1683,6.391,17.202,458,2.942,34.404,136,136,668
2011,4921,4004,8481,489820,487564,1426,17.175,1070,12.887,28284,6482,21802,1.329,5.801,22621,7820,14801,1.604,4.640,5663,1.161,9.279,422,432,1825
2011,4922,3932,4305,32458,31355,1082,26.355,683,16.636,7689,3802,3887,12.126,24.523,5372,2529,2843,8.066,17.133,2317,7.390,34.266,577,585,2120
2011,4931,6830,14151,681508,675690,1026,7.259,994,7.032,87831,26100,61731,3.863,12.999,73925,17009,56916,2.517,10.941,13906,2.058,21.881,326,335,2967
2011,5111,12889,18612,493667,505825,1337,7.069,1942,10.267,40528,11797,28731,2.332,8.012,64659,18417,46242,3.641,12.783,-24131,-4.771,16.025,1060,1073,5538
2011,5112,5026,7582,380483,374650,965,12.965,687,9.230,53933,14834,39099,3.959,14.396,42973,18457,24516,4.926,11.470,10960,2.925,22.940,326,342,6831
2011,5121,12644,16047,288397,288814,2390,15.057,2041,12.859,42328,16638,25690,5.761,14.656,43601,12150,31451,4.207,15.097,-1273,-0.441,29.312,1251,1265,4885
2011,5122,2730,3011,22454,22485,433,14.324,457,15.117,2878,1120,1758,4.981,12.800,2925,1244,1681,5.533,13.009,-47,-0.209,25.600,323,324,821
2011,5151,4060,8723,212002,215121,1049,11.879,1264,14.314,23940,10746,13194,4.995,11.129,30198,11656,18542,5.418,14.038,-6258,-2.909,22.257,213,218,1653
2011,5152,393,776,48675,46133,110,14.676,57,7.605,10898,8153,2745,17.673,23.623,5590,1494,4096,3.238,12.117,5308,11.506,24.234,36,36,575
2011,5171,3213,33937,800740,801272,5511,16.537,4289,12.870,123478,68567,54911,8.557,15.410,125851,50099,75752,6.252,15.706,-2373,-0.296,30.821,263,266,3184
2011,5172,991,10655,244388,249041,896,8.238,1338,12.302,25389,9954,15435,3.997,10.195,33465,10558,22907,4.239,13.438,-8076,-3.243,20.389,91,124,456
2011,5174,382,495,8279,8152,73,14.718,75,15.121,1240,359,881,4.404,15.211,979,492,487,6.035,12.009,261,3.202,24.019,50,50,369
2011,5179,3606,4054,51046,51845,488,11.663,748,17.878,9488,3237,6251,6.244,18.301,11073,4838,6235,9.332,21.358,-1585,-3.057,36.601,597,611,3332
2011,5182,7919,12553,419806,405460,1924,15.760,1235,10.116,99356,39134,60222,9.652,24.505,71226,18875,52351,4.655,17.567,28130,6.938,35.133,718,732,6925
2011,5191,6665,8670,176600,168609,1538,18.300,1007,11.982,35459,12797,22662,7.590,21.030,19047,6643,12404,3.940,11.297,16412,9.734,22.593,707,716,3163
2011,5211,12,47,18039,18043,0,0.000,(D),(D),469,0,469,0.000,2.599,478,(D),449,(D),2.649,-9,-0.050,5.199,0,0,0
2011,5221,13628,123745,1999894,1988891,5445,4.394,5814,4.691,229537,53913,175624,2.711,11.541,210646,50109,160537,2.519,10.591,18891,0.950,21.182,354,537,6089
2011,5222,13470,39046,515902,517546,5085,12.992,5272,13.470,99499,34597,64902,6.685,19.225,101188,40964,60224,7.915,19.552,-1689,-0.326,38.450,1477,1649,8728
2011,5223,12550,28043,241457,246338,2357,8.015,5089,17.304,38124,15329,22795,6.223,15.476,48405,20107,28298,8.162,19.650,-10281,-4.174,30.953,2578,2871,9891
2011,5231,11639,41041,417807,422440,4921,11.977,5011,12.196,59296,18919,40377,4.479,14.037,68391,29771,38620,7.047,16.190,-9095,-2.153,28.073,906,932,4870
2011,5232,18,33,4975,4969,4,7.207,(D),(D),561,71,490,1.429,11.291,557,(D),237,(D),11.211,4,0.081,22.421,0,0,0
2011,5239,38164,43782,446994,442646,5749,13.197,5312,12.194,67335,26903,40432,6.078,15.212,58681,23757,34924,5.367,13.257,8654,1.955,26.514,3435,3475,11766
2011,5241,5423,29820,1381004,1394123,3456,11.365,4636,15.245,134749,51622,83127,3.703,9.666,161628,43966,117662,3.154,11.594,-26879,-1.928,19.331,392,423,2536
2011,5242,117396,131988,845674,847196,10353,7.807,11584,8.736,109993,42832,67161,5.056,12.983,113107,41471,71636,4.895,13.351,-3114,-0.368,25.966,7926,8063,23972
2011,5250,1427,1461,21063,16367,462,37.108,30,2.410,11118,7321,3797,44.732,67.931,1562,67,1495,0.409,9.544,9556,58.388,19.088,11,11,33
2011,5311,82864,106428,513659,515615,9767,9.217,8840,8.342,71386,32413,38973,6.286,13.845,75568,30155,45413,5.848,14.656,-4182,-0.811,27.690,6080,6141,18755
2011,5312,56403,67123,263215,268119,10305,15.159,12018,17.679,49701,25517,24184,9.517,18.537,59094,27856,31238,10.389,22.040,-9393,-3.503,37.074,7264,7427,14872
2011,5313,59715,73939,609878,607876,8715,11.828,8193,11.120,88165,35192,52973,5.789,14.504,84117,33892,50225,5.575,13.838,4048,0.666,27.676,5199,5258,18941
2011,5321,3627,10737,148569,148127,1681,15.855,1412,13.318,23545,12193,11352,8.231,15.895,22764,14414,8350,9.731,15.368,781,0.527,30.736,337,349,1282
2011,5322,8204,22048,169812,179623,2265,9.532,5692,23.955,24195,8441,15754,4.699,13.470,45250,31170,14080,17.353,25.192,-21055,-11.722,26.940,1133,4026,22549
2011,5323,2503,3777,23806,24247,162,4.163,391,10.048,2747,672,2075,2.771,11.329,3688,1520,2168,6.269,15.210,-941,-3.881,22.658,176,254,767
2011,5324,7014,12911,146462,143645,1511,11.823,1250,9.781,25108,9177,15931,6.389,17.479,19601,6874,12727,4.785,13.645,5507,3.834,27.291,623,708,3571
2011,5331,1936,2047,29099,28925,268,13.083,271,13.229,4981,1960,3021,6.776,17.220,4663,2274,2389,7.862,16.121,318,1.099,32.242,203,203,838
2011,5411,159913,169946,1139788,1144172,13327,7.826,13996,8.219,115974,38328,77646,3.350,10.136,125007,37268,87739,3.257,10.926,-9033,-0.789,20.272,10049,10164,26519
2011,5412,97684,113223,1259305,1259105,10727,9.484,10504,9.286,208392,59096,149296,4.693,16.551,208933,78568,130365,6.240,16.594,-541,-0.043,33.102,6605,6651,36942
2011,5413,78851,95117,1269810,1272875,9927,10.373,11086,11.585,185563,67035,118528,5.266,14.578,192119,60526,131593,4.755,15.093,-6556,-0.515,29.157,6246,6360,22044
2011,5414,24038,24309,106674,105558,3483,14.204,3907,15.933,21652,7653,13999,7.250,20.512,19740,9848,9892,9.330,18.701,1912,1.811,37.401,2654,2658,7155
2011,5415,88245,106125,1437659,1424988,18780,17.939,15903,15.191,307491,90807,216684,6.372,21.579,283185,106457,176728,7.471,19.873,24306,1.706,39.746,9826,9939,38374
2011,5416,105941,114352,918500,890362,21553,19.135,18118,16.086,199593,77599,121994,8.715,22.417,144066,62547,81519,7.025,16.181,55527,6.236,32.361,12774,12835,36711
2011,5417,12268,15634,684962,681859,2026,13.138,1600,10.375,74341,17325,57016,2.541,10.903,68555,22990,45565,3.372,10.054,5786,0.849,20.108,983,993,6655
2011,5418,29640,33129,423428,417061,3810,11.443,4145,12.449,66494,19568,46926,4.692,15.943,53445,21981,31464,5.270,12.815,13049,3.129,25.629,2992,3022,13661
2011,5419,51101,60686,577028,573248,5581,9.205,5475,9.030,83275,26519,56756,4.626,14.527,76008,23053,52955,4.021,13.259,7267,1.268,26.518,3922,3986,14962
2011,5511,26502,50403,2944738,2894385,4255,8.501,3551,7.095,469248,144554,324694,4.994,16.212,366957,85437,281520,2.952,12.678,102291,3.534,25.356,821,850,12484
2011,5611,23733,25890,411831,401561,3557,13.890,2992,11.684,76253,25151,51102,6.263,18.989,55159,21133,34026,5.263,13.736,21094,5.253,27.472,2135,2175,14788
2011,5612,1762,5472,263866,259716,582,10.578,642,11.668,46276,9514,36762,3.663,17.818,36463,14519,21944,5.590,14.040,9813,3.778,28.079,92,106,2102
2011,5613,24231,43280,4356040,4173315,5584,12.885,5700,13.152,1100524,171365,929159,4.106,26.371,722607,238422,484185,5.713,17.315,377917,9.056,34.630,2684,2820,93127
2011,5614,24823,31029,752131,761088,3070,9.795,3695,11.789,121612,36931,84681,4.852,15.979,138893,44422,94471,5.837,18.249,-17281,-2.271,31.957,2607,2659,21846
2011,5615,13035,18795,223955,225873,2635,14.000,2689,14.286,29175,11061,18114,4.897,12.917,32979,13240,19739,5.862,14.601,-3804,-1.684,25.833,1128,1161,4634
2011,5616,17243,23351,792646,786353,2413,10.307,2535,10.828,110709,31313,79396,3.982,14.079,98425,31867,66558,4.053,12.517,12284,1.562,25.033,1577,1601,15560
2011,5617,134831,141722,1624419,1610272,19228,13.556,19465,13.723,276875,78415,198460,4.870,17.194,249962,84750,165212,5.263,15.523,26913,1.671,31.046,12855,13017,56090
2011,5619,15611,17649,267334,260486,1803,10.233,1744,9.898,44348,11540,32808,4.430,17.025,30719,10342,20377,3.970,11.793,13629,5.232,23.586,1173,1182,5876
2011,5621,7150,9993,181126,183460,1394,14.268,948,9.703,28258,14777,13481,8.055,15.403,33128,11520,21608,6.279,18.057,-4870,-2.655,30.806,561,566,3601
2011,5622,1301,2564,52472,51921,273,10.853,176,6.997,7228,3168,4060,6.102,13.921,6045,1844,4201,3.552,11.643,1183,2.278,23.286,92,92,757
2011,5629,7644,9144,125569,121522,1230,13.830,730,8.208,27435,9977,17458,8.210,22.576,19617,4568,15049,3.759,16.143,7818,6.433,32.286,482,484,3106
2011,6111,18057,20403,870493,855105,952,4.771,56,0.281,74204,20263,53941,2.370,8.678,43007,186,42821,0.022,5.029,31197,3.648,10.059,39,39,145
2011,6112,451,919,91681,88313,53,5.928,3,0.336,11351,1551,9800,1.756,12.853,4669,5,4664,0.006,5.287,6682,7.566,10.574,(D),(D),(D)
2011,6113,2160,4030,1770608,1738833,497,13.127,9,0.238,124893,15854,109039,0.912,7.183,61906,18,61888,0.001,3.560,62987,3.622,7.120,4,4,7
2011,6114,6310,6849,64032,63455,870,12.765,803,11.782,10977,4068,6909,6.411,17.299,9841,3861,5980,6.085,15.509,1136,1.790,31.017,506,510,2036
2011,6115,6016,7715,137014,134582,719,9.348,672,8.737,22834,8731,14103,6.488,16.967,17980,4461,13519,3.315,13.360,4854,3.607,26.720,441,451,2269
2011,6116,34363,37215,360418,350465,4935,13.439,3948,10.751,76707,25532,51175,7.285,21.887,56557,17719,38838,5.056,16.138,20150,5.750,32.275,2817,2851,11991
2011,6117,5290,6093,89877,84563,975,16.292,758,12.666,20011,5226,14785,6.180,23.664,9356,3211,6145,3.797,11.064,10655,12.600,22.128,557,558,2036
2011,6211,173516,207491,2236819,2218045,15158,7.317,14480,6.990,280187,102462,177725,4.619,12.632,242320,85975,156345,3.876,10.925,37867,1.707,21.850,10149,10455,53798
2011,6212,118459,125979,854209,849664,6225,4.970,4763,3.803,93583,29933,63650,3.523,11.014,84170,20749,63421,2.442,9.906,9413,1.108,19.813,3764,3828,16574
2011,6213,110295,124662,707037,693256,11578,9.386,8952,7.257,118412,48496,69916,6.995,17.081,90400,30670,59730,4.424,13.040,28012,4.041,26.080,6097,6176,20085
2011,6214,14703,33067,740059,727049,2311,7.066,1590,4.861,89753,27128,62625,3.731,12.345,63103,17055,46048,2.346,8.679,26650,3.666,17.359,821,854,7415
2011,6215,7110,12494,249691,248718,1094,8.722,1193,9.511,27889,8065,19824,3.243,11.213,25876,8320,17556,3.345,10.404,2013,0.809,20.808,611,702,4333
2011,6216,18725,27077,1243252,1213838,3664,13.916,2168,8.234,192163,46597,145566,3.839,15.831,134061,36903,97158,3.040,11.044,58102,4.787,22.089,1396,1421,21656
2011,6219,6022,9443,286091,284776,890,9.468,804,8.553,35667,10354,25313,3.636,12.525,32995,12368,20627,4.343,11.586,2672,0.938,23.173,382,403,5947
2011,6221,2902,5069,5166703,5145073,72,1.422,60,1.185,197094,21175,175919,0.412,3.831,152298,18159,134139,0.353,2.960,44796,0.871,5.920,27,27,5422
2011,6222,427,601,216877,217809,14,2.324,17,2.822,6587,2262,4325,1.039,3.024,8414,2259,6155,1.037,3.863,-1827,-0.839,6.048,8,8,1521
2011,6223,367,889,262561,262957,36,4.068,28,3.164,15270,3191,12079,1.214,5.807,15831,4119,11712,1.566,6.020,-561,-0.213,11.614,15,15,2338
2011,6231,8024,16108,1632316,1626702,1274,8.063,658,4.165,118697,47203,71494,2.902,7.297,108474,35903,72571,2.207,6.668,10223,0.628,13.337,311,320,15690
2011,6232,8918,34666,647176,646144,1406,4.054,1434,4.135,62393,13673,48720,2.116,9.656,60149,13640,46509,2.111,9.309,2244,0.347,18.618,349,505,5731
2011,6233,15070,21501,831362,824650,1783,8.350,1487,6.964,80604,27083,53521,3.284,9.774,67721,28367,39354,3.440,8.212,12883,1.562,16.424,992,1073,20376
2011,6239,3191,5598,139271,139820,479,8.580,449,8.042,16015,3971,12044,2.840,11.454,17285,5227,12058,3.738,12.362,-1270,-0.908,22.908,228,246,2681
2011,6241,42284,59215,1382124,1360338,5388,9.204,4038,6.898,177041,41801,135240,3.073,13.014,133938,33354,100584,2.452,9.846,43103,3.169,19.692,2497,2535,17700
2011,6242,9922,13620,178842,177961,622,4.542,773,5.644,20128,3831,16297,2.153,11.310,18296,6114,12182,3.436,10.281,1832,1.029,20.562,513,523,4256
2011,6243,4156,7981,356446,351235,559,7.088,370,4.692,46278,7480,38798,2.130,13.176,35896,4781,31115,1.361,10.220,10382,2.956,20.440,165,180,1970
2011,6244,55386,70865,866038,863376,6487,9.170,6244,8.826,109062,39020,70042,4.519,12.632,103594,35624,67970,4.126,11.999,5468,0.633,23.997,4589,4658,24932
2011,7111,6904,7044,112964,114634,772,10.930,810,11.468,20068,5773,14295,5.036,17.506,23912,4520,19392,3.943,20.859,-3844,-3.353,35.012,510,511,3098
2011,7112,3267,3430,124735,122917,447,12.947,492,14.251,17198,3339,13859,2.716,13.992,13361,3060,10301,2.489,10.870,3837,3.122,21.740,385,387,2591
2011,7113,5305,5639,128518,128407,660,11.795,573,10.240,18715,3537,15178,2.755,14.575,18685,4819,13866,3.753,14.551,30,0.023,29.103,427,427,1610
2011,7114,2786,2890,16941,17213,433,15.153,368,12.878,2778,1264,1514,7.344,16.139,3342,1534,1808,8.912,19.416,-564,-3.277,32.279,270,270,670
2011,7115,13344,13370,42347,42778,2530,19.049,2353,17.716,11107,5603,5504,13.098,25.965,12210,5696,6514,13.315,28.543,-1103,-2.578,51.929,1433,1434,3391
2011,7121,6330,6790,128834,127455,317,4.661,339,4.985,10320,1122,9198,0.880,8.097,7569,1209,6360,0.949,5.939,2751,2.158,11.877,201,201,879
2011,7131,2235,2623,147459,147754,376,14.387,357,13.660,19789,6137,13652,4.154,13.393,20234,4527,15707,3.064,13.694,-445,-0.301,26.787,267,271,2476
2011,7132,1773,2627,164630,166614,284,10.972,207,7.997,12266,4746,7520,2.849,7.362,16553,4598,11955,2.760,9.935,-4287,-2.573,14.724,151,155,3034
2011,7139,48080,55033,1127937,1127700,5695,10.335,5833,10.586,138151,50323,87828,4.462,12.251,137578,42636,94942,3.781,12.200,573,0.051,24.400,4374,4430,30258
2011,7211,38604,49577,1810593,1793348,3668,7.419,3396,6.869,181529,69929,111600,3.899,10.122,148245,52824,95421,2.946,8.266,33284,1.856,16.533,2215,2265,32927
2011,7212,5191,5766,38464,38558,451,7.801,481,8.320,5614,1364,4250,3.538,14.560,5816,1319,4497,3.421,15.084,-202,-0.524,29.120,282,283,770
2011,7213,1854,1969,10667,10546,110,5.578,116,5.882,1451,480,971,4.551,13.759,1226,284,942,2.693,11.625,225,2.134,23.251,76,77,216
2011,7223,12058,35762,663971,655391,3431,9.614,3280,9.191,89223,27032,62191,4.125,13.614,72294,23537,48757,3.591,11.031,16929,2.583,22.061,1482,1490,7548
2011,7224,39018,39751,348254,348436,3899,9.714,4676,11.649,63920,29350,34570,8.423,18.345,64189,26534,37655,7.615,18.422,-269,-0.077,36.690,3747,3754,21812
2011,7225,334237,461850,8676848,8586853,50017,10.921,42284,9.233,1259224,617979,641245,7.197,14.665,1074688,382182,692506,4.451,12.516,184536,2.149,25.031,32699,33722,278006
2011,8111,133036,145460,801243,796718,12113,8.315,12539,8.608,113181,41110,72071,5.160,14.206,104058,37168,66890,4.665,13.061,9123,1.145,26.122,8731,8932,26349
2011,8112,9897,11310,108882,110771,1278,11.263,1351,11.907,15087,7221,7866,6.519,13.620,18612,7751,10861,6.997,16.802,-3525,-3.182,27.240,961,981,3647
2011,8113,17976,19674,185081,183153,1615,8.182,1742,8.826,30992,8060,22932,4.401,16.921,27685,7148,20537,3.903,15.116,3307,1.806,30.232,1168,1177,4152
2011,8114,16680,17394,67813,68895,1967,11.239,2183,12.473,10918,4628,6290,6.717,15.847,13097,5933,7164,8.612,19.010,-2179,-3.163,31.695,1532,1534,3341
2011,8121,87220,103418,631565,629058,12267,11.912,11393,11.063,102879,45703,57176,7.265,16.354,98193,39445,58748,6.270,15.610,4686,0.745,31.219,8875,9011,30609
2011,8122,14407,20015,136135,134992,1008,5.055,860,4.313,17844,5670,12174,4.200,13.219,15772,3130,12642,2.319,11.684,2072,1.535,23.367,456,487,1656
2011,8123,29034,34403,296629,301040,2644,7.639,3058,8.836,29795,11714,18081,3.891,9.897,38723,14331,24392,4.761,12.863,-8928,-2.966,19.795,2233,2337,9377
2011,8129,22448,33080,243747,241798,4762,14.591,3877,11.879,46782,18059,28723,7.469,19.348,43406,16075,27331,6.648,17.951,3376,1.396,35.903,2125,2154,8489
2011,8131,174418,174756,1666146,1665055,8470,4.962,387,0.227,157897,27740,130157,1.666,9.483,156385,915,155470,0.055,9.392,1512,0.091,18.784,235,235,569
2011,8132,15420,17385,171905,169477,1468,8.550,1037,6.040,20014,4101,15913,2.420,11.809,15056,4078,10978,2.406,8.884,4958,2.925,17.768,692,701,2626
2011,8133,13336,15754,146734,144170,1346,8.620,1066,6.827,19572,4491,15081,3.115,13.576,14564,3577,10987,2.481,10.102,5008,3.474,20.204,657,657,2380
2011,8134,23452,25331,235210,236772,1137,4.459,1468,5.758,24042,4862,19180,2.053,10.154,27067,5514,21553,2.329,11.432,-3025,-1.278,20.308,1025,1030,3749
2011,8139,54901,57198,488653,490710,2398,4.208,1983,3.480,44381,8191,36190,1.669,9.044,48706,6707,41999,1.367,9.926,-4325,-0.881,18.088,1407,1408,4102
2012,2111,5896,7320,127441,121280,667,9.185,550,7.574,22629,5761,16868,4.750,18.658,10493,4353,6140,3.589,8.652,12136,10.007,17.304,352,357,1661
2012,2121,539,972,87881,86680,96,9.771,117,11.908,14047,4489,9558,5.179,16.206,11714,5580,6134,6.437,13.514,2333,2.692,27.028,51,52,1057
2012,2122,259,324,39974,37521,48,15.190,32,10.127,6080,288,5792,0.768,16.204,1356,511,845,1.362,3.614,4724,12.590,7.228,21,21,143
2012,2123,2817,4864,76382,78093,312,6.397,338,6.930,11070,2377,8693,3.044,14.175,14601,3277,11324,4.196,18.697,-3531,-4.522,28.351,155,159,1003
2012,2131,10242,12781,393122,364061,1871,15.087,1111,8.959,101011,26829,74182,7.369,27.746,43410,15141,28269,4.159,11.924,57601,15.822,23.848,695,710,7989
2012,2211,1669,10247,513602,514999,557,5.486,368,3.625,33226,10896,22330,2.116,6.452,36256,5956,30300,1.157,7.040,-3030,-0.588,12.903,73,74,1290
2012,2212,433,2422,84508,84016,126,5.111,213,8.639,7933,2613,5320,3.110,9.442,7015,2953,4062,3.515,8.350,918,1.093,16.699,20,25,201
2012,2213,3445,4642,43195,42747,253,5.492,182,3.951,4511,1274,3237,2.980,10.553,3613,1077,2536,2.519,8.452,898,2.101,16.904,101,101,252
2012,2361,119857,120939,529844,522754,23603,19.725,21045,17.587,135852,61658,74194,11.795,25.988,121120,53803,67317,10.292,23.170,14732,2.818,46.339,12954,12975,34123
2012,2362,35715,37051,550452,549134,3825,10.261,4279,11.479,99020,18684,80336,3.402,18.032,96460,27829,68631,5.068,17.566,2560,0.466,35.132,2819,2825,16045
2012,2371,16298,17728,485427,467448,1647,9.267,1735,9.763,99003,13800,85203,2.952,21.179,63955,15135,48820,3.238,13.682,35048,7.498,27.364,1050,1061,7484
2012,2372,4925,4986,23494,24428,483,9.316,880,16.974,3773,1281,2492,5.244,15.446,5559,2888,2671,11.823,22.757,-1786,-7.311,30.891,675,675,2203
2012,2373,8360,9142,260683,256724,688,7.488,780,8.489,44093,8254,35839,3.215,17.175,36220,6947,29273,2.706,14.109,7873,3.067,28.217,464,467,4283
2012,2379,3554,3667,87356,87318,463,12.769,381,10.507,13861,2719,11142,3.114,15.874,13935,3118,10817,3.571,15.959,-74,-0.085,31.748,223,223,997
2012,2381,70623,71349,661207,649085,10938,15.427,10044,14.166,161400,40596,120804,6.254,24.866,137249,43287,93962,6.669,21.145,24151,3.721,42.290,6387,6449,30173
2012,2382,149271,153208,1620192,1602722,15173,9.934,14221,9.311,271717,55095,216622,3.438,16.953,236090,67049,169041,4.183,14.731,35627,2.223,29.461,9563,9589,42511
2012,2383,86383,87345,609227,607933,12264,14.026,12444,14.232,131481,35405,96076,5.824,21.628,128926,44847,84079,7.377,21.207,2555,0.420,42.415,8003,8032,32929
2012,2389,51318,51997,470414,459436,7426,14.434,6328,12.300,100125,22970,77155,5.000,21.793,77731,24992,52739,5.440,16.919,22394,4.874,33.838,3973,3983,17227
2012,3111,1037,1624,44235,46714,69,4.214,96,5.863,3614,696,2918,1.490,7.736,8220,1263,6957,2.704,17.596,-4606,-9.860,15.473,62,62,341
2012,3112,428,785,53791,53960,59,7.584,45,5.784,3874,904,2970,1.675,7.179,4149,1575,2574,2.919,7.689,-275,-0.510,14.359,21,21,376
2012,3113,1553,1719,70439,69705,152,8.931,118,6.933,7874,1632,6242,2.341,11.296,6314,1720,4594,2.468,9.058,1560,2.238,18.116,86,87,1120
2012,3114,1276,1634,155434,155293,122,7.550,86,5.322,12484,2336,10148,1.504,8.039,12360,2428,9932,1.563,7.959,124,0.080,15.918,55,55,1363
2012,3115,1011,1517,133591,134527,101,6.711,77,5.116,8300,1119,7181,0.832,6.170,10272,2719,7553,2.021,7.636,-1972,-1.466,12.340,43,43,1457
2012,3116,2821,3413,486943,488322,167,4.856,219,6.368,25702,2145,23557,0.439,5.263,28621,7760,20861,1.589,5.861,-2919,-0.598,10.527,148,148,2993
2012,3117,449,544,32132,31909,33,6.072,32,5.888,4011,1189,2822,3.726,12.570,3479,1082,2397,3.391,10.903,532,1.667,21.806,27,27,815
2012,3118,9117,9840,276420,276586,1055,10.889,753,7.772,28836,8543,20293,3.089,10.426,28656,7228,21428,2.613,10.361,180,0.065,20.721,582,591,4350
2012,3119,2606,3038,163259,160976,243,8.037,214,7.078,16499,3813,12686,2.369,10.249,12039,3540,8499,2.199,7.479,4460,2.771,14.958,164,164,2209
2012,3121,3791,4387,134308,132555,557,13.118,275,6.477,13709,2787,10922,2.103,10.342,10277,2460,7817,1.856,7.753,3432,2.589,15.506,192,195,1156
2012,3122,89,111,14876,15068,12,10.480,19,16.594,1400,266,1134,1.765,9.292,1779,269,1510,1.785,11.807,-379,-2.515,18.583,13,13,37
2012,3131,231,300,25019,26038,11,3.560,29,9.385,1020,45,975,0.173,3.917,3034,1016,2018,3.902,11.652,-2014,-7.735,7.835,17,17,128
2012,3132,835,919,50471,50394,43,4.609,71,7.610,4175,736,3439,1.461,8.285,4085,1623,2462,3.221,8.106,90,0.179,16.212,54,55,1072
2012,3133,963,1006,30194,30663,50,4.916,72,7.080,2261,392,1869,1.278,7.374,3247,1585,1662,5.169,10.589,-986,-3.216,14.747,53,53,663
2012,3141,1744,1868,51297,52674,115,6.019,200,10.468,4566,1525,3041,2.895,8.668,7285,2430,4855,4.613,13.830,-2719,-5.162,17.337,141,148,1005
2012,3149,3847,3950,61571,60397,316,7.997,319,8.073,8202,2007,6195,3.323,13.580,5800,1548,4252,2.563,9.603,2402,3.977,19.206,237,238,1015
2012,3151,246,261,12821,13073,11,4.128,22,8.255,798,104,694,0.796,6.104,1324,428,896,3.274,10.128,-526,-4.024,12.208,18,18,421
2012,3152,4763,4810,87941,86237,770,16.022,762,15.855,16771,5734,11037,6.649,19.448,13224,6970,6254,8.082,15.335,3547,4.113,30.669,636,639,5437
2012,3159,489,500,8076,8246,52,10.146,77,15.024,718,262,456,3.177,8.707,1074,446,628,5.409,13.024,-356,-4.317,17.415,61,61,331
2012,3161,170,179,3512,3598,10,5.510,15,8.264,230,33,197,0.917,6.393,411,111,300,3.085,11.425,-181,-5.031,12.787,12,12,33
2012,3162,179,198,11248,11279,18,9.045,20,10.050,855,102,753,0.904,7.581,939,448,491,3.972,8.326,-84,-0.745,15.162,14,14,68
2012,3169,648,651,11966,11544,61,9.370,61,9.370,2126,1370,756,11.868,18.417,1329,369,960,3.197,11.513,797,6.904,23.026,44,45,273
2012,3211,2758,3135,76169,76590,208,6.567,273,8.619,7485,1827,5658,2.385,9.773,8364,3057,5307,3.991,10.920,-879,-1.148,19.546,174,183,1874
2012,3212,1116,1386,59507,60365,56,3.960,112,7.921,5612,919,4693,1.522,9.297,7267,3109,4158,5.150,12.038,-1655,-2.742,18.594,65,66,942
2012,3219,7522,8410,205689,205780,500,5.877,695,8.169,23190,4203,18987,2.042,11.269,23488,6926,16562,3.366,11.414,-298,-0.145,22.539,486,496,4599
2012,3221,149,360,106990,108568,14,3.836,24,6.575,2999,957,2042,0.881,2.762,6005,1897,4108,1.747,5.531,-3006,-2.769,5.525,9,9,760
2012,3222,2671,3956,246940,250205,124,3.098,216,5.397,15256,2812,12444,1.124,6.097,21553,7563,13990,3.023,8.614,-6297,-2.517,12.195,120,124,2609
2012,3231,24927,26189,473538,479260,1395,5.252,2139,8.053,38479,10034,28445,2.094,8.029,50073,19059,31014,3.977,10.448,-11594,-2.419,16.058,1672,1679,10884
2012,3241,948,2126,98390,98840,121,5.689,123,5.783,5922,734,5188,0.743,5.992,6955,2149,4806,2.174,7.037,-1033,-1.045,11.983,52,52,379
2012,3251,1361,2428,154790,154576,122,5.051,97,4.016,10771,1768,9003,1.144,6.968,10219,1716,8503,1.110,6.611,552,0.357,13.222,56,57,1093
2012,3252,1062,1387,90483,89055,51,3.665,60,4.312,7986,1066,6920,1.197,8.968,5081,1371,3710,1.540,5.705,2905,3.262,11.411,34,34,606
2012,3253,638,881,29512,29224,63,7.212,48,5.495,2621,392,2229,1.341,8.969,2047,551,1496,1.885,7.005,574,1.964,14.009,28,28,272
2012,3254,1568,2039,236629,234074,153,7.578,113,5.597,17888,2528,15360,1.080,7.642,12664,2986,9678,1.276,5.410,5224,2.232,10.821,79,79,2077
2012,3255,1309,1651,54897,54596,68,4.108,77,4.651,4392,915,3477,1.676,8.045,3791,810,2981,1.484,6.944,601,1.101,13.888,48,48,338
2012,3256,1901,2094,93097,93271,127,6.053,135,6.435,7468,2012,5456,2.157,8.007,7967,2068,5899,2.217,8.542,-499,-0.535,16.014,103,103,967
2012,3259,1824,2308,81399,81438,138,5.959,154,6.649,6962,1309,5653,1.607,8.549,7078,2416,4662,2.967,8.691,-116,-0.142,17.098,88,93,1481
2012,3261,8215,10459,572254,570029,408,3.873,558,5.297,51015,8163,42852,1.432,8.950,46552,12060,34492,2.116,8.167,4463,0.783,16.333,364,365,4994
2012,3262,1478,1885,128190,126233,67,3.530,93,4.900,11002,2531,8471,2.005,8.716,7013,1742,5271,1.380,5.556,3989,3.160,11.111,54,54,337
2012,3271,964,1152,34126,34077,65,5.587,88,7.563,3395,885,2510,2.597,9.963,3223,408,2815,1.197,9.458,172,0.505,18.916,61,61,277
2012,3272,1434,1707,83606,83004,119,6.977,116,6.802,6933,1046,5887,1.260,8.353,5645,1882,3763,2.267,6.801,1288,1.552,13.602,71,71,415
2012,3273,4145,8463,146332,146887,412,4.810,618,7.215,18855,3586,15269,2.441,12.836,19701,4702,14999,3.201,13.412,-846,-0.576,25.673,220,244,1640
2012,3274,169,300,12254,12349,14,4.620,20,6.601,669,112,557,0.907,5.417,848,105,743,0.850,6.867,-179,-1.450,10.835,14,14,76
2012,3279,2564,3016,69765,68636,204,6.724,240,7.910,7997,1908,6089,2.780,11.651,5755,1652,4103,2.407,8.385,2242,3.267,16.770,180,181,1059
2012,3311,254,403,103994,102495,12,2.916,29,7.047,6082,340,5742,0.332,5.934,3081,405,2676,0.395,3.006,3001,2.928,6.012,18,18,138
2012,3312,523,649,47727,45962,39,5.995,42,6.457,5654,887,4767,1.930,12.302,2170,657,1513,1.429,4.721,3484,7.580,9.443,25,25,485
2012,3313,394,521,54689,53228,21,4.019,24,4.593,5136,577,4559,1.084,9.649,2218,267,1951,0.502,4.167,2918,5.482,8.334,17,17,138
2012,3314,800,1001,63104,62093,57,5.746,39,3.931,5441,658,4783,1.060,8.763,3413,802,2611,1.292,5.497,2028,3.266,10.993,27,27,529
2012,3315,1607,1806,126693,121578,73,4.024,89,4.906,15587,1662,13925,1.367,12.821,5375,1508,3867,1.240,4.421,10212,8.400,8.842,54,55,560
2012,3321,2261,2483,113007,109508,59,2.350,114,4.541,12760,1327,11433,1.212,11.652,5810,2336,3474,2.133,5.306,6950,6.347,10.611,71,71,1156
2012,3322,1054,1143,36119,36380,55,4.768,76,6.589,1998,146,1852,0.401,5.492,2518,607,1911,1.669,6.921,-520,-1.429,10.984,55,55,269
2012,3323,10923,11848,318884,314216,579,4.839,812,6.787,38343,6315,32028,2.010,12.203,28905,10102,18803,3.215,9.199,9438,3.004,18.398,564,568,6270
2012,3324,1181,1486,87972,85954,56,3.750,71,4.754,9664,1501,8163,1.746,11.243,5650,1344,4306,1.564,6.573,4014,4.670,13.147,53,55,851
2012,3325,529,583,26524,26479,31,5.290,37,6.314,1891,143,1748,0.540,7.142,1805,315,1490,1.190,6.817,86,0.325,13.634,28,28,180
2012,3326,1108,1251,37685,37429,39,3.090,61,4.834,3461,586,2875,1.566,9.247,2960,717,2243,1.916,7.908,501,1.339,15.817,46,46,581
2012,3327,22182,22637,385385,373474,1269,5.633,1054,4.678,48825,8765,40060,2.347,13.073,25020,7393,17627,1.980,6.699,23805,6.374,13.399,759,760,4825
2012,3328,5052,5565,122821,120332,281,5.053,274,4.927,14297,2420,11877,2.011,11.881,9357,3370,5987,2.801,7.776,4940,4.105,15.552,187,188,1874
2012,3329,5520,6046,253407,247303,439,7.320,341,5.686,28116,5423,22693,2.193,11.369,15923,4934,10989,1.995,6.439,12193,4.930,12.877,244,244,2714
2012,3331,2568,2929,213416,201481,152,5.208,131,4.489,32663,2718,29945,1.349,16.211,9146,2898,6248,1.438,4.539,23517,11.672,9.079,96,96,1399
2012,3332,2976,3138,96644,96210,155,4.917,184,5.837,9607,1343,8264,1.396,9.986,8607,2128,6479,2.212,8.946,1000,1.039,17.892,135,135,1227
2012,3333,1812,1944,77729,78119,97,4.921,151,7.661,6045,775,5270,0.992,7.738,6879,1677,5202,2.147,8.806,-834,-1.068,15.476,112,112,1095
2012,3334,1491,1759,127174,126547,79,4.467,98,5.541,11857,2578,9279,2.037,9.370,10776,2661,8115,2.103,8.515,1081,0.854,17.031,71,71,1730
2012,3335,6290,6493,141268,137208,228,3.495,288,4.415,15585,2260,13325,1.647,11.359,7439,2909,4530,2.120,5.422,8146,5.937,10.843,200,203,1762
2012,3336,777,977,105797,101819,34,3.441,56,5.668,15368,3006,12362,2.952,15.093,7234,1581,5653,1.553,7.105,8134,7.989,14.210,41,41,379
2012,3339,5339,5965,282230,275016,297,4.981,292,4.897,29903,3078,26825,1.119,10.873,15476,5158,10318,1.876,5.627,14427,5.246,11.255,178,180,1696
2012,3341,969,1004,63804,66659,100,9.926,107,10.620,4218,1484,2734,2.226,6.328,10139,3191,6948,4.787,15.210,-5921,-8.883,12.656,80,80,2481
2012,3342,1275,1410,103330,107829,74,5.189,106,7.433,6760,1149,5611,1.066,6.269,15776,2082,13694,1.931,14.631,-9016,-8.361,12.538,79,81,1143
2012,3343,421,427,9290,9128,39,9.155,37,8.685,1054,279,775,3.057,11.547,715,128,587,1.402,7.833,339,3.714,15.666,32,32,117
2012,3344,3597,4037,279106,279983,245,6.046,276,6.811,23156,4331,18825,1.547,8.271,25202,7751,17451,2.768,9.001,-2046,-0.731,16.541,187,189,3784
2012,3345,4469,5124,383042,387717,299,5.827,314,6.119,28413,5674,22739,1.463,7.328,37770,8504,29266,2.193,9.742,-9357,-2.413,14.657,194,194,3359
2012,3346,508,521,14686,14867,54,10.256,65,12.346,1472,716,756,4.816,9.901,1874,831,1043,5.590,12.605,-402,-2.704,19.802,41,41,309
2012,3351,976,1053,43816,43795,66,6.280,62,5.899,4089,503,3586,1.149,9.337,4100,1771,2329,4.044,9.362,-11,-0.025,18.673,41,41,308
2012,3352,195,235,43436,43227,17,7.173,21,8.861,2900,328,2572,0.759,6.709,2472,984,1488,2.276,5.719,428,0.990,11.437,18,18,173
2012,3353,1817,2095,114493,112167,98,4.667,108,5.143,11245,1311,9934,1.169,10.025,6515,1537,4978,1.370,5.808,4730,4.217,11.617,70,70,648
2012,3359,1794,2074,131147,130432,137,6.662,102,4.960,10934,1969,8965,1.510,8.383,9647,1806,7841,1.385,7.396,1287,0.987,14.792,63,63,725
2012,3361,265,323,151266,143796,30,9.288,30,9.288,18984,135,18849,0.094,13.202,4426,1029,3397,0.716,3.078,14558,10.124,6.156,22,22,61
2012,3362,1569,1826,117734,111437,118,6.492,101,5.557,18872,1606,17266,1.441,16.935,6461,2378,4083,2.134,5.798,12411,11.137,11.596,68,68,1054
2012,3363,4089,4963,463350,448176,253,5.089,270,5.431,58358,5787,52571,1.291,13.021,27822,10010,17812,2.233,6.208,30536,6.813,12.416,171,173,1841
2012,3364,1287,1691,361274,358478,85,4.993,108,6.344,33834,2498,31336,0.697,9.438,27267,6092,21175,1.699,7.606,6567,1.832,15.213,55,56,1238
2012,3365,153,230,29512,27646,15,6.479,18,7.775,5895,280,5615,1.013,21.324,2057,751,1306,2.717,7.441,3838,13.883,14.881,6,6,255
2012,3366,1344,1463,133489,131382,125,8.603,105,7.226,14241,1745,12496,1.328,10.839,9944,990,8954,0.754,7.569,4297,3.271,15.138,70,70,483
2012,3369,786,815,34127,35442,88,10.844,81,9.982,4082,346,3736,0.976,11.517,6592,1107,5485,3.123,18.599,-2510,-7.082,23.035,53,53,475
2012,3371,10563,10844,202245,202639,857,7.783,1192,10.825,21148,4470,16678,2.206,10.436,22162,7853,14309,3.875,10.937,-1014,-0.500,20.873,824,825,4750
2012,3372,3434,3605,106132,106342,195,5.341,287,7.861,10368,1366,9002,1.285,9.750,10782,3149,7633,2.961,10.139,-414,-0.389,19.499,194,194,1659
2012,3379,665,752,31120,31101,34,4.379,83,10.689,3289,415,2874,1.334,10.575,3118,1487,1631,4.781,10.025,171,0.550,20.051,59,63,1065
2012,3391,10023,10897,288290,287375,640,5.848,735,6.716,26907,6576,20331,2.288,9.363,24978,7127,17851,2.480,8.692,1929,0.671,17.384,558,558,2968
2012,3399,15152,15525,258176,254637,2091,13.843,1251,8.282,33152,11249,21903,4.418,13.019,26122,8668,17454,3.404,10.259,7030,2.761,20.517,935,937,5751
2012,4231,16237,23798,370221,365366,1592,6.692,1575,6.621,49208,11895,37313,3.256,13.468,39898,11505,28393,3.149,10.920,9310,2.548,21.840,929,980,5336
2012,4232,10152,11961,142137,141540,925,7.684,1078,8.955,18880,4877,14003,3.446,13.339,17698,6135,11563,4.334,12.504,1182,0.835,25.008,707,731,3810
2012,4233,9649,15823,186948,187729,965,6.000,1483,9.221,24023,5560,18463,2.962,12.797,25610,9079,16531,4.836,13.642,-1587,-0.845,25.593,739,771,4107
2012,4234,22319,33399,649785,643378,2697,8.050,2909,8.682,91469,21865,69604,3.398,14.217,78290,25146,53144,3.908,12.169,13179,2.048,24.337,1478,1525,9709
2012,4235,7433,10237,150724,147172,619,6.033,666,6.491,21116,5050,16066,3.431,14.348,13907,4852,9055,3.297,9.449,7209,4.898,18.899,337,347,2168
2012,4236,18655,28303,510077,505622,2348,8.262,2580,9.078,71537,19081,52456,3.774,14.148,62428,19554,42874,3.867,12.347,9109,1.802,24.694,1123,1143,6199
2012,4237,10303,19011,224264,222867,1011,5.315,1033,5.431,26701,7280,19421,3.267,11.981,23491,5894,17597,2.645,10.540,3210,1.440,21.081,436,474,2567
2012,4238,39527,56289,707096,693302,3261,5.776,3601,6.378,98736,21000,77736,3.029,14.241,71016,25675,45341,3.703,10.243,27720,3.998,20.486,1719,1848,10044
2012,4239,27753,31102,341813,332148,3703,12.111,2648,8.661,56090,17282,38808,5.203,16.887,36841,13556,23285,4.081,11.092,19249,5.795,22.184,1861,1908,8787
2012,4241,7889,10136,150290,153284,524,5.038,1052,10.115,13289,3807,9482,2.484,8.670,19455,8508,10947,5.550,12.692,-6166,-4.023,17.339,461,470,2092
2012,4242,5931,9111,285480,279070,839,9.221,815,8.957,43182,14995,28187,5.373,15.474,30131,7223,22908,2.588,10.797,13051,4.677,21.594,444,449,3230
2012,4243,13365,14554,195931,193712,1638,11.258,1629,11.196,30613,8563,22050,4.420,15.803,26106,9253,16853,4.777,13.477,4507,2.327,26.953,1214,1233,6156
2012,4244,24538,31282,753141,756510,2608,8.317,2758,8.795,85411,18799,66612,2.485,11.290,91661,24968,66693,3.300,12.116,-6250,-0.826,22.580,1689,1743,11913
2012,4245,3295,6013,59722,60268,273,4.514,343,5.671,7256,1546,5710,2.565,12.040,8401,1790,6611,2.970,13.940,-1145,-1.900,24.079,166,182,834
2012,4246,8208,12547,147816,146740,731,5.806,819,6.505,19192,4550,14642,3.101,13.079,16634,6685,9949,4.556,11.336,2558,1.743,22.671,370,379,2279
2012,4247,4343,6465,101256,101486,289,4.395,511,7.771,14584,3475,11109,3.424,14.371,15142,4862,10280,4.791,14.920,-558,-0.550,28.741,213,248,1653
2012,4248,3158,4092,183302,181216,331,8.096,324,7.925,16907,3448,13459,1.903,9.330,12621,5378,7243,2.968,6.965,4286,2.365,13.929,204,204,2155
2012,4249,20237,26497,321106,318670,2418,9.144,2309,8.732,44095,12303,31792,3.861,13.837,39556,12718,26838,3.991,12.413,4539,1.424,24.826,1504,1539,6574
2012,4251,34592,36870,271603,276952,4415,11.892,4926,13.269,53399,14940,38459,5.394,19.281,63040,20010,43030,7.225,22.762,-9641,-3.481,38.562,3586,3625,11546
2012,4411,37249,42236,1101663,1077642,3522,8.358,3332,7.907,124081,32338,91743,3.001,11.514,76267,29554,46713,2.742,7.077,47814,4.437,14.154,2311,2351,19015
2012,4412,11643,13154,124001,121508,973,7.345,1158,8.742,18514,5564,12950,4.579,15.237,13551,5396,8155,4.441,11.152,4963,4.085,22.305,752,777,3402
2012,4413,27255,54934,489484,484259,2874,5.253,2420,4.424,60228,15625,44603,3.227,12.437,50022,9922,40100,2.049,10.330,10206,2.108,20.659,1514,1576,5793
2012,4421,13650,22193,192131,194138,2193,9.811,2512,11.238,25250,8740,16510,4.502,13.006,28936,11873,17063,6.116,14.905,-3686,-1.899,26.012,1278,1497,7337
2012,4422,18660,26423,231013,227675,1956,7.319,2560,9.579,36197,16587,19610,7.285,15.899,29576,12851,16725,5.644,12.990,6621,2.908,25.981,1550,1613,5109
2012,4431,23563,45307,416404,418939,4534,9.920,5328,11.658,64658,22257,42401,5.313,15.434,69788,22923,46865,5.472,16.658,-5130,-1.225,30.868,2819,3098,12918
2012,4441,36335,58044,1022669,1024820,2579,4.390,3996,6.801,72923,14654,58269,1.430,7.116,76914,21829,55085,2.130,7.505,-3991,-0.389,14.231,2370,2511,10382
2012,4442,13217,16457,143805,142329,975,5.899,1115,6.747,19536,4002,15534,2.812,13.726,16486,4483,12003,3.150,11.583,3050,2.143,23.166,753,773,3094
2012,4451,58787,85107,2590774,2567367,8697,10.317,7072,8.390,246890,87115,159775,3.393,9.616,203498,58565,144933,2.281,7.926,43392,1.690,15.853,4889,4957,24430
2012,4452,15749,19512,138068,134320,2365,12.187,2152,11.090,29457,10901,18556,8.116,21.930,21942,8629,13313,6.424,16.336,7515,5.595,32.671,1607,1630,6490
2012,4453,26394,30244,150901,149055,2586,8.616,2126,7.083,23747,8331,15416,5.589,15.932,20032,6633,13399,4.450,13.439,3715,2.492,26.879,1527,1543,4612
2012,4461,39483,86599,997039,972351,5522,6.364,5871,6.766,160494,33706,126788,3.466,16.506,107781,36167,71614,3.720,11.085,52713,5.421,22.169,2759,2882,12623
2012,4471,62056,107999,855978,853568,7585,7.024,7549,6.991,125220,44138,81082,5.171,14.670,119948,38085,81863,4.462,14.053,5272,0.618,28.105,4581,4789,22177
2012,4481,32133,91627,1298523,1302331,7659,8.359,7659,8.359,207836,69763,138073,5.357,15.959,217409,65674,151735,5.043,16.694,-9573,-0.735,31.918,3493,3856,14817
2012,4482,5477,24570,201478,204708,1182,4.769,1612,6.504,28656,8263,20393,4.036,13.999,35032,7694,27338,3.759,17.113,-6376,-3.115,27.997,523,577,1976
2012,4483,15965,22803,129059,128055,1632,7.148,1687,7.389,18964,5672,13292,4.429,14.809,16822,6301,10521,4.921,13.137,2142,1.673,26.273,1026,1049,3722
2012,4511,24842,35050,421334,414089,3134,8.950,3068,8.761,56051,19263,36788,4.652,13.536,41473,12781,28692,3.087,10.015,14578,3.520,20.031,2018,2114,7515
2012,4512,3792,8016,92279,101318,538,6.394,1334,15.855,10880,3027,7853,2.988,10.739,26911,20892,6019,20.620,26.561,-16031,-15.823,21.477,457,1091,18453
2012,4521,15,8027,1076995,1068866,82,1.021,85,1.059,56770,5673,51097,0.531,5.311,40498,4756,35742,0.445,3.789,16272,1.522,7.578,7,7,18
2012,4529,7120,38863,1789364,1784033,2818,7.383,1430,3.746,105949,38817,67132,2.176,5.939,94267,8743,85524,0.490,5.284,11682,0.655,10.568,852,933,3058
2012,4531,13048,13609,63470,64011,1028,7.423,1507,10.882,9827,3015,6812,4.710,15.352,10907,4100,6807,6.405,17.039,-1080,-1.687,30.704,1160,1172,3039
2012,4532,19365,29489,243451,248147,2388,7.960,3410,11.367,30098,10525,19573,4.241,12.129,39737,16508,23229,6.653,16.013,-9639,-3.884,24.258,2139,2211,7387
2012,4533,12552,18017,170146,164541,2090,11.828,1397,7.906,29014,11183,17831,6.796,17.633,17943,5048,12895,3.068,10.905,11071,6.728,21.810,1004,1031,3037
2012,4539,27514,36526,232833,230104,4331,11.982,3571,9.879,37906,16357,21549,7.109,16.473,32446,11971,20475,5.202,14.101,5460,2.373,28.201,2438,2528,8079
2012,4541,23772,24823,365342,355153,4657,19.590,2556,10.752,71422,24471,46951,6.890,20.110,50550,16238,34312,4.572,14.233,20872,5.877,28.467,1915,1927,8334
2012,4542,3282,3774,40888,37839,404,10.566,503,13.155,11155,3153,8002,8.333,29.480,5320,2789,2531,7.371,14.060,5835,15.421,28.119,350,360,1517
2012,4543,21165,26574,174830,174877,2602,9.796,2576,9.698,26079,8704,17375,4.977,14.913,26500,9257,17243,5.293,15.154,-421,-0.241,29.826,1701,1774,6122
2012,4811,393,2543,398029,389665,120,4.684,158,6.167,28078,3292,24786,0.845,7.206,11675,1538,10137,0.395,2.996,16403,4.210,5.992,37,39,190
2012,4812,1907,2100,36237,35490,224,10.659,227,10.802,5278,1631,3647,4.596,14.872,3664,1032,2632,2.908,10.324,1614,4.548,20.648,156,157,575
2012,4831,558,878,44053,44054,86,9.751,94,10.658,3722,1026,2696,2.329,8.449,3720,1145,2575,2.599,8.444,2,0.005,16.888,48,48,174
2012,4832,401,464,20639,20171,57,12.432,46,10.033,3283,769,2514,3.812,16.276,2337,898,1439,4.452,11.586,946,4.690,23.172,34,34,120
2012,4841,46526,55698,883606,872528,9246,16.904,7244,13.244,120438,40502,79936,4.642,13.803,98210,35039,63171,4.016,11.256,22228,2.548,22.512,5226,5289,22250
2012,4842,37569,41221,449920,443397,5770,14.170,4766,11.705,84694,25393,59301,5.727,19.101,70860,25004,45856,5.639,15.981,13834,3.120,31.962,3296,3327,15956
2012,4851,516,767,47862,46804,90,11.905,68,8.995,5208,2266,2942,4.842,11.127,3116,1386,1730,2.961,6.658,2092,4.470,13.315,48,49,875
2012,4852,284,478,15064,15614,35,7.315,36,7.524,1719,641,1078,4.105,11.009,2838,339,2499,2.171,18.176,-1119,-7.167,22.019,19,19,85
2012,4853,6255,6404,72346,69399,1067,16.898,888,14.063,14357,5060,9297,7.291,20.688,8526,3719,4807,5.359,12.286,5831,8.402,24.571,701,701,3035
2012,4854,2676,4176,214022,214146,199,4.720,280,6.641,16703,3886,12817,1.815,7.800,17403,5222,12181,2.439,8.127,-700,-0.327,15.600,158,158,2192
2012,4855,1185,1301,32638,32387,115,8.789,130,9.935,4220,1216,3004,3.755,13.030,3698,1297,2401,4.005,11.418,522,1.612,22.837,101,101,976
2012,4859,3267,3732,80729,79556,632,17.272,486,13.282,13279,4569,8710,5.743,16.691,11069,5152,5917,6.476,13.913,2210,2.778,27.827,359,361,3009
2012,4861,41,650,10422,11361,34,5.203,41,6.274,939,129,810,1.136,8.265,2674,1015,1659,8.934,23.538,-1735,-15.272,16.531,(D),(D),(D)
2012,4862,112,2164,29909,27727,389,19.097,135,6.627,7570,3981,3589,14.358,27.302,3165,979,2186,3.531,11.415,4405,15.887,22.830,(D),(D),(D)
2012,4869,43,608,6070,6206,28,4.542,45,7.299,494,136,358,2.191,7.960,779,416,363,6.703,12.552,-285,-4.592,15.920,(D),(D),(D)
2012,4871,434,477,9138,8841,68,14.196,72,15.031,1481,381,1100,4.309,16.751,901,523,378,5.916,10.191,580,6.560,20.382,66,66,497
2012,4872,1166,1212,12410,11817,175,14.559,155,12.895,2381,692,1689,5.856,20.149,1202,423,779,3.580,10.172,1179,9.977,20.344,103,103,255
2012,4879,158,178,2357,2247,25,14.085,24,13.521,386,70,316,3.116,17.182,174,48,126,2.137,7.745,212,9.437,15.491,15,15,31
2012,4881,3773,5562,163004,161868,469,8.436,464,8.346,22810,7821,14989,4.832,14.092,20700,6592,14108,4.072,12.788,2110,1.304,25.576,237,237,1818
2012,4882,480,1258,32529,31597,88,7.015,81,6.457,4604,858,3746,2.715,14.571,2726,801,1925,2.535,8.627,1878,5.944,17.255,37,37,181
2012,4883,1743,2267,93314,90870,176,7.769,173,7.636,16375,1680,14695,1.849,18.020,11879,2114,9765,2.326,13.073,4496,4.948,26.145,89,90,723
2012,4884,8653,9961,84173,82776,1204,12.186,1043,10.556,15297,5893,9404,7.119,18.480,12353,4370,7983,5.279,14.923,2944,3.557,29.847,750,752,2958
2012,4885,13567,18991,227585,225925,1748,9.217,1695,8.938,32747,8904,23843,3.941,14.495,29328,11419,17909,5.054,12.981,3419,1.513,25.963,875,929,4572
2012,4889,1139,1223,14341,14615,156,12.740,159,12.985,3106,1319,1787,9.025,21.253,3625,1809,1816,12.378,24.804,-519,-3.551,42.506,116,116,450
2012,4921,4092,8632,498670,496387,733,8.566,583,6.813,22925,5994,16931,1.208,4.618,17832,2638,15194,0.531,3.592,5093,1.026,7.185,403,404,1309
2012,4922,3800,4190,31689,31924,591,14.092,599,14.282,5420,2066,3354,6.472,16.978,5852,3097,2755,9.701,18.331,-432,-1.353,33.956,484,489,1879
2012,4931,6703,13940,712217,707663,936,6.658,1172,8.337,88854,24149,64705,3.413,12.556,79124,20383,58741,2.880,11.181,9730,1.375,22.362,322,338,3756
2012,5111,12305,17877,454118,471117,1230,6.794,1687,9.318,42983,17604,25379,3.737,9.124,76640,24649,51991,5.232,16.268,-33657,-7.144,18.247,937,980,5426
2012,5112,5352,8248,413434,403985,859,10.536,669,8.206,58786,18598,40188,4.604,14.552,39974,18828,21146,4.661,9.895,18812,4.657,19.790,341,357,6209
2012,5121,13136,16412,318150,303326,2468,15.190,2138,13.159,66956,16430,50526,5.417,22.074,40163,11806,28357,3.892,13.241,26793,8.833,26.482,1241,1260,5227
2012,5122,2790,3105,22837,22971,445,14.538,357,11.663,3034,1045,1989,4.549,13.208,3294,1155,2139,5.028,14.340,-260,-1.132,26.416,248,254,840
2012,5151,4034,8485,219854,215870,490,5.715,668,7.791,28294,7189,21105,3.330,13.107,20023,6672,13351,3.091,9.276,8271,3.831,18.551,221,234,1630
2012,5152,377,729,50482,48879,61,8.238,84,11.344,7283,1390,5893,2.844,14.900,4083,1746,2337,3.572,8.353,3200,6.547,16.707,26,26,107
2012,5171,3243,31248,741650,761026,2807,8.693,4890,15.144,98782,35891,62891,4.716,12.980,140065,57143,82922,7.509,18.405,-41283,-5.425,25.960,202,283,1754
2012,5172,1074,12850,259219,262839,2131,17.040,1443,11.538,30881,14315,16566,5.446,11.749,37721,11947,25774,4.545,14.351,-6840,-2.602,23.498,80,85,1289
2012,5174,348,438,8376,8336,60,12.973,109,23.568,1468,627,841,7.522,17.610,1411,759,652,9.105,16.927,57,0.684,33.853,59,60,457
2012,5179,3073,3532,48430,48388,530,14.706,674,18.701,8545,2801,5744,5.789,17.659,8696,3798,4898,7.849,17.971,-151,-0.312,35.319,536,542,2794
2012,5182,8781,13362,489237,477175,1963,14.639,2058,15.347,106948,27989,78959,5.866,22.413,82435,39148,43287,8.204,17.276,24513,5.137,34.551,670,698,6582
2012,5191,7362,9252,210807,198901,1576,17.453,1132,12.536,48106,18547,29559,9.325,24.186,23746,8422,15324,4.234,11.939,24360,12.247,23.877,670,677,3276
2012,5211,13,57,17939,17989,(D),(D),(D),(D),799,(D),698,(D),4.442,855,(D),851,(D),4.753,-56,-0.311,8.883,0,0,0
2012,5221,13202,124584,2015205,1993195,6246,5.036,5121,4.129,249882,66962,182920,3.360,12.537,207957,46576,161381,2.337,10.433,41925,2.103,20.867,361,537,6874
2012,5222,12963,38396,529153,546876,5545,14.345,6061,15.680,118002,35971,82031,6.578,21.577,153007,98521,54486,18.015,27.978,-35005,-6.401,43.155,1143,1274,6647
2012,5223,12161,27263,238627,238484,2762,10.003,3461,12.534,43794,11405,32389,4.782,18.364,42784,19097,23687,8.008,17.940,1010,0.424,35.880,1597,1726,6566
2012,5231,11778,44771,416647,414278,6803,15.790,3429,7.959,61537,19840,41697,4.789,14.854,58269,20429,37840,4.931,14.065,3268,0.789,28.130,757,772,3297
2012,5232,15,31,5700,5696,(D),(D),4,12.698,229,(D),226,(D),4.021,230,8,222,0.140,4.038,-1,-0.018,8.041,(D),(D),(D)
2012,5239,38746,44283,474525,461257,5672,12.915,4943,11.255,80330,31643,48687,6.860,17.415,53547,19597,33950,4.249,11.609,26783,5.807,23.218,3179,3217,10499
2012,5241,4363,30242,1420543,1408079,4319,14.614,2942,9.955,165445,72841,92604,5.173,11.750,139776,36714,103062,2.607,9.927,25669,1.823,19.853,393,408,2577
2012,5242,118638,132535,852184,848845,10879,8.190,11477,8.640,117865,38859,79006,4.578,13.885,111569,41593,69976,4.900,13.144,6296,0.742,26.287,7069,7271,20337
2012,5250,1181,1188,14225,9479,542,58.155,30,3.219,11460,10219,1241,107.807,120.899,2095,1684,411,17.766,22.101,9365,98.797,44.203,14,14,28
2012,5311,86028,110298,532751,532417,10467,9.540,9308,8.484,81158,33300,47858,6.255,15.243,80589,31922,48667,5.996,15.136,569,0.107,30.273,5916,6032,18936
2012,5312,55641,65929,244781,243393,9258,14.047,9212,13.977,47010,19691,27319,8.090,19.314,43966,18955,25011,7.788,18.064,3044,1.251,36.128,5439,5556,11099
2012,5313,61134,74102,618362,610117,8714,11.801,8197,11.101,100785,41828,58957,6.856,16.519,84436,33908,50528,5.558,13.839,16349,2.680,27.679,4640,4745,18180
2012,5321,3478,13300,139815,143872,4117,34.348,1489,12.423,52560,37942,14618,26.372,36.533,59703,11250,48453,7.819,41.497,-7143,-4.965,73.065,325,375,1315
2012,5322,7680,20877,154886,163405,2058,9.436,3922,17.983,26502,9411,17091,5.759,16.219,42224,23978,18246,14.674,25.840,-15722,-9.622,32.437,919,1268,5073
2012,5323,2362,2787,16973,16980,226,8.060,260,9.272,2838,838,2000,4.935,16.714,2872,1180,1692,6.950,16.915,-34,-0.200,33.429,144,160,705
2012,5324,6986,12928,157984,153196,1120,8.661,1126,8.708,28857,8074,20783,5.270,18.837,19669,6985,12684,4.560,12.839,9188,5.998,25.678,525,551,3505
2012,5331,1983,2137,33244,32048,294,14.033,210,10.024,5770,1937,3833,6.044,18.005,3254,886,2368,2.765,10.154,2516,7.851,20.307,150,150,626
2012,5411,160056,170071,1145002,1144068,13308,7.831,13056,7.682,127175,40889,86286,3.574,11.116,125402,37366,88036,3.266,10.961,1773,0.155,21.922,9112,9202,25461
2012,5412,99015,114161,1279867,1285831,10017,8.789,9630,8.450,177911,57438,120473,4.467,13.836,188104,72060,116044,5.604,14.629,-10193,-0.793,27.673,6092,6246,45222
2012,5413,79346,94854,1319098,1311109,9304,9.790,9677,10.182,202123,55031,147092,4.197,15.416,186739,63639,123100,4.854,14.243,15384,1.173,28.486,5245,5346,21098
2012,5414,24119,24392,99726,98626,3581,14.787,3230,13.338,18100,7779,10321,7.887,18.352,15944,8030,7914,8.142,16.166,2156,2.186,32.332,2233,2236,5830
2012,5415,91186,108658,1451085,1436736,19161,17.887,16087,15.018,319075,101870,217205,7.090,22.208,290394,112235,178159,7.812,20.212,28681,1.996,40.424,9353,9424,40944
2012,5416,109167,117254,989952,960565,21707,18.811,17989,15.589,217964,85997,131967,8.953,22.691,158166,62712,95454,6.529,16.466,59798,6.225,32.932,12399,12495,36369
2012,5417,12255,15237,599827,607503,1897,12.435,1933,12.671,68671,19143,49528,3.151,11.304,83523,31321,52202,5.156,13.749,-14852,-2.445,22.608,1019,1044,6286
2012,5418,29576,32819,441441,435357,3750,11.397,3921,11.916,74379,19627,54752,4.508,17.085,62205,25460,36745,5.848,14.288,12174,2.796,28.577,2653,2674,13971
2012,5419,50154,59862,573736,572702,5385,9.002,5296,8.854,85006,25728,59278,4.492,14.843,83310,25751,57559,4.496,14.547,1696,0.296,29.094,3590,3617,14663
2012,5511,25903,51099,3030877,3013210,4697,9.210,4500,8.823,471031,107710,363321,3.575,15.632,434359,130014,304345,4.315,14.415,36672,1.217,28.830,817,862,11196
2012,5611,24852,26891,379927,373256,3862,14.594,3007,11.363,75037,32421,42616,8.686,20.103,61476,26537,34939,7.110,16.470,13561,3.633,32.940,2037,2044,15248
2012,5612,1710,5210,257209,253470,493,9.494,459,8.839,37956,10883,27073,4.294,14.975,30815,6728,24087,2.654,12.157,7141,2.817,24.315,89,96,866
2012,5613,24084,43465,4693365,4537954,4865,11.207,4753,10.949,990289,159845,830444,3.522,21.822,679910,216227,463683,4.765,14.983,310379,6.840,29.965,2541,2705,123000
2012,5614,24333,30384,753435,748095,2980,9.716,3553,11.584,120185,37418,82767,5.002,16.065,109296,39946,69350,5.340,14.610,10889,1.456,29.220,2305,2355,21304
2012,5615,12880,18256,220760,219360,1446,7.832,1860,10.074,27555,10754,16801,4.902,12.562,24438,10332,14106,4.710,11.141,3117,1.421,22.281,965,988,3461
2012,5616,17654,23760,840186,825295,2473,10.465,2216,9.377,117169,35146,82023,4.259,14.197,86497,26882,59615,3.257,10.481,30672,3.716,20.961,1339,1377,15585
2012,5617,139732,146532,1675118,1647683,21772,15.119,16725,11.614,287282,85800,201482,5.207,17.436,232149,78416,153733,4.759,14.089,55133,3.346,28.179,11185,11216,45285
2012,5619,15340,17253,260276,259592,1742,10.101,1728,10.020,42279,11253,31026,4.335,16.287,40877,14695,26182,5.661,15.747,1402,0.540,31.493,1138,1156,5781
2012,5621,7314,10237,184384,184816,823,8.056,780,7.635,30140,7888,22252,4.268,16.308,30738,9052,21686,4.898,16.632,-598,-0.324,32.616,490,495,3240
2012,5622,1196,2337,48561,48627,141,5.975,187,7.924,6517,1617,4900,3.325,13.402,6588,1832,4756,3.767,13.548,-71,-0.146,26.804,93,98,656
2012,5629,7852,9214,125666,125513,893,9.691,894,9.702,24468,6518,17950,5.193,19.494,24261,9343,14918,7.444,19.329,207,0.165,38.659,481,488,3031
2012,6111,18179,20528,894132,874441,995,4.966,12,0.060,77798,16433,61365,1.879,8.897,38635,51,38584,0.006,4.418,39163,4.479,8.837,5,5,23
2012,6112,443,932,81669,82173,55,6.071,3,0.331,5877,1058,4819,1.288,7.152,6697,12,6685,0.015,8.150,-820,-0.998,14.304,3,3,12
2012,6113,2201,4231,1805297,1786060,271,6.617,0,0.000,101300,7044,94256,0.394,5.672,61657,0,61657,0.000,3.452,39643,2.220,6.904,0,0,0
2012,6114,6861,7338,64557,64164,949,13.064,802,11.040,12514,5052,7462,7.874,19.503,11948,5200,6748,8.104,18.621,566,0.882,37.242,488,493,1947
2012,6115,6022,7834,138995,137530,748,9.628,618,7.955,22234,6605,15629,4.803,16.167,19357,3518,15839,2.558,14.075,2877,2.092,28.149,401,413,1989
2012,6116,36177,39087,382081,372339,5301,13.880,3512,9.196,77781,23893,53888,6.417,20.890,58053,18715,39338,5.026,15.591,19728,5.298,31.183,2538,2559,12311
2012,6117,5082,5881,92097,91084,905,15.475,839,14.347,14788,4044,10744,4.440,16.236,12703,3599,9104,3.951,13.946,2085,2.289,27.893,547,548,2056
2012,6211,169816,203958,2196527,2183723,14941,7.308,15928,7.791,297481,102848,194633,4.710,13.623,271026,105146,165880,4.815,12.411,26455,1.211,24.822,10628,10907,65458
2012,6212,119235,127163,873874,864745,6133,4.840,5241,4.136,104005,31560,72445,3.650,12.027,86058,23905,62153,2.764,9.952,17947,2.075,19.904,4041,4148,18714
2012,6213,113433,128218,748712,732065,11948,9.383,10191,8.003,128430,40924,87506,5.590,17.544,96258,37606,58652,5.137,13.149,32172,4.395,26.298,5745,7293,27261
2012,6214,14966,34565,772696,761771,2854,8.384,1807,5.308,106216,34722,71494,4.558,13.943,83659,21097,62562,2.769,10.982,22557,2.961,21.964,816,931,10288
2012,6215,7190,12784,244595,245471,1259,9.881,1174,9.214,31773,10936,20837,4.455,12.944,34278,10717,23561,4.366,13.964,-2505,-1.020,25.887,605,636,4793
2012,6216,19426,27601,1250784,1222552,3352,12.371,2341,8.640,193841,43421,150420,3.552,15.855,136810,35788,101022,2.927,11.191,57031,4.665,22.381,1361,1413,17655
2012,6219,6056,9390,287179,283315,817,8.733,747,7.985,41810,11154,30656,3.937,14.757,34216,11427,22789,4.033,12.077,7594,2.680,24.154,408,420,6343
2012,6221,2820,5018,5246544,5205772,89,1.776,75,1.497,274299,54957,219342,1.056,5.269,194958,25063,169895,0.481,3.745,79341,1.524,7.490,36,39,8390
2012,6222,414,591,226459,224761,10,1.679,19,3.191,22247,2233,20014,0.994,9.898,18942,5358,13584,2.384,8.428,3305,1.470,16.855,14,14,4519
2012,6223,345,880,270755,267194,25,2.844,23,2.617,19212,3616,15596,1.353,7.190,12238,2427,9811,0.908,4.580,6974,2.610,9.160,7,7,1279
2012,6231,8139,15987,1669567,1659735,917,5.743,878,5.499,142961,63910,79051,3.851,8.613,123473,40617,82856,2.447,7.439,19488,1.174,14.879,427,435,26264
2012,6232,9333,35948,698031,691589,1779,4.966,1524,4.255,83814,16145,67669,2.334,12.119,71427,14802,56625,2.140,10.328,12387,1.791,20.656,321,398,4735
2012,6233,15106,21290,820795,812694,1683,7.976,1307,6.194,84373,28417,55956,3.497,10.382,67348,22659,44689,2.788,8.287,17025,2.095,16.574,887,908,14982
2012,6239,2930,4975,130296,131808,280,5.500,511,10.038,14452,2668,11784,2.024,10.964,17427,6038,11389,4.581,13.222,-2975,-2.257,21.929,189,204,2397
2012,6241,44036,60386,1451062,1431260,5864,9.817,4554,7.624,195833,46112,149721,3.222,13.683,155882,36250,119632,2.533,10.891,39951,2.791,21.782,2560,2630,17513
2012,6242,10002,14011,178079,177328,1062,7.665,749,5.406,25422,8958,16464,5.052,14.336,23872,5727,18145,3.230,13.462,1550,0.874,26.924,321,362,2887
2012,6243,4035,7611,329029,339292,343,4.437,581,7.516,43053,10174,32879,2.999,12.689,64105,19671,44434,5.798,18.894,-21052,-6.205,25.378,172,178,5957
2012,6244,55554,70600,868925,869677,6250,8.832,6586,9.306,110856,35946,74910,4.133,12.747,112500,39593,72907,4.553,12.936,-1644,-0.189,25.494,4424,4513,25696
2012,7111,6845,6979,116942,114705,881,12.744,749,10.835,21045,6091,14954,5.310,18.347,16642,5055,11587,4.407,14.509,4403,3.839,29.017,496,497,3339
2012,7112,3227,3386,120162,119575,467,13.837,445,13.185,15364,4218,11146,3.527,12.849,14279,2816,11463,2.355,11.941,1085,0.907,23.883,323,324,1873
2012,7113,5464,5765,139188,137308,654,11.419,579,10.109,18571,2939,15632,2.140,13.525,14864,3882,10982,2.827,10.825,3707,2.700,21.651,393,397,2329
2012,7114,2840,2948,17309,17116,408,13.970,353,12.087,3337,1774,1563,10.365,19.496,2879,1030,1849,6.018,16.821,458,2.676,33.641,246,248,653
2012,7115,13894,13932,41880,41142,2567,18.689,2173,15.821,11115,5733,5382,13.935,27.017,9602,4697,4905,11.417,23.339,1513,3.678,46.678,1308,1308,2870
2012,7121,6399,6842,136743,132979,365,5.369,277,4.075,14387,2123,12264,1.596,10.819,6952,1215,5737,0.914,5.228,7435,5.591,10.456,163,163,750
2012,7131,2367,2715,162694,155300,405,15.106,337,12.570,26947,4940,22007,3.181,17.352,11481,2595,8886,1.671,7.393,15466,9.959,14.786,227,229,1986
2012,7132,1813,2735,152361,148122,294,10.913,212,7.869,16426,6279,10147,4.239,11.090,8352,2302,6050,1.554,5.639,8074,5.451,11.277,153,159,1795
2012,7139,48329,55464,1175922,1155426,6120,11.109,5370,9.748,168887,57748,111139,4.998,14.617,127823,42226,85597,3.655,11.063,41064,3.554,22.126,3902,3954,27644
2012,7211,38668,49854,1885778,1870363,3967,7.990,3560,7.170,197891,86786,111105,4.640,10.580,167555,70229,97326,3.755,8.958,30336,1.622,17.917,2140,2187,36583
2012,7212,5312,5886,40929,40063,472,8.048,430,7.332,7212,1545,5667,3.856,18.002,5563,1149,4414,2.868,13.886,1649,4.116,27.772,254,256,697
2012,7213,1900,2026,11619,11081,128,6.307,135,6.652,2252,1137,1115,10.261,20.323,1161,398,763,3.592,10.477,1091,9.846,20.955,97,97,307
2012,7223,12472,34648,674433,670769,5106,14.511,6182,17.569,136185,48856,87329,7.284,20.303,128325,53376,74949,7.957,19.131,7860,1.172,38.262,1398,1409,9605
2012,7224,37727,38578,349121,341952,3964,10.255,4114,10.643,69917,31943,37974,9.341,20.446,55596,23931,31665,6.998,16.258,14321,4.188,32.517,3260,3265,19261
2012,7225,343218,471048,9011671,8852986,50494,10.814,42225,9.043,1423988,623176,800812,7.039,16.085,1103626,410307,693319,4.635,12.466,320362,3.619,24.932,31935,33082,287554
2012,8111,133772,146243,811293,805256,12323,8.467,10909,7.496,119024,40746,78278,5.060,14.781,106282,35933,70349,4.462,13.199,12742,1.582,26.397,7740,7846,24525
2012,8112,9786,11098,99869,101847,1202,10.776,1314,11.781,13971,4489,9482,4.408,13.718,17884,7914,9970,7.770,17.560,-3913,-3.842,27.435,856,938,4397
2012,8113,17787,19389,189020,182580,1792,9.308,1518,7.885,34812,10052,24760,5.506,19.067,21553,8369,13184,4.584,11.805,13259,7.262,23.609,1000,1003,3898
2012,8114,16774,17455,64828,64672,1992,11.465,1831,10.538,10956,4568,6388,7.063,16.941,10606,4457,6149,6.892,16.400,350,0.541,32.799,1306,1319,3074
2012,8121,89537,105967,639749,635293,13346,12.760,10591,10.126,112880,52278,60602,8.229,17.768,103431,38756,64675,6.100,16.281,9449,1.487,32.562,7793,7895,27608
2012,8122,14420,20052,136700,136185,737,3.680,684,3.416,16934,3083,13851,2.264,12.435,15639,2470,13169,1.814,11.484,1295,0.951,22.967,416,430,1681
2012,8123,28493,33764,291070,293354,2404,7.077,2814,8.284,37504,11016,26488,3.755,12.785,42164,14094,28070,4.804,14.373,-4660,-1.589,25.569,2041,2122,8684
2012,8129,23318,33119,252607,248986,5148,15.625,4806,14.587,55606,22962,32644,9.222,22.333,48406,24957,23449,10.023,19.441,7200,2.892,38.883,2050,2267,9782
2012,8131,176042,176367,1682183,1665230,8599,4.995,158,0.092,154367,28167,126200,1.691,9.270,121059,387,120672,0.023,7.270,33308,2.000,14.540,90,90,249
2012,8132,15890,17995,176403,174211,1494,8.399,1078,6.061,19996,5782,14214,3.319,11.478,15622,4758,10864,2.731,8.967,4374,2.511,17.935,721,722,2828
2012,8133,13541,15893,150840,147770,1292,8.182,1089,6.896,21165,4848,16317,3.281,14.323,15043,4530,10513,3.066,10.180,6122,4.143,20.360,624,626,2158
2012,8134,23191,24945,228892,228513,1249,4.991,1408,5.626,27083,4882,22201,2.136,11.852,26341,6378,19963,2.791,11.527,742,0.325,23.054,907,917,3715
2012,8139,55112,57309,498491,491504,2798,4.926,1775,3.125,54894,11840,43054,2.409,11.169,41380,5744,35636,1.169,8.419,13514,2.750,16.838,1194,1196,3634
2013,2111,5818,7249,129355,127617,637,8.793,627,8.655,20201,6444,13757,5.049,15.829,16791,5444,11347,4.266,13.157,3410,2.672,26.315,386,389,1537
2013,2121,488,917,84832,86149,78,8.263,132,13.983,7639,4325,3314,5.020,8.867,10363,2468,7895,2.865,12.029,-2724,-3.162,17.734,64,64,1024
2013,2122,260,326,41276,40618,41,12.635,38,11.710,3767,355,3412,0.874,9.274,2436,243,2193,0.598,5.997,1331,3.277,11.995,27,27,198
2013,2123,2730,4803,77208,75758,295,6.119,331,6.866,11264,3620,7644,4.778,14.868,8248,1732,6516,2.286,10.887,3016,3.981,21.775,182,183,937
2013,2131,10251,12739,391377,390540,1661,13.164,1419,11.246,73069,19631,53438,5.027,18.710,71594,29564,42030,7.570,18.332,1475,0.378,36.664,883,913,9146
2013,2211,1695,10361,510253,511820,581,5.639,465,4.513,34600,12276,22324,2.399,6.760,37684,8282,29402,1.618,7.363,-3084,-0.603,13.520,67,74,1260
2013,2212,420,2445,82346,82611,197,8.130,153,6.314,7594,3693,3901,4.470,9.192,8143,1681,6462,2.035,9.857,-549,-0.665,18.385,28,30,159
2013,2213,3465,4599,41911,42636,213,4.603,270,5.835,3051,784,2267,1.839,7.156,4495,1245,3250,2.920,10.543,-1444,-3.387,14.312,112,112,508
2013,2361,124977,126168,598325,581737,23201,18.585,20546,16.458,153764,64471,89293,11.082,26.432,120744,53131,67613,9.133,20.756,33020,5.676,41.512,12829,12834,35245
2013,2362,34286,35569,544051,538560,3525,9.838,4047,11.295,97411,17619,79792,3.272,18.087,85867,21800,64067,4.048,15.944,11544,2.143,31.888,2735,2754,14664
2013,2371,15908,17359,508472,497854,1462,8.360,1720,9.835,105958,18522,87436,3.720,21.283,85674,21240,64434,4.266,17.209,20284,4.074,34.417,1072,1110,14954
2013,2372,4637,4703,23138,23364,422,8.711,705,14.553,4032,1488,2544,6.369,17.258,4435,1988,2447,8.509,18.983,-403,-1.725,34.515,540,540,1531
2013,2373,8083,8891,252011,256627,544,6.027,815,9.029,32396,4219,28177,1.644,12.624,41395,6385,35010,2.488,16.130,-8999,-3.507,25.248,477,479,3580
2013,2379,3495,3597,81084,81014,376,10.367,436,12.021,13057,2900,10157,3.580,16.117,12833,3440,9393,4.246,15.840,224,0.276,31.681,269,270,1390
2013,2381,68336,69054,668242,661861,8654,12.386,10288,14.724,148086,34023,114063,5.141,22.374,135571,42893,92678,6.481,20.483,12515,1.891,40.967,6226,6238,29441
2013,2382,149989,153917,1673638,1645033,14714,9.591,13696,8.928,274909,53049,221860,3.225,16.711,217573,58325,159248,3.546,13.226,57336,3.485,26.452,9418,9445,40760
2013,2383,85338,86297,625315,614189,11415,13.221,11505,13.325,131292,33582,97710,5.468,21.376,108989,36415,72574,5.929,17.745,22303,3.631,35.490,7475,7478,26056
2013,2389,50862,51554,477625,473772,6348,12.296,6489,12.570,88153,21824,66329,4.606,18.607,80370,24483,55887,5.168,16.964,7783,1.643,33.928,3957,3960,16776
2013,3111,1036,1630,45643,44991,101,6.198,100,6.137,5440,1703,3737,3.785,12.091,4222,1680,2542,3.734,9.384,1218,2.707,18.768,66,66,756
2013,3112,454,804,54385,53696,53,6.679,32,4.033,4512,1560,2952,2.905,8.403,3029,221,2808,0.412,5.641,1483,2.762,11.282,23,23,111
2013,3113,1483,1618,71116,69455,135,8.456,92,5.763,8192,801,7391,1.153,11.795,4966,1604,3362,2.309,7.150,3226,4.645,14.300,71,71,438
2013,3114,1273,1635,156301,156138,106,6.467,114,6.955,11975,1669,10306,1.069,7.670,11697,3794,7903,2.430,7.491,278,0.178,14.983,81,81,1681
2013,3115,1048,1548,134788,134155,109,7.092,87,5.660,9337,1360,7977,1.014,6.960,8003,2192,5811,1.634,5.965,1334,0.994,11.931,59,59,556
2013,3116,2772,3364,476020,481310,163,4.831,183,5.424,21430,2781,18649,0.578,4.452,32109,8480,23629,1.762,6.671,-10679,-2.219,8.905,129,129,4016
2013,3117,437,527,31336,31688,30,5.618,44,8.240,2629,370,2259,1.168,8.297,3408,770,2638,2.430,10.755,-779,-2.458,16.593,28,29,610
2013,3118,9024,9680,267413,269820,968,10.056,860,8.934,28215,7858,20357,2.912,10.457,32413,16195,16218,6.002,12.013,-4198,-1.556,20.914,654,663,4522
2013,3119,2659,3086,176725,171075,262,8.531,232,7.555,22897,4268,18629,2.495,13.384,12045,3776,8269,2.207,7.041,10852,6.343,14.082,158,161,1824
2013,3121,4441,5054,145084,139922,894,18.885,254,5.365,18689,5547,13142,3.964,13.357,8397,1925,6472,1.376,6.001,10292,7.356,12.002,165,170,943
2013,3122,90,109,14269,14462,9,8.295,8,7.373,624,117,507,0.809,4.315,1032,292,740,2.019,7.136,-408,-2.821,8.630,4,4,46
2013,3131,240,308,24885,24968,18,5.863,16,5.212,1251,258,993,1.033,5.010,1373,251,1122,1.005,5.499,-122,-0.489,10.021,10,11,79
2013,3132,806,886,50909,50644,43,4.802,62,6.924,4135,450,3685,0.889,8.165,3584,1006,2578,1.986,7.077,551,1.088,14.154,37,39,381
2013,3133,1017,1062,28664,29061,130,12.579,73,7.063,2896,780,2116,2.684,9.965,3796,1293,2503,4.449,13.062,-900,-3.097,19.930,53,53,315
2013,3141,1626,1739,52555,51609,100,5.634,172,9.690,5113,821,4292,1.591,9.907,3151,1059,2092,2.052,6.106,1962,3.802,12.211,128,128,453
2013,3149,3976,4086,60812,61719,407,10.033,348,8.579,6764,1767,4997,2.863,10.959,8491,2562,5929,4.151,13.758,-1727,-2.798,21.919,252,252,1501
2013,3151,255,269,12200,12451,13,4.753,22,8.044,700,25,675,0.201,5.622,1165,552,613,4.434,9.357,-465,-3.735,11.245,19,19,181
2013,3152,4775,4821,90276,89202,722,14.958,734,15.206,17056,7678,9378,8.607,19.121,15041,6126,8915,6.868,16.862,2015,2.259,33.723,613,613,5357
2013,3159,490,498,8427,8521,52,10.379,58,11.577,921,276,645,3.239,10.809,1091,528,563,6.197,12.804,-170,-1.995,21.618,40,40,354
2013,3161,177,187,3610,3566,18,9.756,13,7.046,320,120,200,3.366,8.975,223,37,186,1.038,6.254,97,2.721,12.509,8,8,29
2013,3162,179,197,11667,11474,18,9.114,19,9.620,1268,130,1138,1.133,11.052,931,140,791,1.220,8.114,337,2.937,16.229,15,15,49
2013,3169,649,652,11744,12194,51,7.727,67,10.152,893,130,763,1.066,7.324,1769,665,1104,5.454,14.508,-876,-7.184,14.647,47,47,530
2013,3211,2634,3006,77234,76808,189,6.191,283,9.270,7954,2094,5860,2.726,10.356,7011,2958,4053,3.851,9.128,943,1.228,18.256,194,198,1536
2013,3212,1077,1349,64819,62583,48,3.500,93,6.781,8223,1041,7182,1.663,13.139,3661,1657,2004,2.648,5.850,4562,7.290,11.700,62,63,744
2013,3219,7396,8262,210788,206754,540,6.487,664,7.977,27463,4448,23015,2.151,13.283,19503,7606,11897,3.679,9.433,7960,3.850,18.866,474,474,4840
2013,3221,222,435,107006,107566,13,2.975,17,3.890,4118,737,3381,0.685,3.828,5216,2202,3014,2.047,4.849,-1098,-1.021,7.657,6,6,555
2013,3222,2517,3796,241807,242158,130,3.407,170,4.455,14712,3056,11656,1.262,6.075,15590,4198,11392,1.734,6.438,-878,-0.363,12.151,104,106,1389
2013,3231,24065,25295,463345,468758,1316,5.123,2105,8.194,35800,8821,26979,1.882,7.637,46751,16383,30368,3.495,9.973,-10951,-2.336,15.274,1685,1689,10909
2013,3241,918,2074,96785,97556,107,5.117,141,6.743,6038,1108,4930,1.136,6.189,7565,2147,5418,2.201,7.755,-1527,-1.565,12.379,43,46,295
2013,3251,1306,2366,156572,155302,81,3.390,128,5.357,12719,2675,10044,1.722,8.190,10298,2472,7826,1.592,6.631,2421,1.559,13.262,74,76,1144
2013,3252,1067,1412,94281,93925,66,4.688,58,4.119,6828,1496,5332,1.593,7.270,6034,1827,4207,1.945,6.424,794,0.845,12.849,33,33,855
2013,3253,621,863,28275,28561,60,6.952,60,6.952,2084,348,1736,1.218,7.297,2652,837,1815,2.931,9.285,-568,-1.989,14.593,38,38,317
2013,3254,1561,2009,232141,232021,154,7.745,113,5.683,23500,9423,14077,4.061,10.128,24356,2847,21509,1.227,10.497,-856,-0.369,20.257,82,82,1676
2013,3255,1244,1551,53499,52744,53,3.379,88,5.610,5547,1339,4208,2.539,10.517,4009,1793,2216,3.399,7.601,1538,2.916,15.202,55,55,443
2013,3256,1860,2045,92917,92224,122,5.943,138,6.722,7165,867,6298,0.940,7.769,5804,1849,3955,2.005,6.293,1361,1.476,12.587,105,105,867
2013,3259,1731,2217,80781,81183,121,5.418,154,6.895,7503,2403,5100,2.960,9.242,8176,2220,5956,2.735,10.071,-673,-0.829,18.484,106,106,956
2013,3261,8027,10272,581673,577828,424,4.101,556,5.378,51288,8245,43043,1.427,8.876,43585,14482,29103,2.506,7.543,7703,1.333,15.086,359,371,7620
2013,3262,1409,1805,126191,126496,53,2.913,82,4.507,7277,953,6324,0.753,5.753,8043,1019,7024,0.806,6.358,-766,-0.606,11.506,52,52,497
2013,3271,908,1086,32497,33121,65,5.880,104,9.408,2476,372,2104,1.123,7.476,3797,928,2869,2.802,11.464,-1321,-3.988,14.951,76,76,477
2013,3272,1366,1632,85859,84721,96,5.801,142,8.580,7398,844,6554,0.996,8.732,5128,2078,3050,2.453,6.053,2270,2.679,12.106,100,101,1105
2013,3273,4038,8253,149658,148114,316,3.784,513,6.143,20806,5134,15672,3.466,14.047,18035,4731,13304,3.194,12.176,2771,1.871,24.353,195,200,1915
2013,3274,165,293,12097,12130,11,3.716,17,5.743,683,118,565,0.973,5.631,749,297,452,2.449,6.175,-66,-0.544,11.262,12,12,74
2013,3279,2520,2997,69885,69881,166,5.510,197,6.539,6459,1359,5100,1.945,9.243,6479,2297,4182,3.287,9.272,-20,-0.029,18.486,136,137,1022
2013,3311,292,428,102618,102846,51,12.424,16,3.898,3778,812,2966,0.790,3.673,4300,1330,2970,1.293,4.181,-522,-0.508,7.347,8,8,101
2013,3312,521,649,44883,44854,34,5.227,37,5.688,3428,498,2930,1.110,7.643,3361,306,3055,0.682,7.493,67,0.149,14.986,29,29,270
2013,3313,403,531,56784,55933,19,3.558,25,4.682,4953,966,3987,1.727,8.855,3250,1365,1885,2.440,5.811,1703,3.045,11.621,16,16,224
2013,3314,756,941,59026,59431,41,4.359,40,4.253,3170,633,2537,1.065,5.334,3995,765,3230,1.287,6.722,-825,-1.388,10.668,30,31,470
2013,3315,1581,1784,127882,128758,56,3.120,78,4.345,8411,1566,6845,1.216,6.532,10207,1762,8445,1.368,7.927,-1796,-1.395,13.065,55,55,776
2013,3321,2296,2533,119247,118956,56,2.196,90,3.529,8485,1196,7289,1.005,7.133,7906,1275,6631,1.072,6.646,579,0.487,13.292,61,61,646
2013,3322,1058,1137,35655,36048,36,3.116,73,6.318,2067,159,1908,0.441,5.734,2850,1068,1782,2.963,7.906,-783,-2.172,11.468,49,49,571
2013,3323,11014,11949,333990,329914,625,5.211,717,5.977,37233,6117,31116,1.854,11.286,29025,7867,21158,2.385,8.798,8208,2.488,17.596,509,520,4806
2013,3324,1116,1406,85091,84092,58,4.112,67,4.750,8008,1586,6422,1.886,9.523,5981,1412,4569,1.679,7.112,2027,2.410,14.225,47,47,796
2013,3325,501,550,22850,23589,29,5.249,34,6.154,1285,194,1091,0.822,5.447,2725,805,1920,3.413,11.552,-1440,-6.105,10.895,22,22,170
2013,3326,1102,1239,39747,39261,32,2.547,67,5.332,3716,918,2798,2.338,9.465,2763,800,1963,2.038,7.038,953,2.427,14.075,43,45,400
2013,3327,21087,21550,365773,365120,1034,4.780,1195,5.525,34908,7037,27871,1.927,9.561,33545,10601,22944,2.903,9.187,1363,0.373,18.375,905,908,6632
2013,3328,5103,5634,128281,126787,248,4.385,291,5.145,13143,2781,10362,2.193,10.366,10017,2928,7089,2.309,7.901,3126,2.466,15.801,222,223,1807
2013,3329,5694,6228,265631,262519,394,6.342,364,5.859,25274,3255,22019,1.240,9.627,18869,5182,13687,1.974,7.188,6405,2.440,14.375,261,262,2489
2013,3331,2510,2894,212415,211381,175,6.062,161,5.577,19177,2808,16369,1.328,9.072,17417,4660,12757,2.205,8.240,1760,0.833,16.479,117,117,2367
2013,3332,2994,3153,101703,99835,147,4.657,154,4.879,10476,1833,8643,1.836,10.493,6922,1689,5233,1.692,6.933,3554,3.560,13.867,112,113,1067
2013,3333,1788,1911,76448,77452,97,5.040,124,6.443,5077,841,4236,1.086,6.555,7045,1862,5183,2.404,9.096,-1968,-2.541,13.110,78,78,609
2013,3334,1487,1750,129883,129393,83,4.709,108,6.128,10364,1425,8939,1.101,8.010,9304,2471,6833,1.910,7.190,1060,0.819,14.381,70,71,669
2013,3335,6436,6659,152352,149875,249,3.725,300,4.488,14740,2761,11979,1.842,9.835,9768,3172,6596,2.116,6.517,4972,3.317,13.035,222,222,1682
2013,3336,852,1052,104503,107007,37,3.510,41,3.890,6598,377,6221,0.352,6.166,11841,3292,8549,3.076,11.066,-5243,-4.900,12.332,21,21,1238
2013,3339,5302,5952,288713,284381,251,4.210,271,4.545,25352,4680,20672,1.646,8.915,16674,4433,12241,1.559,5.863,8678,3.052,11.727,183,183,1471
2013,3341,956,990,59813,62765,74,7.433,85,8.538,3633,894,2739,1.424,5.788,9359,5239,4120,8.347,14.911,-5726,-9.123,11.577,57,57,472
2013,3342,1203,1322,102097,102195,65,4.818,119,8.821,7743,532,7211,0.521,7.577,8186,1633,6553,1.598,8.010,-443,-0.433,15.153,90,91,527
2013,3343,412,419,8387,8343,38,9.080,37,8.841,1117,217,900,2.601,13.388,1008,679,329,8.139,12.082,109,1.306,24.164,32,32,295
2013,3344,3536,3974,264028,269919,194,4.840,263,6.561,15525,2877,12648,1.066,5.752,27247,7698,19549,2.852,10.095,-11722,-4.343,11.503,189,191,3306
2013,3345,4324,4953,381912,380562,259,5.194,327,6.557,31002,5795,25207,1.523,8.146,28406,6836,21570,1.796,7.464,2596,0.682,14.928,214,214,2863
2013,3346,486,497,13514,14092,36,7.087,58,11.417,801,140,661,0.994,5.684,1931,1034,897,7.338,13.703,-1130,-8.019,11.369,44,44,482
2013,3351,958,1031,42860,43245,56,5.387,73,7.023,3243,568,2675,1.313,7.499,4014,1012,3002,2.340,9.282,-771,-1.783,14.998,52,52,405
2013,3352,217,254,43022,42941,24,9.677,12,4.839,2582,313,2269,0.729,6.013,2339,1192,1147,2.776,5.447,243,0.566,10.894,7,7,51
2013,3353,1823,2102,116648,115979,105,5.004,98,4.670,8427,1034,7393,0.892,7.266,7102,2205,4897,1.901,6.124,1325,1.142,12.247,68,68,994
2013,3359,1785,2074,131680,133063,97,4.666,107,5.147,8941,1367,7574,1.027,6.719,11693,3494,8199,2.626,8.788,-2752,-2.068,13.439,65,65,900
2013,3361,261,316,163070,157478,25,7.849,30,9.419,17843,635,17208,0.403,11.331,6923,1384,5539,0.879,4.396,10920,6.934,8.792,21,21,211
2013,3362,1565,1824,121827,120157,115,6.312,111,6.092,12772,1740,11032,1.448,10.629,9529,1800,7729,1.498,7.930,3243,2.699,15.861,74,78,1192
2013,3363,3859,4697,471217,457442,250,5.307,278,5.901,56768,7450,49318,1.629,12.410,29277,6832,22445,1.494,6.400,27491,6.010,12.800,182,184,2162
2013,3364,1274,1670,363092,362239,97,5.784,111,6.619,25446,2009,23437,0.555,7.025,23804,4460,19344,1.231,6.571,1642,0.453,13.143,70,70,1018
2013,3365,142,214,30130,29652,20,9.412,17,8.000,4906,1769,3137,5.966,16.545,3765,697,3068,2.351,12.697,1141,3.848,25.395,10,10,217
2013,3366,1280,1394,132552,132782,99,7.014,134,9.493,11657,964,10693,0.726,8.779,11837,6933,4904,5.221,8.915,-180,-0.136,17.558,93,94,1132
2013,3369,774,805,32756,33871,80,9.932,81,10.056,3896,1797,2099,5.305,11.502,6249,1103,5146,3.256,18.449,-2353,-6.947,23.005,56,56,323
2013,3371,10089,10313,204586,202274,796,7.641,1005,9.647,21909,4051,17858,2.003,10.831,17268,6476,10792,3.202,8.537,4641,2.294,17.074,706,708,4342
2013,3372,3457,3623,106614,107015,199,5.460,242,6.640,9308,1771,7537,1.655,8.698,10032,2797,7235,2.614,9.374,-724,-0.677,17.396,173,175,1465
2013,3379,656,747,31013,31075,43,5.749,45,6.016,2662,578,2084,1.860,8.567,2830,1082,1748,3.482,9.107,-168,-0.541,17.133,34,34,480
2013,3391,9759,10640,291806,292507,594,5.522,826,7.679,22604,3997,18607,1.366,7.728,23955,5900,18055,2.017,8.190,-1351,-0.462,15.455,604,609,3098
2013,3399,14242,14623,261900,261881,1315,8.959,1425,9.708,27192,5857,21335,2.237,10.383,26980,9636,17344,3.680,10.302,212,0.081,20.605,1114,1117,6493
2013,4231,15863,23524,371602,368459,1527,6.472,1666,7.061,44279,8747,35532,2.374,12.017,37813,11203,26610,3.041,10.262,6466,1.755,20.525,1109,1173,6699
2013,4232,9795,11585,142688,142048,867,7.432,1027,8.804,16069,4052,12017,2.853,11.312,14672,5750,8922,4.048,10.329,1397,0.983,20.658,740,768,3517
2013,4233,9498,15700,194149,190730,1010,6.412,1113,7.066,24743,5839,18904,3.061,12.973,17964,6705,11259,3.515,9.419,6779,3.554,18.837,644,664,3786
2013,4234,21718,32990,657264,656678,2918,8.815,3146,9.503,84202,28901,55301,4.401,12.822,84046,38444,45602,5.854,12.799,156,0.024,25.597,1616,1654,10670
2013,4235,7284,10063,152834,152497,435,4.277,652,6.410,15449,3001,12448,1.968,10.131,14781,4012,10769,2.631,9.693,668,0.438,19.385,386,386,2117
2013,4236,18124,28008,527320,522961,2159,7.695,2256,8.041,101025,45638,55387,8.727,19.318,92363,26664,65699,5.099,17.662,8662,1.656,35.323,1170,1193,6572
2013,4237,10018,18655,225381,224575,963,5.137,1149,6.129,24047,7577,16470,3.374,10.708,22805,7040,15765,3.135,10.155,1242,0.553,20.310,523,571,3223
2013,4238,38628,55731,727556,715630,3148,5.642,3275,5.870,91801,22742,69059,3.178,12.828,68497,20783,47714,2.904,9.572,23305,3.257,19.143,1924,2003,10799
2013,4239,27933,31405,336751,339298,3275,10.492,2892,9.265,42187,12965,29222,3.821,12.434,46964,16805,30159,4.953,13.842,-4777,-1.408,24.867,2187,2210,11243
2013,4241,7600,9768,146661,147309,443,4.473,713,7.200,10980,2207,8773,1.498,7.454,12322,3769,8553,2.559,8.365,-1342,-0.911,14.907,463,473,2224
2013,4242,5941,9124,296667,289723,888,9.780,800,8.811,40973,13117,27856,4.527,14.142,27306,6572,20734,2.268,9.425,13667,4.717,18.850,478,483,3458
2013,4243,13218,14383,197211,195063,1454,10.095,1495,10.379,28612,7218,21394,3.700,14.668,24242,7425,16817,3.806,12.428,4370,2.240,24.856,1173,1188,4991
2013,4244,24394,31827,777339,763960,3485,11.062,2839,9.012,123267,34278,88989,4.487,16.135,94680,35038,59642,4.586,12.393,28587,3.742,24.787,1763,1814,11963
2013,4245,3217,5947,60826,60699,239,3.998,301,5.035,6594,1089,5505,1.794,10.864,6261,1834,4427,3.021,10.315,333,0.549,20.630,152,163,1015
2013,4246,7980,12359,152372,150626,783,6.306,897,7.225,21479,6251,15228,4.150,14.260,17854,5947,11907,3.948,11.853,3625,2.407,23.706,430,437,1867
2013,4247,4254,6427,100879,100282,386,5.963,478,7.385,15833,3315,12518,3.306,15.788,14569,5571,8998,5.555,14.528,1264,1.260,29.056,231,239,2194
2013,4248,3194,4122,187512,184759,369,9.008,318,7.763,16065,3190,12875,1.727,8.695,10623,4022,6601,2.177,5.750,5442,2.945,11.499,221,234,2910
2013,4249,20168,26399,327597,327000,2211,8.370,2245,8.499,38367,10485,27882,3.206,11.733,37182,11975,25207,3.662,11.371,1185,0.362,22.741,1563,1576,6900
2013,4251,37350,39730,292946,288283,4963,12.599,4289,10.888,49653,23226,26427,8.057,17.224,40156,17138,23018,5.945,13.929,9497,3.294,27.859,3129,3139,9730
2013,4411,37383,42627,1138201,1119577,3642,8.594,3148,7.428,116893,34391,82502,3.072,10.441,79898,25408,54490,2.269,7.136,36995,3.304,14.273,2351,2379,18735
2013,4412,11489,13024,127891,126632,860,6.569,997,7.615,16512,4362,12150,3.445,13.039,14099,4936,9163,3.898,11.134,2413,1.906,22.268,704,721,3578
2013,4413,26960,54920,492589,491428,2695,4.908,2679,4.879,56375,14190,42185,2.888,11.472,54343,12210,42133,2.485,11.058,2032,0.413,22.116,1635,1738,6863
2013,4421,13373,22180,193911,192720,1868,8.422,1870,8.431,25809,9522,16287,4.941,13.392,23466,8836,14630,4.585,12.176,2343,1.216,24.352,1190,1320,6277
2013,4422,18388,26220,231640,232211,1725,6.534,2084,7.894,31128,8599,22529,3.703,13.405,31786,10745,21041,4.627,13.688,-658,-0.283,26.810,1327,1373,3904
2013,4431,22927,44909,407114,414919,3528,7.754,4712,10.356,47401,17402,29999,4.194,11.424,63654,22700,40954,5.471,15.341,-16253,-3.917,22.848,2757,2959,11502
2013,4441,35523,57245,1087342,1054245,2529,4.396,3089,5.370,114550,13702,100848,1.300,10.866,49258,14417,34841,1.368,4.672,65292,6.193,9.345,2035,2092,8606
2013,4442,12830,16423,145527,144212,1187,7.240,1133,6.910,19392,7401,11991,5.132,13.447,16541,4482,12059,3.108,11.470,2851,1.977,22.940,794,804,2917
2013,4451,59259,85409,2593679,2587989,8345,9.847,7020,8.284,214327,83497,130830,3.226,8.282,201271,62635,138636,2.420,7.777,13056,0.504,15.554,4937,4984,24816
2013,4452,16919,20726,155447,151783,2544,12.378,2198,10.694,31378,13197,18181,8.695,20.673,23835,9921,13914,6.536,15.703,7543,4.970,31.407,1499,1509,6376
2013,4453,26718,30515,156255,153531,2583,8.514,2232,7.357,24536,9381,15155,6.110,15.981,18876,7004,11872,4.562,12.295,5660,3.687,24.589,1598,1685,5334
2013,4461,39936,88806,1015958,1011120,6322,7.173,4990,5.661,112202,32658,79544,3.230,11.097,104525,37549,66976,3.714,10.338,7677,0.759,20.675,2938,3113,15416
2013,4471,61536,106956,878528,866676,7301,6.795,8289,7.714,136460,44143,92317,5.093,15.745,113327,43084,70243,4.971,13.076,23133,2.669,26.152,4941,5190,23828
2013,4481,32159,91373,1372688,1335856,7100,7.760,7351,8.034,217739,56330,161409,4.217,16.300,142932,50476,92456,3.779,10.700,74807,5.600,21.399,3412,3819,17318
2013,4482,5372,24134,207167,204476,1368,5.624,1745,7.174,31836,10737,21099,5.251,15.570,26872,10286,16586,5.030,13.142,4964,2.428,26.284,463,712,3984
2013,4483,15731,22647,131729,130149,1548,6.834,1560,6.887,18041,6303,11738,4.843,13.862,14961,4708,10253,3.617,11.495,3080,2.367,22.991,1061,1083,2774
2013,4511,24680,35151,443473,431654,2977,8.497,2743,7.830,61298,19889,41409,4.608,14.201,37497,11083,26414,2.568,8.687,23801,5.514,17.374,1965,1990,6557
2013,4512,3837,8136,95229,95739,523,6.363,690,8.395,11393,4525,6868,4.726,11.900,12555,3652,8903,3.815,13.114,-1162,-1.214,23.800,376,392,1349
2013,4521,62,8108,1033813,1056435,206,2.548,159,1.967,38421,9343,29078,0.884,3.637,81779,11539,70240,1.092,7.741,-43358,-4.104,7.274,0,0,0
2013,4529,7151,40330,1763266,1776209,2736,6.908,1293,3.264,87637,33377,54260,1.879,4.934,112455,6649,105806,0.374,6.331,-24818,-1.397,9.868,846,854,2792
2013,4531,12587,13131,61622,62355,947,7.106,1339,10.047,9501,2834,6667,4.545,15.237,10976,4526,6450,7.258,17.602,-1475,-2.365,30.474,1085,1088,3107
2013,4532,18479,28485,238428,237935,2205,7.672,2716,9.450,30115,9868,20247,4.147,12.657,29288,11432,17856,4.805,12.309,827,0.348,24.619,1927,1975,7175
2013,4533,12610,18212,182461,175676,1942,10.815,1431,7.969,33613,10930,22683,6.222,19.134,19699,5506,14193,3.134,11.213,13914,7.920,22.427,1081,1086,3248
2013,4539,28868,38210,246486,242516,4276,11.311,3464,9.163,39483,16496,22987,6.802,16.281,31793,11664,20129,4.810,13.110,7690,3.171,26.219,2523,2576,8535
2013,4541,25301,26446,384592,374721,4575,17.812,3054,11.890,68563,25571,42992,6.824,18.297,48852,19968,28884,5.329,13.037,19711,5.260,26.074,2293,2308,8808
2013,4542,3163,3617,40200,40569,316,8.583,445,12.087,6425,3034,3391,7.479,15.837,7115,3307,3808,8.152,17.538,-690,-1.701,31.675,327,333,1308
2013,4543,20028,25314,165443,167942,2355,9.223,2796,10.950,23365,8557,14808,5.095,13.913,28090,9393,18697,5.593,16.726,-4725,-2.813,27.825,1898,1916,5912
2013,4811,437,2467,382803,391186,274,10.819,405,15.992,60171,6889,53282,1.761,15.382,77408,52222,25186,13.350,19.788,-17237,-4.406,30.763,49,50,324
2013,4812,1986,2188,37479,37244,244,11.162,240,10.979,4601,1152,3449,3.093,12.354,4203,1272,2931,3.415,11.285,398,1.069,22.570,163,163,620
2013,4831,762,1085,51022,51296,124,11.530,105,9.763,5985,1283,4702,2.501,11.668,6487,1879,4608,3.663,12.646,-502,-0.979,23.335,51,51,204
2013,4832,524,602,21825,21410,70,11.864,46,7.797,2256,631,1625,2.947,10.537,1445,583,862,2.723,6.749,811,3.788,13.498,27,27,113
2013,4841,48658,58037,920086,910684,8868,15.477,7393,12.902,125382,37703,87679,4.140,13.768,106349,39050,67299,4.288,11.678,19033,2.090,23.356,5142,5190,21107
2013,4842,36470,40149,446557,442648,4846,12.015,5213,12.925,73178,23907,49271,5.401,16.532,65231,24841,40390,5.612,14.737,7947,1.795,29.473,3621,3637,15277
2013,4851,700,1005,57531,55835,110,11.128,77,7.790,8097,3336,4761,5.975,14.502,4693,1817,2876,3.254,8.405,3404,6.097,16.810,49,49,1354
2013,4852,209,397,13769,13871,32,7.911,47,11.619,1122,368,754,2.653,8.089,1341,533,808,3.843,9.668,-219,-1.579,16.178,21,21,106
2013,4853,6273,6425,70468,69708,1053,16.680,829,13.132,10472,4086,6386,5.862,15.023,8995,3563,5432,5.111,12.904,1477,2.119,25.808,636,637,2579
2013,4854,2450,3911,211620,210711,178,4.486,292,7.359,16809,4055,12754,1.924,7.977,15234,7504,7730,3.561,7.230,1575,0.747,14.460,190,193,3793
2013,4855,1074,1185,31212,30713,93,7.727,130,10.802,4268,812,3456,2.644,13.896,3314,1804,1510,5.874,10.790,954,3.106,21.580,88,92,783
2013,4859,3786,4255,88150,87029,641,15.309,505,12.061,15074,5585,9489,6.417,17.321,12772,7031,5741,8.079,14.676,2302,2.645,29.351,361,364,3407
2013,4861,49,711,12034,11566,71,10.342,22,3.205,2008,587,1421,5.075,17.362,1080,129,951,1.115,9.338,928,8.024,18.676,(D),(D),(D)
2013,4862,133,2341,32318,31547,204,8.961,75,3.295,5466,1361,4105,4.314,17.327,4020,1817,2203,5.760,12.743,1446,4.584,25.486,8,8,32
2013,4869,52,616,7013,6524,35,5.724,26,4.252,1621,356,1265,5.457,24.847,637,195,442,2.989,9.764,984,15.083,19.528,(D),(D),(D)
2013,4871,440,483,9417,9239,61,12.815,47,9.874,1349,358,991,3.875,14.601,1024,262,762,2.836,11.083,325,3.518,22.167,36,36,118
2013,4872,1127,1172,12162,12160,137,11.709,133,11.368,1552,407,1145,3.347,12.764,1526,382,1144,3.142,12.550,26,0.214,25.100,94,94,291
2013,4879,145,167,2413,2380,18,10.876,15,9.063,270,69,201,2.899,11.345,195,80,115,3.361,8.193,75,3.151,16.387,11,11,22
2013,4881,3659,5393,172414,167556,432,7.926,547,10.036,26200,6827,19373,4.074,15.637,16772,5804,10968,3.464,10.010,9428,5.627,20.020,270,280,2486
2013,4882,476,1346,34381,33070,189,14.550,95,7.313,5659,2069,3590,6.257,17.112,2970,902,2068,2.728,8.981,2689,8.131,17.962,28,30,254
2013,4883,1605,2117,91387,88793,191,9.071,168,7.979,13944,2580,11364,2.906,15.704,9053,2590,6463,2.917,10.196,4891,5.508,20.391,107,108,1572
2013,4884,8741,9930,82349,81854,1125,11.373,1049,10.605,13573,4647,8926,5.677,16.582,12790,4552,8238,5.561,15.625,783,0.957,31.251,744,745,3000
2013,4885,13142,18225,223623,221084,1556,8.507,1688,9.229,32019,9495,22524,4.295,14.483,26785,10663,16122,4.823,12.115,5234,2.367,24.231,943,981,5118
2013,4889,1398,1502,17083,16535,203,13.800,141,9.585,3304,1162,2142,7.028,19.982,2193,689,1504,4.167,13.263,1111,6.719,26.526,109,109,527
2013,4921,4110,8507,487005,492611,599,6.962,792,9.206,20903,5137,15766,1.043,4.243,32943,6043,26900,1.227,6.687,-12040,-2.444,8.487,388,397,1480
2013,4922,3757,4126,34171,33265,474,11.375,556,13.343,7352,2225,5127,6.689,22.102,5468,2615,2853,7.861,16.438,1884,5.664,32.876,422,426,1658
2013,4931,6847,13881,725466,717783,1224,8.774,1364,9.777,97188,29291,67897,4.081,13.540,80722,27567,53155,3.841,11.246,16466,2.294,22.492,309,325,3000
2013,5111,11918,17107,436083,444802,947,5.415,1712,9.789,47281,10977,36304,2.468,10.630,64978,23560,41418,5.297,14.608,-17697,-3.979,21.259,924,933,7235
2013,5112,5295,8045,424897,417729,747,9.230,844,10.428,66142,23422,42720,5.607,15.834,51371,20804,30567,4.980,12.298,14771,3.536,24.595,412,433,6136
2013,5121,13235,16470,312052,307809,2384,14.578,2150,13.147,41015,16481,24534,5.354,13.325,32876,12174,20702,3.955,10.681,8139,2.644,21.361,1383,1402,7639
2013,5122,2733,2967,22012,21860,372,12.448,415,13.887,3836,1082,2754,4.950,17.548,3413,2231,1182,10.206,15.613,423,1.935,31.227,288,288,640
2013,5151,4055,8725,219987,220775,581,6.698,480,5.533,20517,8423,12094,3.815,9.293,22180,5595,16585,2.534,10.046,-1663,-0.753,18.586,236,293,3128
2013,5152,378,725,60286,57513,53,7.255,64,8.761,11077,461,10616,0.802,19.260,5257,1081,4176,1.880,9.141,5820,10.119,18.281,35,35,290
2013,5171,3221,31085,748883,745330,3854,12.377,3961,12.721,140056,71269,68787,9.562,18.791,133309,68556,64753,9.198,17.886,6747,0.905,35.772,247,280,2187
2013,5172,858,10868,246129,248073,1104,9.776,1955,17.311,39357,11849,27508,4.776,15.865,43508,15175,28333,6.117,17.538,-4151,-1.673,31.730,166,203,920
2013,5174,362,450,7986,7942,90,20.713,59,13.579,1158,558,600,7.026,14.582,1099,543,556,6.837,13.839,59,0.743,27.677,31,31,294
2013,5179,3452,4110,57938,56210,724,17.907,590,14.593,12986,3427,9559,6.097,23.103,9495,4483,5012,7.975,16.892,3491,6.211,33.784,416,420,2597
2013,5182,8435,13238,493267,482239,1778,13.569,1509,11.516,84647,23305,61342,4.833,17.553,62857,25596,37261,5.308,13.034,21790,4.519,26.069,769,786,8512
2013,5191,7786,9760,218968,213817,1689,17.792,1155,12.167,40817,16690,24127,7.806,19.090,30579,9412,21167,4.402,14.301,10238,4.788,28.603,814,816,4806
2013,5211,14,58,18503,18221,(D),(D),0,0.000,779,(D),778,(D),4.275,227,0,227,0.000,1.246,552,3.029,2.492,0,0,0
2013,5221,12718,121422,1994578,1999300,3404,2.770,6322,5.145,197042,39776,157266,1.989,9.856,207014,50116,156898,2.507,10.354,-9972,-0.499,19.711,431,543,5708
2013,5222,14583,40312,585838,568612,4683,11.654,4427,11.017,120767,34869,85898,6.132,21.239,87343,31732,55611,5.581,15.361,33424,5.878,30.722,883,936,5495
2013,5223,11153,25687,237439,230179,2407,9.318,2699,10.448,47769,16308,31461,7.085,20.753,33867,14556,19311,6.324,14.713,13902,6.040,29.427,1225,1343,6036
2013,5231,11547,40864,395133,402914,4121,9.667,7654,17.954,52074,18599,33475,4.616,12.924,65621,23379,42242,5.802,16.287,-13547,-3.362,25.849,798,824,3391
2013,5232,16,30,5577,5600,5,17.544,(D),(D),220,119,101,2.125,3.929,263,(D),260,(D),4.697,-43,-0.768,7.858,0,0,0
2013,5239,39476,45283,465364,469203,5779,12.930,4602,10.297,57956,22619,35337,4.821,12.352,65559,28419,37140,6.057,13.972,-7603,-1.620,24.704,3147,3165,19713
2013,5241,5764,31219,1430999,1427773,4244,13.486,4745,15.078,161315,39190,122125,2.745,11.298,155994,67266,88728,4.711,10.926,5321,0.373,21.851,288,337,6320
2013,5242,116745,130488,865762,854622,10366,7.940,10511,8.051,121983,41307,80676,4.833,14.273,99826,39809,60017,4.658,11.681,22157,2.593,23.361,7178,7301,23366
2013,5250,1835,1905,26526,20795,659,41.617,16,1.010,14697,13419,1278,64.530,70.676,3127,107,3020,0.515,15.037,11570,55.638,30.075,(D),(D),(D)
2013,5311,85223,107408,516492,512010,10849,10.161,9583,8.975,86369,43430,42939,8.482,16.869,76719,32441,44278,6.336,14.984,9650,1.885,29.968,6495,6666,20742
2013,5312,58811,68320,242796,236793,12612,19.025,8556,12.907,55548,29741,25807,12.560,23.458,43894,20720,23174,8.750,18.537,11654,4.922,37.074,4577,4640,9713
2013,5313,63934,81524,673382,666167,9762,12.153,7360,9.163,100221,40693,59528,6.109,15.044,85961,32095,53866,4.818,12.904,14260,2.141,25.808,4413,4473,19428
2013,5321,3538,13017,136889,139253,1239,9.403,1558,11.824,29351,10980,18371,7.885,21.077,34410,16909,17501,12.143,24.710,-5059,-3.633,42.155,316,345,1087
2013,5322,7587,19756,150386,154078,1687,8.268,2983,14.620,23736,8145,15591,5.286,15.405,30669,17008,13661,11.039,19.905,-6933,-4.500,30.810,775,818,3065
2013,5323,2205,2609,16027,15980,172,6.555,202,7.698,2298,767,1531,4.800,14.380,2208,692,1516,4.330,13.817,90,0.563,27.635,145,149,454
2013,5324,7276,13145,169546,162850,1113,8.532,914,7.006,31851,7214,24637,4.430,19.559,18730,6274,12456,3.853,11.501,13121,8.057,23.003,541,558,3154
2013,5331,2052,2192,35038,34242,253,11.632,219,10.069,5845,1863,3982,5.441,17.070,4251,1345,2906,3.928,12.415,1594,4.655,24.830,152,152,796
2013,5411,159931,170316,1160247,1152047,13058,7.674,12733,7.483,129862,40133,89729,3.484,11.272,113273,36087,77186,3.132,9.832,16589,1.440,19.665,9194,9239,25567
2013,5412,99084,114653,1221251,1217911,10948,9.577,10278,8.991,207556,69851,137705,5.735,17.042,197503,71271,126232,5.852,16.217,10053,0.825,32.433,6302,6348,40330
2013,5413,78954,94650,1376804,1335203,9149,9.685,8785,9.299,247881,97132,150749,7.275,18.565,162063,56027,106036,4.196,12.138,85818,6.427,24.275,5058,5112,18693
2013,5414,24355,24625,108775,106741,3520,14.388,3200,13.080,18992,7605,11387,7.125,17.793,14840,7088,7752,6.640,13.903,4152,3.890,27.806,2193,2194,4871
2013,5415,94224,111828,1570132,1515264,20230,18.368,16854,15.302,335167,152015,183152,10.032,22.119,231076,95979,135097,6.334,15.250,104091,6.869,30.500,9924,9959,41508
2013,5416,113126,122646,1049983,1021403,23233,19.264,19151,15.879,236687,102379,134308,10.023,23.173,178966,79563,99403,7.790,17.522,57721,5.651,35.043,13026,13061,45160
2013,5417,12593,15776,619089,620702,1867,11.911,1664,10.616,70684,16208,54476,2.611,11.388,75360,18320,57040,2.951,12.141,-4676,-0.753,22.776,1047,1063,7793
2013,5418,29323,32528,439256,435901,3566,10.924,3799,11.637,66621,20823,45798,4.777,15.284,60201,23042,37159,5.286,13.811,6420,1.473,27.621,2701,2732,12124
2013,5419,50850,60094,566829,565679,5760,9.627,5238,8.754,75952,23977,51975,4.239,13.427,74122,26795,47327,4.737,13.103,1830,0.324,26.206,3252,3296,15328
2013,5511,25902,51178,3091965,3075173,3674,7.182,3629,7.094,450809,112534,338275,3.659,14.660,420743,115974,304769,3.771,13.682,30066,0.978,27.364,636,655,7811
2013,5611,24956,27335,443722,428634,3647,13.487,3059,11.312,91387,32956,58431,7.689,21.321,61251,25408,35843,5.928,14.290,30136,7.031,28.580,2308,2314,18596
2013,5612,1725,5056,256170,256206,590,11.628,626,12.337,34510,12686,21824,4.951,13.470,34012,12834,21178,5.009,13.275,498,0.194,26.551,100,105,1982
2013,5613,24187,45039,5032721,4919097,5652,12.746,4258,9.603,969232,191144,778088,3.886,19.703,741785,206213,535572,4.192,15.080,227447,4.624,30.159,2205,2290,98538
2013,5614,24131,30505,758149,759600,3301,10.816,3332,10.917,131354,47231,84123,6.218,17.293,133300,55969,77331,7.368,17.549,-1946,-0.256,34.585,2308,2333,16381
2013,5615,12847,20944,220382,220547,5739,29.342,2969,15.180,38452,18029,20423,8.175,17.435,39396,16578,22818,7.517,17.863,-944,-0.428,34.870,917,924,3083
2013,5616,17611,24208,877503,858629,2707,11.282,2277,9.490,150037,43920,106117,5.115,17.474,112871,36022,76849,4.195,13.145,37166,4.329,26.291,1522,1532,16293
2013,5617,139049,145846,1701798,1686738,18904,12.962,18885,12.949,264433,74743,189690,4.431,15.677,234020,80527,153493,4.774,13.874,30413,1.803,27.748,12136,12148,48789
2013,5619,15339,17169,268228,266474,1674,9.756,1652,9.628,44402,9904,34498,3.717,16.663,41572,12172,29400,4.568,15.601,2830,1.062,31.202,1110,1180,7522
2013,5621,7338,10526,195359,190918,1021,9.785,837,8.022,32432,9799,22633,5.133,16.987,23948,6871,17077,3.599,12.544,8484,4.444,25.087,510,516,3206
2013,5622,1258,2480,52718,52150,240,9.808,174,7.111,6901,2526,4375,4.844,13.233,5664,1297,4367,2.487,10.861,1237,2.372,21.722,100,100,632
2013,5629,7939,9324,126445,125237,875,9.428,788,8.491,21294,4602,16692,3.675,17.003,18854,5047,13807,4.030,15.055,2440,1.948,30.109,494,509,2924
2013,6111,18803,21525,939017,917551,1212,5.793,8,0.038,81579,18835,62744,2.053,8.891,38641,16,38625,0.002,4.211,42938,4.680,8.423,3,3,3
2013,6112,468,985,80139,81797,30,3.093,0,0.000,5210,828,4382,1.012,6.369,8614,0,8614,0.000,10.531,-3404,-4.162,12.739,0,0,0
2013,6113,2315,4499,1828518,1828163,173,3.920,(D),(D),72931,5524,67407,0.302,3.989,71720,(D),71624,(D),3.923,1211,0.066,7.846,0,0,0
2013,6114,6433,6805,58312,57981,808,11.801,892,13.028,9948,3076,6872,5.305,17.157,9196,3870,5326,6.675,15.861,752,1.297,31.721,596,604,2774
2013,6115,6211,7959,120131,121666,712,8.968,673,8.477,16089,5283,10806,4.342,13.224,19192,4696,14496,3.860,15.774,-3103,-2.550,26.448,406,436,2627
2013,6116,37716,40422,384382,379557,5307,13.370,3847,9.692,80490,24511,55979,6.458,21.206,71054,24492,46562,6.453,18.720,9436,2.486,37.441,2702,2750,16040
2013,6117,5207,6137,96186,91909,1047,17.451,772,12.868,21509,6471,15038,7.041,23.402,12519,5123,7396,5.574,13.621,8990,9.781,27.242,562,562,3883
2013,6211,167983,205514,2305296,2277153,15440,7.518,15182,7.392,324042,111348,212694,4.890,14.230,267590,90518,177072,3.975,11.751,56452,2.479,23.502,10728,10968,57462
2013,6212,119147,127185,874301,872081,6184,4.874,5594,4.409,97660,30241,67419,3.468,11.199,93422,27113,66309,3.109,10.713,4238,0.486,21.425,4428,4468,21774
2013,6213,113967,129031,763637,749471,11922,9.333,9346,7.316,134505,42876,91629,5.721,17.947,106135,35835,70300,4.781,14.161,28370,3.785,28.323,6309,6386,20637
2013,6214,15382,35334,819117,801330,2475,7.063,1892,5.399,108519,31789,76730,3.967,13.542,74009,20918,53091,2.610,9.236,34510,4.307,18.472,852,888,9482
2013,6215,7153,12571,249937,248430,1030,8.114,1275,10.045,28646,6959,21687,2.801,11.531,25683,10339,15344,4.162,10.338,2963,1.193,20.676,586,615,4816
2013,6216,19497,27788,1271910,1256976,3263,11.899,2534,9.240,187543,44281,143262,3.523,14.920,157150,44616,112534,3.549,12.502,30393,2.418,25.004,1750,1789,26171
2013,6219,6400,10079,307605,303676,896,8.982,690,6.917,43046,13490,29556,4.442,14.175,35224,11557,23667,3.806,11.599,7822,2.576,23.198,419,424,5650
2013,6221,2770,5089,5145035,5160306,143,2.829,73,1.444,193472,18362,175110,0.356,3.749,224967,36206,188761,0.702,4.360,-31495,-0.610,7.498,35,37,16265
2013,6222,413,608,227377,225016,30,5.013,11,1.838,14207,1050,13157,0.467,6.314,9729,1694,8035,0.753,4.324,4478,1.990,8.647,6,6,1306
2013,6223,417,960,273914,271402,82,8.855,14,1.512,18523,5851,12672,2.156,6.825,13663,1845,11818,0.680,5.034,4860,1.791,10.068,3,3,429
2013,6231,8027,15548,1630199,1624931,906,5.866,700,4.532,122977,56296,66681,3.465,7.568,111961,38178,73783,2.350,6.890,11016,0.678,13.780,392,428,24341
2013,6232,9056,35271,676552,674095,1920,5.465,1647,4.688,90459,20221,70238,3.000,13.419,85894,23801,62093,3.531,12.742,4565,0.677,25.484,334,400,7204
2013,6233,16042,23044,911900,901873,1849,8.096,1437,6.292,93969,28446,65523,3.154,10.419,73884,25774,48110,2.858,8.192,20085,2.227,16.385,968,1012,16834
2013,6239,2953,5138,137152,132851,520,10.274,367,7.251,23511,10838,12673,8.158,17.697,14230,4719,9511,3.552,10.711,9281,6.986,21.422,161,170,2148
2013,6241,47613,63470,1464759,1452568,7690,12.391,4872,7.850,205827,50924,154903,3.506,14.170,180795,49432,131363,3.403,12.447,25032,1.723,24.893,2755,2823,27540
2013,6242,10220,14512,185931,187384,736,5.065,777,5.347,22274,4615,17659,2.463,11.887,24923,8172,16751,4.361,13.301,-2649,-1.414,23.774,418,422,5408
2013,6243,3972,7477,328743,327177,379,5.040,466,6.196,39612,4546,35066,1.389,12.107,36640,8222,28418,2.513,11.199,2972,0.908,22.398,156,165,2267
2013,6244,55143,70217,863615,862834,6471,9.215,6482,9.231,113487,41050,72437,4.758,13.153,112059,41468,70591,4.806,12.987,1428,0.166,25.975,4583,4635,26145
2013,7111,7000,7135,118231,117209,843,11.899,742,10.474,18639,4747,13892,4.050,15.902,16505,5056,11449,4.314,14.082,2134,1.821,28.163,468,468,2795
2013,7112,3406,3584,128803,126912,461,12.868,458,12.784,15535,3178,12357,2.504,12.241,11702,2223,9479,1.752,9.221,3833,3.020,18.441,365,366,1885
2013,7113,5625,5939,148437,144703,670,11.436,509,8.688,25219,6312,18907,4.362,17.428,17521,4957,12564,3.426,12.108,7698,5.320,24.216,369,369,1685
2013,7114,2889,2998,17525,17142,405,13.620,356,11.972,2978,1311,1667,7.648,17.373,2186,1034,1152,6.032,12.752,792,4.620,25.505,243,243,698
2013,7115,14130,14170,42552,42352,2591,18.484,2286,16.308,10508,5549,4959,13.102,24.811,10109,4844,5265,11.437,23.869,399,0.942,47.738,1358,1358,3050
2013,7121,6524,6984,139815,138333,389,5.615,277,3.998,10849,2123,8726,1.535,7.843,7825,972,6853,0.703,5.657,3024,2.186,11.313,173,173,634
2013,7131,2406,2737,172312,168032,350,12.802,344,12.582,19172,4383,14789,2.608,11.410,10917,2511,8406,1.494,6.497,8255,4.913,12.994,274,275,2099
2013,7132,1870,2797,166128,160742,234,8.404,209,7.506,23681,10908,12773,6.786,14.732,12749,3456,9293,2.150,7.931,10932,6.801,15.863,153,153,2903
2013,7139,48695,55809,1175780,1170484,6090,10.981,5393,9.724,152052,58222,93830,4.974,12.991,141124,43044,98080,3.677,12.057,10928,0.934,24.114,3932,3956,28858
2013,7211,39220,50067,1895098,1889401,3916,7.833,3773,7.547,196837,75411,121426,3.991,10.418,185044,80530,104514,4.262,9.794,11793,0.624,19.588,2164,2225,33475
2013,7212,5336,5919,41770,41566,432,7.299,431,7.282,6484,1550,4934,3.729,15.599,5984,1481,4503,3.563,14.397,500,1.203,28.793,274,279,889
2013,7213,1857,1980,11065,11182,101,5.075,121,6.080,1603,584,1019,5.223,14.336,1827,452,1375,4.042,16.339,-224,-2.003,28.671,79,79,218
2013,7223,14062,38657,710098,689037,8387,22.893,4344,11.857,167495,98627,68868,14.314,24.309,124337,56628,67709,8.218,18.045,43158,6.264,36.090,1462,1505,8766
2013,7224,39018,39879,365066,358013,5116,12.982,4174,10.592,75247,39790,35457,11.114,21.018,61022,25580,35442,7.145,17.045,14225,3.973,34.089,3356,3365,21153
2013,7225,347049,476432,9346819,9183109,49931,10.549,43682,9.229,1481668,655201,826467,7.135,16.135,1149673,438880,710793,4.779,12.519,331995,3.615,25.039,33894,34800,304854
2013,8111,134094,146804,826300,820441,12223,8.338,11787,8.041,119190,44085,75105,5.373,14.528,107828,39066,68762,4.762,13.143,11362,1.385,26.285,8442,8550,28267
2013,8112,9869,11136,100914,102115,1158,10.321,1326,11.818,12535,4116,8419,4.031,12.275,14768,5875,8893,5.753,14.462,-2233,-2.187,24.551,914,921,3059
2013,8113,17706,19437,193129,190255,1897,9.829,1622,8.404,34236,14096,20140,7.409,17.995,27737,10431,17306,5.483,14.579,6499,3.416,29.158,1080,1088,4556
2013,8114,17008,17609,66586,66287,2019,11.499,1918,10.923,10993,4696,6297,7.084,16.584,10295,4473,5822,6.748,15.531,698,1.053,31.062,1416,1418,3166
2013,8121,91454,107879,655104,647600,13069,12.231,11015,10.309,116561,53040,63521,8.190,17.999,101391,39977,61414,6.173,15.656,15170,2.342,31.313,8272,8413,30212
2013,8122,14238,19576,135418,137855,653,3.296,1120,5.654,12340,2870,9470,2.082,8.951,16922,5832,11090,4.231,12.275,-4582,-3.324,17.903,469,487,1821
2013,8123,28264,33485,292199,292108,2429,7.221,2734,8.128,39084,10678,28406,3.655,13.380,38439,15682,22757,5.369,13.159,645,0.221,26.318,1904,1979,9639
2013,8129,24734,34220,260309,256186,5693,16.923,4534,13.478,54219,23163,31056,9.041,21.164,45528,21401,24127,8.354,17.771,8691,3.392,35.543,1990,2010,7307
2013,8131,177015,177346,1682767,1671207,7712,4.444,59,0.034,139732,22382,117350,1.339,8.361,117154,210,116944,0.013,7.010,22578,1.351,14.020,28,28,52
2013,8132,16038,18041,176426,175934,1276,7.095,1163,6.467,18097,4343,13754,2.469,10.286,16831,4194,12637,2.384,9.567,1266,0.720,19.133,736,740,2548
2013,8133,13691,16125,154414,153187,1192,7.422,1061,6.607,20852,5552,15300,3.624,13.612,18345,5093,13252,3.325,11.976,2507,1.637,23.951,674,674,2835
2013,8134,22766,24640,237428,237012,1245,5.050,1274,5.167,27002,5843,21159,2.465,11.393,26221,4960,21261,2.093,11.063,781,0.330,22.126,863,865,3116
2013,8139,54511,56655,487574,488773,2449,4.350,1730,3.073,44293,8696,35597,1.779,9.062,46568,5666,40902,1.159,9.528,-2275,-0.465,18.124,1226,1227,3703
2014,2111,5854,7413,135923,133372,685,9.293,602,8.167,23869,8300,15569,6.223,17.897,18668,5698,12970,4.272,13.997,5201,3.900,27.994,379,392,2725
2014,2121,474,861,74156,79376,81,9.096,140,15.722,9713,3939,5774,4.962,12.237,19824,9515,10309,11.987,24.975,-10111,-12.738,24.474,54,54,890
2014,2122,256,324,42431,41880,43,13.110,51,15.549,4187,1092,3095,2.607,9.998,3090,573,2517,1.368,7.378,1097,2.619,14.757,47,47,565
2014,2123,2728,4812,78909,78332,265,5.492,291,6.031,8605,1747,6858,2.230,10.985,7432,2145,5287,2.738,9.488,1173,1.497,18.976,141,141,1349
2014,2131,10843,13481,422504,407330,1804,13.665,1246,9.438,81698,25552,56146,6.273,20.057,51887,14287,37600,3.507,12.738,29811,7.319,25.477,867,885,8698
2014,2211,1720,10381,506759,508383,490,4.724,474,4.570,32341,5874,26467,1.155,6.362,35220,7404,27816,1.456,6.928,-2879,-0.566,12.723,66,76,705
2014,2212,426,2492,84620,83676,158,6.395,115,4.655,8612,2978,5634,3.559,10.292,6750,1893,4857,2.262,8.067,1862,2.225,16.134,23,23,218
2014,2213,3480,4618,42444,42237,236,5.130,201,4.369,3267,917,2350,2.171,7.735,2883,867,2016,2.053,6.826,384,0.909,13.652,105,106,378
2014,2361,125950,127216,599268,577002,23629,18.902,19211,15.368,155293,63511,91782,11.007,26.914,110430,49955,60475,8.658,19.139,44863,7.775,38.277,12531,12535,33870
2014,2362,35204,36551,576014,569025,3540,9.653,3786,10.323,100342,20906,79436,3.674,17.634,86181,20299,65882,3.567,15.145,14161,2.489,30.291,2659,2661,13094
2014,2371,16052,17548,531892,523518,1581,9.029,1506,8.601,101664,26446,75218,5.052,19.419,84393,16560,67833,3.163,16.120,17271,3.299,32.241,926,930,7132
2014,2372,4451,4518,24469,24309,410,8.931,555,12.090,4119,1373,2746,5.648,16.945,3776,1791,1985,7.368,15.534,343,1.411,31.067,429,429,1350
2014,2373,7970,8767,259803,256088,622,7.051,730,8.276,41828,9317,32511,3.638,16.333,34849,7080,27769,2.765,13.608,6979,2.725,27.216,462,491,4270
2014,2379,3505,3645,80964,80905,405,11.191,353,9.754,13175,3782,9393,4.675,16.285,12888,3039,9849,3.756,15.930,287,0.355,31.860,229,229,1653
2014,2381,69044,69780,705772,688723,9181,13.199,8735,12.558,154020,37990,116030,5.516,22.363,120041,34973,85068,5.078,17.430,33979,4.934,34.859,5325,5335,23892
2014,2382,151898,156081,1738393,1704108,14948,9.643,12811,8.264,283832,61444,222388,3.606,16.656,215274,53925,161349,3.164,12.633,68558,4.023,25.265,8981,8998,36415
2014,2383,87480,88481,661822,646583,11797,13.428,10543,12.001,139223,36496,102727,5.644,21.532,108167,34990,73177,5.412,16.729,31056,4.803,33.458,6978,6983,23071
2014,2389,51882,52596,513543,496962,6737,12.914,5885,11.280,107135,28090,79045,5.652,21.558,74239,24802,49437,4.991,14.939,32896,6.619,29.877,3628,3628,14575
2014,3111,1055,1644,46485,46093,90,5.488,82,5.000,4933,1668,3265,3.619,10.702,4133,1607,2526,3.486,8.967,800,1.736,17.934,49,50,429
2014,3112,474,825,56989,56140,54,6.626,34,4.172,4476,673,3803,1.199,7.973,2718,682,2036,1.215,4.842,1758,3.131,9.683,22,22,243
2014,3113,1628,1799,75564,74757,132,7.376,113,6.315,7337,904,6433,1.209,9.814,5568,742,4826,0.993,7.448,1769,2.366,14.896,91,91,589
2014,3114,1351,1717,157110,156824,169,10.075,90,5.365,12027,2864,9163,1.826,7.669,11485,2762,8723,1.761,7.324,542,0.346,14.647,65,65,874
2014,3115,1099,1594,136885,135883,136,8.690,78,4.984,10620,1517,9103,1.116,7.816,8655,2971,5684,2.186,6.369,1965,1.446,12.739,45,45,702
2014,3116,2814,3406,467596,472261,160,4.686,177,5.184,27367,6115,21252,1.295,5.795,36001,7032,28969,1.489,7.623,-8634,-1.828,11.590,124,124,2078
2014,3117,468,557,32205,31930,49,8.974,27,4.945,3360,628,2732,1.967,10.523,2712,612,2100,1.917,8.494,648,2.029,16.987,14,14,156
2014,3118,9521,10224,280510,276238,1038,10.244,856,8.448,32738,9366,23372,3.391,11.851,24098,7075,17023,2.561,8.724,8640,3.128,17.447,694,696,4572
2014,3119,2790,3237,183243,179649,363,11.524,189,6.000,20284,7874,12410,4.383,11.291,13367,2401,10966,1.336,7.441,6917,3.850,14.881,141,141,1295
2014,3121,5004,5619,154991,150939,969,18.299,322,6.081,19177,5724,13453,3.792,12.705,10964,2348,8616,1.556,7.264,8213,5.441,14.528,244,244,1244
2014,3122,98,121,14582,14514,19,16.450,8,6.926,1051,195,856,1.344,7.241,887,68,819,0.469,6.111,164,1.130,12.223,7,7,52
2014,3131,238,302,25011,25031,18,5.950,19,6.281,1354,153,1201,0.611,5.409,1435,161,1274,0.643,5.733,-81,-0.324,10.819,12,12,29
2014,3132,813,891,50291,50607,44,4.944,42,4.719,3544,660,2884,1.304,7.003,4072,1075,2997,2.124,8.046,-528,-1.043,14.006,23,23,141
2014,3133,910,957,28577,28774,43,4.386,90,9.179,2262,252,2010,0.876,7.861,2584,901,1683,3.131,8.980,-322,-1.119,15.723,69,69,716
2014,3141,1650,1761,53774,53457,89,4.996,130,7.297,4669,813,3856,1.521,8.734,4081,1348,2733,2.522,7.634,588,1.100,15.268,101,102,549
2014,3149,3869,3965,59342,59566,336,8.456,353,8.884,6217,1588,4629,2.666,10.437,6609,2224,4385,3.734,11.095,-392,-0.658,20.874,277,277,1724
2014,3151,224,235,12261,12228,16,6.625,29,12.008,1211,239,972,1.955,9.904,1111,279,832,2.282,9.086,100,0.818,18.172,23,25,268
2014,3152,4946,4992,86123,88389,852,17.312,711,14.447,14167,6440,7727,7.286,16.028,18688,6130,12558,6.935,21.143,-4521,-5.115,32.056,590,591,4850
2014,3159,512,518,8547,8527,73,14.342,55,10.806,926,281,645,3.296,10.860,884,304,580,3.565,10.368,42,0.493,20.735,45,45,142
2014,3161,172,182,3388,3482,7,3.825,9,4.918,144,15,129,0.431,4.136,326,20,306,0.574,9.362,-182,-5.227,8.271,5,5,12
2014,3162,200,217,11409,11522,38,18.447,16,7.767,1043,259,784,2.248,9.052,1244,236,1008,2.048,10.797,-201,-1.744,18.104,12,12,130
2014,3169,661,665,10544,10542,73,11.111,57,8.676,1125,441,684,4.183,10.672,1061,300,761,2.846,10.065,64,0.607,20.130,49,49,247
2014,3211,2573,2968,79858,78303,203,6.814,225,7.553,9244,3208,6036,4.097,11.805,6154,2032,4122,2.595,7.859,3090,3.946,15.718,177,177,1409
2014,3212,1061,1353,68413,66398,82,6.076,75,5.558,8487,2288,6199,3.446,12.782,4388,1199,3189,1.806,6.609,4099,6.173,13.217,53,54,493
2014,3219,7552,8499,216793,214386,689,8.146,608,7.188,26651,5995,20656,2.796,12.431,21677,5911,15766,2.757,10.111,4974,2.320,20.222,442,445,3429
2014,3221,226,441,106450,107106,19,4.323,16,3.641,4009,594,3415,0.555,3.743,5361,619,4742,0.578,5.005,-1352,-1.262,7.486,6,6,183
2014,3222,2460,3728,244071,243868,128,3.397,207,5.494,17450,3978,13472,1.631,7.156,17178,7087,10091,2.906,7.044,272,0.112,14.088,114,118,1922
2014,3231,23727,24952,457811,460515,1364,5.412,1871,7.423,38067,9882,28185,2.146,8.266,43414,16749,26665,3.637,9.427,-5347,-1.161,16.532,1518,1529,10303
2014,3241,924,2069,101815,99373,113,5.447,124,5.977,9352,2071,7281,2.084,9.411,4490,579,3911,0.583,4.518,4862,4.893,9.037,39,41,125
2014,3251,1293,2364,158365,158153,103,4.345,116,4.893,13237,3151,10086,1.992,8.370,12597,3539,9058,2.238,7.965,640,0.405,15.930,67,68,896
2014,3252,1058,1391,95328,93431,53,3.813,51,3.669,9318,2542,6776,2.721,9.973,5650,1802,3848,1.929,6.047,3668,3.926,12.094,29,29,476
2014,3253,624,869,28556,28192,62,7.139,61,7.024,2985,817,2168,2.898,10.588,2197,625,1572,2.217,7.793,788,2.795,15.586,34,34,314
2014,3254,1610,2055,233791,232427,179,8.794,140,6.878,19977,3561,16416,1.532,8.595,17462,5630,11832,2.422,7.513,2515,1.082,15.026,90,90,1758
2014,3255,1262,1592,56509,55752,74,4.653,71,4.464,5945,1406,4539,2.522,10.663,4474,1168,3306,2.095,8.025,1471,2.638,16.050,44,44,531
2014,3256,1867,2059,94795,94570,119,5.767,128,6.203,7510,1055,6455,1.116,7.941,6984,2647,4337,2.799,7.385,526,0.556,14.770,92,92,798
2014,3259,1716,2190,77978,78784,113,5.132,137,6.222,6314,1471,4843,1.867,8.014,7950,1927,6023,2.446,10.091,-1636,-2.077,16.029,93,96,1264
2014,3261,7971,10214,593959,586909,387,3.770,490,4.773,54078,9815,44263,1.672,9.214,39902,12478,27424,2.126,6.799,14176,2.415,13.597,304,308,4880
2014,3262,1431,1847,129417,128731,80,4.321,89,4.807,8570,1181,7389,0.917,6.657,7068,1441,5627,1.119,5.491,1502,1.167,10.981,57,57,589
2014,3271,893,1071,33088,32821,65,6.016,84,7.774,3379,349,3030,1.063,10.295,2815,1061,1754,3.233,8.577,564,1.718,17.154,63,63,525
2014,3272,1370,1632,85631,85529,117,7.163,120,7.346,6876,1809,5067,2.115,8.039,6624,1482,5142,1.733,7.745,252,0.295,15.490,84,86,748
2014,3273,3945,8148,154685,152458,408,4.970,529,6.445,21171,4612,16559,3.025,13.886,16877,5064,11813,3.322,11.070,4294,2.817,22.140,194,205,2264
2014,3274,158,285,13329,12787,9,3.087,22,7.547,1516,302,1214,2.362,11.856,454,153,301,1.197,3.550,1062,8.305,7.101,11,11,56
2014,3279,2508,2963,72245,71118,151,5.059,195,6.533,7645,1932,5713,2.717,10.750,5433,1473,3960,2.071,7.639,2212,3.110,15.279,120,120,666
2014,3311,341,498,101616,101301,50,10.246,30,6.148,4842,807,4035,0.797,4.780,4454,781,3673,0.771,4.397,388,0.383,8.794,19,19,165
2014,3312,512,637,48657,48548,34,5.321,38,5.947,3776,584,3192,1.203,7.778,3627,1083,2544,2.231,7.471,149,0.307,14.942,23,24,261
2014,3313,400,526,55266,55803,14,2.644,21,3.966,3129,417,2712,0.747,5.607,4306,304,4002,0.545,7.717,-1177,-2.109,11.215,11,11,143
2014,3314,761,953,60382,60727,27,2.813,41,4.271,3619,591,3028,0.973,5.960,4303,844,3459,1.390,7.086,-684,-1.126,11.919,30,30,596
2014,3315,1519,1723,124734,124575,56,3.222,86,4.948,8383,1811,6572,1.454,6.729,7970,1280,6690,1.027,6.398,413,0.332,12.796,68,68,776
2014,3321,2193,2424,113877,113756,73,2.995,99,4.062,8727,937,7790,0.824,7.672,8388,1969,6419,1.731,7.374,339,0.298,14.747,73,73,984
2014,3322,1056,1133,35208,35355,57,5.026,59,5.203,2308,518,1790,1.465,6.528,2632,812,1820,2.297,7.444,-324,-0.916,13.056,34,34,201
2014,3323,10889,11826,331967,330030,659,5.567,684,5.778,33997,5676,28321,1.720,10.301,30095,9408,20687,2.851,9.119,3902,1.182,18.238,495,498,6345
2014,3324,1198,1505,91362,90700,69,4.606,55,3.672,7704,1355,6349,1.494,8.494,6260,1431,4829,1.578,6.902,1444,1.592,13.804,33,33,741
2014,3325,516,565,25786,25281,30,5.296,33,5.825,2455,206,2249,0.815,9.711,1428,374,1054,1.479,5.649,1027,4.062,11.297,23,23,182
2014,3326,1071,1204,38893,38834,50,4.127,65,5.365,3511,701,2810,1.805,9.041,3458,1149,2309,2.959,8.905,53,0.136,17.809,47,48,736
2014,3327,21674,22194,390382,388600,955,4.280,1195,5.355,36078,8302,27776,2.136,9.284,32571,7504,25067,1.931,8.382,3507,0.902,16.763,929,930,5185
2014,3328,5018,5562,128247,126957,253,4.552,245,4.408,13597,2885,10712,2.272,10.710,10888,2605,8283,2.052,8.576,2709,2.134,17.152,190,190,1437
2014,3329,5654,6191,265280,263049,437,7.109,350,5.693,24445,5163,19282,1.963,9.293,20044,4822,15222,1.833,7.620,4401,1.673,15.240,259,260,2804
2014,3331,2548,2950,215108,214739,168,5.732,130,4.435,17716,3514,14202,1.636,8.250,17487,3480,14007,1.621,8.143,229,0.107,16.287,93,97,892
2014,3332,2936,3093,100651,100160,143,4.599,176,5.660,8770,1139,7631,1.137,8.756,7722,2568,5154,2.564,7.710,1048,1.046,15.419,131,131,1303
2014,3333,1806,1927,75747,75455,117,6.075,115,5.971,6298,1317,4981,1.745,8.347,5869,1329,4540,1.761,7.778,429,0.569,15.556,81,84,674
2014,3334,1453,1720,127164,127218,78,4.501,104,6.001,10398,1713,8685,1.347,8.173,10634,3143,7491,2.471,8.359,-236,-0.186,16.347,74,74,1244
2014,3335,6189,6413,146941,146376,241,3.742,296,4.596,12323,2930,9393,2.002,8.419,11202,4328,6874,2.957,7.653,1121,0.766,15.306,239,239,2348
2014,3336,838,1047,101745,101250,59,5.649,54,5.170,9115,2967,6148,2.930,9.003,8149,2586,5563,2.554,8.048,966,0.954,16.097,42,43,531
2014,3339,5166,5821,291015,288372,208,3.565,236,4.045,24640,4253,20387,1.475,8.545,19403,4219,15184,1.463,6.728,5237,1.816,13.457,160,160,1276
2014,3341,961,992,42234,49904,91,9.234,78,7.915,4076,1861,2215,3.729,8.168,19189,2390,16799,4.789,38.452,-15113,-30.284,16.335,52,52,607
2014,3342,1186,1309,97297,99163,87,6.573,116,8.765,7662,3633,4029,3.664,7.727,11666,2881,8785,2.905,11.764,-4004,-4.038,15.453,81,82,2031
2014,3343,432,440,9429,9130,41,9.436,30,6.904,1335,335,1000,3.669,14.623,763,113,650,1.238,8.358,572,6.265,16.715,23,23,73
2014,3344,3432,3876,265334,266275,196,5.019,254,6.504,25074,4372,20702,1.642,9.417,26525,7243,19282,2.720,9.962,-1451,-0.545,18.833,194,195,2258
2014,3345,4362,5028,385831,385251,269,5.339,289,5.736,31295,6727,24568,1.746,8.123,29917,8495,21422,2.205,7.766,1378,0.358,15.531,196,196,2194
2014,3346,464,473,11663,12478,49,10.145,69,14.286,616,290,326,2.324,4.937,2200,672,1528,5.386,17.632,-1584,-12.695,9.874,51,51,324
2014,3351,966,1031,41410,41958,82,7.930,88,8.511,3672,873,2799,2.081,8.752,4721,1810,2911,4.314,11.252,-1049,-2.500,17.503,63,64,483
2014,3352,223,266,47564,45837,25,9.506,19,7.224,4637,637,4000,1.390,10.116,1233,32,1201,0.070,2.690,3404,7.426,5.380,17,17,30
2014,3353,1794,2074,117293,116448,86,4.124,109,5.227,8453,1725,6728,1.481,7.259,6724,1832,4892,1.573,5.774,1729,1.485,11.549,73,73,815
2014,3359,1761,2036,130353,130691,99,4.847,112,5.483,11175,2429,8746,1.859,8.551,11972,3644,8328,2.788,9.161,-797,-0.610,17.101,76,76,833
2014,3361,260,313,170361,166134,24,7.631,27,8.585,12662,103,12559,0.062,7.622,4427,367,4060,0.221,2.665,8235,4.957,5.329,24,24,208
2014,3362,1545,1812,128671,124537,108,5.950,114,6.281,17582,2551,15031,2.048,14.118,9295,3845,5450,3.087,7.464,8287,6.654,14.927,85,85,1298
2014,3363,3965,4860,511265,500128,207,4.256,215,4.420,54276,8354,45922,1.670,10.852,31286,7969,23317,1.593,6.256,22990,4.597,12.511,151,152,3389
2014,3364,1275,1682,364444,363044,90,5.360,84,5.003,33194,6294,26900,1.734,9.143,29090,7084,22006,1.951,8.013,4104,1.130,16.026,58,58,397
2014,3365,157,237,30645,30798,16,6.882,7,3.011,3151,445,2706,1.445,10.231,3467,87,3380,0.282,11.257,-316,-1.026,20.462,5,5,63
2014,3366,1290,1406,138677,135229,124,8.879,105,7.519,13792,2215,11577,1.638,10.199,7082,1667,5415,1.233,5.237,6710,4.962,10.474,66,66,677
2014,3369,794,822,32431,32363,84,10.294,72,8.824,3333,530,2803,1.638,10.299,3102,570,2532,1.761,9.585,231,0.714,19.170,61,61,354
2014,3371,10103,10376,214754,210640,769,7.363,904,8.656,28612,4904,23708,2.328,13.583,20136,9633,10503,4.573,9.559,8476,4.024,19.119,680,682,6650
2014,3372,3351,3519,108226,106569,191,5.382,251,7.072,13122,2362,10760,2.216,12.313,9831,3098,6733,2.907,9.225,3291,3.088,18.450,188,188,2294
2014,3379,644,733,31243,31109,28,3.774,46,6.199,2933,408,2525,1.312,9.428,2648,726,1922,2.334,8.512,285,0.916,17.024,36,36,459
2014,3391,9520,10441,281238,282616,617,5.862,786,7.468,23645,4225,19420,1.495,8.366,26174,7274,18900,2.574,9.261,-2529,-0.895,16.733,620,621,2801
2014,3399,13846,14233,258447,257046,1204,8.423,1327,9.283,27111,8017,19094,3.119,10.547,24178,8049,16129,3.131,9.406,2933,1.141,18.812,1060,1062,6241
2014,4231,15735,23295,375766,372259,1382,5.922,1465,6.278,40026,9363,30663,2.515,10.752,32834,9505,23329,2.553,8.820,7192,1.932,17.640,1003,1042,6174
2014,4232,9755,11542,147562,145450,780,6.728,884,7.625,17326,3016,14310,2.074,11.912,13164,4411,8753,3.033,9.051,4162,2.861,18.101,606,615,2981
2014,4233,9496,16081,206232,200229,1284,8.069,946,5.945,29834,10202,19632,5.095,14.900,17361,6148,11213,3.070,8.671,12473,6.229,17.341,573,613,3680
2014,4234,21552,33317,651008,654257,3556,10.683,3493,10.494,79241,19890,59351,3.040,12.112,86274,37857,48417,5.786,13.187,-7033,-1.075,24.223,1613,1643,9817
2014,4235,7145,9821,152447,151881,388,3.906,613,6.171,14856,2170,12686,1.429,9.781,13661,5260,8401,3.463,8.995,1195,0.787,17.989,359,370,2023
2014,4236,18192,28025,522612,520006,1842,6.564,1913,6.817,69623,14795,54828,2.845,13.389,64789,21725,43064,4.178,12.459,4834,0.930,24.919,1094,1142,6314
2014,4237,10010,18657,228214,226979,764,4.089,816,4.368,22569,4666,17903,2.056,9.943,20104,7625,12479,3.359,8.857,2465,1.086,17.714,386,410,2362
2014,4238,38503,55810,757358,745987,2821,5.043,3089,5.522,84270,23060,61210,3.091,11.296,61608,21255,40353,2.849,8.259,22662,3.038,16.517,1784,1838,9744
2014,4239,28014,31388,335420,336323,2975,9.464,3072,9.772,40477,12482,27995,3.711,12.035,42051,14769,27282,4.391,12.503,-1574,-0.468,24.070,2230,2311,9527
2014,4241,7419,9582,146972,147097,420,4.329,658,6.783,12995,3302,9693,2.245,8.834,13178,5672,7506,3.856,8.959,-183,-0.124,17.669,426,437,1979
2014,4242,6045,9263,297253,295634,820,8.908,705,7.658,30595,6764,23831,2.288,10.349,27225,7947,19278,2.688,9.209,3370,1.140,18.418,452,461,3610
2014,4243,13505,14677,200263,198475,1648,11.301,1459,10.005,27585,7840,19745,3.950,13.898,23907,6321,17586,3.185,12.045,3678,1.853,24.091,1106,1132,4387
2014,4244,24653,32127,786687,781545,2801,8.749,2576,8.046,93084,23571,69513,3.016,11.910,81294,36789,44505,4.707,10.402,11790,1.509,20.803,1675,1694,12491
2014,4245,3188,5993,62105,61406,292,4.887,256,4.285,6656,1563,5093,2.545,10.839,5273,1128,4145,1.837,8.587,1383,2.252,17.174,143,149,599
2014,4246,7973,12275,155714,154432,643,5.202,813,6.578,21374,4788,16586,3.100,13.840,18791,5464,13327,3.538,12.168,2583,1.673,24.336,354,359,1682
2014,4247,4167,6462,102628,102400,370,5.749,317,4.926,12569,3257,9312,3.181,12.274,12419,2715,9704,2.651,12.128,150,0.146,24.256,196,199,1565
2014,4248,3248,4192,193329,190532,321,7.705,269,6.457,16212,2751,13461,1.444,8.509,10537,2831,7706,1.486,5.530,5675,2.979,11.061,207,209,2073
2014,4249,20212,26559,330270,328603,2121,7.992,2081,7.841,38898,9685,29213,2.947,11.837,35844,13008,22836,3.959,10.908,3054,0.929,21.816,1494,1542,8076
2014,4251,35878,38245,291661,288665,4639,12.096,4855,12.659,50670,17840,32830,6.180,17.553,44770,17630,27140,6.107,15.509,5900,2.044,31.019,3767,3792,11870
2014,4411,37503,43072,1190478,1164963,3644,8.508,3162,7.383,127126,38786,88340,3.329,10.912,76017,27232,48785,2.338,6.525,51109,4.387,13.051,2446,2471,20442
2014,4412,11352,12916,133623,130287,897,6.939,920,7.117,18539,5590,12949,4.291,14.229,11885,4591,7294,3.524,9.122,6654,5.107,18.244,676,684,3449
2014,4413,26874,55579,508526,501369,2975,5.376,2495,4.509,51377,17068,34309,3.404,10.247,37251,11088,26163,2.212,7.430,14126,2.817,14.860,1650,1701,6027
2014,4421,13232,22341,197760,196215,1868,8.374,1799,8.065,24990,9015,15975,4.594,12.736,21938,8414,13524,4.288,11.181,3052,1.555,22.361,1092,1162,4664
2014,4422,18017,25787,231136,229912,1664,6.437,1792,6.932,24640,7765,16875,3.377,10.717,22064,6938,15126,3.018,9.597,2576,1.120,19.193,1222,1239,3404
2014,4431,22538,42384,400529,402959,3444,7.909,5767,13.244,48017,15550,32467,3.859,11.916,54402,25377,29025,6.298,13.501,-6385,-1.585,23.832,2635,2978,11104
2014,4441,35103,57341,1119762,1104121,2582,4.501,2628,4.581,90577,19643,70934,1.779,8.204,58979,12537,46442,1.135,5.342,31598,2.862,10.683,1849,1885,7365
2014,4442,12551,16286,143228,144138,967,5.916,1087,6.650,16787,5297,11490,3.675,11.646,18854,4305,14549,2.987,13.081,-2067,-1.434,23.293,769,787,3011
2014,4451,59990,86255,2702292,2650562,7852,9.133,7289,8.478,257379,96808,160571,3.652,9.710,157162,55646,101516,2.099,5.929,100217,3.781,11.859,5237,5323,26395
2014,4452,16402,20104,151577,149535,2298,11.498,2062,10.317,27751,11675,16076,7.808,18.558,23699,8984,14715,6.008,15.848,4052,2.710,31.697,1592,1611,7065
2014,4453,27240,31122,157398,156914,2589,8.396,2020,6.550,21771,8313,13458,5.298,13.875,20829,6136,14693,3.910,13.274,942,0.600,26.548,1554,1577,4875
2014,4461,39833,88433,1016853,1012037,5562,6.316,4819,5.472,99692,32460,67232,3.207,9.851,90830,25055,65775,2.476,8.975,8862,0.876,17.950,3023,3315,15259
2014,4471,61424,107120,901570,891000,6987,6.519,7112,6.635,119722,42214,77508,4.738,13.437,98001,33848,64153,3.799,10.999,21721,2.438,21.998,4537,4779,20289
2014,4481,32335,92623,1380688,1377314,7926,8.606,6873,7.463,178528,70134,108394,5.092,12.962,174743,39685,135058,2.881,12.687,3785,0.275,25.374,3578,4030,13540
2014,4482,5304,24415,223954,215755,1475,6.070,1248,5.135,38657,12420,26237,5.757,17.917,23305,6550,16755,3.036,10.802,15352,7.115,21.603,473,505,1855
2014,4483,15423,22295,130314,130965,1397,6.222,1712,7.625,16192,5241,10951,4.002,12.364,17473,6410,11063,4.894,13.342,-1281,-0.978,24.727,1123,1148,3893
2014,4511,24651,35276,458690,451839,2963,8.390,3040,8.608,58615,22166,36449,4.906,12.973,45859,12773,33086,2.827,10.149,12756,2.823,20.299,2136,2195,7776
2014,4512,3492,7590,100920,96927,385,4.975,682,8.813,17175,2307,14868,2.380,17.720,9122,2929,6193,3.022,9.411,8053,8.308,18.823,362,362,1190
2014,4521,51,7966,1035062,1033474,60,0.748,165,2.058,41769,3076,38693,0.298,4.042,37550,8935,28615,0.865,3.633,4219,0.408,7.267,10,10,25
2014,4529,7111,41979,1804209,1784227,2922,7.096,1316,3.196,102431,23807,78624,1.334,5.741,59106,6147,52959,0.345,3.313,43325,2.428,6.625,930,964,2844
2014,4531,12214,12751,60876,61386,851,6.572,1248,9.637,8575,2457,6118,4.003,13.969,9528,3451,6077,5.622,15.521,-953,-1.552,27.938,1022,1027,2820
2014,4532,17962,27774,235973,238110,2141,7.572,3147,11.129,29961,10792,19169,4.532,12.583,34635,10822,23813,4.545,14.546,-4674,-1.963,25.166,2000,2035,6509
2014,4533,12868,18703,194177,189544,1688,9.072,1495,8.035,28091,9304,18787,4.909,14.820,18730,5124,13606,2.703,9.882,9361,4.939,19.763,1165,1186,3152
2014,4539,29625,39436,255537,248823,5196,13.490,3360,8.723,41666,18779,22887,7.547,16.745,27995,10374,17621,4.169,11.251,13671,5.494,22.502,2561,2616,8105
2014,4541,26013,27155,395974,388863,4397,16.574,3146,11.858,62452,17429,45023,4.482,16.060,47717,18229,29488,4.688,12.271,14735,3.789,24.542,2502,2522,9860
2014,4542,3099,3526,39062,39610,328,9.177,424,11.863,4925,988,3937,2.494,12.434,5999,2621,3378,6.617,15.145,-1074,-2.711,24.867,328,346,2096
2014,4543,20317,25538,172584,170971,2636,10.301,2741,10.711,26914,8862,18052,5.183,15.742,23638,9941,13697,5.814,13.826,3276,1.916,27.651,1651,1683,5608
2014,4811,419,2469,392433,387196,155,6.321,121,4.935,25915,3049,22866,0.787,6.693,15494,2591,12903,0.669,4.002,10421,2.691,8.003,40,41,1381
2014,4812,1885,2078,35970,36665,225,10.768,248,11.869,4946,1987,2959,5.419,13.490,6128,1946,4182,5.308,16.713,-1182,-3.224,26.979,172,174,1315
2014,4831,643,983,47597,46683,157,16.614,81,8.571,6670,1849,4821,3.961,14.288,4783,730,4053,1.564,10.246,1887,4.042,20.492,48,48,286
2014,4832,424,490,21840,21675,54,10.976,58,11.789,2106,612,1494,2.824,9.716,1841,451,1390,2.081,8.494,265,1.223,16.987,36,36,154
2014,4841,49403,58441,918170,909076,9028,15.643,7570,13.117,110492,33216,77276,3.654,12.154,92533,37102,55431,4.081,10.179,17959,1.976,20.358,5581,5614,22251
2014,4842,37227,41156,477191,468894,4976,12.122,4766,11.610,78325,24206,54119,5.162,16.704,61614,22510,39104,4.801,13.140,16711,3.564,26.281,3294,3318,13770
2014,4851,517,811,51973,51801,87,10.741,85,10.494,5690,1031,4659,1.990,10.984,5276,3706,1570,7.154,10.185,414,0.799,20.370,53,55,422
2014,4852,275,477,13982,14690,53,11.447,25,5.400,1292,476,816,3.240,8.795,2816,294,2522,2.001,19.170,-1524,-10.374,17.590,12,12,82
2014,4853,6762,6921,76078,74745,1136,16.770,842,12.430,11767,4531,7236,6.062,15.743,9189,4169,5020,5.578,12.294,2578,3.449,24.588,677,677,3042
2014,4854,2538,4030,219944,217664,254,6.273,292,7.212,40210,15685,24525,7.206,18.473,35677,7566,28111,3.476,16.391,4533,2.083,32.782,192,194,2829
2014,4855,1139,1258,32913,33120,105,8.297,120,9.482,3815,962,2853,2.905,11.519,4225,1172,3053,3.539,12.757,-410,-1.238,23.038,95,98,790
2014,4859,3553,4009,85684,84146,592,14.940,499,12.593,13815,4501,9314,5.349,16.418,10764,4417,6347,5.249,12.792,3051,3.626,25.584,384,388,2721
2014,4861,57,736,12215,11912,87,12.000,65,8.966,2143,863,1280,7.245,17.990,1576,251,1325,2.107,13.230,567,4.760,26.461,4,4,12
2014,4862,116,2580,34941,33286,504,20.664,222,9.102,8010,5576,2434,16.752,24.065,4632,1686,2946,5.065,13.916,3378,10.149,27.832,9,9,15
2014,4869,64,666,6722,6669,68,10.608,18,2.808,1011,476,535,7.138,15.161,914,179,735,2.684,13.706,97,1.455,27.412,(D),(D),(D)
2014,4871,495,542,10306,10000,92,17.692,48,9.231,1492,283,1209,2.830,14.920,895,348,547,3.480,8.950,597,5.970,17.900,33,34,255
2014,4872,1181,1223,12667,12545,153,12.515,152,12.434,1636,312,1324,2.487,13.041,1384,340,1044,2.710,11.032,252,2.009,22.065,102,102,235
2014,4879,162,185,2257,2161,25,14.085,10,5.634,313,101,212,4.674,14.484,135,34,101,1.573,6.247,178,8.237,12.494,7,7,31
2014,4881,3729,5485,175582,174569,456,8.322,445,8.121,20172,4947,15225,2.834,11.555,17989,5913,12076,3.387,10.305,2183,1.251,20.610,259,269,1998
2014,4882,489,1389,36620,35755,130,9.538,78,5.723,4738,1610,3128,4.503,13.251,3088,683,2405,1.910,8.637,1650,4.615,17.273,28,28,296
2014,4883,1767,2301,98481,97917,172,7.477,171,7.433,9768,1123,8645,1.147,9.976,8527,1005,7522,1.026,8.708,1241,1.267,17.417,87,89,315
2014,4884,8812,10018,89939,87041,1164,11.661,1092,10.940,17364,5410,11954,6.215,19.949,11624,4706,6918,5.407,13.355,5740,6.595,26.709,804,805,2953
2014,4885,13487,18948,238384,235115,1652,8.755,1494,7.918,34703,12797,21906,5.443,14.760,28390,8334,20056,3.545,12.075,6313,2.685,24.150,916,973,4558
2014,4889,1289,1412,16207,16030,211,15.240,156,11.268,3341,936,2405,5.839,20.842,2970,1074,1896,6.700,18.528,371,2.314,37.056,118,119,632
2014,4921,4039,8761,504306,495782,944,10.934,690,7.992,42622,13103,29519,2.643,8.597,25755,7485,18270,1.510,5.195,16867,3.402,10.390,426,428,1880
2014,4922,3686,4055,35868,34814,447,10.922,522,12.755,7949,2461,5488,7.069,22.833,5982,3297,2685,9.470,17.183,1967,5.650,34.365,426,426,2747
2014,4931,6954,14050,757101,741111,1112,7.964,937,6.711,98486,24519,73967,3.308,13.289,65284,20392,44892,2.752,8.809,33202,4.480,17.618,316,349,3196
2014,5111,11815,16830,427785,432245,1048,6.173,1340,7.893,44907,18597,26310,4.302,10.389,54422,15430,38992,3.570,12.591,-9515,-2.201,20.779,791,804,4950
2014,5112,5660,8461,441443,433735,972,11.704,659,7.935,54923,14632,40291,3.373,12.663,39099,10820,28279,2.495,9.014,15824,3.648,18.029,364,371,4670
2014,5121,13548,16769,340553,326203,2369,14.270,2033,12.246,65572,14550,51022,4.460,20.102,37432,10078,27354,3.089,11.475,28140,8.627,22.950,1309,1327,6607
2014,5122,2763,2964,27558,25112,353,11.802,407,13.607,7867,675,7192,2.688,31.328,3220,1617,1603,6.439,12.823,4647,18.505,25.646,244,252,1060
2014,5151,4012,8612,212647,216914,436,5.039,517,5.975,22978,8066,14912,3.719,10.593,31896,9538,22358,4.397,14.704,-8918,-4.111,21.186,218,246,2409
2014,5152,387,738,52437,54197,55,7.493,47,6.403,4874,897,3977,1.655,8.993,8519,1232,7287,2.273,15.719,-3645,-6.726,17.986,20,20,117
2014,5171,3283,34636,753092,751691,6876,20.905,3386,10.295,108076,57515,50561,7.651,14.378,104417,31580,72837,4.201,13.891,3659,0.487,27.782,235,244,2025
2014,5172,843,10866,229394,237787,1596,14.706,1569,14.457,23516,12538,10978,5.273,9.890,40685,14671,26014,6.170,17.110,-17169,-7.220,19.779,104,119,599
2014,5174,361,455,8446,8285,66,14.537,64,14.097,1512,430,1082,5.190,18.250,1159,412,747,4.973,13.989,353,4.261,27.978,42,42,228
2014,5179,3552,4410,57754,56301,963,22.774,600,14.189,13115,4748,8367,8.433,23.294,10276,3775,6501,6.705,18.252,2839,5.043,36.504,431,433,2259
2014,5182,8585,12798,531210,518341,1530,11.705,2076,15.882,120135,36769,83366,7.094,23.177,91913,33703,58210,6.502,17.732,28222,5.445,35.464,730,743,6055
2014,5191,8176,10291,247897,234154,1690,16.768,1266,12.561,58511,14489,44022,6.188,24.988,30043,7064,22979,3.017,12.830,28468,12.158,25.661,945,952,4072
2014,5211,13,59,18787,18645,(D),(D),0,0.000,524,(D),454,(D),2.810,211,0,211,0.000,1.132,313,1.679,2.263,0,0,0
2014,5221,12268,119590,1965280,1984014,3871,3.213,5684,4.717,154934,32333,122601,1.630,7.809,193554,41989,151565,2.116,9.756,-38620,-1.947,15.618,375,520,4328
2014,5222,13604,40438,563656,564624,5268,13.294,3644,9.196,98689,41030,57659,7.267,17.479,100565,28722,71843,5.087,17.811,-1876,-0.332,34.957,1126,1236,8942
2014,5223,11569,27019,254136,250917,2436,9.029,2356,8.733,39918,12280,27638,4.894,15.909,33626,9569,24057,3.814,13.401,6292,2.508,26.803,1255,1311,3839
2014,5231,11336,41472,398676,401200,4396,10.648,4023,9.744,51820,28822,22998,7.184,12.916,56376,13192,43184,3.288,14.052,-4556,-1.136,25.833,774,801,2757
2014,5232,13,32,6194,5967,(D),(D),(D),(D),669,(D),63,(D),11.212,270,(D),269,(D),4.525,399,6.687,9.050,(D),(D),(D)
2014,5239,41231,47258,477565,469875,6411,13.853,4451,9.618,76960,33515,43445,7.133,16.379,61785,25058,36727,5.333,13.149,15175,3.230,26.298,3173,3197,11044
2014,5241,4775,31203,1437146,1430619,4142,13.536,2935,9.592,194125,73305,120820,5.124,13.569,180995,45036,135959,3.148,12.652,13130,0.918,25.303,339,343,2434
2014,5242,118114,132627,927968,918443,10772,8.149,9907,7.494,125657,45269,80388,4.929,13.682,107260,36606,70654,3.986,11.678,18397,2.003,23.357,6909,6989,20346
2014,5250,1245,1296,42598,28700,500,47.148,29,2.735,30639,11929,18710,41.564,106.756,3228,165,3063,0.575,11.247,27411,95.509,22.495,22,22,96
2014,5311,86761,112373,557701,549257,10449,9.370,8745,7.842,89235,39898,49337,7.264,16.246,72331,29552,42779,5.380,13.169,16904,3.078,26.338,6390,6490,19823
2014,5312,62945,73692,272617,265169,11959,16.629,8409,11.693,54520,24752,29768,9.334,20.561,39516,17590,21926,6.634,14.902,15004,5.658,29.804,4869,4914,9904
2014,5313,63680,79360,651910,643031,10532,13.501,7826,10.032,99314,43130,56184,6.707,15.445,81664,35924,45740,5.587,12.700,17650,2.745,25.400,4672,4792,20221
2014,5321,3483,14499,147605,139805,2514,18.439,785,5.757,36563,21138,15425,15.120,26.153,20978,4443,16535,3.178,15.005,15585,11.148,30.010,328,334,1254
2014,5322,7238,18646,145177,146783,1128,5.901,2069,10.823,23538,5700,17838,3.883,16.036,25572,13331,12241,9.082,17.422,-2034,-1.386,32.072,839,920,3975
2014,5323,2234,2693,18241,17681,160,5.896,201,7.407,3168,964,2204,5.452,17.918,1966,780,1186,4.412,11.120,1202,6.798,22.239,140,144,515
2014,5324,7230,13413,180320,175347,1210,9.093,997,7.493,33179,7524,25655,4.291,18.922,22392,7526,14866,4.292,12.770,10787,6.152,25.540,548,568,3002
2014,5331,2026,2169,32869,34009,219,10.048,240,11.012,4255,891,3364,2.620,12.512,6606,2964,3642,8.715,19.425,-2351,-6.913,25.023,170,170,990
2014,5411,159157,170146,1147235,1153048,13029,7.655,13125,7.712,112516,35459,77057,3.075,9.758,124435,37130,87305,3.220,10.792,-11919,-1.034,19.516,9631,9708,27300
2014,5412,99249,118591,1282491,1249633,13713,11.761,9724,8.340,215565,60623,154942,4.851,17.250,150763,48977,101786,3.919,12.065,64802,5.186,24.129,6443,6668,30562
2014,5413,79657,97200,1418936,1411132,10403,10.836,8007,8.340,187862,52630,135232,3.730,13.313,171374,39137,132237,2.773,12.144,16488,1.168,24.289,4972,5046,18817
2014,5414,24799,25086,107534,105323,3519,14.145,3104,12.477,19489,7679,11810,7.291,18.504,15148,6712,8436,6.373,14.382,4341,4.122,28.765,2193,2194,4965
2014,5415,95225,113479,1610528,1585558,17427,15.470,15765,13.995,326926,114847,212079,7.243,20.619,275307,88881,186426,5.606,17.363,51619,3.256,34.727,10302,10355,38082
2014,5416,117564,127501,1134978,1101159,23263,18.599,18416,14.724,237529,98611,138918,8.955,21.571,169976,74899,95077,6.802,15.436,67553,6.135,30.872,13324,13375,40575
2014,5417,12615,16197,664003,648218,2219,13.917,1714,10.750,90978,32520,58458,5.017,14.035,60412,15128,45284,2.334,9.320,30566,4.715,18.639,1095,1102,5823
2014,5418,29296,32727,462857,459368,3511,10.724,3537,10.803,70997,22667,48330,4.934,15.455,64200,19276,44924,4.196,13.976,6797,1.480,27.951,2605,2666,13425
2014,5419,52117,58420,584316,579740,6188,10.425,8057,13.574,86879,32709,54170,5.642,14.986,78717,32804,45913,5.658,13.578,8162,1.408,27.156,3465,3520,17282
2014,5511,26183,52287,3227848,3214127,4264,8.209,3572,6.877,435875,132602,303273,4.126,13.561,403970,86509,317461,2.692,12.569,31905,0.993,25.137,699,726,11861
2014,5611,24960,27242,424777,413049,3189,11.747,2999,11.047,81639,28687,52952,6.945,19.765,58196,26635,31561,6.448,14.089,23443,5.676,28.179,2170,2198,18849
2014,5612,1767,5595,248950,248746,1140,21.388,610,11.445,37457,12292,25165,4.942,15.058,36491,15303,21188,6.152,14.670,966,0.388,29.340,88,89,1216
2014,5613,24045,44585,5187834,5064192,5163,11.607,4953,11.135,1172657,275104,897553,5.432,23.156,939873,332856,607017,6.573,18.559,232784,4.597,37.118,2211,2344,103258
2014,5614,23634,30106,761228,754935,3032,10.034,3254,10.769,115086,33676,81410,4.461,15.244,101444,35551,65893,4.709,13.437,13642,1.807,26.875,2351,2406,16543
2014,5615,12779,23416,230785,225623,4481,20.218,1976,8.916,36779,14922,21857,6.614,16.301,26973,7826,19147,3.469,11.955,9806,4.346,23.910,916,925,3148
2014,5616,17508,23406,892292,883141,2133,8.968,2892,12.159,141013,29286,111727,3.316,15.967,120717,46939,73778,5.315,13.669,20296,2.298,27.338,1444,1477,14933
2014,5617,141177,148154,1760654,1731540,20011,13.618,17591,11.971,284067,88916,195151,5.135,16.405,225131,76713,148418,4.430,13.002,58936,3.404,26.004,11833,11861,46476
2014,5619,15347,17142,266218,265716,1635,9.542,1622,9.466,38397,9551,28846,3.594,14.450,36761,11323,25438,4.261,13.835,1636,0.616,27.669,1079,1083,6306
2014,5621,7271,10518,196222,195022,789,7.513,757,7.208,21127,5613,15514,2.878,10.833,18490,6322,12168,3.242,9.481,2637,1.352,18.962,497,500,3366
2014,5622,1226,2499,52603,52592,194,7.846,141,5.703,4418,1037,3381,1.972,8.401,4498,763,3735,1.451,8.553,-80,-0.152,16.801,88,88,469
2014,5629,8033,9438,128796,128138,843,8.981,740,7.884,19877,5132,14745,4.005,15.512,18583,4684,13899,3.655,14.502,1294,1.010,29.005,483,490,2383
2014,6111,18778,21605,970998,950826,978,4.626,55,0.260,80240,16713,63527,1.758,8.439,39639,271,39368,0.029,4.169,40601,4.270,8.338,41,41,84
2014,6112,472,1058,83011,84253,25,2.390,(D),(D),5152,290,4862,0.344,6.115,7410,(D),7377,(D),8.795,-2258,-2.680,12.230,0,0,0
2014,6113,2350,4566,1842316,1831056,268,6.046,(D),(D),108957,18314,90643,1.000,5.951,85657,(D),85654,(D),4.678,23300,1.272,9.356,(D),(D),(D)
2014,6114,6517,6894,58695,58520,677,9.724,814,11.691,8401,2488,5913,4.252,14.356,8009,2892,5117,4.942,13.686,392,0.670,27.372,538,538,2000
2014,6115,6019,7670,112395,112142,646,8.425,641,8.360,13661,4429,9232,3.949,12.182,13208,4365,8843,3.892,11.778,453,0.404,23.556,435,468,2849
2014,6116,38705,41518,388582,384066,5341,13.090,3911,9.585,69493,24778,44715,6.451,18.094,60495,20779,39716,5.410,15.751,8998,2.343,31.502,2874,2895,13859
2014,6117,5532,6377,104345,97966,996,15.879,787,12.547,28867,18186,10681,18.564,29.466,15324,4645,10679,4.741,15.642,13543,13.824,31.284,534,535,2442
2014,6211,164333,204662,2322569,2286984,16227,7.942,15548,7.610,319790,123421,196369,5.397,13.983,246881,88767,158114,3.881,10.795,72909,3.188,21.590,11236,11598,58684
2014,6212,119634,128426,894863,886804,6330,4.943,5602,4.374,100740,30907,69833,3.485,11.360,84446,25133,59313,2.834,9.523,16294,1.837,19.045,4425,4488,20191
2014,6213,115886,132224,804896,790405,11142,8.483,9369,7.134,124776,41588,83188,5.262,15.786,94995,29228,65767,3.698,12.019,29781,3.768,24.037,6564,6655,20217
2014,6214,15566,36201,837972,821209,2969,8.312,2007,5.619,105679,39245,66434,4.779,12.869,72182,20492,51690,2.495,8.790,33497,4.079,17.579,918,997,9980
2014,6215,7026,12729,250237,248425,1185,9.376,1003,7.936,29199,8649,20550,3.482,11.754,25716,7234,18482,2.912,10.352,3483,1.402,20.703,627,645,4210
2014,6216,19510,28024,1300794,1284300,3127,11.202,2910,10.424,192079,48110,143969,3.746,14.956,158269,47268,111001,3.680,12.323,33810,2.633,24.647,1919,1949,24303
2014,6219,6143,9526,290116,289087,782,8.171,872,9.111,37258,10895,26363,3.769,12.888,35048,12000,23048,4.151,12.124,2210,0.764,24.247,452,510,5958
2014,6221,2709,5107,5114239,5127642,156,3.075,88,1.735,164012,35748,128264,0.697,3.199,190227,26246,163981,0.512,3.710,-26215,-0.511,6.397,45,47,9697
2014,6222,431,637,230268,229695,44,7.103,9,1.453,5458,1574,3884,0.685,2.376,4350,1210,3140,0.527,1.894,1108,0.482,3.788,7,7,661
2014,6223,429,1000,285323,282578,87,8.869,49,4.995,18274,6283,11991,2.223,6.467,12531,4378,8153,1.549,4.435,5743,2.032,8.869,18,18,1670
2014,6231,8242,16048,1663519,1669441,813,5.074,761,4.750,119048,44764,74284,2.681,7.131,130275,49520,80755,2.966,7.804,-11227,-0.673,14.262,435,456,29456
2014,6232,9399,39107,743184,722078,4314,11.455,1424,3.781,118289,45642,72647,6.321,16.382,75729,13890,61839,1.924,10.488,42560,5.894,20.975,340,444,5907
2014,6233,15857,22505,879526,862677,2005,9.023,1436,6.463,97972,36318,61654,4.210,11.357,64801,23307,41494,2.702,7.512,33171,3.845,15.023,1021,1039,14671
2014,6239,2963,5007,133786,135344,391,7.723,503,9.935,17508,6694,10814,4.946,12.936,21048,9801,11247,7.242,15.551,-3540,-2.616,25.872,183,200,2170
2014,6241,52618,69315,1543549,1513573,9858,14.740,4986,7.455,207942,60704,147238,4.011,13.738,147796,36485,111311,2.411,9.765,60146,3.974,19.529,3273,3378,20556
2014,6242,9989,14032,180826,177488,646,4.613,587,4.192,21143,5075,16068,2.859,11.912,14427,3636,10791,2.049,8.128,6716,3.784,16.257,286,316,1615
2014,6243,3981,7515,331390,331348,403,5.366,393,5.233,35625,8194,27431,2.473,10.752,35468,7897,27571,2.383,10.704,157,0.047,21.408,146,159,2370
2014,6244,54863,69807,870432,867434,6045,8.642,6328,9.047,106754,38196,68558,4.403,12.307,100702,36370,64332,4.193,11.609,6052,0.698,23.218,4498,4648,26409
2014,7111,7011,7157,121412,120217,845,11.851,792,11.107,20114,5699,14415,4.741,16.731,17750,4488,13262,3.733,14.765,2364,1.966,29.530,539,539,2969
2014,7112,3268,3439,127295,125814,452,13.182,432,12.598,14770,3170,11600,2.520,11.740,11745,2850,8895,2.265,9.335,3025,2.404,18.670,326,327,2299
2014,7113,5823,6182,158195,153215,774,12.714,586,9.625,24375,5900,18475,3.851,15.909,14444,5349,9095,3.491,9.427,9931,6.482,18.855,432,435,2669
2014,7114,2941,3053,20009,19032,454,15.028,390,12.910,4935,2083,2852,10.945,25.930,3044,1187,1857,6.237,15.994,1891,9.936,31.988,287,289,896
2014,7115,14629,14671,45925,44141,2764,19.167,2263,15.693,12947,6629,6318,15.018,29.331,9360,4784,4576,10.838,21.205,3587,8.126,42.410,1430,1430,3033
2014,7121,6542,7007,142881,141247,316,4.521,282,4.034,11193,1285,9908,0.910,7.924,7973,1251,6722,0.886,5.645,3220,2.280,11.289,184,184,732
2014,7131,2347,2672,182269,177023,338,12.532,388,14.386,24576,3838,20738,2.168,13.883,13673,3616,10057,2.043,7.724,10903,6.159,15.448,325,328,2912
2014,7132,1756,2749,155987,153061,244,8.818,280,10.119,19218,9488,9730,6.199,12.556,13285,6062,7223,3.961,8.680,5933,3.876,17.359,209,214,4574
2014,7139,49680,57359,1213784,1198609,6443,11.363,5129,9.046,159705,64367,95338,5.370,13.324,128504,41142,87362,3.432,10.721,31201,2.603,21.442,3849,3918,29711
2014,7211,39766,50551,1937100,1926353,4130,8.206,3681,7.314,201783,79041,122742,4.103,10.475,178205,70967,107238,3.684,9.251,23578,1.224,18.502,2366,2455,38063
2014,7212,5252,5837,42035,41754,393,6.712,429,7.327,5745,1442,4303,3.454,13.759,5202,1444,3758,3.458,12.459,543,1.300,24.918,265,265,855
2014,7213,1848,1992,13140,12323,111,5.542,133,6.640,3319,1978,1341,16.052,26.934,1569,681,888,5.526,12.733,1750,14.202,25.466,87,88,204
2014,7223,13419,37001,721067,710813,4421,11.860,4969,13.331,131813,41053,90760,5.776,18.544,110469,43663,66806,6.143,15.541,21344,3.003,31.082,1652,1668,10028
2014,7224,36797,37692,355123,354438,3460,9.075,4329,11.354,60325,25845,34480,7.292,17.020,59200,25077,34123,7.075,16.703,1125,0.317,33.405,3640,3643,21065
2014,7225,354425,487139,9707598,9537923,52456,10.865,43751,9.062,1485731,711516,774215,7.460,15.577,1146560,424780,721780,4.454,12.021,339171,3.556,24.042,35380,36371,323345
2014,8111,133823,146991,848555,837136,11872,8.088,11453,7.803,126150,46380,79770,5.540,15.069,103439,38981,64458,4.656,12.356,22711,2.713,24.713,8414,8521,28709
2014,8112,9590,10877,97641,97625,1080,9.884,1179,10.790,12584,3593,8991,3.680,12.890,12686,4277,8409,4.381,12.995,-102,-0.104,25.780,904,908,2622
2014,8113,18038,19983,208214,206456,1745,8.774,1557,7.828,28653,10997,17656,5.327,13.879,25260,7003,18257,3.392,12.235,3393,1.643,24.470,1127,1136,4373
2014,8114,17113,17840,67891,66752,2083,11.754,1845,10.411,11898,5148,6750,7.712,17.824,9641,4551,5090,6.818,14.443,2257,3.381,28.886,1367,1367,3391
2014,8121,93247,110148,658463,656238,13628,12.507,11256,10.330,112048,56359,55689,8.588,17.074,107402,39636,67766,6.040,16.366,4646,0.708,32.733,8676,8774,30391
2014,8122,14212,20024,139110,137304,1014,5.119,584,2.948,13595,5376,8219,3.915,9.901,9968,2285,7683,1.664,7.260,3627,2.642,14.520,392,394,1595
2014,8123,27965,33310,288031,289852,2492,7.463,2653,7.945,32884,15010,17874,5.179,11.345,36363,12587,23776,4.343,12.545,-3479,-1.200,22.690,2010,2051,8638
2014,8129,26122,35466,277689,269294,5707,16.376,4473,12.835,64126,33074,31052,12.282,23.813,46606,23982,22624,8.906,17.307,17520,6.506,34.614,2231,2325,8162
2014,8131,177114,177445,1676443,1669134,7432,4.276,148,0.085,134668,21259,113409,1.274,8.068,120110,269,119841,0.016,7.196,14558,0.872,14.392,91,91,171
2014,8132,16232,18238,181906,179583,1267,6.993,1025,5.658,19427,4138,15289,2.304,10.818,14729,3616,11113,2.014,8.202,4698,2.616,16.404,727,735,2010
2014,8133,13771,16252,159468,156656,1199,7.420,1015,6.281,20868,4947,15921,3.158,13.321,15225,3647,11578,2.328,9.719,5643,3.602,19.438,682,684,2378
2014,8134,22692,24597,232015,231370,1256,5.103,1292,5.249,23784,4616,19168,1.995,10.280,22515,5120,17395,2.213,9.731,1269,0.548,19.462,904,912,3672
2014,8139,54386,56564,489999,486485,2632,4.689,1766,3.146,46094,9627,36467,1.979,9.475,39011,5921,33090,1.217,8.019,7083,1.456,16.038,1292,1292,4273
2015,2111,5705,7173,134294,134347,549,7.536,774,10.624,21652,7891,13761,5.874,16.117,22068,9515,12553,7.082,16.426,-416,-0.310,32.233,464,467,3948
2015,2121,448,842,69704,72775,72,8.431,96,11.241,9885,3862,6023,5.307,13.583,15986,5651,10335,7.765,21.966,-6101,-8.383,27.166,46,46,1332
2015,2122,214,285,39990,41249,22,7.201,63,20.622,2196,606,1590,1.469,5.324,4772,1390,3382,3.370,11.569,-2576,-6.245,10.648,53,53,1016
2015,2123,2714,4873,81668,80567,366,7.554,310,6.398,11581,3743,7838,4.646,14.374,9568,2292,7276,2.845,11.876,2013,2.499,23.752,164,164,815
2015,2131,10947,13753,415169,420436,1815,13.322,1557,11.428,63433,24491,38942,5.825,15.087,74109,17874,56235,4.251,17.627,-10676,-2.539,30.175,1103,1116,7839
2015,2211,1708,10428,511196,509544,624,5.997,579,5.564,36218,7647,28571,1.501,7.108,33099,6103,26996,1.198,6.496,3119,0.612,12.992,89,90,492
2015,2212,415,2498,86218,85682,118,4.723,119,4.763,8554,3016,5538,3.520,9.983,7500,2136,5364,2.493,8.753,1054,1.230,17.507,25,25,120
2015,2213,3492,4580,42721,42468,179,3.892,218,4.740,3530,956,2574,2.251,8.312,2980,1118,1862,2.633,7.017,550,1.295,14.034,114,114,406
2015,2361,130988,132373,646297,621441,23968,18.503,18297,14.125,160294,64867,95427,10.438,25.794,110361,50410,59951,8.112,17.759,49933,8.035,35.518,12309,12318,35351
2015,2362,35354,36772,610360,595214,3509,9.547,3475,9.454,114537,29352,85185,4.931,19.243,83830,17982,65848,3.021,14.084,30707,5.159,28.168,2492,2496,12898
2015,2371,16086,17665,546045,540005,1489,8.442,1433,8.125,102753,20320,82433,3.763,19.028,92291,16000,76291,2.963,17.091,10462,1.937,34.182,945,946,6997
2015,2372,4362,4445,25222,24597,450,10.082,487,10.911,4703,1589,3114,6.460,19.121,3409,1604,1805,6.521,13.860,1294,5.261,27.719,384,384,1203
2015,2373,7920,8737,260740,259953,605,6.913,634,7.244,36406,5975,30431,2.298,14.005,34355,5301,29054,2.039,13.216,2051,0.789,26.432,433,434,3318
2015,2379,3595,3728,86750,83897,415,11.262,329,8.928,15592,2955,12637,3.522,18.585,10143,2443,7700,2.912,12.090,5449,6.495,24.180,210,210,1204
2015,2381,71040,71857,753245,730140,9841,13.886,7863,11.095,164330,40801,123529,5.588,22.507,117850,33577,84273,4.599,16.141,46480,6.366,32.281,5127,5132,24213
2015,2382,154224,158656,1824813,1781610,15365,9.766,12714,8.081,300993,66820,234173,3.751,16.894,215221,56916,158305,3.195,12.080,85772,4.814,24.160,9079,9099,38391
2015,2383,90083,91158,704963,684381,12426,13.807,10109,11.232,145946,40922,105024,5.979,21.325,104766,32432,72334,4.739,15.308,41180,6.017,30.616,6921,6925,23342
2015,2389,53406,54136,544328,528187,6996,13.130,5288,9.925,103596,25129,78467,4.758,19.614,71234,20530,50704,3.887,13.487,32362,6.127,26.973,3446,3449,13337
2015,3111,1096,1701,54491,50402,115,6.870,61,3.644,12078,8023,4055,15.918,23.964,4284,836,3448,1.659,8.500,7794,15.464,16.999,44,45,428
2015,3112,475,822,57566,56854,46,5.610,42,5.122,4091,438,3653,0.770,7.196,2627,426,2201,0.749,4.621,1464,2.575,9.241,29,29,187
2015,3113,1636,1809,75841,74855,136,7.553,119,6.609,7709,983,6726,1.313,10.299,5718,1397,4321,1.866,7.639,1991,2.660,15.278,90,91,542
2015,3114,1375,1739,155947,156576,142,8.249,107,6.216,12810,1833,10977,1.171,8.181,14011,4225,9786,2.698,8.948,-1201,-0.767,16.363,73,76,1772
2015,3115,1087,1584,141489,139647,112,7.084,106,6.705,12403,2174,10229,1.557,8.882,8497,2446,6051,1.752,6.085,3906,2.797,12.169,67,67,387
2015,3116,2804,3417,486567,477429,206,6.043,190,5.573,41208,6439,34769,1.349,8.631,22658,4387,18271,0.919,4.746,18550,3.885,9.492,140,140,1848
2015,3117,432,521,30583,31142,38,7.177,55,10.387,1844,511,1333,1.641,5.921,2883,977,1906,3.137,9.258,-1039,-3.336,11.843,40,40,486
2015,3118,9475,10212,285778,283206,920,9.029,875,8.587,28626,7613,21013,2.688,10.108,23344,7469,15875,2.637,8.243,5282,1.865,16.486,722,726,4770
2015,3119,2925,3379,191253,186341,391,11.886,212,6.445,21202,3413,17789,1.832,11.378,11119,3056,8063,1.640,5.967,10083,5.411,11.934,153,154,1469
2015,3121,5901,6526,168185,161528,1180,19.327,339,5.552,23534,6294,17240,3.897,14.570,10117,3302,6815,2.044,6.263,13417,8.306,12.527,253,257,2488
2015,3122,121,143,14024,14332,33,24.719,14,10.487,633,203,430,1.416,4.417,1231,157,1074,1.095,8.589,-598,-4.172,8.833,10,10,119
2015,3131,244,305,25058,24922,21,6.908,19,6.250,1480,637,843,2.556,5.939,1217,356,861,1.428,4.883,263,1.055,9.766,12,12,76
2015,3132,790,873,49757,50479,35,3.957,58,6.557,3369,372,2997,0.737,6.674,4894,1105,3789,2.189,9.695,-1525,-3.021,13.348,48,48,368
2015,3133,860,906,28490,28641,45,4.857,86,9.282,2175,455,1720,1.589,7.594,2433,507,1926,1.770,8.495,-258,-0.901,15.188,71,71,355
2015,3141,1601,1722,54015,53926,99,5.701,128,7.371,5145,2700,2445,5.007,9.541,4900,955,3945,1.771,9.087,245,0.454,18.173,104,104,485
2015,3149,3873,3979,60050,59821,332,8.366,311,7.837,6140,1466,4674,2.451,10.264,5642,1639,4003,2.740,9.432,498,0.832,18.863,236,236,1036
2015,3151,220,230,12568,12290,19,8.279,18,7.843,1208,298,910,2.425,9.829,659,110,549,0.895,5.362,549,4.467,10.724,15,15,35
2015,3152,4996,5042,83571,84463,900,18.043,792,15.878,13859,6952,6907,8.231,16.408,15624,7704,7920,9.121,18.498,-1765,-2.090,32.817,668,669,6611
2015,3159,544,549,7943,8073,75,14.019,47,8.785,872,323,549,4.001,10.801,1102,257,845,3.183,13.650,-230,-2.849,21.603,40,40,245
2015,3161,166,176,3660,3524,11,6.197,14,7.887,448,85,363,2.412,12.713,182,29,153,0.823,5.165,266,7.548,10.329,13,13,28
2015,3162,190,207,11792,11604,27,12.857,33,15.714,1367,440,927,3.792,11.780,1012,459,553,3.956,8.721,355,3.059,17.442,28,29,450
2015,3169,697,702,10734,10458,89,13.031,51,7.467,1668,701,967,6.703,15.950,1104,409,695,3.911,10.557,564,5.393,21.113,47,47,401
2015,3211,2593,3009,84348,82502,210,7.023,172,5.753,8931,2341,6590,2.838,10.825,5200,1543,3657,1.870,6.303,3731,4.522,12.606,129,130,988
2015,3212,1045,1358,70266,69396,69,5.079,70,5.153,7636,1683,5953,2.425,11.004,5963,1822,4141,2.626,8.593,1673,2.411,17.185,45,46,732
2015,3219,7768,8734,225247,220476,767,8.877,580,6.713,27246,6133,21113,2.782,12.358,17654,5837,11817,2.647,8.007,9592,4.351,16.014,434,437,3939
2015,3221,229,447,105485,106203,19,4.255,18,4.031,4660,717,3943,0.675,4.388,6121,824,5297,0.776,5.763,-1461,-1.376,8.776,13,13,383
2015,3222,2409,3679,244266,243982,118,3.186,168,4.536,17823,4583,13240,1.878,7.305,17364,5600,11764,2.295,7.117,459,0.188,14.234,101,104,2885
2015,3231,23156,24400,447818,453305,1300,5.262,1907,7.720,37647,8491,29156,1.873,8.305,48246,18174,30072,4.009,10.643,-10599,-2.338,16.610,1531,1535,9551
2015,3241,912,2056,101880,101742,106,5.146,114,5.534,5926,1456,4470,1.431,5.825,5666,1500,4166,1.474,5.569,260,0.256,11.138,39,40,355
2015,3251,1279,2361,158291,157700,80,3.382,89,3.762,10178,2159,8019,1.369,6.454,8895,1170,7725,0.742,5.640,1283,0.814,11.281,51,52,668
2015,3252,1050,1376,94616,95030,39,2.821,52,3.761,6324,763,5561,0.803,6.655,7203,933,6270,0.982,7.580,-879,-0.925,13.310,30,30,382
2015,3253,641,891,28755,28647,68,7.727,46,5.227,2858,707,2151,2.468,9.977,2581,472,2109,1.648,9.010,277,0.967,18.019,22,25,273
2015,3254,1631,2139,235845,234575,214,10.200,132,6.292,27715,11590,16125,4.941,11.815,25556,6003,19553,2.559,10.895,2159,0.920,21.789,90,92,1991
2015,3255,1289,1636,58846,58135,96,5.911,72,4.433,6393,1108,5285,1.906,10.997,4844,1866,2978,3.210,8.332,1549,2.665,16.665,39,39,293
2015,3256,1853,2046,95626,95587,139,6.779,148,7.218,7752,1470,6282,1.538,8.110,7744,3253,4491,3.403,8.102,8,0.008,16.203,106,106,811
2015,3259,1707,2185,78635,78450,145,6.635,146,6.680,7462,2285,5177,2.913,9.512,7038,2546,4492,3.245,8.971,424,0.540,17.943,95,99,969
2015,3261,7885,10181,608747,599228,414,4.059,450,4.412,56770,9542,47228,1.592,9.474,37597,9519,28078,1.589,6.274,19173,3.200,12.548,325,328,5485
2015,3262,1393,1806,130969,129597,55,3.024,81,4.453,8568,763,7805,0.589,6.611,5789,1080,4709,0.833,4.467,2779,2.144,8.934,57,57,451
2015,3271,871,1047,33872,33512,51,4.800,82,7.718,2916,624,2292,1.862,8.701,2230,601,1629,1.793,6.654,686,2.047,13.309,55,56,420
2015,3272,1357,1612,86514,85670,117,7.218,135,8.328,7346,1594,5752,1.861,8.575,5668,2075,3593,2.422,6.616,1678,1.959,13.232,93,94,677
2015,3273,3912,8240,161594,158163,493,6.013,410,5.001,22603,5142,17461,3.251,14.291,15835,4499,11336,2.845,10.012,6768,4.279,20.024,193,195,2363
2015,3274,165,294,13203,13110,19,6.574,9,3.114,956,182,774,1.388,7.292,775,61,714,0.465,5.912,181,1.381,11.823,8,8,60
2015,3279,2534,2982,74927,73709,199,6.676,197,6.609,8137,1250,6887,1.696,11.039,5703,1625,4078,2.205,7.737,2434,3.302,15.474,128,128,848
2015,3311,329,501,103191,102246,44,8.880,33,6.660,5723,1196,4527,1.170,5.597,3921,550,3371,0.538,3.835,1802,1.762,7.670,18,18,183
2015,3312,526,647,49037,48890,37,5.745,31,4.814,4492,363,4129,0.742,9.188,4195,569,3626,1.164,8.580,297,0.607,17.161,20,20,334
2015,3313,385,514,57954,56593,23,4.449,29,5.609,5161,491,4670,0.868,9.120,2574,1050,1524,1.855,4.548,2587,4.571,9.097,22,22,391
2015,3314,755,943,60834,61004,42,4.433,51,5.383,3686,415,3271,0.680,6.042,4029,1342,2687,2.200,6.604,-343,-0.562,12.084,37,37,262
2015,3315,1504,1711,126033,125424,68,3.963,78,4.545,9737,1577,8160,1.257,7.763,8608,2746,5862,2.189,6.863,1129,0.900,13.726,58,58,1904
2015,3321,2154,2401,116934,115927,68,2.820,89,3.691,10246,2268,7978,1.956,8.838,8151,1283,6868,1.107,7.031,2095,1.807,14.062,67,67,860
2015,3322,1053,1127,35824,35556,60,5.329,58,5.151,2668,402,2266,1.131,7.504,2101,838,1263,2.357,5.909,567,1.595,11.818,42,43,467
2015,3323,10954,11909,343165,337324,686,5.766,663,5.573,38268,7428,30840,2.202,11.345,26506,6728,19778,1.995,7.858,11762,3.487,15.715,487,489,4016
2015,3324,1197,1528,93127,91966,84,5.532,65,4.281,8795,1645,7150,1.789,9.563,6498,2148,4350,2.336,7.066,2297,2.498,14.131,43,43,509
2015,3325,506,552,27770,26956,29,5.202,40,7.175,3255,922,2333,3.420,12.075,1629,544,1085,2.018,6.043,1626,6.032,12.087,24,24,157
2015,3326,1024,1159,38985,38849,28,2.381,62,5.272,3052,595,2457,1.532,7.856,2757,680,2077,1.750,7.097,295,0.759,14.193,50,50,244
2015,3327,21463,21998,389929,389414,946,4.274,1217,5.498,34361,6926,27435,1.779,8.824,33321,10706,22615,2.749,8.557,1040,0.267,17.113,968,969,7663
2015,3328,4982,5548,129963,129318,267,4.802,292,5.251,12537,3220,9317,2.490,9.695,11304,3217,8087,2.488,8.741,1233,0.953,17.483,219,219,1838
2015,3329,5634,6176,269459,267425,386,6.261,365,5.920,23729,4275,19454,1.599,8.873,19608,3990,15618,1.492,7.332,4121,1.541,14.664,278,278,2690
2015,3331,2559,2974,215119,215552,153,5.147,150,5.046,19420,4092,15328,1.898,9.009,20178,2934,17244,1.361,9.361,-758,-0.352,18.019,111,111,1668
2015,3332,2930,3092,105186,103488,163,5.253,185,5.962,10828,1927,8901,1.862,10.463,7505,2277,5228,2.200,7.252,3323,3.211,14.504,139,139,1587
2015,3333,1787,1913,76868,76221,110,5.722,129,6.710,6593,1283,5310,1.683,8.650,5322,947,4375,1.242,6.982,1271,1.668,13.965,110,110,674
2015,3334,1427,1700,128796,127996,73,4.255,104,6.062,10083,1374,8709,1.073,7.878,8389,1959,6430,1.531,6.554,1694,1.323,13.108,75,75,1247
2015,3335,6146,6376,148766,147212,240,3.752,282,4.408,12531,2120,10411,1.440,8.512,9402,2747,6655,1.866,6.387,3129,2.126,12.773,226,226,1505
2015,3336,823,1042,103149,103078,38,3.628,49,4.678,8398,1011,7387,0.981,8.147,8487,1369,7118,1.328,8.234,-89,-0.086,16.294,39,39,550
2015,3339,5181,5845,299636,297075,215,3.673,231,3.947,23628,3120,20508,1.050,7.954,18360,2998,15362,1.009,6.180,5268,1.773,12.361,169,169,1426
2015,3341,943,984,44071,43091,93,9.461,91,9.257,6352,2732,3620,6.340,14.741,4254,1742,2512,4.043,9.872,2098,4.869,19.744,70,70,986
2015,3342,1163,1279,92008,91392,70,5.412,99,7.654,7468,797,6671,0.872,8.171,6352,2135,4217,2.336,6.950,1116,1.221,13.901,78,79,1337
2015,3343,430,440,9100,9034,44,9.966,47,10.646,1182,284,898,3.144,13.084,1036,575,461,6.365,11.468,146,1.616,22.936,38,38,226
2015,3344,3355,3795,257830,257230,181,4.722,258,6.730,20915,2844,18071,1.106,8.131,19949,7406,12543,2.879,7.755,966,0.376,15.511,184,187,2902
2015,3345,4326,4983,382510,385225,276,5.524,303,6.064,28865,7715,21150,2.003,7.493,34290,8087,26203,2.099,8.901,-5425,-1.408,14.986,203,203,2706
2015,3346,437,446,9708,10685,34,7.473,52,11.429,867,303,564,2.836,8.115,2731,421,2310,3.940,25.560,-1864,-17.446,16.229,42,42,366
2015,3351,974,1037,42879,42266,83,8.012,81,7.819,4505,924,3581,2.186,10.659,3226,1338,1888,3.166,7.633,1279,3.026,15.265,57,57,553
2015,3352,234,279,47578,47453,27,9.872,16,5.850,3991,932,3059,1.964,8.410,3748,264,3484,0.556,7.898,243,0.512,15.797,12,12,49
2015,3353,1778,2049,121036,120075,94,4.550,128,6.196,9971,1273,8698,1.060,8.304,8108,2374,5734,1.977,6.752,1863,1.552,13.505,94,95,1212
2015,3359,1776,2048,133888,131890,128,6.264,119,5.823,11878,1735,10143,1.315,9.006,7816,2271,5545,1.722,5.926,4062,3.080,11.852,86,86,858
2015,3361,270,323,185101,178153,29,9.048,24,7.488,17954,651,17303,0.365,10.078,4389,240,4149,0.135,2.464,13565,7.614,4.927,22,22,95
2015,3362,1560,1842,137673,132631,141,7.730,105,5.757,17678,3440,14238,2.594,13.329,7555,2329,5226,1.756,5.696,10123,7.632,11.393,81,82,1328
2015,3363,3942,4881,540269,526648,241,4.944,228,4.677,61046,11004,50042,2.089,11.591,33856,8169,25687,1.551,6.429,27190,5.163,12.857,157,158,3028
2015,3364,1288,1727,363920,369879,114,6.645,91,5.305,24370,2948,21422,0.797,6.589,35224,5129,30095,1.387,9.523,-10854,-2.934,13.177,54,54,584
2015,3365,155,233,31794,31039,7,2.985,10,4.264,3369,120,3249,0.387,10.854,1822,503,1319,1.621,5.870,1547,4.984,11.740,5,5,41
2015,3366,1286,1411,143156,141422,110,7.840,94,6.700,13884,2048,11836,1.448,9.817,10321,1228,9093,0.868,7.298,3563,2.519,14.596,78,78,571
2015,3369,787,812,31337,31350,82,10.061,88,10.798,2653,280,2373,0.893,8.463,2611,642,1969,2.048,8.329,42,0.134,16.657,68,68,250
2015,3371,9867,10131,217810,216552,697,6.812,899,8.786,21968,4250,17718,1.963,10.144,19694,6212,13482,2.869,9.094,2274,1.050,18.189,674,677,4127
2015,3372,3330,3489,110326,109501,177,5.042,220,6.267,10287,1811,8476,1.654,9.394,8688,2596,6092,2.371,7.934,1599,1.460,15.868,158,159,1491
2015,3379,634,725,31140,31423,46,6.297,57,7.803,3455,881,2574,2.804,10.995,4002,1581,2421,5.031,12.736,-547,-1.741,21.991,43,48,1262
2015,3391,9237,10188,277517,277509,638,6.200,843,8.192,27205,7978,19227,2.875,9.803,27717,7018,20699,2.529,9.988,-512,-0.184,19.607,664,670,3498
2015,3399,14038,14415,259979,257881,1324,9.237,1162,8.107,28241,8640,19601,3.350,10.951,23845,6550,17295,2.540,9.247,4396,1.705,18.493,910,917,4777
2015,4231,15394,22985,389493,382747,1400,6.055,1675,7.244,46315,11328,34987,2.960,12.101,32714,13187,19527,3.445,8.547,13601,3.554,17.094,1132,1176,7540
2015,4232,9573,11367,150287,148957,753,6.576,921,8.043,16783,3931,12852,2.639,11.267,14002,5296,8706,3.555,9.400,2781,1.867,18.800,677,698,3867
2015,4233,9450,16084,215451,211516,1030,6.397,1067,6.626,29180,6754,22426,3.193,13.796,21396,8565,12831,4.049,10.116,7784,3.680,20.231,582,609,3635
2015,4234,21233,32073,642625,643990,2640,8.070,3922,11.989,74927,23179,51748,3.599,11.635,76143,31318,44825,4.863,11.824,-1216,-0.189,23.270,1541,1576,10058
2015,4235,6964,9610,155798,154366,388,3.993,601,6.185,15952,2694,13258,1.745,10.334,13143,4240,8903,2.747,8.514,2809,1.820,17.028,391,403,2107
2015,4236,17952,27778,544791,535936,2020,7.272,2020,7.272,77970,19275,58695,3.597,14.548,58464,18772,39692,3.503,10.909,19506,3.640,21.818,1226,1263,7355
2015,4237,9913,18604,234336,231432,740,3.968,833,4.466,23080,4332,18748,1.872,9.973,17477,5047,12430,2.181,7.552,5603,2.421,15.103,444,458,2250
2015,4238,38093,55791,769734,761514,2853,5.107,2992,5.356,81146,19223,61923,2.524,10.656,64845,19417,45428,2.550,8.515,16301,2.141,17.031,1923,1990,9909
2015,4239,27746,31085,332044,334864,2765,8.855,3048,9.761,38365,11097,27269,3.314,11.457,44013,14947,29066,4.464,13.144,-5648,-1.687,22.914,2320,2365,10409
2015,4241,7192,9519,146468,147077,591,6.189,650,6.807,13849,5996,7853,4.077,9.416,14889,3591,11298,2.442,10.123,-1040,-0.707,18.832,451,462,2290
2015,4242,6120,9438,298937,296848,852,9.095,711,7.590,39411,9185,30226,3.094,13.276,35741,6367,29374,2.145,12.040,3670,1.236,24.080,498,499,3361
2015,4243,13433,14606,199619,199303,1450,9.901,1529,10.440,24515,6127,18388,3.074,12.300,23995,8706,15289,4.368,12.039,520,0.261,24.079,1240,1246,6741
2015,4244,24745,32755,812431,799863,3038,9.356,2470,7.607,83547,26023,57524,3.253,10.445,59153,18301,40852,2.288,7.395,24394,3.050,14.791,1834,1856,11705
2015,4245,3226,6076,64110,63211,333,5.498,295,4.870,7206,2016,5190,3.189,11.400,5447,1399,4048,2.213,8.617,1759,2.783,17.234,154,158,773
2015,4246,7760,12048,157349,157024,569,4.672,832,6.831,17626,4918,12708,3.132,11.225,17269,6358,10911,4.049,10.998,357,0.227,21.995,448,477,2506
2015,4247,4049,6465,102882,102553,405,6.264,406,6.279,13648,4038,9610,3.937,13.308,13025,5268,7757,5.137,12.701,623,0.607,25.402,203,214,1562
2015,4248,3230,4176,198560,195892,302,7.226,309,7.393,16358,4135,12223,2.111,8.351,10986,3460,7526,1.766,5.608,5372,2.742,11.216,244,249,2323
2015,4249,20198,26694,337528,334209,2248,8.432,2179,8.173,42066,12288,29778,3.677,12.587,35271,12213,23058,3.654,10.554,6795,2.033,21.107,1583,1641,7280
2015,4251,36152,38586,299481,293867,4612,12.020,4181,10.896,47368,19408,27960,6.604,16.119,35895,13836,22059,4.708,12.215,11473,3.904,24.429,3209,3234,8402
2015,4411,37604,43478,1244305,1217532,3600,8.321,3171,7.330,136590,43280,93310,3.555,11.219,82911,28100,54811,2.308,6.810,53679,4.409,13.620,2521,2551,21922
2015,4412,11252,12872,138550,136106,835,6.482,855,6.637,17078,4812,12266,3.535,12.548,12154,4454,7700,3.272,8.930,4924,3.618,17.860,644,661,3595
2015,4413,26624,55743,523506,515742,3012,5.413,2815,5.059,54717,19547,35170,3.790,10.609,39239,13710,25529,2.658,7.608,15478,3.001,15.217,1614,1656,6159
2015,4421,13043,22444,202549,199799,1821,8.128,1739,7.762,26778,9514,17264,4.762,13.402,21442,8009,13433,4.009,10.732,5336,2.671,21.464,1072,1327,5627
2015,4422,17708,25536,245247,238054,1572,6.131,1779,6.939,36409,10566,25843,4.438,15.294,21444,7116,14328,2.989,9.008,14965,6.286,18.016,1198,1222,3584
2015,4431,22019,41610,394257,396853,3484,8.315,4069,9.711,42098,14833,27265,3.738,10.608,48146,18352,29794,4.624,12.132,-6048,-1.524,21.216,2531,2831,11585
2015,4441,34415,56915,1129549,1124170,2262,3.964,2561,4.488,73616,13248,60368,1.178,6.548,62206,11884,50322,1.057,5.534,11410,1.015,11.067,1821,1875,8078
2015,4442,12531,16478,148644,146010,1009,6.142,908,5.527,18489,5502,12987,3.768,12.663,13084,3137,9947,2.148,8.961,5405,3.702,17.922,672,684,2360
2015,4451,60084,86781,2804885,2743682,8405,9.738,7473,8.658,304972,120784,184188,4.402,11.115,182645,64073,118572,2.335,6.657,122327,4.458,13.314,5266,5376,26995
2015,4452,16585,20806,166515,159439,2777,13.583,2054,10.047,36972,19089,17883,11.973,23.189,23307,8977,14330,5.630,14.618,13665,8.571,29.236,1556,1598,6963
2015,4453,27440,31365,162603,160002,2352,7.531,2085,6.676,23839,8101,15738,5.063,14.899,18519,6084,12435,3.802,11.574,5320,3.325,23.149,1660,1698,5048
2015,4461,39815,88861,1038240,1028165,5386,6.081,4794,5.413,98193,29159,69034,2.836,9.550,77543,27884,49659,2.712,7.542,20650,2.008,15.084,3079,3190,14739
2015,4471,61170,107137,921410,911166,6796,6.338,6988,6.517,120947,44739,76208,4.910,13.274,100570,35135,65435,3.856,11.038,20377,2.236,22.075,4682,4916,22914
2015,4481,32109,92811,1346717,1359157,8279,8.932,8044,8.678,193756,83999,109757,6.180,14.256,221736,59528,162208,4.380,16.314,-27980,-2.059,28.511,3732,4949,26569
2015,4482,5116,24400,234140,229120,1300,5.328,1303,5.340,34373,9204,25169,4.017,15.002,24119,7339,16780,3.203,10.527,10254,4.475,21.054,487,514,1862
2015,4483,14958,21952,128561,129378,1274,5.760,1604,7.252,15402,4748,10654,3.670,11.905,17051,4890,12161,3.780,13.179,-1649,-1.275,23.809,1143,1161,3137
2015,4511,24690,35564,480863,469749,2965,8.368,2704,7.631,65755,22572,43183,4.805,13.998,42616,11170,31446,2.378,9.072,23139,4.926,18.144,2000,2064,7315
2015,4512,3409,7528,99792,100389,450,5.954,509,6.735,10279,1999,8280,1.991,10.239,11320,2693,8627,2.683,11.276,-1041,-1.037,20.478,312,323,1164
2015,4521,75,8019,1020178,1027677,91,1.138,40,0.500,30616,8240,22376,0.802,2.979,45518,2497,43021,0.243,4.429,-14902,-1.450,5.958,(D),(D),(D)
2015,4529,7194,43456,1877479,1841390,2992,6.998,1592,3.723,134264,75276,58988,4.088,7.291,60585,8528,52057,0.463,3.290,73679,4.001,6.580,846,875,2705
2015,4531,11885,12431,59975,60398,898,7.133,1214,9.643,8439,2565,5874,4.247,13.972,9303,3248,6055,5.378,15.403,-864,-1.431,27.945,975,977,2627
2015,4532,17117,26551,226857,231250,1796,6.619,2965,10.927,27520,7779,19741,3.364,11.901,35748,12525,23223,5.416,15.459,-8228,-3.558,23.801,1950,2044,6603
2015,4533,12761,18839,198928,196779,1673,8.905,1570,8.357,27630,10231,17399,5.199,14.041,23427,6077,17350,3.088,11.905,4203,2.136,23.810,1247,1261,3880
2015,4539,31335,41575,269105,262466,5664,13.973,3586,8.846,45053,22271,22782,8.485,17.165,31849,11095,20754,4.227,12.135,13204,5.031,24.269,2629,2693,8391
2015,4541,27119,28512,428853,411354,5093,18.352,3571,12.868,95074,45919,49155,11.163,23.112,59752,23641,36111,5.747,14.526,35322,8.587,29.051,2886,2897,12556
2015,4542,3033,3436,39332,39172,311,8.941,396,11.384,3882,1022,2860,2.609,9.910,3497,1738,1759,4.437,8.927,385,0.983,17.855,296,297,870
2015,4543,19986,24972,171751,171801,2242,8.907,2642,10.496,23487,8547,14940,4.975,13.671,23213,10201,13012,5.938,13.512,274,0.159,27.023,1843,1872,6279
2015,4811,431,2234,416625,404291,178,7.552,424,17.989,61272,4310,56962,1.066,15.155,36117,16552,19565,4.094,8.933,25155,6.222,17.867,37,71,269
2015,4812,1902,2093,36717,36356,229,10.991,210,10.079,4772,1067,3705,2.935,13.126,3995,1909,2086,5.251,10.989,777,2.137,21.977,157,162,651
2015,4831,664,1012,45371,45950,112,11.222,84,8.417,3797,910,2887,1.980,8.263,5033,668,4365,1.454,10.953,-1236,-2.690,16.527,47,49,381
2015,4832,426,493,22600,22349,59,11.980,58,11.777,1570,372,1198,1.665,7.025,1087,395,692,1.767,4.864,483,2.161,9.728,46,46,157
2015,4841,52670,62362,955176,937112,11220,18.598,7153,11.857,136662,46740,89922,4.988,14.583,99884,34096,65788,3.638,10.659,36778,3.925,21.317,5328,5370,21331
2015,4842,37872,41946,489241,482704,5139,12.359,4409,10.603,80810,26267,54543,5.442,16.741,67615,21624,45991,4.480,14.008,13195,2.734,28.015,3258,3270,13418
2015,4851,490,791,53858,52846,75,9.398,89,11.153,6428,2429,3999,4.596,12.164,4612,2137,2475,4.044,8.727,1816,3.436,17.455,54,54,646
2015,4852,262,465,12553,13222,20,4.255,30,6.383,949,98,851,0.741,7.177,2374,470,1904,3.555,17.955,-1425,-10.777,14.355,22,23,150
2015,4853,6851,7005,77187,76558,1142,16.426,1037,14.915,11714,3731,7983,4.873,15.301,10565,4752,5813,6.207,13.800,1149,1.501,27.600,843,853,3834
2015,4854,2499,4109,228068,224350,397,9.751,322,7.909,30761,13768,16993,6.137,13.711,23019,10571,12448,4.712,10.260,7742,3.451,20.521,170,171,2238
2015,4855,1105,1239,33759,33374,98,7.818,127,10.132,4706,1153,3553,3.455,14.101,3996,894,3102,2.679,11.974,710,2.127,23.947,106,108,762
2015,4859,3756,4243,88490,87051,711,17.228,479,11.606,14627,5037,9590,5.786,16.803,11923,5118,6805,5.879,13.697,2704,3.106,27.393,378,380,3476
2015,4861,66,758,13831,13052,82,11.036,52,6.999,2917,1215,1702,9.309,22.349,1337,288,1049,2.207,10.244,1580,12.105,20.487,5,5,20
2015,4862,114,2156,30027,32381,85,3.595,502,21.231,2589,825,1764,2.548,7.995,7454,6118,1336,18.894,23.020,-4865,-15.024,15.991,7,7,31
2015,4869,66,680,7894,7545,22,3.214,31,4.529,1250,509,741,6.747,16.568,522,109,413,1.445,6.919,728,9.649,13.838,(D),(D),(D)
2015,4871,524,572,11129,10753,89,15.822,70,12.444,1688,403,1285,3.748,15.699,956,323,633,3.004,8.891,732,6.808,17.782,53,53,270
2015,4872,1204,1249,13006,12916,171,13.824,147,11.884,1784,534,1250,4.135,13.813,1611,455,1156,3.523,12.473,173,1.339,24.947,105,106,353
2015,4879,150,174,2331,2295,19,10.556,31,17.222,288,66,222,2.876,12.552,208,115,93,5.012,9.065,80,3.487,18.130,18,18,74
2015,4881,3679,5382,174890,174985,385,7.079,499,9.174,25336,6205,19131,3.546,14.479,25925,10858,15067,6.205,14.816,-589,-0.337,28.958,283,286,2110
2015,4882,497,1391,39548,38054,110,7.925,104,7.493,5912,1673,4239,4.396,15.536,2936,1117,1819,2.935,7.715,2976,7.820,15.431,26,26,198
2015,4883,1788,2330,96840,98116,191,8.249,162,6.996,12689,1991,10698,2.029,12.933,14776,7673,7103,7.820,15.060,-2087,-2.127,25.865,107,109,403
2015,4884,8980,10131,92691,91250,1205,11.967,1081,10.736,15569,4870,10699,5.337,17.062,12906,5246,7660,5.749,14.144,2663,2.918,28.287,758,760,3308
2015,4885,13427,19254,249851,244045,2087,10.931,1763,9.234,38889,16966,21923,6.952,15.935,27405,13399,14006,5.490,11.230,11484,4.706,22.459,936,958,4528
2015,4889,1379,1505,17134,16739,236,16.137,151,10.325,2861,1168,1693,6.978,17.092,2045,729,1316,4.355,12.217,816,4.875,24.434,119,119,505
2015,4921,3953,9681,553056,528932,1682,18.253,750,8.139,67844,23009,44835,4.350,12.827,19414,5574,13840,1.054,3.670,48430,9.156,7.341,428,446,1872
2015,4922,3677,4034,38480,37318,468,11.504,536,13.176,7643,2615,5028,7.007,20.481,5365,2601,2764,6.970,14.377,2278,6.104,28.753,423,423,1845
2015,4931,7128,14572,795099,777147,1369,9.538,931,6.486,106194,37964,68230,4.885,13.665,69816,18994,50822,2.444,8.984,36378,4.681,17.967,338,355,3888
2015,5111,11565,16273,402608,413966,933,5.639,1479,8.939,35417,8013,27404,1.936,8.556,58989,17384,41605,4.199,14.250,-23572,-5.694,17.111,855,918,6454
2015,5112,5948,8764,479567,471205,1127,13.004,932,10.754,66465,15915,50550,3.378,14.105,49400,15586,33814,3.308,10.484,17065,3.622,20.968,484,486,5263
2015,5121,13674,16924,358579,349582,2317,13.756,2155,12.795,50472,16701,33771,4.777,14.438,33376,11020,22356,3.152,9.547,17096,4.890,19.095,1457,1475,6205
2015,5122,2758,2959,28397,28033,404,13.683,391,13.243,3668,2289,1379,8.166,13.085,2955,1237,1718,4.413,10.541,713,2.543,21.083,279,279,791
2015,5151,3980,7439,210944,212276,477,5.935,1673,20.816,28450,10716,17734,5.048,13.402,31685,13010,18675,6.129,14.926,-3235,-1.524,26.805,218,266,2915
2015,5152,382,699,51316,52065,49,6.921,67,9.463,4845,843,4002,1.619,9.306,6385,1069,5316,2.053,12.264,-1540,-2.958,18.612,27,28,236
2015,5171,3199,35148,740469,747788,3055,8.736,2703,7.729,83405,29052,54353,3.885,11.154,96665,23717,72948,3.172,12.927,-13260,-1.773,22.307,249,254,2652
2015,5172,952,11441,227611,229217,1104,9.831,682,6.073,24427,7048,17379,3.075,10.657,27223,4967,22256,2.167,11.877,-2796,-1.220,21.313,55,66,683
2015,5174,366,457,8710,8596,64,14.128,56,12.362,1196,244,952,2.839,13.913,942,290,652,3.374,10.959,254,2.955,21.917,40,40,218
2015,5179,3894,4847,62347,59795,1006,21.726,573,12.374,15447,8211,7236,13.732,25.833,10363,5026,5337,8.405,17.331,5084,8.502,34.662,443,443,2086
2015,5182,8549,12798,535086,523928,1541,12.087,1443,11.319,94305,18738,75567,3.576,18.000,71327,26358,44969,5.031,13.614,22978,4.386,27.228,810,938,15353
2015,5191,8444,10578,259985,253202,1637,15.688,1351,12.947,51786,13234,38552,5.227,20.452,36987,17485,19502,6.906,14.608,14799,5.845,29.215,938,947,4836
2015,5211,13,59,19189,18988,0,0.000,0,0.000,653,0,653,0.000,3.439,270,0,270,0.000,1.422,383,2.017,2.844,0,0,0
2015,5221,11842,118694,1908367,1935860,4467,3.751,5281,4.434,184232,44539,139693,2.301,9.517,235200,43155,192045,2.229,12.150,-50968,-2.633,19.034,338,494,4925
2015,5222,13635,41627,582903,570254,5372,13.092,4183,10.194,106870,29384,77486,5.153,18.741,82409,29299,53110,5.138,14.451,24461,4.289,28.903,1063,1283,6702
2015,5223,11475,26885,268748,266231,2370,8.792,2515,9.330,45400,12455,32945,4.678,17.053,40470,13155,27315,4.941,15.201,4930,1.852,30.402,1200,1299,5502
2015,5231,11092,40053,403385,401284,3237,7.946,4611,11.318,61860,16059,45801,4.002,15.416,57435,17976,39459,4.480,14.313,4425,1.103,28.626,777,784,2950
2015,5232,13,31,5997,6108,0,0.000,(D),(D),512,0,512,0.000,8.382,760,(D),666,(D),12.443,-248,-4.060,16.765,0,0,0
2015,5239,42712,48282,483614,480856,6405,13.388,5522,11.543,71323,24398,46925,5.074,14.833,65982,27071,38911,5.630,13.722,5341,1.111,27.444,3303,3327,11961
2015,5241,4912,31576,1485405,1463164,5247,16.696,4949,15.748,199283,65775,133508,4.495,13.620,154123,48953,105170,3.346,10.534,45160,3.086,21.067,305,311,2071
2015,5242,118359,133599,928382,915113,11417,8.584,10227,7.689,129028,49136,79892,5.369,14.100,103042,40357,62685,4.410,11.260,25986,2.840,22.520,7139,7248,23392
2015,5250,1258,1290,19930,15830,571,56.479,13,1.286,12993,11910,1083,75.237,82.078,4868,519,4349,3.279,30.752,8125,51.327,61.503,7,7,15
2015,5311,86646,112979,568641,563492,10718,9.525,9807,8.716,88989,39954,49035,7.090,15.792,78345,35015,43330,6.214,13.903,10644,1.889,27.807,6961,7204,22881
2015,5312,67145,78135,279459,275386,13244,17.446,8804,11.597,53450,26360,27090,9.572,19.409,45355,23359,21996,8.482,16.470,8095,2.940,32.939,5042,5098,10663
2015,5313,65067,81974,669348,662107,9871,12.228,7367,9.126,99490,40485,59005,6.115,15.026,85044,36063,48981,5.447,12.844,14446,2.182,25.689,4876,4924,20443
2015,5321,3515,15103,166411,156831,1514,10.236,889,6.011,30590,11347,19243,7.235,19.505,11955,4183,7772,2.667,7.623,18635,11.882,15.246,333,403,2196
2015,5322,7186,18321,142804,144005,1250,6.764,1571,8.500,15927,4753,11174,3.301,11.060,18545,7784,10761,5.405,12.878,-2618,-1.818,22.120,713,748,3158
2015,5323,2198,2628,18661,18338,169,6.427,172,6.541,2670,702,1968,3.828,14.560,2033,553,1480,3.016,11.087,637,3.474,22.173,126,132,423
2015,5324,7276,13588,181530,181035,1322,9.759,1240,9.153,31382,9607,21775,5.307,17.335,30523,10188,20335,5.628,16.860,859,0.474,33.721,523,532,3988
2015,5331,2026,2158,33902,33290,230,10.670,225,10.438,4273,977,3296,2.935,12.836,2996,930,2066,2.794,9.000,1277,3.836,18.000,174,174,615
2015,5411,157890,169288,1139166,1143291,12742,7.509,13524,7.970,111595,34805,76790,3.044,9.761,120044,35062,84982,3.067,10.500,-8449,-0.739,19.522,10087,10159,25870
2015,5412,99227,119269,1341635,1310132,10148,8.537,9364,7.877,220800,60525,160275,4.620,16.853,158262,49651,108611,3.790,12.080,62538,4.773,24.160,6550,6728,36332
2015,5413,80081,100031,1439292,1425506,11519,11.685,8624,8.748,242376,107610,134766,7.549,17.003,213737,52688,161049,3.696,14.994,28639,2.009,29.988,5097,5173,18231
2015,5414,25391,25709,112773,110173,3763,14.808,3168,12.467,20291,8342,11949,7.572,18.417,15106,7198,7908,6.533,13.711,5185,4.706,27.422,2273,2276,5318
2015,5415,97145,116959,1694228,1659040,20319,17.634,16858,14.630,349250,138320,210930,8.337,21.051,276915,105968,170947,6.387,16.691,72335,4.360,33.383,10577,10614,40364
2015,5416,120854,130766,1178612,1152719,22964,17.812,19285,14.958,249047,90857,158190,7.882,21.605,196326,81918,114408,7.107,17.032,52721,4.574,34.063,14198,14236,48641
2015,5417,12796,16390,665878,654903,1941,11.893,1801,11.036,85963,23355,62608,3.566,13.126,63568,20429,43139,3.119,9.706,22395,3.420,19.413,1089,1098,7932
2015,5418,29127,32702,460176,461588,3556,10.857,3656,11.163,65210,21054,44156,4.561,14.127,67955,22316,45639,4.835,14.722,-2745,-0.595,28.255,2742,2788,15246
2015,5419,53280,59527,606685,596471,6518,11.057,5361,9.094,93941,35726,58215,5.990,15.749,72925,30241,42684,5.070,12.226,21016,3.523,24.452,3590,3620,16913
2015,5511,26491,52607,3323833,3289475,4265,8.135,3908,7.454,488309,145530,342779,4.424,14.845,420383,92113,328270,2.800,12.780,67926,2.065,25.559,697,732,10977
2015,5611,24892,27188,430329,425040,3235,11.921,3133,11.545,77069,27697,49372,6.516,18.132,66347,26920,39427,6.334,15.610,10722,2.523,31.219,2272,2283,17170
2015,5612,1747,6192,252474,248697,1565,26.492,996,16.860,39919,18369,21550,7.386,16.051,32830,13840,18990,5.565,13.201,7089,2.850,26.402,111,119,1516
2015,5613,24090,47042,5577549,5415578,7629,16.667,5093,11.126,1029907,226049,803858,4.174,19.017,701565,184187,517378,3.401,12.955,328342,6.063,25.909,2183,2267,102813
2015,5614,23292,29873,782904,773703,2875,9.587,3105,10.354,114622,27363,87259,3.537,14.815,95572,28223,67349,3.648,12.353,19050,2.462,24.705,2275,2331,16922
2015,5615,12744,21629,230292,230573,2015,8.957,3749,16.665,45103,24087,21016,10.447,19.561,47277,28945,18332,12.554,20.504,-2174,-0.943,39.123,876,886,3779
2015,5616,17624,23483,909720,900668,2301,9.816,2220,9.470,118368,21372,96996,2.373,13.142,99170,32253,66917,3.581,11.011,19198,2.132,22.021,1416,1424,15190
2015,5617,143965,151033,1802562,1783060,20288,13.569,17250,11.537,278439,83927,194512,4.707,15.616,239258,83774,155484,4.698,13.418,39181,2.197,26.837,11966,12019,55862
2015,5619,15503,17301,269589,267245,1794,10.416,1638,9.511,44173,11934,32239,4.466,16.529,39409,18707,20702,7.000,14.746,4764,1.783,29.493,1137,1140,9068
2015,5621,7151,10494,200147,198246,626,5.954,666,6.334,20537,5016,15521,2.530,10.359,16144,4418,11726,2.229,8.143,4393,2.216,16.287,495,500,2875
2015,5622,1231,2505,50327,50257,141,5.645,127,5.084,4831,1199,3632,2.386,9.613,4768,1883,2885,3.747,9.487,63,0.125,18.975,63,64,630
2015,5629,8152,9621,131325,129628,885,9.289,698,7.326,23327,6164,17163,4.755,17.995,20117,4386,15731,3.384,15.519,3210,2.476,31.038,463,476,2981
2015,6111,19022,21858,1007078,982687,1219,5.733,28,0.132,83942,18240,65702,1.856,8.542,35846,160,35686,0.016,3.648,48096,4.894,7.296,20,20,43
2015,6112,462,1018,78772,80584,24,2.386,0,0.000,3383,582,2801,0.722,4.198,7019,0,7019,0.000,8.710,-3636,-4.512,8.396,0,0,0
2015,6113,2382,4573,1872036,1849767,329,7.458,6,0.136,97413,2569,94844,0.139,5.266,52654,7,52647,0.000,2.847,44759,2.420,5.693,4,4,4
2015,6114,6392,6827,58601,57832,757,11.041,816,11.901,10018,3369,6649,5.826,17.323,8458,3379,5079,5.843,14.625,1560,2.697,29.250,583,597,2662
2015,6115,5992,7697,110171,110379,675,8.794,633,8.246,14955,5704,9251,5.168,13.549,15486,3916,11570,3.548,14.030,-531,-0.481,27.098,427,451,2350
2015,6116,40101,43100,403370,395716,5675,13.415,4083,9.652,72167,26413,45754,6.675,18.237,57056,17279,39777,4.367,14.418,15111,3.819,28.837,3055,3186,13368
2015,6117,5910,6863,107546,107435,1115,16.744,707,10.617,21229,5698,15531,5.304,19.760,21295,3960,17335,3.686,19.821,-66,-0.061,39.520,548,548,2483
2015,6211,161076,207589,2442139,2383190,19501,9.467,16300,7.913,385678,171702,213976,7.205,16.183,264163,100950,163213,4.236,11.084,121515,5.099,22.169,11450,11816,57312
2015,6212,119247,128597,906000,900500,6251,4.864,6090,4.739,104275,30790,73485,3.419,11.580,93808,31436,62372,3.491,10.417,10467,1.162,20.835,5001,5056,24573
2015,6213,117026,134738,820595,813057,12437,9.318,9918,7.430,131823,45757,86066,5.628,16.213,118491,38095,80396,4.685,14.574,13332,1.640,29.147,6957,7034,22733
2015,6214,15806,38634,895952,869260,4103,10.942,1831,4.883,130154,60320,69834,6.939,14.973,77161,17591,59570,2.024,8.877,52993,6.096,17.753,927,995,7525
2015,6215,7025,16196,277487,265807,4573,31.604,1120,7.740,67289,42336,24953,15.927,25.315,42706,10927,31779,4.111,16.067,24583,9.248,32.133,598,640,5333
2015,6216,19780,28923,1376353,1340994,3578,12.568,2670,9.379,261584,85795,175789,6.398,19.507,190363,61487,128876,4.585,14.196,71221,5.311,28.391,1727,1773,25272
2015,6219,6148,9686,292723,290405,882,9.193,698,7.275,44878,15686,29192,5.401,15.454,40296,14822,25474,5.104,13.876,4582,1.578,27.752,443,462,5759
2015,6221,2567,5154,5092018,5108196,193,3.782,91,1.783,204113,43572,160541,0.853,3.996,238064,29605,208459,0.580,4.660,-33951,-0.665,7.992,48,49,6323
2015,6222,401,615,223812,226462,19,3.117,8,1.313,6239,1321,4918,0.583,2.755,11166,208,10958,0.092,4.931,-4927,-2.176,5.510,6,6,151
2015,6223,362,950,284226,284385,32,3.353,41,4.295,13184,1580,11604,0.556,4.636,13518,3536,9982,1.243,4.753,-334,-0.117,9.272,20,20,1625
2015,6231,8361,16198,1666844,1667158,1027,6.366,898,5.566,150613,69180,81433,4.150,9.034,151830,59724,92106,3.582,9.107,-1217,-0.073,18.068,490,515,36612
2015,6232,9546,39900,751627,747360,2769,7.002,2064,5.219,106857,28072,78785,3.756,14.298,97242,24219,73023,3.241,13.011,9615,1.287,26.023,379,465,4921
2015,6233,16210,23012,914993,896900,2023,8.892,1499,6.589,114868,35909,78959,4.004,12.807,77610,22863,54747,2.549,8.653,37258,4.154,17.306,1049,1069,15529
2015,6239,2986,4951,133302,132971,357,7.187,389,7.832,15527,3229,12298,2.428,11.677,14924,4886,10038,3.674,11.224,603,0.453,22.447,152,172,1593
2015,6241,55919,73048,1620491,1582981,9381,13.155,5909,8.286,226950,63195,163755,3.992,14.337,152764,41337,111427,2.611,9.650,74186,4.686,19.301,4074,4135,26094
2015,6242,10067,14190,188497,184249,624,4.416,506,3.581,22769,3322,19447,1.803,12.358,14588,2981,11607,1.618,7.918,8181,4.440,15.835,304,320,1862
2015,6243,3959,7513,327251,329511,412,5.483,413,5.497,38376,4919,33457,1.493,11.646,43557,7051,36506,2.140,13.219,-5181,-1.572,23.293,145,154,3202
2015,6244,54923,69989,891612,881050,6278,8.982,6094,8.719,115833,38402,77431,4.359,13.147,94595,36186,58409,4.107,10.737,21238,2.411,21.473,4400,4474,24991
2015,7111,7205,7359,123743,122983,874,12.026,691,9.508,17890,5168,12722,4.202,14.547,16503,4441,12062,3.611,13.419,1387,1.128,26.838,462,463,3185
2015,7112,3319,3494,128284,127124,451,13.008,397,11.451,16280,3283,12997,2.583,12.806,13882,2740,11142,2.155,10.920,2398,1.886,21.840,310,311,2324
2015,7113,6026,6399,161020,159782,814,12.901,635,10.064,22263,5952,16311,3.725,13.933,19777,5359,14418,3.354,12.378,2486,1.556,24.755,400,403,1975
2015,7114,2991,3119,20102,20042,432,14.019,357,11.585,3117,1241,1876,6.192,15.553,2987,1397,1590,6.971,14.904,130,0.649,29.808,266,267,1196
2015,7115,15097,15134,46696,45902,2847,19.123,2355,15.818,12487,6410,6077,13.965,27.204,10875,5105,5770,11.122,23.692,1612,3.512,47.384,1511,1511,3489
2015,7121,6612,7090,146070,144618,348,4.938,262,3.718,10774,1858,8916,1.285,7.450,7801,1049,6752,0.725,5.394,2973,2.056,10.788,165,165,784
2015,7131,2341,2667,197090,189694,333,12.479,336,12.591,23886,4538,19348,2.392,12.592,9338,4140,5198,2.182,4.923,14548,7.669,9.845,271,274,2054
2015,7132,1771,2810,158075,157008,253,9.091,199,7.151,12312,4615,7697,2.939,7.842,10086,3586,6500,2.284,6.424,2226,1.418,12.848,164,165,2941
2015,7139,50801,58713,1249152,1227958,6877,11.852,5503,9.484,169863,63029,106834,5.133,13.833,126823,46624,80199,3.797,10.328,43040,3.505,20.656,4089,4144,33502
2015,7211,40231,51259,1965387,1951181,4458,8.755,3774,7.412,214671,93974,120697,4.816,11.002,186883,75628,111255,3.876,9.578,27788,1.424,19.156,2589,2629,45964
2015,7212,5334,5922,43448,42719,464,7.870,411,6.971,6580,1650,4930,3.862,15.403,5225,1399,3826,3.275,12.231,1355,3.172,24.462,264,264,848
2015,7213,1732,1929,11550,11623,151,7.706,212,10.819,2114,1141,973,9.817,18.188,2257,1126,1131,9.688,19.418,-143,-1.230,36.376,153,153,823
2015,7223,14017,33740,707763,716155,4080,11.536,7337,20.744,149428,42065,107363,5.874,20.865,163374,97574,65800,13.625,22.813,-13946,-1.947,41.731,1539,1572,8884
2015,7224,36258,37192,357431,357185,3453,9.199,4146,11.045,61223,25986,35237,7.275,17.140,60830,25366,35464,7.102,17.030,393,0.110,34.061,3429,3440,21512
2015,7225,359301,496565,10104284,9901870,51037,10.381,41213,8.383,1605078,762035,843043,7.696,16.210,1205243,439022,766221,4.434,12.172,399835,4.038,24.344,31509,32695,327037
2015,8111,134097,147752,866917,857989,12194,8.274,11430,7.756,123320,44577,78743,5.196,14.373,104991,42703,62288,4.977,12.237,18329,2.136,24.474,8445,8554,29073
2015,8112,9622,10921,99079,98956,1232,11.275,1244,11.385,15748,6322,9426,6.389,15.914,15716,6473,9243,6.541,15.882,32,0.032,31.764,860,867,2824
2015,8113,18137,20024,209743,209583,1642,8.207,1608,8.037,29610,7566,22044,3.610,14.128,29506,8888,20618,4.241,14.078,104,0.050,28.157,1129,1133,5020
2015,8114,17355,18096,69837,68704,2161,12.046,1849,10.307,11663,4910,6753,7.147,16.976,9365,3997,5368,5.818,13.631,2298,3.345,27.262,1400,1401,3120
2015,8121,95533,112292,671053,664688,13697,12.320,11473,10.319,113826,53949,59877,8.116,17.125,101805,41760,60045,6.283,15.316,12021,1.809,30.632,8508,8721,29599
2015,8122,14163,20087,139401,139272,698,3.481,626,3.122,12696,3005,9691,2.158,9.116,12263,2097,10166,1.506,8.805,433,0.311,17.610,404,429,1502
2015,8123,27490,32737,294315,291169,2231,6.759,2773,8.401,37608,10522,27086,3.614,12.916,31556,13766,17790,4.728,10.838,6052,2.079,21.675,2023,2118,8519
2015,8129,27751,37834,294131,285525,6801,18.564,4403,12.019,63404,29859,33545,10.458,22.206,46618,25251,21367,8.844,16.327,16786,5.879,32.654,2412,2439,9848
2015,8131,177734,178077,1681048,1670773,7872,4.517,235,0.135,131589,22634,108955,1.355,7.876,111601,471,111130,0.028,6.680,19988,1.196,13.359,155,155,297
2015,8132,16456,18398,186100,183327,1295,7.075,1107,6.048,19852,4043,15809,2.205,10.829,14134,3788,10346,2.066,7.710,5718,3.119,15.419,784,807,2194
2015,8133,13946,16506,170992,165501,1193,7.271,996,6.070,26161,11160,15001,6.743,15.807,14853,3268,11585,1.975,8.975,11308,6.833,17.949,665,666,2239
2015,8134,22564,24502,239126,238919,1263,5.142,1381,5.623,24012,4981,19031,2.085,10.050,23535,5900,17635,2.469,9.851,477,0.200,19.701,934,940,3654
2015,8139,53573,55711,487444,485829,2235,4.028,1782,3.212,43602,8231,35371,1.694,8.975,40275,7367,32908,1.516,8.290,3327,0.685,16.580,1304,1309,4547
2016,2111,5113,6639,119357,126500,471,6.877,890,12.996,14381,8445,5936,6.676,11.368,28491,8572,19919,6.776,22.523,-14110,-11.154,22.737,614,614,2462
2016,2121,406,765,54469,62353,48,5.937,135,16.698,3962,2312,1650,3.708,6.354,19558,6688,12870,10.726,31.367,-15596,-25.012,12.708,57,74,3812
2016,2122,217,287,38030,39049,32,11.150,32,11.150,2556,401,2155,1.027,6.546,4500,557,3943,1.426,11.524,-1944,-4.978,13.091,20,20,317
2016,2123,2708,4871,80736,81127,269,5.526,263,5.403,8503,2289,6214,2.822,10.481,9124,1790,7334,2.206,11.247,-621,-0.765,20.962,150,151,730
2016,2131,9882,12517,290505,352940,1133,8.596,2460,18.664,24329,12839,11490,3.638,6.893,149152,24258,124894,6.873,42.260,-124823,-35.367,13.786,1634,1644,11641
2016,2211,1716,10629,508386,508469,666,6.347,393,3.746,31620,8317,23303,1.636,6.219,31614,7572,24042,1.489,6.217,6,0.001,12.435,88,93,967
2016,2212,414,2518,87174,87245,130,5.179,114,4.542,6039,2323,3716,2.663,6.922,6090,1629,4461,1.867,6.980,-51,-0.058,13.844,21,22,79
2016,2213,3495,4576,43238,43083,272,5.933,289,6.304,5498,2164,3334,5.023,12.761,5253,2166,3087,5.028,12.193,245,0.569,24.385,146,146,399
2016,2361,134063,135423,669864,648171,24426,18.475,17999,13.614,158302,66781,91521,10.303,24.423,114697,48647,66050,7.505,17.695,43605,6.727,35.391,12763,12767,35367
2016,2362,36320,37803,645892,630620,3680,9.790,3253,8.654,110568,21993,88575,3.488,17.533,80452,17632,62820,2.796,12.758,30116,4.776,25.515,2410,2412,11785
2016,2371,16238,17871,548210,547675,1521,8.532,1431,8.028,90880,18858,72022,3.443,16.594,89591,19430,70161,3.548,16.358,1289,0.235,32.717,1018,1021,10022
2016,2372,4240,4330,25514,25280,398,9.104,481,11.003,4086,1194,2892,4.723,16.163,3677,1822,1855,7.207,14.545,409,1.618,29.091,387,387,1485
2016,2373,7914,8744,273656,266695,600,6.863,597,6.829,43702,6531,37171,2.449,16.387,29543,4813,24730,1.805,11.077,14159,5.309,22.155,425,427,3279
2016,2379,3613,3738,88948,87870,373,10.030,335,9.008,13686,1972,11714,2.244,15.575,11647,3139,8508,3.572,13.255,2039,2.320,26.510,225,226,2061
2016,2381,74626,75519,809481,783619,10414,14.049,7630,10.293,169688,41835,127853,5.339,21.654,118010,33162,84848,4.232,15.060,51678,6.595,30.119,5325,5332,25150
2016,2382,157830,162424,1919762,1873165,15692,9.769,12092,7.528,307359,67828,239531,3.621,16.409,214117,58149,155968,3.104,11.431,93242,4.978,22.862,8946,8970,39540
2016,2383,94518,95631,753357,732582,13428,14.297,10011,10.659,150383,40842,109541,5.575,20.528,108611,33117,75494,4.521,14.826,41772,5.702,29.652,7092,7110,25372
2016,2389,55162,55933,572651,556804,7474,13.636,5229,9.540,113708,26646,87062,4.786,20.422,82036,21772,60264,3.910,14.733,31672,5.688,29.467,3646,3646,14863
2016,3111,1102,1724,52812,53664,100,5.851,70,4.096,5743,1164,4579,2.169,10.702,7092,1021,6071,1.903,13.216,-1349,-2.514,21.404,50,50,414
2016,3112,478,822,55511,55698,35,4.266,32,3.900,2957,331,2626,0.594,5.309,3268,983,2285,1.765,5.867,-311,-0.558,10.618,21,22,139
2016,3113,1646,1814,79433,77532,150,8.294,139,7.686,9256,2307,6949,2.976,11.938,5443,1142,4301,1.473,7.020,3813,4.918,14.041,110,111,636
2016,3114,1403,1758,156046,155635,155,8.895,124,7.116,14548,1899,12649,1.220,9.348,13809,4609,9200,2.961,8.873,739,0.475,17.745,92,92,1670
2016,3115,1073,1575,144449,142764,110,7.033,88,5.627,10452,1531,8921,1.072,7.321,6892,1079,5813,0.756,4.828,3560,2.494,9.655,67,67,385
2016,3116,2770,3383,494647,489495,172,5.085,171,5.055,28786,2618,26168,0.535,5.881,18918,2836,16082,0.579,3.865,9868,2.016,7.730,128,128,1150
2016,3117,428,515,30547,30556,41,8.000,36,7.024,3505,408,3097,1.335,11.471,3552,461,3091,1.509,11.625,-47,-0.154,22.942,24,24,122
2016,3118,9650,10413,290413,287868,999,9.659,859,8.305,33513,10088,23425,3.504,11.642,27842,7942,19900,2.759,9.672,5671,1.970,19.344,723,725,5397
2016,3119,2959,3418,195386,193406,352,10.434,263,7.796,21138,4720,16418,2.440,10.929,17027,4719,12308,2.440,8.804,4111,2.126,17.608,212,212,2047
2016,3121,6581,7229,182977,175324,1213,17.791,391,5.735,25570,7529,18041,4.294,14.584,10261,2394,7867,1.365,5.853,15309,8.732,11.705,312,312,1415
2016,3122,115,141,13381,13755,20,14.286,18,12.857,517,244,273,1.774,3.759,1220,119,1101,0.865,8.870,-703,-5.111,7.517,16,16,57
2016,3131,245,305,24986,25005,22,7.201,23,7.529,1548,92,1456,0.368,6.191,1490,313,1177,1.252,5.959,58,0.232,11.918,18,18,94
2016,3132,751,837,47925,47756,36,4.233,63,7.407,3573,557,3016,1.166,7.482,3215,968,2247,2.027,6.732,358,0.750,13.464,52,52,758
2016,3133,816,861,28299,28102,40,4.582,64,7.331,2350,249,2101,0.886,8.363,1903,383,1520,1.363,6.772,447,1.591,13.544,52,52,289
2016,3141,1556,1668,53371,53643,95,5.610,146,8.621,3774,489,3285,0.912,7.035,4271,1911,2360,3.562,7.962,-497,-0.926,14.071,110,110,705
2016,3149,3829,3931,58541,58922,323,8.221,319,8.119,5639,1430,4209,2.427,9.570,6404,2268,4136,3.849,10.869,-765,-1.298,19.141,258,258,1312
2016,3151,215,224,11958,12250,18,7.947,23,10.155,609,114,495,0.931,4.971,1222,215,1007,1.755,9.976,-613,-5.004,9.943,19,19,164
2016,3152,4618,4664,76749,79422,633,13.324,807,16.986,13464,5095,8369,6.415,16.953,18867,6664,12203,8.391,23.756,-5403,-6.803,33.905,704,704,5814
2016,3159,502,508,8170,7946,49,9.478,67,12.959,1188,186,1002,2.341,14.952,742,324,418,4.078,9.339,446,5.613,18.677,56,56,228
2016,3161,167,176,3484,3571,15,8.547,14,7.977,323,90,233,2.520,9.045,489,219,270,6.133,13.694,-166,-4.649,18.090,9,9,20
2016,3162,186,204,11388,11523,23,11.220,25,12.195,327,97,230,0.842,2.838,584,94,490,0.816,5.068,-257,-2.230,5.676,21,21,87
2016,3169,713,718,10880,10842,73,10.238,63,8.836,1165,290,875,2.675,10.746,1080,255,825,2.352,9.962,85,0.784,19.923,53,53,220
2016,3211,2605,3046,85116,85229,198,6.517,182,5.991,7215,1764,5451,2.070,8.465,7455,1492,5963,1.751,8.747,-240,-0.282,16.931,141,141,977
2016,3212,1042,1372,75339,73493,77,5.641,63,4.615,8071,1833,6238,2.494,10.982,4423,1111,3312,1.512,6.018,3648,4.964,12.037,45,45,571
2016,3219,7836,8836,232049,228232,761,8.678,628,7.161,26706,6435,20271,2.819,11.701,18896,6046,12850,2.649,8.279,7810,3.422,16.559,507,507,4655
2016,3221,226,444,103049,104203,16,3.600,17,3.825,3597,291,3306,0.279,3.452,5665,1404,4261,1.347,5.437,-2068,-1.985,6.904,12,12,105
2016,3222,2331,3593,245736,245166,107,2.950,175,4.825,16528,3079,13449,1.256,6.742,15344,4713,10631,1.922,6.259,1184,0.483,12.517,112,114,2091
2016,3231,22811,24208,445861,446232,1549,6.362,1832,7.524,44099,13605,30494,3.049,9.883,44827,17811,27016,3.991,10.046,-728,-0.163,19.765,1506,1513,10062
2016,3241,916,2091,103232,102736,141,6.774,122,5.861,8436,2230,6206,2.171,8.211,7658,2985,4673,2.906,7.454,778,0.757,14.908,45,45,674
2016,3251,1245,2456,156386,157662,191,7.942,89,3.701,13191,4180,9011,2.651,8.367,15637,2927,12710,1.857,9.918,-2446,-1.551,16.733,62,64,2246
2016,3252,1049,1376,95972,96117,59,4.280,64,4.643,7120,1398,5722,1.454,7.408,7367,1209,6158,1.258,7.665,-247,-0.257,14.815,41,42,412
2016,3253,665,921,29766,29413,72,7.934,45,4.959,2642,415,2227,1.411,8.982,1907,582,1325,1.979,6.484,735,2.499,12.967,30,30,296
2016,3254,1721,2202,241696,240391,195,8.955,146,6.705,21451,4874,16577,2.028,8.923,19271,5823,13448,2.422,8.017,2180,0.907,16.033,84,84,1469
2016,3255,1282,1639,60231,59864,72,4.372,88,5.343,5377,1661,3716,2.775,8.982,4720,1363,3357,2.277,7.885,657,1.097,15.769,61,61,611
2016,3256,1890,2089,96533,96738,148,7.109,134,6.436,7198,1442,5756,1.491,7.441,7608,2183,5425,2.257,7.865,-410,-0.424,14.881,96,96,678
2016,3259,1712,2200,80055,80120,142,6.463,136,6.190,7039,1280,5759,1.598,8.786,7103,1498,5605,1.870,8.865,-64,-0.080,17.571,103,104,762
2016,3261,7757,10066,617369,611603,351,3.470,451,4.458,53130,7025,46105,1.149,8.687,41307,9286,32021,1.518,6.754,11823,1.933,13.508,324,330,5072
2016,3262,1379,1783,131751,131112,64,3.569,84,4.685,7921,776,7145,0.592,6.041,6615,1400,5215,1.068,5.045,1306,0.996,10.091,58,59,933
2016,3271,864,1042,33383,33497,71,6.811,72,6.906,2783,704,2079,2.102,8.308,2992,593,2399,1.770,8.932,-209,-0.624,16.616,64,65,470
2016,3272,1343,1597,90687,88372,97,6.044,113,7.040,9231,1177,8054,1.332,10.446,4444,1759,2685,1.990,5.029,4787,5.417,10.058,77,77,533
2016,3273,3932,8458,169787,165593,501,5.987,322,3.848,24057,5829,18228,3.520,14.528,15746,3782,11964,2.284,9.509,8311,5.019,19.018,156,164,1581
2016,3274,170,304,13540,13513,15,4.959,12,3.967,684,82,602,0.607,5.062,628,40,588,0.296,4.647,56,0.414,9.295,8,8,36
2016,3279,2631,3077,76010,75841,208,6.810,163,5.336,7566,1323,6243,1.744,9.976,7227,1550,5677,2.044,9.529,339,0.447,19.058,113,113,949
2016,3311,326,494,92597,97425,29,5.876,28,5.674,2119,213,1906,0.219,2.175,11360,543,10817,0.557,11.660,-9241,-9.485,4.350,21,21,87
2016,3312,518,647,46665,48463,40,6.159,45,6.928,3339,1093,2246,2.255,6.890,7024,1357,5667,2.800,14.494,-3685,-7.604,13.780,36,36,850
2016,3313,393,524,57922,58181,21,4.019,18,3.445,4375,352,4023,0.605,7.520,4805,234,4571,0.402,8.259,-430,-0.739,15.039,15,15,134
2016,3314,741,927,59667,60061,26,2.778,44,4.701,3113,568,2545,0.946,5.183,3824,1121,2703,1.866,6.367,-711,-1.184,10.366,31,32,303
2016,3315,1488,1686,119038,122393,49,2.882,78,4.587,5856,894,4962,0.730,4.785,12480,1823,10657,1.489,10.197,-6624,-5.412,9.569,54,57,790
2016,3321,2130,2385,109698,112096,72,3.004,96,4.005,6342,685,5657,0.611,5.658,11128,1795,9333,1.601,9.927,-4786,-4.270,11.315,69,69,931
2016,3322,1033,1107,35075,35287,69,6.180,88,7.882,2916,734,2182,2.080,8.264,3354,1218,2136,3.452,9.505,-438,-1.241,16.527,69,69,414
2016,3323,11299,12262,348308,345702,814,6.690,625,5.137,36061,7595,28466,2.197,10.431,30867,7477,23390,2.163,8.929,5194,1.502,17.858,482,485,4980
2016,3324,1184,1498,84903,89153,51,3.376,76,5.031,4449,822,3627,0.922,4.990,12856,1962,10894,2.201,14.420,-8407,-9.430,9.981,54,54,990
2016,3325,503,546,27645,27438,32,5.877,29,5.326,1918,318,1600,1.159,6.990,1493,366,1127,1.334,5.441,425,1.549,10.883,22,22,219
2016,3326,1007,1150,38377,38777,35,3.030,45,3.896,2412,417,1995,1.075,6.220,3196,635,2561,1.638,8.242,-784,-2.022,12.441,38,39,571
2016,3327,21170,21742,371119,380506,1039,4.741,1381,6.302,30236,9318,20918,2.449,7.946,48910,9927,38983,2.609,12.854,-18674,-4.908,15.893,1078,1087,6939
2016,3328,4967,5523,127191,128333,275,4.960,317,5.718,11573,2963,8610,2.309,9.018,13846,3529,10317,2.750,10.789,-2273,-1.771,18.036,247,247,2275
2016,3329,5595,6129,261554,265769,353,5.743,388,6.313,18063,3177,14886,1.195,6.797,26859,4906,21953,1.846,10.106,-8796,-3.310,13.593,285,288,1762
2016,3331,2492,2909,188550,203181,115,3.890,209,7.070,7965,1556,6409,0.766,3.920,37335,4506,32829,2.218,18.375,-29370,-14.455,7.840,150,151,1943
2016,3332,2884,3054,105111,105514,143,4.650,185,6.016,8120,1504,6616,1.425,7.696,9008,2198,6810,2.083,8.537,-888,-0.842,15.391,145,145,1028
2016,3333,1756,1879,73086,74078,112,5.932,130,6.886,5156,1192,3964,1.609,6.960,7019,1798,5221,2.427,9.475,-1863,-2.515,13.921,92,92,882
2016,3334,1417,1683,126561,127683,76,4.496,91,5.383,8549,1522,7027,1.192,6.695,10781,4463,6318,3.495,8.444,-2232,-1.748,13.391,64,64,963
2016,3335,6169,6421,147714,148254,309,4.813,308,4.797,11488,3183,8305,2.147,7.749,12462,2778,9684,1.874,8.406,-974,-0.657,15.498,242,242,1744
2016,3336,809,1018,94645,97941,35,3.413,50,4.876,4909,301,4608,0.307,5.012,11711,3168,8543,3.235,11.957,-6802,-6.945,10.024,32,32,876
2016,3339,5128,5816,294216,297262,264,4.527,295,5.059,20259,4686,15573,1.576,6.815,26334,5080,21254,1.709,8.859,-6075,-2.044,13.630,206,206,2240
2016,3341,915,953,43145,43326,67,6.976,82,8.537,4578,806,3772,1.860,10.567,4994,1200,3794,2.770,11.527,-416,-0.960,21.133,61,62,882
2016,3342,1154,1271,86435,87677,92,7.241,91,7.163,6752,1269,5483,1.447,7.701,9387,2271,7116,2.590,10.706,-2635,-3.005,15.402,67,68,1130
2016,3343,443,455,9811,9781,50,11.173,35,7.821,839,156,683,1.595,8.578,769,225,544,2.300,7.862,70,0.716,15.724,28,28,164
2016,3344,3340,3770,262791,264824,170,4.485,211,5.567,18069,2331,15738,0.880,6.823,22046,5942,16104,2.244,8.325,-3977,-1.502,13.646,154,155,2533
2016,3345,4245,4902,376586,376470,250,5.059,330,6.677,26233,3434,22799,0.912,6.968,25616,6208,19408,1.649,6.804,617,0.164,13.609,234,236,1991
2016,3346,419,429,9585,9555,43,9.919,52,11.995,1037,345,692,3.611,10.853,1016,579,437,6.060,10.633,21,0.220,21.266,43,43,468
2016,3351,988,1049,43428,43168,79,7.531,79,7.531,3719,761,2958,1.763,8.615,3177,869,2308,2.013,7.360,542,1.256,14.719,56,56,555
2016,3352,234,280,48744,48216,20,7.092,24,8.511,3622,278,3344,0.577,7.512,2596,451,2145,0.935,5.384,1026,2.128,10.768,22,22,439
2016,3353,1737,2007,116298,118179,76,3.747,119,5.866,5710,1148,4562,0.971,4.832,9608,1996,7612,1.689,8.130,-3898,-3.298,9.663,83,83,581
2016,3359,1764,2038,135589,135577,100,4.884,119,5.812,10374,1532,8842,1.130,7.652,10342,2068,8274,1.525,7.628,32,0.024,15.256,91,91,873
2016,3361,267,321,198212,191698,22,6.843,23,7.154,19552,284,19268,0.148,10.199,6513,363,6150,0.189,3.398,13039,6.802,6.795,15,15,169
2016,3362,1547,1835,144860,141740,111,6.034,120,6.524,14895,1811,13084,1.278,10.509,8865,2154,6711,1.520,6.254,6030,4.254,12.509,88,88,900
2016,3363,3817,4766,559302,551122,186,3.874,256,5.332,48924,4869,44055,0.883,8.877,32600,7261,25339,1.317,5.915,16324,2.962,11.830,173,183,3514
2016,3364,1307,1750,366765,365371,101,5.791,89,5.103,23683,3606,20077,0.987,6.482,20792,5955,14837,1.630,5.691,2891,0.791,11.381,59,59,579
2016,3365,147,226,29099,30472,4,1.743,11,4.793,1568,44,1524,0.144,5.146,4281,662,3619,2.173,14.049,-2713,-8.903,10.292,4,4,43
2016,3366,1271,1400,139831,141287,102,7.275,106,7.561,10574,2028,8546,1.435,7.484,13698,2440,11258,1.727,9.695,-3124,-2.211,14.968,75,76,1550
2016,3369,803,836,32081,31595,98,11.879,76,9.212,4093,967,3126,3.061,12.955,3033,1160,1873,3.672,9.600,1060,3.355,19.200,65,65,382
2016,3371,9869,10131,225020,221248,701,6.902,752,7.404,24778,5358,19420,2.422,11.199,17240,5807,11433,2.625,7.792,7538,3.407,15.584,576,580,4100
2016,3372,3337,3503,113503,111943,229,6.525,242,6.896,11253,1927,9326,1.721,10.052,8219,3066,5153,2.739,7.342,3034,2.710,14.684,194,195,1893
2016,3379,606,703,31543,31486,31,4.345,52,7.288,2251,341,1910,1.083,7.149,2162,502,1660,1.594,6.867,89,0.283,13.733,42,42,358
2016,3391,8950,9891,280148,278579,565,5.637,828,8.261,27474,4795,22679,1.721,9.862,24190,7489,16701,2.688,8.683,3284,1.179,17.367,653,656,4004
2016,3399,14166,14570,259233,259600,1254,8.653,1097,7.570,24604,6699,17905,2.581,9.478,25283,8143,17140,3.137,9.739,-679,-0.262,18.955,884,884,5736
2016,4231,15089,22812,397589,393789,1471,6.437,1554,6.800,40458,11098,29360,2.818,10.274,32557,10256,22301,2.604,8.268,7901,2.006,16.535,1067,1085,6033
2016,4232,9536,11400,152701,151446,833,7.295,871,7.628,17184,4374,12810,2.888,11.347,14723,5241,9482,3.461,9.722,2461,1.625,19.443,660,667,3584
2016,4233,9484,16467,232410,223947,1369,8.416,969,5.957,36967,13237,23730,5.911,16.507,20303,7239,13064,3.232,9.066,16664,7.441,18.132,579,601,4044
2016,4234,21117,32710,652270,651760,3130,9.631,2708,8.333,79402,24011,55391,3.684,12.183,77640,29592,48048,4.540,11.912,1762,0.270,23.825,1506,1535,8764
2016,4235,6755,9422,150367,153293,356,3.725,625,6.540,11314,2310,9004,1.507,7.381,17212,4192,13020,2.735,11.228,-5898,-3.848,14.761,413,426,2637
2016,4236,17671,28462,547087,547440,2569,9.134,1897,6.745,67486,15441,52045,2.821,12.328,68260,23936,44324,4.372,12.469,-774,-0.141,24.655,1211,1251,7688
2016,4237,9747,18403,237556,235681,763,4.125,953,5.152,24431,5492,18939,2.330,10.366,20743,9232,11511,3.917,8.801,3688,1.565,17.603,501,511,3207
2016,4238,37572,55663,760578,764110,2834,5.080,3084,5.528,69545,19888,49657,2.603,9.101,76951,20837,56114,2.727,10.071,-7406,-0.969,18.203,1951,2094,11259
2016,4239,27089,30442,320995,327654,2706,8.808,3266,10.631,35015,11228,23787,3.427,10.687,48292,16179,32113,4.938,14.739,-13277,-4.052,21.373,2529,2584,12064
2016,4241,6924,9194,148714,148607,485,5.173,847,9.035,19297,8505,10792,5.723,12.985,19631,10113,9518,6.805,13.210,-334,-0.225,25.971,481,602,5387
2016,4242,6177,9559,311306,311529,840,8.802,809,8.477,33349,8370,24979,2.687,10.705,33529,9649,23880,3.097,10.763,-180,-0.058,21.410,533,537,4070
2016,4243,13168,14312,198684,199102,1323,9.165,1571,10.883,23631,6287,17344,3.158,11.869,24410,9054,15356,4.547,12.260,-779,-0.391,23.738,1276,1288,6350
2016,4244,24742,32919,817159,814359,2636,8.029,2463,7.502,76645,17994,58651,2.210,9.412,70449,25699,44750,3.156,8.651,6196,0.761,17.302,1874,1899,12413
2016,4245,3162,6054,64270,64192,278,4.582,304,5.011,6450,1585,4865,2.469,10.048,6381,1521,4860,2.369,9.941,69,0.107,19.881,171,178,914
2016,4246,7611,12138,158147,157454,726,6.004,634,5.243,15887,4562,11325,2.897,10.090,14496,3325,11171,2.112,9.206,1391,0.883,18.413,438,456,2270
2016,4247,3966,6446,99481,101114,368,5.691,409,6.325,12534,4509,8025,4.459,12.396,15845,3848,11997,3.806,15.671,-3311,-3.275,24.792,207,260,1906
2016,4248,3212,4232,201250,199890,362,8.621,296,7.049,19365,5450,13915,2.727,9.688,16610,4071,12539,2.037,8.310,2755,1.378,16.619,235,236,2270
2016,4249,20116,26451,350295,347026,2024,7.600,2387,8.963,39150,10619,28531,3.060,11.282,32998,10764,22234,3.102,9.509,6152,1.773,19.018,1563,1580,6460
2016,4251,36363,38802,304081,300780,4480,11.582,4236,10.951,45269,12375,32894,4.114,15.051,38661,14548,24113,4.837,12.854,6608,2.197,25.707,3351,3387,10635
2016,4411,37646,43839,1297356,1272922,3697,8.475,3263,7.480,137091,43270,93821,3.399,10.770,88341,30086,58255,2.364,6.940,48750,3.830,13.880,2582,2634,23602
2016,4412,11206,12893,144748,141719,880,6.830,863,6.698,18351,5447,12904,3.844,12.949,12349,4680,7669,3.302,8.714,6002,4.235,17.427,651,663,3618
2016,4413,26342,56040,529534,527262,2695,4.818,2484,4.441,44944,13715,31229,2.601,8.524,40414,11216,29198,2.127,7.665,4530,0.859,15.330,1723,1774,7075
2016,4421,12902,22394,210243,206464,1398,6.235,1451,6.472,26117,7606,18511,3.684,12.650,18396,5805,12591,2.812,8.910,7721,3.740,17.820,987,1079,4175
2016,4422,17613,25742,248890,247834,1754,6.792,1921,7.438,28193,11797,16396,4.760,11.376,25691,9649,16042,3.893,10.366,2502,1.010,20.732,1214,1237,3817
2016,4431,20345,38991,378316,385077,2253,5.633,4265,10.663,35168,9652,25516,2.507,9.133,48765,20788,27977,5.398,12.664,-13597,-3.531,18.265,2501,2854,13827
2016,4441,33941,56350,1174023,1150011,2400,4.257,2466,4.374,98198,16843,81355,1.465,8.539,50646,12463,38183,1.084,4.404,47552,4.135,8.808,1774,1842,8405
2016,4442,12458,16615,154406,151506,1015,6.130,902,5.447,19328,4658,14670,3.074,12.757,13543,3359,10184,2.217,8.939,5785,3.818,17.878,704,717,2428
2016,4451,60262,86832,2835020,2819139,7890,9.119,7278,8.411,264289,102218,162071,3.626,9.375,232093,79437,152656,2.818,8.233,32196,1.142,16.466,5086,5144,24647
2016,4452,16772,20998,177598,172149,2589,12.408,2325,11.143,36985,17034,19951,9.895,21.484,26007,10303,15704,5.985,15.107,10978,6.377,30.215,1555,1597,7603
2016,4453,27718,31738,167250,164761,2507,7.953,2080,6.598,24032,8923,15109,5.416,14.586,18983,6463,12520,3.923,11.522,5049,3.064,23.043,1655,1675,5198
2016,4461,39955,93202,1050838,1044635,10228,11.252,5629,6.192,169238,64559,104679,6.180,16.201,156381,46081,110300,4.411,14.970,12857,1.231,29.940,3137,3317,16855
2016,4471,61698,107358,947527,937852,6766,6.302,6772,6.308,124355,44605,79750,4.756,13.260,105135,35354,69781,3.770,11.210,19220,2.049,22.420,4235,4540,21587
2016,4481,32221,91816,1369234,1358097,6815,7.382,7816,8.467,180376,59532,120844,4.383,13.282,161075,47784,113291,3.518,11.860,19301,1.421,23.721,3468,4953,21748
2016,4482,4959,24276,238763,236456,1060,4.354,1197,4.917,30687,7940,22747,3.358,12.978,25710,7600,18110,3.214,10.873,4977,2.105,21.746,437,493,2414
2016,4483,14573,21550,126998,128412,1242,5.713,1619,7.448,12554,4934,7620,3.842,9.776,15343,6553,8790,5.103,11.948,-2789,-2.172,19.553,1095,1116,2790
2016,4511,24750,35876,477810,478683,2910,8.135,2698,7.543,51264,19722,31542,4.120,10.709,54246,12071,42175,2.522,11.332,-2982,-0.623,21.419,2089,2135,7658
2016,4512,3332,7224,91323,94009,442,6.050,606,8.295,8347,2309,6038,2.456,8.879,13825,4119,9706,4.382,14.706,-5478,-5.827,17.758,302,304,957
2016,4521,101,8006,974609,998895,73,0.911,88,1.098,40601,4258,36343,0.426,4.065,91895,6146,85749,0.615,9.200,-51294,-5.135,8.129,(D),(D),(D)
2016,4529,7120,44321,1948492,1912519,2259,5.150,1348,3.073,140587,34972,105615,1.829,7.351,67380,10091,57289,0.528,3.523,73207,3.828,7.046,871,1056,5450
2016,4531,11672,12219,59664,59617,948,7.695,1149,9.327,8544,2759,5785,4.628,14.331,8507,3053,5454,5.121,14.269,37,0.062,28.539,947,955,2586
2016,4532,16764,26460,223269,225202,2416,9.086,2678,10.071,32076,13105,18971,5.819,14.243,36011,17504,18507,7.773,15.991,-3935,-1.747,28.486,1704,1806,6047
2016,4533,12758,18967,208552,204237,1644,8.683,1576,8.324,30401,9343,21058,4.575,14.885,21299,6984,14315,3.420,10.429,9102,4.457,20.857,1241,1246,4341
2016,4539,32957,43807,287289,277762,5696,13.328,3557,8.323,49659,21312,28347,7.673,17.878,30760,11508,19252,4.143,11.074,18899,6.804,22.148,2861,2925,9090
2016,4541,28747,30258,451979,438655,5591,19.066,3723,12.696,92480,50504,41976,11.513,21.083,65026,28943,36083,6.598,14.824,27454,6.259,29.648,2937,2949,13166
2016,4542,2968,3374,39534,39430,304,8.929,365,10.721,3791,1076,2715,2.729,9.615,3586,1409,2177,3.573,9.095,205,0.520,18.189,309,315,1089
2016,4543,19942,24955,168503,167550,2414,9.700,2279,9.157,22993,9018,13975,5.382,13.723,20850,7853,12997,4.687,12.444,2143,1.279,24.888,1760,1779,5734
2016,4811,421,2193,428225,422539,145,6.561,179,8.100,60291,2437,57854,0.577,14.269,49339,35872,13467,8.490,11.677,10952,2.592,23.354,39,121,34545
2016,4812,1856,2068,37786,37299,205,9.872,222,10.691,4989,1159,3830,3.107,13.376,4079,1356,2723,3.635,10.936,910,2.440,21.872,178,180,578
2016,4831,648,1011,42456,43719,116,11.629,89,8.922,3956,1311,2645,2.999,9.049,6523,2066,4457,4.726,14.920,-2567,-5.872,18.098,60,61,336
2016,4832,422,493,22566,22669,49,9.909,52,10.516,1763,424,1339,1.870,7.777,1998,232,1766,1.023,8.814,-235,-1.037,15.554,41,41,185
2016,4841,54429,64649,971670,959043,11138,17.601,8402,13.277,120152,47961,72191,5.001,12.528,95668,33575,62093,3.501,9.975,24484,2.553,19.951,6390,6426,21883
2016,4842,38432,42711,481036,486259,5355,12.604,4908,11.552,71106,23061,48045,4.743,14.623,81470,27846,53624,5.727,16.754,-10364,-2.131,29.246,3639,3655,17407
2016,4851,500,798,54614,54283,68,8.564,60,7.557,4340,1126,3214,2.074,7.995,3724,1007,2717,1.855,6.860,616,1.135,13.721,36,36,365
2016,4852,244,450,13314,12957,22,4.819,35,7.667,2017,237,1780,1.829,15.567,1237,233,1004,1.798,9.547,780,6.020,19.095,24,25,210
2016,4853,6764,6928,77251,77104,1065,15.336,1098,15.811,13268,4251,9017,5.513,17.208,13352,4860,8492,6.303,17.317,-84,-0.109,34.416,908,911,3519
2016,4854,2471,4190,241517,235241,350,8.432,272,6.553,29286,7438,21848,3.162,12.449,16488,5005,11483,2.128,7.009,12798,5.440,14.018,167,167,2306
2016,4855,1074,1209,33952,33920,103,8.371,146,11.865,4338,919,3419,2.709,12.789,4325,1476,2849,4.351,12.751,13,0.038,25.501,109,110,779
2016,4859,4076,4587,95390,92203,829,18.739,503,11.370,17110,5911,11199,6.411,18.557,10585,4551,6034,4.936,11.480,6525,7.077,22.960,392,395,3432
2016,4861,76,768,14293,14019,58,7.607,47,6.164,2278,810,1468,5.778,16.250,1725,348,1377,2.482,12.305,553,3.945,24.610,6,6,50
2016,4862,108,2196,31077,30657,90,4.124,63,2.887,2412,933,1479,3.043,7.868,1610,436,1174,1.422,5.252,802,2.616,10.503,9,9,27
2016,4869,74,679,8767,8381,24,3.532,25,3.679,1673,573,1100,6.837,19.962,895,393,502,4.689,10.679,778,9.283,21.358,(D),(D),(D)
2016,4871,565,615,11885,11521,99,16.555,65,10.870,2272,595,1677,5.165,19.721,1500,591,909,5.130,13.020,772,6.701,26.041,44,44,545
2016,4872,1255,1298,14579,13823,179,13.984,143,11.172,2730,549,2181,3.972,19.750,1163,586,577,4.239,8.414,1567,11.337,16.828,102,102,491
2016,4879,166,191,2689,2510,31,17.080,12,6.612,654,140,514,5.579,26.061,281,54,227,2.152,11.197,373,14.864,22.395,8,8,48
2016,4881,3752,5494,181079,177390,425,7.784,357,6.538,23894,5604,18290,3.159,13.470,16237,5427,10810,3.059,9.153,7657,4.316,18.307,209,212,1373
2016,4882,507,1369,41938,40769,97,7.019,123,8.900,6348,944,5404,2.316,15.571,4099,1582,2517,3.880,10.054,2249,5.517,20.109,27,29,202
2016,4883,1789,2353,92886,94988,192,8.193,173,7.382,7850,739,7111,0.778,8.264,12228,2537,9691,2.671,12.873,-4378,-4.609,16.528,127,128,731
2016,4884,9245,10322,95314,93935,1282,12.548,1072,10.492,15788,5423,10365,5.773,16.807,13129,5528,7601,5.885,13.977,2659,2.831,27.954,792,799,3351
2016,4885,13599,19555,259600,254838,1589,8.164,1408,7.234,35338,11324,24014,4.444,13.867,25609,9421,16188,3.697,10.049,9729,3.818,20.098,908,951,5615
2016,4889,1460,1600,17101,16978,270,17.380,177,11.394,2888,1333,1555,7.852,17.011,2663,1025,1638,6.037,15.685,225,1.325,31.371,141,148,792
2016,4921,3751,9634,565737,560244,1035,10.703,1107,11.448,48853,20901,27952,3.731,8.720,36579,13656,22923,2.438,6.529,12274,2.191,13.058,566,568,2647
2016,4922,3569,4018,46595,42782,562,13.865,633,15.616,14332,4388,9944,10.257,33.500,6538,3186,3352,7.447,15.282,7794,18.218,30.564,551,554,2688
2016,4931,7229,15107,837976,819179,1481,9.977,955,6.434,107958,33875,74083,4.135,13.179,72278,22970,49308,2.804,8.823,35680,4.356,17.646,379,408,4167
2016,5111,11328,16130,367474,377544,1313,8.135,1333,8.259,32000,12082,19918,3.200,8.476,52110,13498,38612,3.575,13.802,-20110,-5.327,16.952,830,895,5929
2016,5112,6488,9418,512230,498063,1345,14.595,940,10.200,81618,36687,44931,7.366,16.387,53196,14757,38439,2.963,10.681,28422,5.707,21.361,547,634,6041
2016,5121,13992,17281,385604,386938,2456,14.348,2129,12.438,62868,18025,44843,4.658,16.248,64066,22251,41815,5.751,16.557,-1198,-0.310,32.495,1437,1453,6491
2016,5122,2771,2961,22801,25310,367,12.399,365,12.331,2612,929,1683,3.670,10.320,7406,2089,5317,8.254,29.261,-4794,-18.941,20.640,273,273,725
2016,5151,3942,7394,212983,211158,463,6.267,451,6.104,24271,8277,15994,3.920,11.494,20343,7908,12435,3.745,9.634,3928,1.860,19.268,217,223,1761
2016,5152,398,700,49785,50492,51,7.286,51,7.286,3038,988,2050,1.957,6.017,4461,997,3464,1.975,8.835,-1423,-2.818,12.034,20,20,45
2016,5171,3176,37131,758616,749168,4238,11.743,2158,5.979,98708,49881,48827,6.658,13.176,81082,30000,51082,4.004,10.823,17626,2.353,21.646,229,235,1703
2016,5172,1121,13948,234896,231540,2832,22.221,425,3.335,23758,11638,12120,5.026,10.261,17000,3532,13468,1.525,7.342,6758,2.919,14.684,63,72,381
2016,5174,354,442,8742,8738,66,14.949,65,14.723,1323,406,917,4.647,15.142,1307,472,835,5.402,14.959,16,0.183,29.917,49,49,156
2016,5179,4512,5501,67203,64808,1328,25.531,729,14.015,16636,7277,9359,11.229,25.670,11667,5749,5918,8.871,18.002,4969,7.667,36.005,503,521,2745
2016,5182,8664,12942,472369,470629,1422,11.033,1315,10.203,62278,16084,46194,3.418,13.233,58664,26521,32143,5.635,12.465,3614,0.768,24.930,856,870,9722
2016,5191,8570,10899,284604,278376,1539,14.259,1327,12.295,46104,12404,33700,4.456,16.562,33903,11393,22510,4.093,12.179,12201,4.383,24.358,1003,1016,6182
2016,5211,15,61,19369,19280,(D),(D),0,0.000,717,(D),716,(D),3.719,514,0,514,0.000,2.666,203,1.053,5.332,0,0,0
2016,5221,11342,118299,1961376,1933899,3921,3.309,4298,3.627,230407,42092,188315,2.177,11.914,180965,35908,145057,1.857,9.358,49442,2.557,18.715,387,572,6509
2016,5222,13610,43514,608151,595181,5022,11.799,3119,7.328,106785,28331,78454,4.760,17.942,80367,32601,47766,5.477,13.503,26418,4.439,27.006,1093,1247,8477
2016,5223,11456,26526,281300,274677,2058,7.701,2455,9.186,42706,9327,33380,3.395,15.548,29872,11772,18100,4.286,10.875,12834,4.672,21.751,1124,1250,7100
2016,5231,10785,42128,407167,405441,5268,12.834,3104,7.562,48880,17148,31732,4.229,12.056,45068,11404,33664,2.813,11.116,3812,0.940,22.232,830,850,3149
2016,5232,11,33,6247,6167,(D),(D),(D),(D),288,(D),279,(D),4.670,139,(D),98,(D),2.254,149,2.416,4.508,0,0,0
2016,5239,43899,49774,488395,484325,6418,13.066,5112,10.407,65107,25608,39499,5.287,13.443,57097,21771,35326,4.495,11.789,8010,1.654,23.578,3623,3652,10815
2016,5241,5178,35985,1537142,1511994,8010,23.675,3705,10.951,203096,71889,131207,4.755,13.432,150318,37931,112387,2.509,9.942,52778,3.491,19.883,304,315,2323
2016,5242,118481,134332,956030,940257,11384,8.506,10382,7.758,149832,66200,83632,7.041,15.935,119384,47986,71398,5.104,12.697,30448,3.238,25.394,7279,7418,25551
2016,5250,1639,1753,25704,18084,638,44.076,27,1.865,16926,15469,1457,85.540,93.597,1380,87,1293,0.481,7.631,15546,85.965,15.262,6,6,16
2016,5311,86592,114115,565172,566772,11094,9.774,9879,8.703,83969,36647,47322,6.466,14.815,87164,39102,48062,6.899,15.379,-3195,-0.564,29.631,7219,7330,24840
2016,5312,72207,84303,299709,289633,15001,18.455,8966,11.030,63582,34543,29039,11.926,21.953,43555,18570,24985,6.412,15.038,20027,6.915,30.076,5401,5467,10994
2016,5313,66525,85026,689101,674145,11425,13.702,8137,9.759,118617,53818,64799,7.983,17.595,89386,36660,52726,5.438,13.259,29231,4.336,26.518,5086,5144,21682
2016,5321,3521,15524,169449,167769,1532,9.993,1144,7.462,22173,11162,11011,6.653,13.216,19298,4128,15170,2.461,11.503,2875,1.714,23.006,343,362,1690
2016,5322,7125,18104,145243,144250,1030,5.658,1230,6.757,17920,5778,12142,4.006,12.423,15986,6684,9302,4.634,11.082,1934,1.341,22.164,722,771,3529
2016,5323,2164,2592,19237,18952,143,5.487,171,6.562,2775,614,2161,3.240,14.642,2172,708,1464,3.736,11.461,603,3.182,22.921,133,134,526
2016,5324,7253,13901,178714,179349,1324,9.639,993,7.229,27418,10161,17257,5.666,15.288,28595,6692,21903,3.731,15.944,-1177,-0.656,30.575,590,619,3378
2016,5331,2007,2164,35500,34644,215,9.912,225,10.373,5684,1191,4493,3.438,16.407,4085,1233,2852,3.559,11.792,1599,4.616,23.583,183,183,1052
2016,5411,157314,169115,1137288,1138249,13102,7.744,13243,7.828,111531,34740,76791,3.052,9.798,113478,36417,77061,3.199,9.970,-1947,-0.171,19.597,10195,10289,27433
2016,5412,99570,119432,1249984,1242316,9922,8.313,9765,8.182,165403,50885,114518,4.096,13.314,149900,58566,91334,4.714,12.066,15503,1.248,24.132,6819,7009,35726
2016,5413,80775,100358,1438886,1439011,9040,9.019,8784,8.764,179120,48077,131043,3.341,12.447,180594,56387,124207,3.918,12.550,-1474,-0.102,24.895,5303,5355,23366
2016,5414,26219,26617,119457,116718,3878,14.788,3092,11.791,21166,8908,12258,7.632,18.134,15635,6785,8850,5.813,13.396,5531,4.739,26.791,2344,2348,5343
2016,5415,99828,121747,1832920,1786561,20269,16.956,15846,13.256,327799,106147,221652,5.941,18.348,234484,76094,158390,4.259,13.125,93315,5.223,26.250,11047,11139,45229
2016,5416,122009,132736,1222982,1192967,23357,17.763,20876,15.876,240155,98319,141836,8.242,20.131,180018,77766,102252,6.519,15.090,60137,5.041,30.180,15734,15785,53474
2016,5417,13229,16709,674104,668333,2203,13.300,1912,11.543,78800,24315,54485,3.638,11.791,67765,18566,49199,2.778,10.139,11035,1.651,20.279,1114,1130,7448
2016,5418,29075,33194,468696,463667,3936,11.932,3524,10.683,82855,34232,48623,7.383,17.870,72551,21205,51346,4.573,15.647,10304,2.222,31.294,2675,2703,12935
2016,5419,54259,61172,634662,621464,6912,11.470,5088,8.443,95703,33264,62439,5.353,15.400,69403,24459,44944,3.936,11.168,26300,4.232,22.335,3876,3918,18429
2016,5511,26691,53789,3352436,3340554,4807,9.048,3484,6.558,444589,116848,327741,3.498,13.309,422732,93200,329532,2.790,12.655,21857,0.654,25.309,704,737,13627
2016,5611,25118,27902,447785,437247,3500,12.692,2851,10.338,81121,25194,55927,5.762,18.553,60084,21455,38629,4.907,13.741,21037,4.811,27.483,2245,2273,16993
2016,5612,1748,6409,263164,258131,966,15.367,720,11.454,86026,64155,21871,24.854,33.327,75665,59390,16275,23.008,29.313,10361,4.014,58.625,115,118,2174
2016,5613,24243,48240,5717167,5705333,5346,11.211,4236,8.883,1058815,249216,809599,4.368,18.558,1034551,318548,716003,5.583,18.133,24264,0.425,36.266,2228,2271,114385
2016,5614,22826,29870,794696,790106,2922,9.774,2972,9.941,118708,39753,78955,5.031,15.024,109928,32566,77362,4.122,13.913,8780,1.111,27.826,2264,2297,17084
2016,5615,12712,22030,218147,224009,3018,13.836,2583,11.842,32018,11454,20564,5.113,14.293,42871,16828,26043,7.512,19.138,-10853,-4.845,28.586,970,984,4321
2016,5616,17800,23702,934371,922233,2304,9.759,2120,8.979,116109,27875,88234,3.023,12.590,92121,31326,60795,3.397,9.989,23988,2.601,19.978,1486,1518,19774
2016,5617,150858,158527,1885050,1850913,23472,15.146,16352,10.552,302246,99500,202746,5.376,16.330,231674,71698,159976,3.874,12.517,70572,3.813,25.033,12131,12150,51637
2016,5619,15552,17581,285424,277224,1828,10.485,1536,8.810,50821,15571,35250,5.617,18.332,34361,9391,24970,3.388,12.395,16460,5.937,24.789,1163,1169,6133
2016,5621,7180,11056,203860,201791,1136,10.519,622,5.760,25550,9374,16176,4.645,12.662,21708,4387,17321,2.174,10.758,3842,1.904,21.515,501,511,3502
2016,5622,1243,2549,52826,51682,166,6.561,128,5.059,6447,1570,4877,3.038,12.474,4257,1128,3129,2.183,8.237,2190,4.237,16.474,88,88,544
2016,5629,8391,9873,131396,132150,907,9.257,758,7.736,20255,5409,14846,4.093,15.327,21736,6745,14991,5.104,16.448,-1481,-1.121,30.655,524,549,4338
2016,6111,18815,21542,1023490,999954,940,4.457,40,0.190,86800,17074,69726,1.707,8.680,39665,187,39478,0.019,3.967,47135,4.714,7.933,32,32,105
2016,6112,448,992,73755,74843,29,2.965,(D),(D),4128,439,3689,0.587,5.516,6407,(D),6406,(D),8.561,-2279,-3.045,11.031,(D),(D),(D)
2016,6113,2367,4368,1865744,1864362,144,3.350,5,0.116,79555,3404,76151,0.183,4.267,76074,10,76064,0.001,4.080,3481,0.187,8.161,4,4,9
2016,6114,6384,6841,58884,58380,738,10.775,754,11.009,9855,2565,7290,4.394,16.881,8751,3445,5306,5.901,14.990,1104,1.891,29.979,547,550,2352
2016,6115,6097,7728,110123,110456,685,8.853,704,9.099,16047,3751,12296,3.396,14.528,16601,6786,9815,6.144,15.030,-554,-0.502,29.056,416,484,5356
2016,6116,41468,44764,423774,412626,5889,13.422,4110,9.368,82269,32175,50094,7.798,19.938,59995,19488,40507,4.723,14.540,22274,5.398,29.080,3184,3217,14038
2016,6117,6434,7360,106077,105713,1294,18.140,841,11.789,20280,6322,13958,5.980,19.184,19494,10382,9112,9.821,18.441,786,0.744,36.881,580,585,3887
2016,6211,157931,208709,2549252,2491216,17571,8.446,16241,7.807,377461,143466,233995,5.759,15.152,259034,93784,165250,3.765,10.398,118427,4.754,20.796,11770,12150,60501
2016,6212,119169,129081,922728,914349,6701,5.201,6203,4.815,108973,36081,72892,3.946,11.918,92322,29058,63264,3.178,10.097,16651,1.821,20.194,5191,5264,24729
2016,6213,119204,138211,844101,826186,13192,9.664,9773,7.160,138918,47995,90923,5.809,16.814,103294,42892,60402,5.192,12.503,35624,4.312,25.005,7101,7267,25659
2016,6214,16250,40284,951574,930863,3317,8.386,1858,4.697,122574,45351,77223,4.872,13.168,80716,23740,56976,2.550,8.671,41858,4.497,17.342,973,1052,10495
2016,6215,7008,16437,282745,280236,1512,9.266,1272,7.796,36627,9993,26634,3.566,13.070,31538,10099,21439,3.604,11.254,5089,1.816,22.508,627,640,5649
2016,6216,20656,30216,1426881,1398810,3600,12.147,2440,8.233,209086,47415,161671,3.390,14.947,152601,42056,110545,3.007,10.909,56485,4.038,21.819,1683,1720,26716
2016,6219,6199,10304,295226,293419,1319,13.184,720,7.197,43303,16641,26662,5.671,14.758,38877,9075,29802,3.093,13.250,4426,1.508,26.499,498,526,6499
2016,6221,2496,5162,5187993,5140905,117,2.271,98,1.902,227412,18549,208863,0.361,4.424,134159,20917,113242,0.407,2.610,93253,1.814,5.219,39,39,6757
2016,6222,410,643,235275,231035,33,5.197,17,2.677,17723,2855,14868,1.236,7.671,9527,1745,7782,0.755,4.124,8196,3.548,8.247,9,9,756
2016,6223,365,964,290685,287556,25,2.601,19,1.977,14646,1780,12866,0.619,5.093,8305,2193,6112,0.763,2.888,6341,2.205,5.776,13,13,1337
2016,6231,8331,16308,1662374,1664886,957,5.899,786,4.845,138633,61138,77495,3.672,8.327,142493,57463,85030,3.451,8.559,-3860,-0.232,16.654,526,537,37824
2016,6232,9778,41537,760679,757395,2881,7.072,1284,3.152,92017,27248,64769,3.598,12.149,85267,16596,68671,2.191,11.258,6750,0.891,22.516,378,426,5170
2016,6233,16599,23728,948822,934013,2092,8.926,1509,6.439,104926,34132,70794,3.654,11.234,76018,23741,52277,2.542,8.139,28908,3.095,16.278,1140,1182,17766
2016,6239,2986,4962,131864,131354,421,8.568,324,6.594,14551,3500,11051,2.665,11.078,13527,3099,10428,2.359,10.298,1024,0.780,20.596,171,183,1309
2016,6241,58716,76636,1676323,1652611,10000,13.367,6345,8.482,231492,63109,168383,3.819,14.008,185941,42125,143816,2.549,11.251,45551,2.756,22.503,4548,4610,29913
2016,6242,10292,14525,201321,196055,850,5.909,569,3.956,30618,5617,25001,2.865,15.617,20020,3819,16201,1.948,10.211,10598,5.406,20.423,281,322,1609
2016,6243,3968,7616,320824,323579,448,5.926,336,4.444,34762,8120,26642,2.509,10.743,40162,5801,34361,1.793,12.412,-5400,-1.669,21.486,159,164,2512
2016,6244,55582,71080,929081,911931,6620,9.384,5556,7.875,125328,41199,84129,4.518,13.743,90779,34100,56679,3.739,9.955,34549,3.789,19.909,4191,4301,26238
2016,7111,7394,7554,127512,125315,917,12.284,739,9.900,20637,5800,14837,4.628,16.468,16128,4490,11638,3.583,12.870,4509,3.598,25.740,522,522,2912
2016,7112,3425,3607,136192,132228,499,14.019,404,11.350,20135,4415,15720,3.339,15.228,12193,2323,9870,1.757,9.221,7942,6.006,18.442,324,325,1935
2016,7113,6236,6683,169848,165794,858,13.077,614,9.358,23409,6426,16983,3.876,14.119,15009,3354,11655,2.023,9.053,8400,5.067,18.106,469,469,2523
2016,7114,3063,3241,20506,20245,522,16.501,367,11.601,3393,1337,2056,6.604,16.760,2854,1237,1617,6.110,14.097,539,2.662,28.195,268,270,825
2016,7115,15762,15806,46686,46691,3104,20.086,2399,15.524,11377,6482,4895,13.883,24.367,11457,5459,5998,11.692,24.538,-80,-0.171,48.733,1602,1602,3860
2016,7121,6697,7183,151363,148716,376,5.272,274,3.842,12902,1388,11514,0.933,8.676,7591,1069,6522,0.719,5.104,5311,3.571,10.209,198,198,825
2016,7131,2489,2826,201120,199275,464,16.839,323,11.722,16462,5667,10795,2.844,8.261,12614,3954,8660,1.984,6.330,3848,1.931,12.660,270,274,2996
2016,7132,1763,2827,152980,153007,223,7.911,207,7.343,9192,2751,6441,1.798,6.008,9182,2028,7154,1.325,6.001,10,0.007,12.002,145,158,1517
2016,7139,52500,60771,1304764,1276593,7462,12.484,5467,9.146,190250,65795,124455,5.154,14.903,132625,48693,83932,3.814,10.389,57625,4.514,20.778,4316,4354,36627
2016,7211,41018,52081,1992073,1984777,4683,9.051,3999,7.729,208999,92908,116091,4.681,10.530,193890,84877,109013,4.276,9.769,15109,0.761,19.538,2557,2600,40803
2016,7212,5385,5985,44935,44388,485,8.132,443,7.428,6800,1602,5198,3.609,15.320,5649,1524,4125,3.433,12.727,1151,2.593,25.453,316,317,1170
2016,7213,1731,1924,11575,11487,129,6.696,134,6.956,1885,541,1344,4.710,16.410,1708,460,1248,4.005,14.869,177,1.541,29.738,99,99,297
2016,7223,14764,37491,778843,743403,7407,20.862,3434,9.672,203750,116302,87448,15.645,27.408,134195,36662,97533,4.932,18.051,69555,9.356,36.103,1665,1680,8910
2016,7224,36286,37205,364592,361506,3726,9.995,3875,10.394,63923,29353,34570,8.120,17.682,57852,25069,32783,6.935,16.003,6071,1.679,32.006,3292,3318,21926
2016,7225,368676,510379,10499208,10302949,52202,10.368,38384,7.624,1573567,748745,824822,7.267,15.273,1181958,411645,770313,3.995,11.472,391609,3.801,22.944,29759,30763,309647
2016,8111,135226,149295,892935,880430,12602,8.480,11236,7.561,128972,45961,83011,5.220,14.649,103766,40171,63595,4.563,11.786,25206,2.863,23.572,8619,8742,30506
2016,8112,9827,11187,103164,101021,1316,11.839,1174,10.561,18064,5399,12665,5.344,17.882,13734,4145,9589,4.103,13.595,4330,4.286,27.191,918,926,3119
2016,8113,18192,19990,197570,198214,1718,8.621,1593,7.994,27086,9209,17877,4.646,13.665,28087,7581,20506,3.825,14.170,-1001,-0.505,27.330,1215,1226,4271
2016,8114,17640,18444,71451,70436,2263,12.403,1865,10.222,11947,5145,6802,7.305,16.961,9926,4401,5525,6.248,14.092,2021,2.869,28.184,1467,1471,3495
2016,8121,98815,115740,701424,686588,14896,13.062,11502,10.086,128115,60705,67410,8.842,18.660,98829,41163,57666,5.995,14.394,29286,4.265,28.788,9073,9212,33177
2016,8122,14150,20104,139826,139645,689,3.428,679,3.378,11251,2377,8874,1.702,8.057,10892,2507,8385,1.795,7.800,359,0.257,15.600,429,445,1435
2016,8123,27168,32432,293598,294635,2287,7.016,2619,8.034,31058,9346,21712,3.172,10.541,33401,13623,19778,4.624,11.336,-2343,-0.795,21.082,2057,2151,9053
2016,8129,29446,39362,307524,300135,5949,15.441,4280,11.109,56669,23476,33193,7.822,18.881,41519,17188,24331,5.727,13.833,15150,5.048,27.667,2614,2655,9832
2016,8131,178381,178928,1688354,1672519,8334,4.765,298,0.170,141104,23480,117624,1.404,8.437,110381,541,109840,0.032,6.600,30723,1.837,13.199,202,202,368
2016,8132,17025,19055,195388,190678,1540,8.184,1064,5.654,27598,12266,15332,6.433,14.474,18256,8429,9827,4.421,9.574,9342,4.899,19.149,797,804,2149
2016,8133,14349,17022,175570,172905,1403,8.336,1019,6.055,22450,5442,17008,3.147,12.984,17056,4761,12295,2.754,9.864,5394,3.120,19.729,676,682,2404
2016,8134,22864,24875,244902,243283,1541,6.229,1267,5.122,27074,6212,20862,2.553,11.129,23949,5401,18548,2.220,9.844,3125,1.285,19.688,898,901,3520
2016,8139,53502,55661,492456,487905,2548,4.609,1795,3.247,48300,9090,39210,1.863,9.899,39349,7324,32025,1.501,8.065,8951,1.835,16.130,1408,1410,4906
2017,2111,4666,5930,112184,115058,388,6.260,925,14.923,17201,6803,10398,5.913,14.950,23041,11732,11309,10.197,20.026,-5840,-5.076,29.900,548,566,2797
2017,2121,378,713,49944,51724,58,7.859,108,14.634,7869,3691,4178,7.136,15.213,11477,3421,8056,6.614,22.189,-3608,-6.975,30.427,52,54,596
2017,2122,195,261,36836,37431,26,9.541,49,17.982,3614,1029,2585,2.749,9.655,4809,2137,2672,5.709,12.848,-1195,-3.193,19.310,32,32,151
2017,2123,2673,4854,89404,86730,273,5.607,303,6.223,14702,1975,12727,2.277,16.951,9637,2663,6974,3.070,11.111,5065,5.840,22.223,149,151,934
2017,2131,9460,12052,293361,292360,1525,12.384,2049,16.640,59684,19547,40137,6.686,20.415,58258,24597,33661,8.413,19.927,1426,0.488,39.854,1249,1301,11595
2017,2211,1762,10830,507355,507882,700,6.520,512,4.769,36706,13599,23107,2.678,7.227,37927,5560,32367,1.095,7.468,-1221,-0.240,14.455,84,88,900
2017,2212,398,2471,87661,87093,163,6.559,191,7.686,8205,3176,5029,3.647,9.421,6954,3117,3837,3.579,7.985,1251,1.436,15.969,22,22,139
2017,2213,3490,4598,43643,43426,240,5.229,223,4.859,4842,1631,3211,3.756,11.150,4451,1015,3436,2.337,10.250,391,0.900,20.499,136,136,420
2017,2361,140228,141644,723401,705783,24736,17.818,19104,13.761,161309,69315,91994,9.821,22.855,126603,53774,72829,7.619,17.938,34706,4.917,35.876,14174,14181,39744
2017,2362,35492,36932,654664,643577,3363,9.080,3571,9.642,104866,20254,84612,3.147,16.294,82578,20688,61890,3.215,12.831,22288,3.463,25.662,2672,2674,13935
2017,2371,16057,17643,542446,543401,1357,7.648,1557,8.775,81375,13429,67946,2.471,14.975,82669,21046,61623,3.873,15.213,-1294,-0.238,29.950,1051,1057,8920
2017,2372,4058,4147,24627,24057,391,9.388,427,10.252,4228,1462,2766,6.077,17.575,3157,1285,1872,5.341,13.123,1071,4.452,26.246,343,343,1050
2017,2373,7769,8609,282578,278075,507,5.859,597,6.899,40204,4388,35816,1.578,14.458,31069,4797,26272,1.725,11.173,9135,3.285,22.346,417,421,3165
2017,2379,3626,3746,87448,88157,397,10.649,361,9.683,12049,3005,9044,3.409,13.668,13695,3199,10496,3.629,15.535,-1646,-1.867,27.335,272,275,1152
2017,2381,75620,76540,828551,818539,9473,12.457,8479,11.150,157200,40866,116334,4.993,19.205,137124,35708,101416,4.362,16.752,20076,2.453,33.505,6154,6162,26363
2017,2382,160918,165547,1976442,1946746,15709,9.580,12577,7.670,296844,59618,237226,3.062,15.248,237589,60356,177233,3.100,12.204,59255,3.044,24.409,9544,9560,43263
2017,2383,96845,97992,782937,767011,13168,13.616,10605,10.966,152481,42176,110305,5.499,19.880,120810,36862,83948,4.806,15.751,31671,4.129,31.502,7859,7870,27737
2017,2389,55985,56766,589796,578520,6886,12.257,5711,10.166,98418,24641,73777,4.259,17.012,75681,22122,53559,3.824,13.082,22737,3.930,26.164,4191,4192,16884
2017,3111,1111,1736,53565,53215,95,5.493,82,4.741,5259,1339,3920,2.516,9.883,4626,1183,3443,2.223,8.693,633,1.190,17.386,56,56,683
2017,3112,528,873,56627,56417,53,6.141,33,3.824,4411,536,3875,0.950,7.819,4062,466,3596,0.826,7.200,349,0.619,14.400,20,20,258
2017,3113,1644,1819,81077,80985,148,8.179,129,7.129,7006,1019,5987,1.258,8.651,6950,1742,5208,2.151,8.582,56,0.069,17.164,103,105,982
2017,3114,1429,1788,158190,157023,148,8.331,125,7.036,16121,2413,13708,1.537,10.267,13925,2703,11222,1.721,8.868,2196,1.399,17.736,91,92,1213
2017,3115,1067,1583,146213,144707,120,7.621,103,6.542,13467,2260,11207,1.562,9.306,10525,3012,7513,2.081,7.273,2942,2.033,14.547,79,79,1686
2017,3116,2748,3380,511106,504061,184,5.441,187,5.530,39535,7142,32393,1.417,7.843,25554,5181,20373,1.028,5.070,13981,2.774,10.139,142,142,2095
2017,3117,403,493,31166,30533,33,6.633,42,8.442,3419,634,2785,2.076,11.198,2221,658,1563,2.155,7.274,1198,3.924,14.548,31,32,561
2017,3118,9821,10609,292805,290778,1029,9.760,898,8.517,34542,9143,25399,3.144,11.879,30588,9696,20892,3.335,10.519,3954,1.360,21.039,733,744,6100
2017,3119,3065,3545,209102,203621,392,11.266,261,7.501,25950,4635,21315,2.276,12.744,15059,5312,9747,2.609,7.396,10891,5.349,14.791,191,196,3147
2017,3121,7392,8090,207390,196029,1296,16.895,458,5.971,35511,10717,24794,5.467,18.115,12610,3487,9123,1.779,6.433,22901,11.682,12.865,339,339,2069
2017,3122,116,139,13617,13506,18,12.903,19,13.620,1361,161,1200,1.192,10.077,1111,149,962,1.103,8.226,250,1.851,16.453,13,13,69
2017,3131,222,279,22851,23571,19,6.667,31,10.877,1594,364,1230,1.544,6.763,3182,1191,1991,5.053,13.500,-1588,-6.737,13.525,21,24,560
2017,3132,734,817,45829,46600,55,6.716,59,7.204,3903,860,3043,1.846,8.376,5412,1154,4258,2.476,11.614,-1509,-3.238,16.751,46,48,535
2017,3133,739,783,27474,27986,47,5.908,72,9.051,2169,673,1496,2.405,7.750,3213,1224,1989,4.374,11.481,-1044,-3.730,15.501,53,53,800
2017,3141,1518,1624,51635,51871,104,6.355,129,7.883,5867,1776,4091,3.424,11.311,6497,2412,4085,4.650,12.525,-630,-1.215,22.622,101,102,542
2017,3149,3750,3845,57647,57282,303,7.830,352,9.097,6287,1355,4932,2.365,10.976,5595,1650,3945,2.880,9.767,692,1.208,19.535,271,271,948
2017,3151,205,214,11427,11593,13,6.032,16,7.425,991,380,611,3.278,8.548,1321,425,896,3.666,11.395,-330,-2.847,17.097,15,15,280
2017,3152,4298,4346,73216,75853,581,13.021,813,18.221,10668,4740,5928,6.249,14.064,15940,5866,10074,7.733,21.014,-5272,-6.950,28.128,720,722,5135
2017,3159,509,516,8175,8477,60,11.639,59,11.445,964,371,593,4.377,11.372,1517,242,1275,2.855,17.895,-553,-6.524,22.744,53,53,219
2017,3161,157,167,3613,3520,12,7.059,18,10.588,455,25,430,0.710,12.928,266,87,179,2.472,7.558,189,5.370,15.116,14,14,70
2017,3162,198,216,12463,12097,25,11.710,20,9.368,1326,56,1270,0.463,10.962,629,159,470,1.314,5.200,697,5.762,10.400,17,17,50
2017,3169,741,746,11830,11796,63,8.417,68,9.085,1406,450,956,3.815,11.919,1309,299,1010,2.535,11.097,97,0.822,22.194,58,58,188
2017,3211,2595,3061,88450,87802,191,6.209,221,7.185,9054,2138,6916,2.435,10.312,7687,2770,4917,3.155,8.755,1367,1.557,17.510,163,165,1630
2017,3212,1038,1401,80080,77936,91,6.528,77,5.524,11249,3098,8151,3.975,14.434,6827,2075,4752,2.662,8.760,4422,5.674,17.520,52,52,1137
2017,3219,7978,9054,238326,233031,807,8.996,641,7.145,30726,7834,22892,3.362,13.185,19947,6938,13009,2.977,8.560,10779,4.626,17.120,505,509,4695
2017,3221,216,433,100141,102257,11,2.532,14,3.222,3900,834,3066,0.816,3.814,8272,1293,6979,1.264,8.089,-4372,-4.276,7.628,6,6,62
2017,3222,2255,3511,244154,244259,117,3.300,185,5.219,19798,4033,15765,1.651,8.105,20059,5654,14405,2.315,8.212,-261,-0.107,16.211,118,121,1833
2017,3231,22533,23998,444067,448118,1402,5.792,1821,7.522,40173,12359,27814,2.758,8.965,48477,14749,33728,3.291,10.818,-8304,-1.853,17.930,1483,1493,9157
2017,3241,921,2096,104528,104144,97,4.604,119,5.648,6937,824,6113,0.791,6.661,6249,1822,4427,1.750,6.000,688,0.661,12.001,38,38,556
2017,3251,1193,2372,157222,156034,103,4.285,166,6.907,17437,4103,13334,2.630,11.175,14706,5854,8852,3.752,9.425,2731,1.750,18.850,64,65,1112
2017,3252,1069,1407,100794,100287,56,3.963,68,4.812,9500,1491,8009,1.487,9.473,8450,2590,5860,2.583,8.426,1050,1.047,16.852,42,43,1352
2017,3253,682,929,30800,30476,64,6.900,61,6.577,2948,568,2380,1.864,9.673,2280,531,1749,1.742,7.481,668,2.192,14.963,31,32,288
2017,3254,1789,2281,250658,247043,213,9.462,153,6.797,28211,4660,23551,1.886,11.419,20781,6082,14699,2.462,8.412,7430,3.008,16.824,102,102,1840
2017,3255,1268,1637,61896,61515,68,4.138,81,4.929,4353,529,3824,0.860,7.076,3594,1230,2364,2.000,5.842,759,1.234,11.685,54,54,687
2017,3256,1919,2126,99756,98562,186,8.815,154,7.299,10528,1831,8697,1.858,10.682,8172,3161,5011,3.207,8.291,2356,2.390,16.583,124,124,1603
2017,3259,1702,2176,82785,82569,151,6.886,185,8.436,8139,1300,6839,1.574,9.857,7694,2052,5642,2.485,9.318,445,0.539,18.637,119,129,1317
2017,3261,7600,9992,635611,629425,357,3.547,501,4.978,58872,8065,50807,1.281,9.353,46200,12442,33758,1.977,7.340,12672,2.013,14.680,344,353,5847
2017,3262,1353,1775,131735,132105,63,3.528,84,4.705,9167,1684,7483,1.275,6.939,10000,3087,6913,2.337,7.570,-833,-0.631,13.878,52,52,1034
2017,3271,841,1017,33438,33491,61,5.975,69,6.758,2655,524,2131,1.565,7.928,2777,913,1864,2.726,8.292,-122,-0.364,15.855,49,50,328
2017,3272,1341,1600,94778,93776,98,6.098,112,6.970,8097,1591,6506,1.697,8.634,6012,2024,3988,2.158,6.411,2085,2.223,12.822,78,78,870
2017,3273,3880,8470,172104,170037,399,4.717,378,4.468,23139,4975,18164,2.926,13.608,18950,5184,13766,3.049,11.145,4189,2.464,22.289,177,179,2503
2017,3274,154,289,13915,13443,16,5.479,22,7.534,1523,96,1427,0.714,11.329,520,82,438,0.610,3.868,1003,7.461,7.736,20,20,78
2017,3279,2650,3115,79743,79497,191,6.117,206,6.597,8895,1842,7053,2.317,11.189,8444,2371,6073,2.983,10.622,451,0.567,21.244,135,136,1245
2017,3311,302,459,89966,90098,40,8.734,38,8.297,7809,2447,5362,2.716,8.667,8152,1534,6618,1.703,9.048,-343,-0.381,17.335,22,22,632
2017,3312,531,681,48334,48050,46,6.850,27,4.021,3990,426,3564,0.887,8.304,3410,308,3102,0.641,7.097,580,1.207,14.194,19,19,112
2017,3313,372,504,57786,57853,26,5.143,29,5.737,4750,1825,2925,3.155,8.210,5288,2289,2999,3.957,9.140,-538,-0.930,16.421,20,24,2034
2017,3314,665,853,57047,57960,27,3.132,45,5.220,3832,1107,2725,1.910,6.611,5617,2082,3535,3.592,9.691,-1785,-3.080,13.223,28,28,662
2017,3315,1412,1608,115443,117223,50,3.078,83,5.109,8124,1024,7100,0.874,6.930,11729,2842,8887,2.424,10.006,-3605,-3.075,13.861,63,64,1825
2017,3321,2058,2330,107283,107241,73,3.111,106,4.517,8982,1890,7092,1.762,8.376,8929,2475,6454,2.308,8.326,53,0.049,16.652,80,80,1313
2017,3322,1009,1084,34644,34845,58,5.328,67,6.155,2913,847,2066,2.431,8.360,3316,645,2671,1.851,9.517,-403,-1.157,16.720,54,54,296
2017,3323,11864,12881,361151,359168,782,6.086,719,5.596,39825,10583,29242,2.947,11.088,35754,12066,23688,3.359,9.955,4071,1.133,19.909,544,548,7362
2017,3324,1150,1461,83822,84320,63,4.264,96,6.497,10102,2210,7892,2.621,11.981,11070,2156,8914,2.557,13.129,-968,-1.148,23.961,57,58,994
2017,3325,511,556,27845,27539,30,5.410,27,4.869,2178,702,1476,2.549,7.909,1474,187,1287,0.679,5.353,704,2.556,10.705,22,22,173
2017,3326,962,1111,39164,39082,29,2.580,55,4.893,3535,973,2562,2.490,9.045,3370,1155,2215,2.955,8.623,165,0.422,17.246,40,40,584
2017,3327,20818,21385,364594,367621,946,4.373,1443,6.670,33408,7760,25648,2.111,9.088,39546,13036,26510,3.546,10.757,-6138,-1.670,18.175,1117,1129,8989
2017,3328,4880,5436,128651,127956,231,4.215,320,5.839,14204,2250,11954,1.758,11.101,12759,3519,9240,2.750,9.971,1445,1.129,19.943,243,243,2363
2017,3329,5352,5866,251230,253340,360,6.093,445,7.532,20414,3666,16748,1.447,8.058,24782,8814,15968,3.479,9.782,-4368,-1.724,16.116,338,341,5200
2017,3331,2413,2787,183782,185116,123,4.349,206,7.283,17049,3241,13808,1.751,9.210,19837,4066,15771,2.196,10.716,-2788,-1.506,18.420,131,131,1096
2017,3332,2792,2966,106699,104799,157,5.281,171,5.752,12010,2190,9820,2.090,11.460,8193,2659,5534,2.537,7.818,3817,3.642,15.636,121,122,1704
2017,3333,1723,1843,70259,70401,117,6.326,130,7.029,6036,1067,4969,1.516,8.574,6280,2120,4160,3.011,8.920,-244,-0.347,17.148,94,94,1249
2017,3334,1394,1656,128217,127542,75,4.498,98,5.877,9093,1216,7877,0.953,7.129,7609,2145,5464,1.682,5.966,1484,1.164,11.932,69,69,982
2017,3335,6172,6425,148517,148298,278,4.299,361,5.583,14392,3150,11242,2.124,9.705,14000,4282,9718,2.887,9.440,392,0.264,18.881,282,283,2647
2017,3336,798,1002,101688,101476,31,3.002,92,8.910,9573,1245,8328,1.227,9.434,9333,3486,5847,3.435,9.197,240,0.237,18.394,42,43,881
2017,3339,5011,5717,293311,295294,243,4.215,340,5.897,23419,5089,18330,1.723,7.931,27601,7591,20010,2.571,9.347,-4182,-1.416,15.861,248,248,3219
2017,3341,850,884,41261,40919,74,8.291,91,10.196,4605,400,4205,0.978,11.254,3886,1057,2829,2.583,9.497,719,1.757,18.994,70,70,442
2017,3342,1077,1181,78340,79429,72,5.985,116,9.643,5293,601,4692,0.757,6.664,7423,2735,4688,3.443,9.345,-2130,-2.682,13.328,79,80,844
2017,3343,415,426,8609,8842,29,6.721,40,9.270,810,112,698,1.267,9.161,1270,693,577,7.838,14.363,-460,-5.202,18.322,30,30,142
2017,3344,3279,3719,258415,262158,175,4.648,267,7.092,17023,2464,14559,0.940,6.493,24532,7692,16840,2.934,9.358,-7509,-2.864,12.987,195,196,3050
2017,3345,4214,4912,391345,390341,241,4.870,314,6.345,30862,5112,25750,1.310,7.906,29038,7089,21949,1.816,7.439,1824,0.467,14.878,227,227,2915
2017,3346,404,412,7971,8886,28,6.643,47,11.151,884,132,752,1.485,9.948,2594,669,1925,7.529,29.192,-1710,-19.244,19.896,43,43,352
2017,3351,984,1045,43460,43627,83,7.962,78,7.482,3268,613,2655,1.405,7.491,3509,946,2563,2.168,8.043,-241,-0.552,14.982,63,63,681
2017,3352,216,264,51096,49553,26,9.793,29,10.923,4727,1177,3550,2.375,9.539,1704,517,1187,1.043,3.439,3023,6.101,6.877,22,22,384
2017,3353,1700,1958,112939,114788,82,4.142,125,6.315,8441,1298,7143,1.131,7.354,12121,2607,9514,2.271,10.560,-3680,-3.206,14.707,78,78,1014
2017,3359,1726,2006,131472,131394,117,5.815,129,6.412,10155,1882,8273,1.432,7.729,9931,3484,6447,2.652,7.558,224,0.170,15.116,86,86,1340
2017,3361,252,306,210248,203139,29,9.477,29,9.477,20903,520,20383,0.256,10.290,6601,1036,5565,0.510,3.249,14302,7.040,6.499,20,20,244
2017,3362,1547,1862,154479,151329,124,6.677,114,6.139,19207,4399,14808,2.907,12.692,13077,4697,8380,3.104,8.641,6130,4.051,17.283,86,87,2790
2017,3363,3585,4521,574125,566509,202,4.416,308,6.734,51397,7157,44240,1.263,9.073,36294,10551,25743,1.862,6.407,15103,2.666,12.813,198,205,3468
2017,3364,1267,1693,361447,361372,88,5.154,117,6.852,23976,1267,22709,0.351,6.635,23991,5910,18081,1.635,6.639,-15,-0.004,13.269,76,76,883
2017,3365,143,218,28730,29522,6,2.679,18,8.036,1929,477,1452,1.616,6.534,3500,489,3011,1.656,11.856,-1571,-5.322,13.068,10,10,228
2017,3366,1239,1363,135852,137734,98,7.174,104,7.613,8729,1171,7558,0.850,6.338,12326,1661,10665,1.206,8.949,-3597,-2.612,12.675,73,73,640
2017,3369,787,822,33108,33464,78,9.455,84,10.182,3489,1658,1831,4.955,10.426,4187,1135,3052,3.392,12.512,-698,-2.086,20.852,70,70,772
2017,3371,9544,9823,225225,223612,675,6.837,775,7.850,22037,4305,17732,1.925,9.855,18811,6801,12010,3.041,8.412,3226,1.443,16.825,602,605,4626
2017,3372,3483,3630,117683,117335,189,5.148,271,7.382,12076,1499,10577,1.278,10.292,11325,4110,7215,3.503,9.652,751,0.640,19.304,206,209,2631
2017,3379,600,706,32241,31934,46,6.502,49,6.926,4620,1021,3599,3.197,14.468,3924,1506,2418,4.716,12.288,696,2.180,24.576,37,37,354
2017,3391,8664,9663,279641,277432,586,6.005,777,7.962,28896,4637,24259,1.671,10.416,24408,9004,15404,3.245,8.798,4488,1.618,17.596,634,635,5310
2017,3399,14010,14422,259455,257149,1270,8.813,1248,8.660,30360,8467,21893,3.293,11.806,25727,8354,17373,3.249,10.005,4633,1.802,20.009,979,981,5560
2017,4231,14704,22476,404782,403392,1347,5.948,1685,7.441,45836,11655,34181,2.889,11.363,42992,11871,31121,2.943,10.658,2844,0.705,21.315,1131,1197,7721
2017,4232,9406,11307,159969,156877,774,6.806,905,7.958,23468,4672,18796,2.978,14.959,17375,5658,11717,3.607,11.076,6093,3.884,22.151,646,662,3281
2017,4233,9499,16540,241208,236735,1051,6.365,997,6.038,32259,7013,25246,2.962,13.627,23079,7721,15358,3.261,9.749,9180,3.878,19.498,553,585,3568
2017,4234,20641,32312,640696,645753,2535,7.808,2845,8.763,75655,19069,56586,2.953,11.716,85803,30669,55134,4.749,13.287,-10148,-1.571,23.432,1561,1604,11162
2017,4235,6548,9172,150129,149807,411,4.427,633,6.819,16314,2871,13443,1.916,10.890,15797,5116,10681,3.415,10.545,517,0.345,21.090,374,398,2813
2017,4236,17120,28293,550161,548914,2009,7.060,2336,8.209,59513,15230,44283,2.775,10.842,56674,18307,38367,3.335,10.325,2839,0.517,20.650,1317,1372,8910
2017,4237,9459,18430,247805,243496,935,5.074,926,5.026,32489,8687,23802,3.568,13.343,23846,6726,17120,2.762,9.793,8643,3.550,19.586,507,551,3706
2017,4238,36616,54573,747138,753372,2661,4.828,3740,6.786,82934,19879,63055,2.639,11.008,94891,32000,62891,4.248,12.596,-11957,-1.587,22.017,2098,2192,13142
2017,4239,26629,29891,321791,320411,2562,8.499,3069,10.181,44639,12173,32466,3.799,13.932,42054,15399,26655,4.806,13.125,2585,0.807,26.250,2371,2426,10734
2017,4241,6628,8858,145666,146438,407,4.513,726,8.051,14102,2848,11254,1.945,9.630,15658,5911,9747,4.037,10.693,-1556,-1.063,19.260,434,438,2368
2017,4242,6171,9415,293450,295090,786,8.328,832,8.815,34841,11219,23622,3.802,11.807,38260,13581,24679,4.602,12.966,-3419,-1.159,23.614,533,558,4155
2017,4243,12752,13827,195776,196297,1250,8.916,1636,11.669,24239,5543,18696,2.824,12.348,25437,9513,15924,4.846,12.958,-1198,-0.610,24.696,1326,1345,6561
2017,4244,24846,33023,828566,821044,2700,8.192,2572,7.804,98665,27904,70761,3.399,12.017,83916,30107,53809,3.667,10.221,14749,1.796,20.441,1745,1767,11264
2017,4245,3088,5928,62521,63064,230,3.851,320,5.357,7293,1270,6023,2.014,11.565,8242,1966,6276,3.117,13.069,-949,-1.505,23.129,157,167,993
2017,4246,7438,11827,159877,159252,521,4.339,883,7.353,19967,2575,17392,1.617,12.538,18625,7463,11162,4.686,11.695,1342,0.843,23.391,403,423,2556
2017,4247,3793,6304,98087,98348,263,4.131,388,6.094,12764,3675,9089,3.737,12.978,13428,4380,9048,4.454,13.654,-664,-0.675,25.957,201,213,2399
2017,4248,3183,4187,203552,201951,325,7.729,361,8.585,19150,6121,13029,3.031,9.482,16046,6907,9139,3.420,7.945,3104,1.537,15.891,244,248,3396
2017,4249,19728,26297,347364,348241,2095,7.937,2293,8.687,42156,10298,31858,2.957,12.105,43445,14185,29260,4.073,12.476,-1289,-0.370,24.211,1707,1743,8359
2017,4251,36552,38973,315935,309854,4502,11.572,4364,11.217,60156,14320,45836,4.622,19.414,47396,19408,27988,6.264,15.296,12760,4.118,30.592,3428,3458,10932
2017,4411,37583,43922,1331120,1315318,3598,8.202,3490,7.956,141416,41827,99589,3.180,10.751,109549,36077,73472,2.743,8.329,31867,2.423,16.657,2702,2738,24886
2017,4412,11135,12894,150317,147770,878,6.796,928,7.183,20456,5518,14938,3.734,13.843,15384,5732,9652,3.879,10.411,5072,3.432,20.822,679,698,3615
2017,4413,26109,56308,537969,533376,2893,5.151,2598,4.626,56701,19166,37535,3.593,10.631,47852,14629,33223,2.743,8.972,8849,1.659,17.943,1633,1692,6941
2017,4421,12639,22269,209200,208812,1603,7.199,1599,7.181,29039,7869,21170,3.768,13.907,28470,7653,20817,3.665,13.634,569,0.272,27.269,1058,1129,4872
2017,4422,17399,25593,254410,252701,1624,6.307,1938,7.526,27261,8301,18960,3.285,10.788,23773,8119,15654,3.213,9.408,3488,1.380,18.815,1286,1311,4049
2017,4431,18165,29885,329218,344802,1670,5.052,8015,24.246,33289,7287,26002,2.113,9.655,65430,40109,25321,11.632,18.976,-32141,-9.322,19.309,2551,2894,13095
2017,4441,33352,55637,1158007,1164657,2474,4.433,2814,5.042,76285,17822,58463,1.530,6.550,87909,16380,71529,1.406,7.548,-11624,-0.998,13.100,1828,1938,10408
2017,4442,12169,16396,158502,156245,858,5.207,1021,6.196,23258,3949,19309,2.527,14.886,18290,4499,13791,2.879,11.706,4968,3.180,23.412,724,733,2992
2017,4451,60368,86869,2795982,2804883,7548,8.709,7139,8.238,237221,90148,147073,3.214,8.457,256656,77176,179480,2.751,9.150,-19435,-0.693,16.915,5121,5200,25469
2017,4452,16766,21081,179623,178391,2223,10.587,2056,9.792,31771,11894,19877,6.667,17.810,29409,9583,19826,5.372,16.486,2362,1.324,32.971,1514,1540,7408
2017,4453,27868,31969,171384,169161,2401,7.540,2153,6.761,26357,8360,17997,4.942,15.581,22182,7210,14972,4.262,13.113,4175,2.468,26.226,1658,1680,5292
2017,4461,39768,93908,1037154,1043555,5478,5.857,4721,5.048,172322,37948,134374,3.636,16.513,185187,25668,159519,2.460,17.746,-12865,-1.233,33.026,3323,3442,17322
2017,4471,61733,107667,951882,949895,7192,6.692,6799,6.326,133917,46607,87310,4.907,14.098,129751,35573,94178,3.745,13.660,4166,0.439,27.319,4160,4616,21502
2017,4481,32194,91113,1389856,1378599,7358,8.043,8104,8.858,180430,69461,110969,5.039,13.088,160795,49089,111706,3.561,11.664,19635,1.424,23.327,3638,4229,18870
2017,4482,4756,23946,239658,239126,927,3.843,1273,5.278,30756,6536,24220,2.733,12.862,29365,6783,22582,2.837,12.280,1391,0.582,24.560,465,574,2150
2017,4483,14226,21116,125290,125320,1223,5.741,1600,7.510,17767,7602,10165,6.066,14.177,18089,5625,12464,4.489,14.434,-322,-0.257,28.355,1038,1049,2740
2017,4511,24447,34873,451208,464711,2775,7.843,3791,10.715,56940,16663,40277,3.586,12.253,80886,37038,43848,7.970,17.406,-23946,-5.153,24.506,2174,2579,13259
2017,4512,3273,7406,88653,90188,657,8.954,520,7.087,10783,4778,6005,5.298,11.956,13582,3111,10471,3.449,15.060,-2799,-3.104,23.912,304,329,1636
2017,4521,193,7510,898255,928101,278,3.576,805,10.356,52110,9408,42702,1.014,5.615,108885,67597,41288,7.283,11.732,-56775,-6.117,11.229,(D),(D),(D)
2017,4529,7111,44483,1815406,1802963,2285,5.145,2142,4.823,107826,26540,81286,1.472,5.980,85256,18166,67090,1.008,4.729,22570,1.252,9.457,806,814,2472
2017,4531,11439,11941,59221,59396,888,7.351,1167,9.660,9488,2797,6691,4.709,15.974,9838,3570,6268,6.011,16.564,-350,-0.589,31.949,925,933,2816
2017,4532,16176,25228,215441,219302,1812,7.019,2988,11.574,28262,8252,20010,3.763,12.887,36110,13071,23039,5.960,16.466,-7848,-3.579,25.775,1726,1796,6392
2017,4533,12357,18629,199180,203604,1479,7.878,1768,9.418,24566,8472,16094,4.161,12.066,33505,7868,25637,3.864,16.456,-8939,-4.390,24.131,1348,1387,5036
2017,4539,33363,44989,292923,291062,5285,11.893,4184,9.415,48349,20799,27550,7.146,16.611,44897,14322,30575,4.921,15.425,3452,1.186,30.851,3221,3327,11050
2017,4541,30100,31578,464043,455541,5514,17.819,4246,13.722,89025,25081,63944,5.506,19.543,70934,36788,34146,8.076,15.571,18091,3.971,31.143,3378,3397,15915
2017,4542,2883,3421,41491,40432,420,12.358,375,11.034,6193,3873,2320,9.579,15.317,4159,1401,2758,3.465,10.287,2034,5.031,20.573,322,323,1150
2017,4543,19892,24842,166811,166582,2474,9.960,2469,9.940,24513,8812,15701,5.290,14.715,23770,8212,15558,4.930,14.269,743,0.446,28.538,1852,1876,6311
2017,4811,431,2238,432160,430313,163,7.362,115,5.194,33472,4779,28693,1.111,7.779,29989,3410,26579,0.792,6.969,3483,0.809,13.938,26,40,429
2017,4812,1839,2079,39383,38590,236,11.365,231,11.124,5766,1799,3967,4.662,14.942,4116,1137,2979,2.946,10.666,1650,4.276,21.332,179,180,689
2017,4831,671,1052,42182,42667,134,12.866,113,10.850,4541,937,3604,2.196,10.643,5452,1188,4264,2.784,12.778,-911,-2.135,21.286,62,75,336
2017,4832,462,535,21823,22341,63,11.921,50,9.461,1491,533,958,2.386,6.674,2500,267,2233,1.195,11.190,-1009,-4.516,13.348,45,46,166
2017,4841,55620,65853,995980,989651,9981,15.246,9208,14.065,123497,39110,84387,3.952,12.479,112202,41867,70335,4.230,11.338,11295,1.141,22.675,6989,7044,26642
2017,4842,38299,42381,474629,473033,5149,12.160,5075,11.985,72297,19767,52530,4.179,15.284,69046,22636,46410,4.785,14.596,3251,0.687,29.193,3837,3902,15808
2017,4851,619,949,60347,60076,87,9.285,63,6.724,3274,785,2489,1.307,5.450,2686,1259,1427,2.096,4.471,588,0.979,8.942,44,44,945
2017,4852,211,430,12158,12120,36,8.491,24,5.660,970,439,531,3.622,8.003,916,394,522,3.251,7.558,54,0.446,15.116,17,17,232
2017,4853,6461,6628,72860,73830,1009,15.053,1159,17.291,9752,3976,5776,5.385,13.209,11882,4880,7002,6.610,16.094,-2130,-2.885,26.417,1013,1015,3911
2017,4854,2377,4059,231756,233763,182,4.441,261,6.368,14983,3609,11374,1.544,6.409,19240,8946,10294,3.827,8.231,-4257,-1.821,12.819,170,174,2644
2017,4855,1013,1145,32161,31823,101,8.779,112,9.735,4292,1406,2886,4.418,13.487,3646,1764,1882,5.543,11.457,646,2.030,22.914,86,86,1192
2017,4859,4418,4977,105361,102517,863,17.763,626,12.885,18531,6668,11863,6.504,18.076,12754,4760,7994,4.643,12.441,5777,5.635,24.882,497,505,3663
2017,4861,69,719,13043,13516,37,4.990,82,11.059,1155,398,757,2.945,8.545,2101,752,1349,5.564,15.545,-946,-6.999,17.091,13,13,58
2017,4862,108,2267,30060,30589,165,7.396,93,4.169,3298,1270,2028,4.152,10.782,4303,965,3338,3.155,14.067,-1005,-3.286,21.564,4,4,41
2017,4869,76,686,9074,8931,46,6.725,42,6.140,1270,565,705,6.327,14.221,986,330,656,3.695,11.041,284,3.180,22.082,5,5,24
2017,4871,581,627,11205,11543,85,13.677,74,11.907,1571,469,1102,4.063,13.611,2310,1199,1111,10.388,20.013,-739,-6.402,27.221,56,58,300
2017,4872,1265,1307,14677,14549,185,14.369,146,11.340,2183,778,1405,5.348,15.005,1980,521,1459,3.581,13.610,203,1.395,27.219,103,103,368
2017,4879,157,182,2901,2799,16,8.556,26,13.904,363,44,319,1.572,12.971,168,63,105,2.251,6.003,195,6.968,12.006,19,19,45
2017,4881,3759,5485,195701,190084,409,7.427,453,8.226,38498,6318,32180,3.324,20.253,27022,11815,15207,6.216,14.216,11476,6.037,28.432,263,288,2507
2017,4882,499,1395,40522,41224,140,10.116,118,8.526,5198,2537,2661,6.154,12.609,6732,1994,4738,4.837,16.330,-1534,-3.721,25.218,26,26,189
2017,4883,1760,2340,88596,90436,177,7.554,183,7.810,7349,1241,6108,1.372,8.126,11061,1388,9673,1.535,12.231,-3712,-4.105,16.252,124,127,633
2017,4884,9388,10294,90968,89686,1267,12.403,1109,10.857,14800,4842,9958,5.399,16.502,12345,5198,7147,5.796,13.765,2455,2.737,27.530,827,833,3537
2017,4885,13329,19788,269964,266151,1820,9.241,1634,8.297,39621,13277,26344,4.989,14.887,32093,11056,21037,4.154,12.058,7528,2.828,24.116,1030,1056,4716
2017,4889,1577,1717,17291,17366,256,15.184,194,11.507,3044,1375,1669,7.918,17.529,3147,811,2336,4.670,18.122,-103,-0.593,35.058,156,158,625
2017,4921,3559,9223,583029,574259,512,5.431,921,9.769,43930,6729,37201,1.172,7.650,25540,8431,17109,1.468,4.447,18390,3.202,8.895,521,525,2645
2017,4922,3469,3848,51322,49179,520,13.267,663,16.915,12838,5649,7189,11.487,26.105,8642,4283,4359,8.709,17.573,4196,8.532,35.145,477,478,2731
2017,4931,7221,15450,946853,888985,1378,8.984,1156,7.536,206160,75438,130722,8.486,23.191,84369,24470,59899,2.753,9.490,121791,13.700,18.981,395,410,4009
2017,5111,10987,15468,353863,362163,952,6.014,1678,10.599,35967,9598,26369,2.650,9.931,52639,19089,33550,5.271,14.535,-16672,-4.603,19.862,933,978,6315
2017,5112,6959,10188,535064,524125,1728,17.576,1015,10.324,76137,26983,49154,5.148,14.526,53655,17898,35757,3.415,10.237,22482,4.289,20.474,678,689,8967
2017,5121,14023,17286,304164,344696,2117,12.240,2136,12.350,43152,16776,26376,4.867,12.519,123431,12429,111002,3.606,35.809,-80279,-23.290,25.038,1534,1550,7887
2017,5122,2784,2969,22003,22368,351,11.822,351,11.822,2963,1260,1703,5.633,13.247,3656,2164,1492,9.675,16.345,-693,-3.098,26.493,265,265,663
2017,5151,3922,7364,207593,210348,346,4.683,395,5.346,15273,4461,10812,2.121,7.261,20640,4920,15720,2.339,9.812,-5367,-2.551,14.522,232,240,2104
2017,5152,373,673,50227,49944,26,3.807,46,6.735,3593,449,3144,0.899,7.194,2958,931,2027,1.864,5.923,635,1.271,11.845,30,30,718
2017,5171,3258,34478,737295,750792,2727,7.526,6241,17.224,103467,23691,79776,3.155,13.781,133124,45607,87517,6.075,17.731,-29657,-3.950,27.562,236,247,2128
2017,5172,1494,16430,244379,244501,2354,14.764,1382,8.668,36833,10352,26481,4.234,15.065,36943,10389,26554,4.249,15.110,-110,-0.045,30.129,90,138,992
2017,5174,377,481,9513,8958,101,21.909,61,13.232,2042,768,1274,8.574,22.797,948,357,591,3.985,10.583,1094,12.213,21.167,42,42,116
2017,5179,5004,6497,80441,75819,1656,27.048,907,14.814,20047,10567,9480,13.937,26.441,10809,4476,6333,5.904,14.256,9238,12.184,28.513,750,766,3650
2017,5182,8668,14591,494253,486135,3218,23.312,1644,11.910,101037,48914,52123,10.062,20.784,84702,33216,51486,6.833,17.424,16335,3.360,34.847,849,897,13743
2017,5191,8665,10892,303520,296277,1410,12.946,1409,12.937,52211,10763,41448,3.633,17.622,37793,12799,24994,4.320,12.756,14418,4.866,25.512,1037,1066,6844
2017,5211,16,62,19758,19564,(D),(D),(D),(D),695,(D),678,(D),3.553,309,(D),308,(D),1.579,386,1.973,3.159,(D),(D),(D)
2017,5221,10876,117739,1965065,1964157,4578,3.879,5162,4.373,213601,48578,165023,2.473,10.875,213009,39627,173382,2.018,10.845,592,0.030,21.690,341,548,6073
2017,5222,13729,44400,607495,613048,3820,8.606,3797,8.554,100383,28076,72307,4.580,16.374,109218,44501,64717,7.259,17.816,-8835,-1.441,32.749,1141,1247,6957
2017,5223,11099,24472,266903,269064,1798,7.167,3030,12.077,38896,13995,24901,5.201,14.456,43403,19776,23627,7.350,16.131,-4507,-1.675,28.912,984,1094,5556
2017,5231,10395,41611,397592,401417,2861,6.839,3309,7.910,36986,12250,24736,3.052,9.214,44892,11827,33065,2.946,11.183,-7906,-1.970,18.428,890,904,3160
2017,5232,11,35,5777,5928,(D),(D),(D),(D),63,(D),46,(D),1.063,372,(D),351,(D),6.276,-309,-5.213,2.126,(D),(D),(D)
2017,5239,44738,50864,497731,493790,6203,12.311,5250,10.419,68663,24570,44093,4.976,13.905,60944,21935,39009,4.442,12.342,7719,1.563,24.684,3733,3776,13404
2017,5241,5319,31542,1522991,1535706,3283,9.721,7745,22.933,222143,92083,130060,5.996,14.465,250438,111427,139011,7.256,16.308,-28295,-1.842,28.930,319,351,4121
2017,5242,118198,133834,977488,967055,10803,8.060,11209,8.363,151399,58209,93190,6.019,15.656,130070,52652,77418,5.445,13.450,21329,2.206,26.900,7855,7967,27259
2017,5250,1857,1899,34498,22211,724,46.785,21,1.357,27095,25555,1540,115.058,121.992,1853,54,1799,0.243,8.343,25242,113.649,16.686,8,8,33
2017,5311,85649,112981,556999,553995,10755,9.530,10497,9.302,92441,37987,54454,6.857,16.686,85074,36982,48092,6.676,15.356,7367,1.330,30.713,7728,7975,24070
2017,5312,76627,91475,302475,294450,17382,19.866,9425,10.772,62879,37065,25814,12.588,21.355,45885,19720,26165,6.697,15.583,16994,5.771,31.167,6408,6465,12992
2017,5313,69462,90168,749762,734889,10731,12.105,7694,8.679,121449,44044,77405,5.993,16.526,91619,36134,55485,4.917,12.467,29830,4.059,24.934,5164,5236,22625
2017,5321,3469,15629,162899,164998,1118,7.180,1002,6.435,17944,4459,13485,2.702,10.875,21382,4510,16872,2.733,12.959,-3438,-2.084,21.751,366,371,1541
2017,5322,7055,16642,133129,140467,1024,5.882,2561,14.710,18629,4588,14041,3.266,13.262,33773,14367,19406,10.228,24.043,-15144,-10.781,26.524,746,824,5891
2017,5323,2043,3926,21663,19801,1663,52.050,201,6.291,6924,4286,2638,21.645,34.968,2570,794,1776,4.010,12.979,4354,21.989,25.958,134,141,519
2017,5324,7250,14146,184165,181319,1271,9.057,1047,7.460,27736,7846,19890,4.327,15.297,21798,5943,15855,3.278,12.022,5938,3.275,24.044,556,568,2510
2017,5331,2017,2163,36968,36390,242,11.173,248,11.450,6099,1219,4880,3.350,16.760,5064,1894,3170,5.205,13.916,1035,2.844,27.832,165,166,870
2017,5411,156431,168375,1150851,1144130,12474,7.392,13206,7.826,132924,35692,97232,3.120,11.618,119588,38446,81142,3.360,10.452,13336,1.166,20.905,10168,10339,27205
2017,5412,99469,119095,1183660,1183375,9288,7.791,9533,7.996,154185,37462,116723,3.166,13.029,152647,75731,76916,6.400,12.899,1538,0.130,25.799,6998,7063,47024
2017,5413,80674,100013,1471470,1450154,8440,8.431,8624,8.615,203611,52269,151342,3.604,14.041,160627,57175,103452,3.943,11.077,42984,2.964,22.153,5442,5529,24574
2017,5414,26635,27026,120710,119743,3704,13.822,3246,12.113,19710,7559,12151,6.313,16.460,17689,8350,9339,6.973,14.772,2021,1.688,29.545,2491,2494,5423
2017,5415,100559,122905,1908475,1874922,17213,14.060,16253,13.276,289532,83886,205646,4.474,15.442,223418,82586,140832,4.405,11.916,66114,3.526,23.832,11913,11995,48806
2017,5416,125029,135257,1279470,1254792,23525,17.563,20906,15.608,252216,91582,160634,7.299,20.100,201449,92019,109430,7.333,16.054,50767,4.046,32.109,15699,15782,54896
2017,5417,13536,16866,699840,692859,2060,12.276,1890,11.263,83656,14558,69098,2.101,12.074,70129,23933,46196,3.454,10.122,13527,1.952,20.243,1193,1216,8041
2017,5418,28335,32478,468271,465278,3366,10.313,3688,11.299,67965,17386,50579,3.737,14.607,61601,25572,36029,5.496,13.240,6364,1.368,26.479,2857,2883,17953
2017,5419,54834,61938,651957,645142,6763,10.996,5898,9.589,102772,34040,68732,5.276,15.930,88858,37169,51689,5.761,13.773,13914,2.157,27.547,4317,4398,24276
2017,5511,26324,54773,3472342,3402700,5125,9.421,4373,8.039,545239,135994,409245,3.997,16.024,408092,117364,290728,3.449,11.993,137147,4.031,23.986,801,832,15339
2017,5611,25352,28238,459643,447559,3374,12.026,3011,10.732,86912,30344,56568,6.780,19.419,62538,26576,35962,5.938,13.973,24374,5.446,27.946,2287,2307,18017
2017,5612,1737,6203,266595,261215,386,6.133,567,9.009,37998,9067,28931,3.471,14.547,27398,11685,15713,4.473,10.489,10600,4.058,20.977,110,119,2345
2017,5613,24147,48558,5760756,5728889,4576,9.445,4354,8.987,982033,171003,811030,2.985,17.142,915751,254750,661001,4.447,15.985,66282,1.157,31.970,2417,2485,117247
2017,5614,22209,29168,794811,796944,2464,8.339,3221,10.901,125746,43260,82486,5.428,15.779,130625,46322,84303,5.812,16.391,-4879,-0.612,31.557,2233,2266,25200
2017,5615,12575,18550,221793,219963,1245,6.134,4741,23.357,41396,6644,34752,3.021,18.820,36780,23579,13201,10.720,16.721,4616,2.099,33.442,1022,1042,4903
2017,5616,17954,23011,953787,945277,2286,9.781,3008,12.870,234436,120165,114271,12.712,24.801,218520,82087,136433,8.684,23.117,15916,1.684,46.234,1465,1484,17255
2017,5617,153130,162079,1950495,1922245,22344,13.934,18904,11.789,334597,113272,221325,5.893,17.407,278971,96841,182130,5.038,14.513,55626,2.894,29.026,14248,14298,65958
2017,5619,15514,17402,286696,283967,1662,9.533,1727,9.906,46322,10254,36068,3.611,16.312,41215,15427,25788,5.433,14.514,5107,1.798,29.028,1222,1345,11128
2017,5621,7229,11154,213614,209502,693,6.229,637,5.725,22731,5130,17601,2.449,10.850,14243,5410,8833,2.582,6.799,8488,4.052,13.597,498,513,3990
2017,5622,1225,2554,59648,56644,130,5.084,136,5.319,9941,3050,6891,5.385,17.550,3927,1892,2035,3.340,6.933,6014,10.617,13.866,83,87,470
2017,5629,8498,10013,133245,132757,853,8.551,777,7.789,21625,5106,16519,3.846,16.289,20625,7326,13299,5.518,15.536,1000,0.753,31.072,564,572,4098
2017,6111,18746,21455,1049870,1026126,903,4.299,5,0.024,88742,16390,72352,1.597,8.648,41356,16,41340,0.002,4.030,47386,4.618,8.061,(D),(D),(D)
2017,6112,425,786,61560,62049,17,2.186,0,0.000,3563,210,3353,0.338,5.742,4531,0,4531,0.000,7.302,-968,-1.560,11.484,0,0,0
2017,6113,2351,4335,1866791,1869005,218,5.157,(D),(D),76026,2681,73345,0.143,4.068,78511,(D),78509,(D),4.201,-2485,-0.133,8.135,0,0,0
2017,6114,6363,6793,59009,58477,774,11.385,785,11.547,9711,2561,7150,4.379,16.607,8703,3638,5065,6.221,14.883,1008,1.724,29.766,570,579,2649
2017,6115,6215,7738,110920,111551,729,9.367,819,10.523,18059,5069,12990,4.544,16.189,19480,6775,12705,6.073,17.463,-1421,-1.274,32.378,445,627,5133
2017,6116,42615,46050,451616,438912,5676,12.500,4393,9.674,88722,29764,58958,6.781,20.214,63060,21887,41173,4.987,14.367,25662,5.847,28.735,3459,3518,16871
2017,6117,6772,7617,105833,105326,1318,17.664,1007,13.496,18684,5884,12800,5.586,17.739,18243,5539,12704,5.259,17.321,441,0.419,34.641,674,681,2727
2017,6211,155591,209450,2650322,2606283,17067,8.150,17003,8.119,401807,125376,276431,4.811,15.417,313324,121881,191443,4.676,12.022,88483,3.395,24.044,11708,12004,62499
2017,6212,118475,129186,940494,930615,6879,5.331,6561,5.085,120982,35148,85834,3.777,13.000,101180,32388,68792,3.480,10.872,19802,2.128,21.745,5414,5490,26432
2017,6213,120283,140295,861781,846638,14150,10.196,11127,8.018,149866,49352,100514,5.829,17.701,118956,46765,72191,5.524,14.050,30910,3.651,28.101,7460,7609,28147
2017,6214,16777,40738,996043,979149,3542,8.709,3409,8.382,146136,42742,103394,4.365,14.925,113844,43466,70378,4.439,11.627,32292,3.298,23.254,1017,1318,14247
2017,6215,6819,16076,287246,285655,1341,8.250,1697,10.441,39975,11574,28401,4.052,13.994,36687,15576,21111,5.453,12.843,3288,1.151,25.686,695,764,6877
2017,6216,21304,30880,1453390,1427360,3584,11.734,2913,9.537,223800,48924,174876,3.428,15.679,173261,57279,115982,4.013,12.139,50539,3.541,24.277,1859,1906,30287
2017,6219,6368,10751,328393,316066,1117,10.568,755,7.143,55261,15565,39696,4.925,17.484,30317,9360,20957,2.961,9.592,24944,7.892,19.184,426,450,5725
2017,6221,2399,5208,5391770,5300809,141,2.718,100,1.928,340264,31340,308924,0.591,6.419,158225,24918,133307,0.470,2.985,182039,3.434,5.970,39,39,13027
2017,6222,398,643,231472,229089,19,2.966,14,2.186,18477,2795,15682,1.220,8.065,13671,3097,10574,1.352,5.968,4806,2.098,11.935,8,8,1664
2017,6223,342,862,260832,260802,59,6.829,63,7.292,18856,2674,16182,1.025,7.230,18746,6944,11802,2.663,7.188,110,0.042,14.376,19,19,1107
2017,6231,8194,15711,1599048,1622538,941,5.923,1293,8.139,138918,59090,79828,3.642,8.562,187356,95061,92295,5.859,11.547,-48438,-2.985,17.124,585,638,45197
2017,6232,9865,40955,765642,758951,2420,5.896,2593,6.318,109659,25469,84190,3.356,14.449,96019,25814,70205,3.401,12.652,13640,1.797,25.303,472,580,6039
2017,6233,17012,24798,1001337,995613,2075,8.436,1671,6.794,107864,38244,69620,3.841,10.834,97297,34198,63099,3.435,9.773,10567,1.061,19.545,1224,1281,21193
2017,6239,2985,4964,128660,130722,453,9.194,379,7.692,17587,4186,13401,3.202,13.454,21559,5174,16385,3.958,16.492,-3972,-3.039,26.907,193,211,2368
2017,6241,60100,77800,1731914,1711749,9742,12.677,7832,10.192,270585,61592,208993,3.598,15.808,231124,55487,175637,3.242,13.502,39461,2.305,27.004,5406,5531,33623
2017,6242,10565,15010,215760,212522,737,4.918,688,4.591,34897,5869,29028,2.762,16.420,28023,5125,22898,2.412,13.186,6874,3.234,26.372,334,355,2266
2017,6243,3946,7466,308190,312972,381,5.078,455,6.064,37176,6303,30873,2.014,11.878,47206,7468,39738,2.386,15.083,-10030,-3.205,23.757,155,159,1536
2017,6244,56132,71590,953799,941700,6283,8.809,5753,8.066,134344,43883,90461,4.660,14.266,110380,39750,70630,4.221,11.721,23964,2.545,23.443,4225,4297,26672
2017,7111,7481,7639,128727,127890,879,11.577,786,10.352,20604,5549,15055,4.339,16.111,18956,5095,13861,3.984,14.822,1648,1.289,29.644,578,578,3377
2017,7112,3426,3623,133848,134229,433,11.965,425,11.744,17201,3484,13717,2.596,12.815,17847,3421,14426,2.549,13.296,-646,-0.481,25.629,339,339,1724
2017,7113,6350,6792,177090,175154,763,11.302,681,10.087,29630,4946,24684,2.824,16.917,25316,10926,14390,6.238,14.454,4314,2.463,28.907,477,478,3294
2017,7114,3112,3255,21812,21217,446,13.725,435,13.387,3985,1601,2384,7.546,18.783,2817,1153,1664,5.434,13.277,1168,5.505,26.555,306,307,778
2017,7115,16774,16823,50314,48230,3501,21.468,2471,15.152,14369,8559,5810,17.746,29.793,10135,5305,4830,10.999,21.014,4234,8.779,42.028,1794,1794,4071
2017,7121,6730,7235,155126,153243,338,4.687,292,4.049,13225,1917,11308,1.251,8.630,9496,1764,7732,1.151,6.197,3729,2.433,12.393,213,213,1433
2017,7131,2642,3227,213888,207519,752,24.835,354,11.691,28001,6997,21004,3.372,13.493,15863,4235,11628,2.041,7.644,12138,5.849,15.288,273,273,2925
2017,7132,1804,2825,154046,152929,248,8.782,246,8.711,14717,5914,8803,3.867,9.623,12440,4253,8187,2.781,8.134,2277,1.489,16.269,117,137,1795
2017,7139,53648,62617,1342538,1324100,7696,12.476,5830,9.451,189279,72473,116806,5.473,14.295,151837,51097,100740,3.859,11.467,37442,2.828,22.934,4591,4612,37532
2017,7211,41632,52819,2014408,2002985,4739,9.039,3963,7.559,219271,89670,129601,4.477,10.947,197689,74901,122788,3.739,9.870,21582,1.077,19.739,2745,2810,42730
2017,7212,5474,6085,47208,46136,533,8.834,430,7.127,8317,1777,6540,3.852,18.027,6196,1800,4396,3.902,13.430,2121,4.597,26.860,281,281,939
2017,7213,1699,1876,10732,10963,118,6.227,156,8.232,1631,501,1130,4.570,14.877,2066,1014,1052,9.249,18.845,-435,-3.968,29.755,113,125,892
2017,7223,15176,38819,817125,783772,8147,21.458,6444,16.972,229029,112002,117027,14.290,29.221,169477,99837,69640,12.738,21.623,59552,7.598,43.247,1908,1961,10705
2017,7224,34864,35677,337194,336181,3447,9.601,3897,10.855,60893,27331,33562,8.130,18.113,59055,26154,32901,7.780,17.566,1838,0.547,35.133,3234,3249,21089
2017,7225,377365,522106,10772881,10662362,51781,10.014,41740,8.072,1676931,760517,916414,7.133,15.728,1457428,494828,962600,4.641,13.669,219503,2.059,27.338,31011,32391,351516
2017,8111,135306,150162,913576,903302,12707,8.485,11915,7.956,143665,57141,86524,6.326,15.904,122476,43641,78835,4.831,13.559,21189,2.346,27.117,9248,9449,33409
2017,8112,9782,11256,104841,104556,1241,11.013,1266,11.235,17179,6951,10228,6.648,16.430,16637,6445,10192,6.164,15.912,542,0.518,31.824,918,941,3804
2017,8113,18004,19754,199295,197730,1547,7.798,1717,8.655,30904,7136,23768,3.609,15.629,27675,10195,17480,5.156,13.996,3229,1.633,27.993,1242,1259,5334
2017,8114,17920,18778,74112,72936,2276,12.220,1971,10.582,12994,5411,7583,7.419,17.816,10417,4556,5861,6.247,14.282,2577,3.533,28.565,1577,1583,3515
2017,8121,101824,118808,715405,708772,15042,12.826,11976,10.212,129487,61161,68326,8.629,18.269,115651,45947,69704,6.483,16.317,13836,1.952,32.634,9335,9495,34223
2017,8122,14109,19979,142972,141369,966,4.820,1092,5.449,22311,4845,17466,3.427,15.782,18738,6087,12651,4.306,13.255,3573,2.527,26.509,485,519,1815
2017,8123,26762,31925,288309,289864,2191,6.808,2705,8.405,35187,10688,24499,3.687,12.139,38433,12396,26037,4.276,13.259,-3246,-1.120,24.278,2025,2139,8787
2017,8129,30990,40648,320426,315184,5846,14.627,4485,11.222,56863,22062,34801,7.000,18.041,45653,20111,25542,6.381,14.485,11210,3.557,28.969,3115,3155,13911
2017,8131,179063,179738,1690389,1678399,8017,4.561,57,0.032,131993,21755,110238,1.296,7.864,108597,120,108477,0.007,6.470,23396,1.394,12.941,35,35,70
2017,8132,17274,19120,200612,198018,1429,7.497,1313,6.888,24859,4767,20092,2.407,12.554,19642,6408,13234,3.236,9.919,5217,2.635,19.839,948,979,3908
2017,8133,14494,17251,185627,181867,1302,7.591,1106,6.448,24809,4326,20483,2.379,13.641,17349,4407,12942,2.423,9.539,7460,4.102,19.079,751,752,2987
2017,8134,22825,24803,249047,247356,1422,5.729,1458,5.874,29656,5138,24518,2.077,11.989,26090,5554,20536,2.245,10.548,3566,1.442,21.095,1057,1063,3841
2017,8139,52752,54882,485336,485882,2206,4.032,1859,3.398,45183,8730,36453,1.797,9.299,46431,7936,38495,1.633,9.556,-1248,-0.257,18.598,1444,1453,6116
2018,2111,4516,5791,109676,111245,377,6.416,547,9.309,10775,3213,7562,2.888,9.686,14095,4073,10022,3.661,12.670,-3320,-2.984,19.372,412,426,1604
2018,2121,372,678,49798,49997,42,6.030,79,11.342,5452,940,4512,1.880,10.905,5725,1921,3804,3.842,11.451,-273,-0.546,21.810,42,43,865
2018,2122,200,265,35155,35996,33,12.524,30,11.385,1807,299,1508,0.831,5.020,3566,695,2871,1.931,9.907,-1759,-4.887,10.040,27,28,230
2018,2123,2649,4836,90614,90134,230,4.745,253,5.219,11456,2308,9148,2.561,12.710,10236,2017,8219,2.238,11.356,1220,1.354,22.713,162,170,1103
2018,2131,9606,12148,328430,311276,1484,12.260,1396,11.533,78255,14999,63256,4.819,25.140,43485,20376,23109,6.546,13.970,34770,11.170,27.940,977,1016,7396
2018,2211,1807,11309,506766,507571,1619,14.622,1145,10.341,64365,36787,27578,7.248,12.681,65663,33845,31818,6.668,12.937,-1298,-0.256,25.362,92,100,485
2018,2212,385,2422,88186,87747,93,3.803,140,5.725,5838,1644,4194,1.874,6.653,5061,1788,3273,2.038,5.768,777,0.886,11.535,26,27,317
2018,2213,3463,4584,45144,44385,216,4.704,231,5.031,5509,1707,3802,3.846,12.412,3923,1434,2489,3.231,8.839,1586,3.573,17.677,131,132,402
2018,2361,146638,148031,768227,744237,26055,17.989,19672,13.582,173724,72125,101599,9.691,23.343,125777,53909,71868,7.244,16.900,47947,6.442,33.800,16201,16218,44167
2018,2362,35600,37080,680440,668796,3451,9.320,3350,9.047,109455,22736,86719,3.400,16.366,85628,16531,69097,2.472,12.803,23827,3.563,25.607,2798,2807,13654
2018,2371,16035,17640,568383,556336,1270,7.199,1274,7.221,93318,15071,78247,2.709,16.774,69227,12579,56648,2.261,12.443,24091,4.330,24.887,1003,1017,8485
2018,2372,4011,4106,25593,25360,396,9.592,441,10.682,3902,1155,2747,4.554,15.386,3402,1293,2109,5.099,13.415,500,1.972,26.830,393,395,1100
2018,2373,7698,8549,289765,285928,490,5.710,555,6.467,39108,4149,34959,1.451,13.678,31792,3997,27795,1.398,11.119,7316,2.559,22.238,443,443,2692
2018,2379,3674,3807,98140,93007,393,10.383,349,9.221,21118,10353,10765,11.131,22.706,10571,2909,7662,3.128,11.366,10547,11.340,22.732,282,282,1486
2018,2381,77143,78063,866832,847913,9834,12.723,8290,10.726,166110,43265,122845,5.103,19.590,128334,35051,93283,4.134,15.135,37776,4.455,30.271,6562,6568,28387
2018,2382,163336,168038,2064902,2021787,15687,9.406,13176,7.900,307868,65134,242734,3.222,15.228,222019,60409,161610,2.988,10.981,85849,4.246,21.963,11092,11130,48833
2018,2383,98999,100165,808000,794281,13195,13.313,11087,11.186,150822,47247,103575,5.948,18.989,123706,36260,87446,4.565,15.575,27116,3.414,31.149,9073,9076,28623
2018,2389,57430,58216,616811,604927,6991,12.154,5595,9.727,105139,25947,79192,4.289,17.380,80884,20762,60122,3.432,13.371,24255,4.010,26.742,4500,4503,17127
2018,3111,1147,1769,55751,54604,109,6.216,78,4.448,5942,984,4958,1.802,10.882,3633,1254,2379,2.297,6.653,2309,4.229,13.307,52,55,581
2018,3112,529,877,59200,58128,38,4.328,40,4.556,7120,281,6839,0.483,12.249,4671,832,3839,1.431,8.036,2449,4.213,16.071,30,31,601
2018,3113,1629,1802,80235,80230,117,6.466,132,7.295,6547,879,5668,1.096,8.160,6640,1518,5122,1.892,8.276,-93,-0.116,16.321,110,114,861
2018,3114,1427,1787,159091,158193,132,7.393,129,7.225,14488,3409,11079,2.155,9.158,12823,2507,10316,1.585,8.106,1665,1.053,16.212,103,105,1486
2018,3115,1091,1605,148850,147391,98,6.144,78,4.890,10928,1901,9027,1.290,7.414,7976,1586,6390,1.076,5.411,2952,2.003,10.823,59,59,913
2018,3116,2705,3341,522816,515996,156,4.653,180,5.368,35938,5259,30679,1.019,6.965,21935,5078,16857,0.984,4.251,14003,2.714,8.502,153,153,2219
2018,3117,415,505,30162,30562,41,8.225,28,5.617,2686,699,1987,2.287,8.789,3496,608,2888,1.989,11.439,-810,-2.650,17.577,23,23,181
2018,3118,9736,10544,293076,292395,918,8.703,925,8.770,31387,8162,23225,2.791,10.734,30083,9531,20552,3.260,10.288,1304,0.446,20.577,812,815,5535
2018,3119,3161,3663,214493,211471,410,11.398,278,7.729,24298,5646,18652,2.670,11.490,18179,4014,14165,1.898,8.596,6119,2.894,17.193,239,240,2273
2018,3121,8180,8902,227726,217932,1271,14.958,461,5.425,35069,11563,23506,5.306,16.092,15371,3895,11476,1.787,7.053,19698,9.039,14.106,392,396,3040
2018,3122,110,134,13361,13496,10,7.353,14,10.294,1082,38,1044,0.282,8.017,1320,122,1198,0.904,9.781,-238,-1.764,16.035,13,13,120
2018,3131,208,263,22746,23085,19,7.024,34,12.569,1791,204,1587,0.884,7.758,2522,691,1831,2.993,10.925,-731,-3.167,15.517,28,28,394
2018,3132,710,794,45184,45048,37,4.605,56,6.970,3465,678,2787,1.505,7.692,3219,668,2551,1.483,7.146,246,0.546,14.291,51,51,464
2018,3133,756,795,26863,27119,65,8.197,61,7.692,2269,446,1823,1.645,8.367,2813,618,2195,2.279,10.373,-544,-2.006,16.734,51,51,473
2018,3141,1482,1587,49924,50928,84,5.221,128,7.955,4038,803,3235,1.577,7.929,6169,1186,4983,2.329,12.113,-2131,-4.184,15.858,108,108,698
2018,3149,3733,3832,59225,58810,320,8.366,306,8.000,6638,1889,4749,3.212,11.287,5872,1513,4359,2.573,9.985,766,1.302,19.969,264,264,1183
2018,3151,202,210,11007,11280,11,5.164,17,7.981,638,57,581,0.505,5.656,1224,265,959,2.349,10.851,-586,-5.195,11.312,15,15,132
2018,3152,4112,4161,65640,69234,576,13.563,748,17.612,9589,4285,5304,6.189,13.850,16963,7510,9453,10.847,24.501,-7374,-10.651,27.700,680,680,6439
2018,3159,516,521,8111,8229,64,12.296,63,12.104,905,311,594,3.780,10.998,1154,416,738,5.056,14.024,-249,-3.026,21.997,51,51,213
2018,3161,152,161,3340,3491,10,6.079,17,10.334,179,26,153,0.745,5.128,490,67,423,1.919,14.038,-311,-8.910,10.256,15,15,32
2018,3162,204,220,11565,12014,15,6.834,14,6.378,827,387,440,3.221,6.884,1721,111,1610,0.924,14.326,-894,-7.442,13.768,11,11,20
2018,3169,711,717,11449,11515,63,8.672,82,11.287,1209,307,902,2.666,10.499,1347,438,909,3.804,11.698,-138,-1.198,20.999,77,77,395
2018,3211,2574,3038,93825,92753,190,6.235,209,6.858,9490,2722,6768,2.935,10.231,7246,2369,4877,2.554,7.812,2244,2.419,15.624,157,157,1061
2018,3212,1030,1395,77773,77375,54,3.861,61,4.362,7687,976,6711,1.261,9.935,6967,1542,5425,1.993,9.004,720,0.931,18.009,49,49,732
2018,3219,8047,9141,242144,240236,706,7.749,645,7.080,26287,7016,19271,2.920,10.942,22711,7766,14945,3.233,9.454,3576,1.489,18.907,535,537,5585
2018,3221,230,444,98493,99345,18,4.059,17,3.833,4088,550,3538,0.554,4.115,5683,896,4787,0.902,5.720,-1595,-1.606,8.230,8,8,368
2018,3222,2175,3447,243287,242503,99,2.843,170,4.882,18098,3050,15048,1.258,7.463,16445,4527,11918,1.867,6.781,1653,0.682,13.563,134,134,3040
2018,3231,21927,23308,429767,436728,1241,5.249,1909,8.075,36475,8317,28158,1.904,8.352,50041,18281,31760,4.186,11.458,-13566,-3.106,16.704,1586,1595,10138
2018,3241,897,2066,106603,105920,56,2.685,95,4.555,7127,1004,6123,0.948,6.729,5697,927,4770,0.875,5.379,1430,1.350,10.757,59,59,438
2018,3251,1189,2361,154693,155233,85,3.590,99,4.181,11385,2650,8735,1.707,7.334,12436,5340,7096,3.440,8.011,-1051,-0.677,14.668,55,58,1034
2018,3252,1061,1413,106229,104091,64,4.529,64,4.529,12060,1628,10432,1.564,11.586,8049,3181,4868,3.056,7.733,4011,3.853,15.465,45,49,1797
2018,3253,687,936,31973,31348,57,6.113,50,5.362,3311,874,2437,2.788,10.562,2043,227,1816,0.724,6.517,1268,4.045,13.035,43,43,166
2018,3254,1786,2301,254646,252395,211,9.260,166,7.285,25853,4133,21720,1.638,10.243,20887,4670,16217,1.850,8.276,4966,1.968,16.551,125,125,2154
2018,3255,1286,1640,63890,63485,83,5.030,103,6.242,7379,1323,6056,2.084,11.623,6639,3647,2992,5.745,10.458,740,1.166,20.915,68,91,3414
2018,3256,1944,2142,100080,100179,148,6.914,145,6.774,10817,3034,7783,3.029,10.798,11025,4109,6916,4.102,11.005,-208,-0.208,21.595,107,111,2525
2018,3259,1645,2117,83877,83280,124,5.824,148,6.952,7749,1559,6190,1.872,9.305,6575,1409,5166,1.692,7.895,1174,1.410,15.790,113,114,792
2018,3261,7428,9840,647408,641073,334,3.372,464,4.685,58026,9311,48715,1.452,9.051,45749,9858,35891,1.538,7.136,12277,1.915,14.273,365,368,5555
2018,3262,1360,1806,136260,134107,97,5.407,73,4.069,12651,3506,9145,2.614,9.434,8318,1024,7294,0.764,6.203,4333,3.231,12.405,56,56,511
2018,3271,815,993,35002,34143,70,6.969,93,9.258,3769,764,3005,2.238,11.039,2088,659,1429,1.930,6.116,1681,4.923,12.231,77,78,580
2018,3272,1327,1598,96301,95769,111,6.938,115,7.188,6673,1573,5100,1.643,6.968,5579,1090,4489,1.138,5.826,1094,1.142,11.651,94,94,599
2018,3273,3819,8432,174153,173036,370,4.379,403,4.770,22314,5625,16689,3.251,12.896,19892,4329,15563,2.502,11.496,2422,1.400,22.992,193,201,2011
2018,3274,154,304,14281,14101,28,9.428,14,4.714,886,257,629,1.823,6.283,543,117,426,0.830,3.851,343,2.433,7.702,7,7,29
2018,3279,2631,3094,80529,80150,158,5.093,174,5.609,8033,2048,5985,2.555,10.023,7243,1561,5682,1.948,9.037,790,0.986,18.074,134,137,1052
2018,3311,302,465,89932,90004,43,9.389,29,6.332,5878,2423,3455,2.692,6.531,5961,200,5761,0.222,6.623,-83,-0.092,13.062,26,26,169
2018,3312,543,701,49646,49172,41,5.870,36,5.154,4694,617,4077,1.255,9.546,3688,442,3246,0.899,7.500,1006,2.046,15.001,26,26,242
2018,3313,368,502,59935,59032,23,4.568,26,5.164,4438,523,3915,0.886,7.518,2515,404,2111,0.684,4.260,1923,3.258,8.521,22,23,235
2018,3314,650,832,58021,57374,25,2.969,45,5.344,4530,542,3988,0.945,7.896,3135,545,2590,0.950,5.464,1395,2.431,10.928,31,32,313
2018,3315,1356,1541,115784,114852,49,3.145,83,5.327,10194,1109,9085,0.966,8.876,8287,2206,6081,1.921,7.215,1907,1.660,14.431,68,70,1465
2018,3321,2009,2269,107858,106869,65,2.842,102,4.459,8750,781,7969,0.731,8.188,6758,1807,4951,1.691,6.324,1992,1.864,12.647,77,77,871
2018,3322,951,1024,34685,34396,35,3.365,67,6.442,2807,421,2386,1.224,8.161,2258,660,1598,1.919,6.565,549,1.596,13.130,58,58,587
2018,3323,11810,12844,374865,368046,743,5.785,741,5.770,44762,9815,34947,2.667,12.162,31306,8956,22350,2.433,8.506,13456,3.656,17.012,626,632,6523
2018,3324,1129,1441,85661,84935,50,3.421,91,6.226,8156,574,7582,0.676,9.603,6704,1940,4764,2.284,7.893,1452,1.710,15.786,70,70,940
2018,3325,512,556,27533,27711,22,3.922,32,5.704,2068,119,1949,0.429,7.463,2537,490,2047,1.768,9.155,-469,-1.692,14.926,29,29,299
2018,3326,931,1085,38421,38440,40,3.660,56,5.124,3341,725,2616,1.886,8.691,3423,1252,2171,3.257,8.905,-82,-0.213,17.383,46,47,780
2018,3327,21239,21809,377337,372124,1039,4.740,1258,5.739,41116,8732,32384,2.347,11.049,30619,9362,21257,2.516,8.228,10497,2.821,16.456,1091,1097,7623
2018,3328,4826,5381,129397,128369,240,4.451,263,4.877,14607,3803,10804,2.963,11.379,12673,3077,9596,2.397,9.872,1934,1.507,19.745,224,229,1436
2018,3329,5243,5799,256102,254046,414,7.152,393,6.789,25417,7065,18352,2.781,10.005,21223,5279,15944,2.078,8.354,4194,1.651,16.708,321,322,3506
2018,3331,2391,2781,188978,186155,158,5.689,151,5.437,17548,1809,15739,0.972,9.427,11736,2533,9203,1.361,6.304,5812,3.122,12.609,115,119,1350
2018,3332,2768,2943,109231,108283,151,5.123,160,5.428,10060,1663,8397,1.536,9.291,8210,1784,6426,1.648,7.582,1850,1.708,15.164,140,140,1172
2018,3333,1681,1810,70487,70290,102,5.604,122,6.703,6061,1617,4444,2.300,8.623,5725,1283,4442,1.825,8.145,336,0.478,16.290,105,106,1116
2018,3334,1364,1624,129391,128922,62,3.796,81,4.959,8738,971,7767,0.753,6.778,7888,1972,5916,1.530,6.118,850,0.659,12.237,68,68,1340
2018,3335,5978,6232,150347,150017,241,3.836,343,5.459,12579,2879,9700,1.919,8.385,11888,3252,8636,2.168,7.924,691,0.461,15.849,290,291,2326
2018,3336,766,974,106597,106003,35,3.546,61,6.180,12842,4013,8829,3.786,12.115,11608,2186,9422,2.062,10.951,1234,1.164,21.901,37,37,312
2018,3339,4967,5802,304217,298218,406,7.078,274,4.777,29540,5564,23976,1.866,9.906,17574,4007,13567,1.344,5.893,11966,4.013,11.786,206,208,2450
2018,3341,804,836,41988,41725,57,6.714,83,9.776,5639,370,5269,0.887,13.515,5040,1544,3496,3.700,12.079,599,1.436,24.158,67,67,382
2018,3342,1073,1179,74430,76608,68,5.700,96,8.047,4276,856,3420,1.117,5.582,8674,796,7878,1.039,11.323,-4398,-5.741,11.163,83,83,496
2018,3343,415,428,8843,8726,39,9.123,38,8.889,962,219,743,2.510,11.025,701,222,479,2.544,8.033,261,2.991,16.067,35,35,186
2018,3344,3202,3644,257950,257477,168,4.578,219,5.968,18161,2672,15489,1.038,7.053,17184,4885,12299,1.897,6.674,977,0.379,13.348,183,186,2269
2018,3345,4110,4928,382579,385378,391,7.966,352,7.171,30538,8150,22388,2.115,7.924,35884,6001,29883,1.557,9.311,-5346,-1.387,15.848,269,270,2556
2018,3346,370,377,7167,7546,26,6.624,57,14.522,1120,401,719,5.314,14.843,1893,1316,577,17.441,25.088,-773,-10.245,29.687,48,48,346
2018,3351,969,1036,44356,44915,65,6.250,73,7.019,3781,930,2851,2.071,8.418,4902,1584,3318,3.527,10.914,-1121,-2.496,16.836,61,61,721
2018,3352,237,287,52282,51765,29,10.413,12,4.309,3453,1439,2014,2.780,6.671,2362,384,1978,0.742,4.563,1091,2.108,9.126,9,9,48
2018,3353,1657,1986,117154,114785,158,8.061,106,5.408,11808,3168,8640,2.760,10.287,6994,1385,5609,1.207,6.093,4814,4.194,12.186,84,84,719
2018,3359,1711,1988,133543,132763,97,4.861,112,5.613,10729,1720,9009,1.296,8.081,9325,2423,6902,1.825,7.024,1404,1.058,14.048,91,91,890
2018,3361,251,304,213254,210017,27,8.955,22,7.297,12810,659,12151,0.314,6.100,6979,241,6738,0.115,3.323,5831,2.776,6.646,19,19,135
2018,3362,1520,1849,168512,161352,131,7.096,125,6.771,22730,4055,18675,2.513,14.087,8741,2891,5850,1.792,5.417,13989,8.670,10.835,104,106,1536
2018,3363,3625,4615,588851,581732,245,5.319,227,4.928,49012,8633,40379,1.484,8.425,34865,4268,30597,0.734,5.993,14147,2.432,11.987,180,180,2293
2018,3364,1227,1827,374639,370302,264,15.077,112,6.396,32452,13642,18810,3.684,8.764,24723,7946,16777,2.146,6.676,7729,2.087,13.353,89,89,1403
2018,3365,145,228,27622,28359,15,6.682,8,3.563,1663,731,932,2.578,5.864,3130,497,2633,1.753,11.037,-1467,-5.173,11.728,3,3,122
2018,3366,1239,1366,136664,136214,115,8.459,102,7.503,11648,2348,9300,1.724,8.551,10981,1352,9629,0.993,8.062,667,0.490,16.123,87,87,782
2018,3369,769,800,33972,33311,84,10.500,84,10.500,3746,665,3081,1.996,11.246,2422,863,1559,2.591,7.271,1324,3.975,14.542,74,74,385
2018,3371,9354,9634,227017,225805,560,5.755,754,7.748,19530,4984,14546,2.207,8.649,17005,4205,12800,1.862,7.531,2525,1.118,15.062,652,653,3601
2018,3372,3462,3609,118721,118649,202,5.592,208,5.759,11034,2032,9002,1.713,9.300,11000,2381,8619,2.007,9.271,34,0.029,18.542,177,180,1732
2018,3379,591,688,33150,32707,35,4.996,60,8.565,4180,255,3925,0.780,12.780,3319,1350,1969,4.128,10.148,861,2.633,20.296,46,46,455
2018,3391,8394,9414,286894,283812,555,5.830,768,8.067,27026,6598,20428,2.325,9.523,21146,7090,14056,2.498,7.451,5880,2.072,14.901,670,671,4179
2018,3399,13679,14522,274370,266355,1579,11.016,1203,8.393,42048,21871,20177,8.211,15.786,26886,7375,19511,2.769,10.094,15162,5.692,20.188,1064,1067,5854
2018,4231,14417,22267,409189,407160,1330,5.949,1508,6.745,40889,9849,31040,2.419,10.043,36971,10481,26490,2.574,9.080,3918,0.962,18.160,1083,1189,7218
2018,4232,9235,11124,158486,159088,696,6.209,868,7.743,16458,3781,12677,2.377,10.345,17655,5341,12314,3.357,11.098,-1197,-0.752,20.690,714,755,4530
2018,4233,9413,16440,250876,246003,853,5.171,965,5.850,30599,4642,25957,1.887,12.438,21115,7042,14073,2.863,8.583,9484,3.855,17.166,659,725,5277
2018,4234,20355,32151,643088,640466,3199,9.932,3318,10.301,78901,21379,57522,3.338,12.319,73364,25574,47790,3.993,11.455,5537,0.865,22.910,1574,1652,10613
2018,4235,6367,8960,148957,148907,320,3.535,507,5.600,14160,2012,12148,1.351,9.509,13959,3428,10531,2.302,9.374,201,0.135,18.749,361,376,2167
2018,4236,16799,26752,547028,547675,1501,5.455,3032,11.018,57435,8884,48551,1.622,10.487,58548,18756,39792,3.425,10.690,-1113,-0.203,20.974,1295,1353,8163
2018,4237,9292,18327,254053,250935,698,3.799,795,4.326,27553,8872,18681,3.536,10.980,20985,5614,15371,2.237,8.363,6568,2.617,16.725,537,576,4106
2018,4238,35951,53521,763365,754735,2184,4.043,3173,5.874,84796,15512,69284,2.055,11.235,67813,22491,45322,2.980,8.985,16983,2.250,17.970,2066,2248,12990
2018,4239,26163,29369,323106,321834,2319,7.830,2818,9.514,40894,9644,31250,2.997,12.707,38376,13475,24901,4.187,11.924,2518,0.782,23.848,2358,2392,10261
2018,4241,6381,8421,152046,150242,285,3.296,738,8.534,18710,2468,16242,1.643,12.453,14637,6483,8154,4.315,9.742,4073,2.711,19.485,426,449,2162
2018,4242,6193,9436,287489,290817,678,7.194,656,6.960,25437,3633,21804,1.249,8.747,32513,11728,20785,4.033,11.180,-7076,-2.433,17.494,541,551,4118
2018,4243,12282,13400,193036,194389,1181,8.673,1616,11.867,23989,6830,17159,3.514,12.341,26985,9002,17983,4.631,13.882,-2996,-1.541,24.681,1416,1452,7822
2018,4244,24745,32881,859511,845218,2430,7.375,2562,7.776,98870,30286,68584,3.583,11.698,69487,23838,45649,2.820,8.221,29383,3.476,16.442,1932,1951,12873
2018,4245,3030,5793,60901,61445,192,3.282,307,5.247,7122,1283,5839,2.088,11.591,8181,1995,6186,3.247,13.314,-1059,-1.724,23.182,168,182,926
2018,4246,7264,11509,160396,160046,405,3.471,720,6.172,15954,1974,13980,1.233,9.968,15280,5984,9296,3.739,9.547,674,0.421,19.095,436,455,2439
2018,4247,3715,6163,98983,98488,212,3.399,360,5.772,12982,3038,9944,3.085,13.181,11813,4000,7813,4.061,11.994,1169,1.187,23.989,189,199,1608
2018,4248,3177,4195,200483,201977,301,7.185,290,6.922,12934,2840,10094,1.406,6.404,16074,2831,13243,1.402,7.958,-3140,-1.555,12.807,224,229,1807
2018,4249,19370,25860,343557,345404,1694,6.499,2102,8.065,38468,8202,30266,2.375,11.137,42367,15152,27215,4.387,12.266,-3899,-1.129,22.274,1626,1692,9795
2018,4251,36008,38398,312123,314236,3902,10.093,4424,11.444,33269,12642,20627,4.023,10.587,37250,14466,22784,4.604,11.854,-3981,-1.267,21.175,3792,3815,11930
2018,4411,37345,43685,1333261,1332340,3266,7.455,3510,8.012,120011,38791,81220,2.911,9.008,118209,33920,84289,2.546,8.872,1802,0.135,17.745,2964,3032,27104
2018,4412,11052,12828,151402,150783,761,5.916,830,6.453,17854,5497,12357,3.646,11.841,16409,5997,10412,3.977,10.883,1445,0.958,21.765,697,736,5527
2018,4413,25750,56084,530451,535920,2321,4.130,2541,4.522,48229,12424,35805,2.318,8.999,58285,12070,46215,2.252,10.876,-10056,-1.876,17.999,1866,2008,8401
2018,4421,12365,21891,209463,209249,1230,5.570,1617,7.322,24753,7857,16896,3.755,11.829,24579,7142,17437,3.413,11.746,174,0.083,23.493,1154,1237,5352
2018,4422,17110,25381,264726,259472,1536,6.030,1723,6.764,46095,12265,33830,4.727,17.765,37016,7510,29506,2.894,14.266,9079,3.499,28.532,1281,1327,4309
2018,4431,16980,27809,321652,325514,1364,4.731,3408,11.821,36183,5542,30641,1.703,11.116,44243,20396,23847,6.266,13.592,-8060,-2.476,22.231,2099,2624,13475
2018,4441,32698,55112,1217379,1187304,2175,3.931,2618,4.731,112709,14468,98241,1.219,9.493,52813,13838,38975,1.165,4.448,59896,5.045,8.896,1907,2027,10391
2018,4442,11874,16260,156924,157718,857,5.249,991,6.070,18032,4946,13086,3.136,11.433,19809,4659,15150,2.954,12.560,-1777,-1.127,22.866,771,808,3736
2018,4451,60999,87445,2750429,2773561,7625,8.744,7139,8.187,200671,85264,115407,3.074,7.235,250696,67973,182723,2.451,9.039,-50025,-1.804,14.470,5331,5508,34116
2018,4452,16875,21045,179898,179392,2142,10.164,2201,10.444,31754,12839,18915,7.157,17.701,30485,10633,19852,5.927,16.994,1269,0.707,33.987,1653,1760,8110
2018,4453,28063,32148,175593,173267,2318,7.236,2094,6.536,25806,8441,17365,4.872,14.894,21108,6832,14276,3.943,12.182,4698,2.711,24.365,1747,1770,5654
2018,4461,39760,90738,1065367,1051318,5034,5.453,8198,8.880,216450,33947,182503,3.229,20.588,188381,113214,75167,10.769,17.919,28069,2.670,35.837,3268,3592,17219
2018,4471,60945,107545,978452,964729,6572,6.112,6545,6.087,143660,45732,97928,4.740,14.891,113487,34662,78825,3.593,11.764,30173,3.128,23.527,4326,4683,22396
2018,4481,31766,89186,1353395,1370035,5816,6.452,7734,8.580,170973,52420,118553,3.826,12.479,204529,51644,152885,3.770,14.929,-33556,-2.449,24.959,3857,4546,20303
2018,4482,4553,22707,234515,237084,883,3.785,2124,9.105,23412,6057,17355,2.555,9.875,28522,10142,18380,4.278,12.030,-5110,-2.155,19.750,474,513,2105
2018,4483,13840,20796,123240,124771,1179,5.609,1623,7.722,15141,4672,10469,3.744,12.135,18253,5992,12261,4.802,14.629,-3112,-2.494,24.270,1075,1112,3283
2018,4511,23881,34194,443125,447175,2262,6.551,2931,8.489,40080,12356,27724,2.763,8.963,47717,13101,34616,2.930,10.671,-7637,-1.708,17.926,2304,2451,9053
2018,4512,3214,7021,77071,82627,444,6.162,814,11.296,6507,2567,3940,3.107,7.875,17810,2751,15059,3.329,21.555,-11303,-13.680,15.750,330,601,1489
2018,4521,236,7571,880289,889255,442,5.861,383,5.079,40563,6178,34385,0.695,4.561,57099,26548,30551,2.985,6.421,-16536,-1.860,9.123,19,60,1449
2018,4529,6940,44965,1797798,1806538,1689,3.776,1215,2.716,61410,10960,50450,0.607,3.399,79519,12651,66868,0.700,4.402,-18109,-1.002,6.799,841,870,2910
2018,4531,11121,11605,58027,58563,817,6.942,1146,9.737,8651,2534,6117,4.327,14.772,9776,3508,6268,5.990,16.693,-1125,-1.921,29.545,995,1006,3031
2018,4532,15660,24333,205187,210533,1571,6.339,2469,9.963,24316,7076,17240,3.361,11.550,35379,11495,23884,5.460,16.805,-11063,-5.255,23.100,1747,1859,7146
2018,4533,11924,18039,202480,200902,1188,6.492,1710,9.344,25299,5551,19748,2.763,12.593,22408,7045,15363,3.507,11.154,2891,1.439,22.307,1320,1401,4824
2018,4539,33858,45625,304756,298612,4623,10.203,3997,8.821,50748,20884,29864,6.994,16.995,38699,14004,24695,4.690,12.960,12049,4.035,25.919,3253,3409,11970
2018,4541,31203,32868,556121,545679,5633,17.465,4405,13.657,83419,37448,45971,6.863,15.287,62923,21724,41199,3.981,11.531,20496,3.756,23.062,3861,3888,14949
2018,4542,2804,3362,40896,41147,299,8.821,354,10.444,3066,843,2223,2.049,7.451,3598,1491,2107,3.624,8.744,-532,-1.293,14.903,310,317,1257
2018,4543,19932,24528,166948,166517,2485,10.079,2738,11.105,23589,7782,15807,4.673,14.166,22925,9260,13665,5.561,13.767,664,0.399,27.535,2055,2099,7576
2018,4811,411,2198,439107,435229,102,4.605,136,6.140,25441,1903,23538,0.437,5.845,18257,2627,15630,0.604,4.195,7184,1.651,8.390,44,49,924
2018,4812,1818,2051,42684,41663,189,9.148,219,10.600,5815,725,5090,1.740,13.957,3703,974,2729,2.338,8.888,2112,5.069,17.776,171,175,730
2018,4831,674,1039,43668,42927,99,9.492,107,10.259,5268,698,4570,1.626,12.272,3773,1334,2439,3.108,8.789,1495,3.483,17.579,60,60,218
2018,4832,457,528,21753,21775,45,8.483,50,9.425,2139,559,1580,2.567,9.823,2107,737,1370,3.385,9.676,32,0.147,19.353,38,39,516
2018,4841,59655,70304,1038109,1017007,12517,18.376,8144,11.956,149743,54443,95300,5.353,14.724,105687,31817,73870,3.128,10.392,44056,4.332,20.784,6706,6740,22582
2018,4842,38379,42414,478575,476393,4953,11.692,4849,11.447,69108,19975,49133,4.193,14.507,64910,20173,44737,4.235,13.625,4198,0.881,27.251,4031,4068,15949
2018,4851,497,804,58356,57348,57,7.068,62,7.688,4927,1037,3890,1.808,8.591,2938,904,2034,1.576,5.123,1989,3.468,10.246,36,36,489
2018,4852,207,484,16336,14377,93,20.239,44,9.576,5679,3056,2623,21.257,39.502,1601,537,1064,3.735,11.136,4078,28.366,22.272,18,28,180
2018,4853,6442,6622,72714,73506,1019,15.252,1137,17.018,12118,5012,7106,6.818,16.486,13768,5032,8736,6.846,18.730,-1650,-2.245,32.971,1015,1020,4397
2018,4854,2366,4052,231305,232650,240,5.883,295,7.231,20297,5145,15152,2.211,8.724,23795,9614,14181,4.132,10.228,-3498,-1.504,17.449,176,181,3656
2018,4855,1011,1153,32771,33365,94,8.065,119,10.210,3321,618,2703,1.852,9.954,4309,1634,2675,4.897,12.915,-988,-2.961,19.907,101,104,966
2018,4859,4526,5016,104269,103567,782,15.761,673,13.564,15657,4144,11513,4.001,15.118,14223,6392,7831,6.172,13.733,1434,1.385,27.466,539,553,5247
2018,4861,74,697,12327,12509,40,5.682,54,7.670,898,362,536,2.894,7.179,1255,505,750,4.037,10.033,-357,-2.854,14.358,6,6,83
2018,4862,104,2092,28197,28437,76,3.512,220,10.166,3062,756,2306,2.659,10.768,3566,1709,1857,6.010,12.540,-504,-1.772,21.535,11,11,142
2018,4869,81,649,8697,8864,18,2.703,52,7.808,963,72,891,0.812,10.865,1332,607,725,6.848,15.028,-369,-4.163,21.730,5,5,52
2018,4871,572,618,11638,11417,72,11.594,78,12.560,2105,537,1568,4.704,18.437,1648,632,1016,5.536,14.435,457,4.003,28.869,66,67,590
2018,4872,1313,1353,14309,14509,198,14.859,157,11.782,1753,522,1231,3.598,12.083,2183,915,1268,6.307,15.046,-430,-2.964,24.165,134,135,780
2018,4879,163,189,2939,2918,20,10.811,12,6.486,209,38,171,1.302,7.162,168,27,141,0.925,5.757,41,1.405,11.515,10,10,25
2018,4881,3760,5543,205899,200706,451,8.173,401,7.267,30750,6480,24270,3.229,15.321,20461,6243,14218,3.111,10.195,10289,5.126,20.389,266,268,2223
2018,4882,513,1373,41125,40847,80,5.780,102,7.370,4909,1113,3796,2.725,12.018,4413,1265,3148,3.097,10.804,496,1.214,21.607,23,23,139
2018,4883,1752,2300,92404,90605,125,5.391,162,6.987,11989,1173,10816,1.295,13.232,7957,1720,6237,1.898,8.782,4032,4.450,17.564,101,102,448
2018,4884,9526,10467,93558,92210,1243,11.976,1068,10.290,16114,5418,10696,5.876,17.475,13327,5131,8196,5.564,14.453,2787,3.022,28.906,875,889,3933
2018,4885,13236,19442,274973,272078,1415,7.218,1739,8.871,38737,9443,29294,3.471,14.237,32757,13679,19078,5.028,12.040,5980,2.198,24.079,1048,1088,5237
2018,4889,1569,1703,17495,17440,202,11.830,211,12.357,2943,885,2058,5.075,16.875,2903,1024,1879,5.872,16.646,40,0.229,33.291,187,187,810
2018,4921,3521,9198,608959,596025,594,6.447,626,6.794,65454,7427,58027,1.246,10.982,39805,8095,31710,1.358,6.678,25649,4.303,13.357,445,469,3729
2018,4922,3377,3910,65548,58474,593,15.284,533,13.737,21583,7767,13816,13.283,36.910,7008,3961,3047,6.774,11.985,14575,24.926,23.970,471,477,3529
2018,4931,7322,15537,921880,895145,1204,7.796,1017,6.585,122203,41080,81123,4.589,13.652,68752,18017,50735,2.013,7.681,53451,5.971,15.361,409,437,5692
2018,5111,10601,14565,330988,341517,781,5.203,1673,11.145,30606,9476,21130,2.775,8.962,52352,15130,37222,4.430,15.329,-21746,-6.367,17.924,935,1008,5960
2018,5112,7767,11043,553923,540723,1947,18.307,1132,10.644,86275,31058,55217,5.744,15.956,59124,20339,38785,3.761,10.934,27151,5.021,21.869,805,834,6957
2018,5121,14014,17264,311492,312169,2112,12.224,2139,12.380,37572,14003,23569,4.486,12.036,38332,12194,26138,3.906,12.279,-760,-0.243,24.072,1697,1708,8270
2018,5122,2800,2977,22859,22388,382,12.849,374,12.580,3854,1811,2043,8.089,17.215,2942,987,1955,4.409,13.141,912,4.074,26.282,297,300,641
2018,5151,3790,7145,200239,204113,222,3.061,435,5.999,12108,2783,9325,1.363,5.932,20253,4355,15898,2.134,9.922,-8145,-3.990,11.864,265,279,1409
2018,5152,351,648,50239,50323,35,5.295,61,9.228,2946,664,2282,1.319,5.854,3158,872,2286,1.733,6.275,-212,-0.421,11.708,32,34,299
2018,5171,3804,35927,771448,766132,3394,9.638,1972,5.600,106183,45255,60928,5.907,13.860,95685,26567,69118,3.468,12.489,10498,1.370,24.979,246,277,1990
2018,5172,1794,16802,263619,259385,1682,10.115,1334,8.023,37739,13898,23841,5.358,14.549,29609,8027,21582,3.095,11.415,8130,3.134,22.830,158,322,2615
2018,5174,372,516,9468,9481,105,21.063,70,14.042,1905,1035,870,10.917,20.093,2017,1170,847,12.340,21.274,-112,-1.181,40.186,62,63,895
2018,5179,4867,6497,82513,81627,946,14.568,939,14.461,14672,4953,9719,6.068,17.975,12913,5365,7548,6.573,15.820,1759,2.155,31.639,738,754,4046
2018,5182,8629,15116,527444,515990,2037,13.693,1558,10.473,90100,24559,65541,4.760,17.462,66974,28289,38685,5.482,12.980,23126,4.482,25.959,912,945,10433
2018,5191,8770,10879,319913,311965,1428,13.141,1403,12.911,54993,19485,35508,6.246,17.628,38496,13318,25178,4.269,12.340,16497,5.288,24.680,966,1072,9302
2018,5211,15,61,19797,19776,0,0.000,0,0.000,347,0,347,0.000,1.755,308,0,308,0.000,1.557,39,0.197,3.115,0,0,0
2018,5221,10520,115498,1945583,1956505,3006,2.579,5164,4.430,168806,31242,137564,1.597,8.628,192952,39964,152988,2.043,9.862,-24146,-1.234,17.256,426,1176,12545
2018,5222,13556,44830,621312,615760,4329,9.696,3965,8.881,96710,30415,66295,4.939,15.706,86556,28021,58535,4.551,14.057,10154,1.649,28.114,1165,1337,9549
2018,5223,10980,24248,274689,271399,1645,6.754,1861,7.641,39815,14429,25386,5.317,14.670,33599,10786,22813,3.974,12.380,6216,2.290,24.760,1102,1245,5631
2018,5231,10144,41525,400543,398214,3853,9.277,3872,9.322,59739,18301,41438,4.596,15.002,54686,11467,43219,2.880,13.733,5053,1.269,27.466,855,898,3281
2018,5232,11,34,9413,7595,(D),(D),(D),(D),4541,(D),225,(D),59.789,798,(D),682,(D),10.507,3743,49.282,21.014,0,0,0
2018,5239,45782,52233,518184,508586,6275,12.167,4956,9.610,77226,34995,42231,6.881,15.184,58306,22144,36162,4.354,11.464,18920,3.720,22.929,3980,4007,13970
2018,5241,5432,32359,1522140,1528319,4689,14.669,3900,12.201,185538,78164,107374,5.114,12.140,198474,48534,149940,3.176,12.986,-12936,-0.846,24.280,362,375,3820
2018,5242,117815,134904,1072348,1024706,12499,9.303,11400,8.485,233693,126166,107527,12.312,22.806,134426,51324,83102,5.009,13.118,99267,9.687,26.237,8684,8828,29464
2018,5250,1883,1923,76180,42368,775,50.276,12,0.778,69004,67020,1984,158.185,162.868,830,21,809,0.050,1.959,68174,160.909,3.918,(D),(D),(D)
2018,5311,86063,113759,573438,565711,11082,9.778,10226,9.023,102707,49863,52844,8.814,18.155,87768,36488,51280,6.450,15.515,14939,2.641,31.029,7814,8059,25700
2018,5312,81872,96844,321083,312237,16803,17.843,11459,12.168,74433,35558,38875,11.388,23.839,56244,27372,28872,8.766,18.013,18189,5.825,36.026,7694,7789,13672
2018,5313,71339,92418,765926,756996,9894,10.832,7744,8.478,107659,37100,70559,4.901,14.222,90054,36066,53988,4.764,11.896,17605,2.326,23.792,5601,5807,23250
2018,5321,3416,15610,173294,166909,981,6.303,891,5.724,26326,4105,22221,2.459,15.773,14286,3529,10757,2.114,8.559,12040,7.214,17.118,395,410,1860
2018,5322,6900,15838,130477,131900,841,5.180,1637,10.083,17207,3559,13648,2.698,13.045,20053,8574,11479,6.500,15.203,-2846,-2.158,26.091,808,859,4983
2018,5323,2005,3812,20665,21090,366,9.467,474,12.261,3235,1313,1922,6.226,15.339,4177,1439,2738,6.823,19.806,-942,-4.467,30.678,154,160,708
2018,5324,7305,14359,190576,187263,1231,8.640,1008,7.075,27260,7329,19931,3.914,14.557,20915,6622,14293,3.536,11.169,6345,3.388,22.338,558,595,3109
2018,5331,2060,2195,37721,37272,281,12.911,244,11.211,4822,1656,3166,4.443,12.937,3879,1078,2801,2.892,10.407,943,2.530,20.815,196,197,817
2018,5411,155085,167005,1148720,1149664,11780,7.025,13142,7.837,119145,31891,87254,2.774,10.363,121002,36454,84548,3.171,10.525,-1857,-0.162,20.727,11036,11164,29192
2018,5412,99363,119495,1242306,1238971,9783,8.203,9320,7.815,144080,38093,105987,3.075,11.629,136274,47647,88627,3.846,10.999,7806,0.630,21.998,7692,7814,35690
2018,5413,80849,100365,1502576,1487157,8425,8.412,8003,7.991,192888,53319,139569,3.585,12.970,163858,51180,112678,3.441,11.018,29030,1.952,22.036,5835,5941,22837
2018,5414,26994,27379,121966,121396,3640,13.380,3290,12.094,19315,7554,11761,6.223,15.911,18248,8664,9584,7.137,15.032,1067,0.879,30.064,2759,2761,6934
2018,5415,100176,120458,1972944,1943388,15214,12.499,17740,14.574,306574,72335,234239,3.722,15.775,248260,110796,137464,5.701,12.775,58314,3.001,25.549,12929,13057,50864
2018,5416,128914,139615,1355896,1319835,24408,17.756,20101,14.623,276141,104699,171442,7.933,20.922,203147,88918,114229,6.737,15.392,72994,5.531,30.784,16708,16878,56837
2018,5417,13834,17187,728665,715406,2101,12.328,1811,10.627,86858,16105,70753,2.251,12.141,59778,15233,44545,2.129,8.356,27080,3.785,16.712,1318,1342,9140
2018,5418,28054,32137,463678,465831,3238,10.027,3547,10.984,53472,20360,33112,4.371,11.479,57780,23404,34376,5.024,12.404,-4308,-0.925,22.958,2916,2972,18714
2018,5419,55680,62590,679338,662685,7005,11.262,6228,10.013,109351,37456,71895,5.652,16.501,75818,35276,40542,5.323,11.441,33533,5.060,22.882,4782,5342,29982
2018,5511,25928,53898,3582558,3527902,2484,4.574,3293,6.064,514190,128611,385579,3.646,14.575,402532,105521,297011,2.991,11.410,111658,3.165,22.820,899,932,15850
2018,5611,25829,28641,485199,472785,3361,11.813,2982,10.481,86329,30109,56220,6.368,18.260,62078,19991,42087,4.228,13.130,24251,5.129,26.261,2412,2428,15483
2018,5612,1752,5813,263433,267311,259,4.314,640,10.660,27504,4807,22697,1.798,10.289,35557,12056,23501,4.510,13.302,-8053,-3.013,20.578,97,101,3086
2018,5613,24203,48666,5841176,5753886,4381,9.013,4263,8.770,968976,211895,757081,3.683,16.840,785630,198442,587188,3.449,13.654,183346,3.186,27.308,2589,2667,91447
2018,5614,21673,28659,807512,806495,2509,8.674,3042,10.517,148092,50148,97944,6.218,18.362,146727,56497,90230,7.005,18.193,1365,0.169,36.386,2279,2323,19264
2018,5615,12600,16216,229097,225060,1377,7.924,3700,21.292,33334,17457,15877,7.757,14.811,24966,10090,14876,4.483,11.093,8368,3.718,22.186,1010,1033,4188
2018,5616,18088,23099,986979,969912,2286,9.914,2203,9.554,126338,29435,96903,3.035,13.026,93169,28545,64624,2.943,9.606,33169,3.420,19.212,1635,1665,16512
2018,5617,156195,165074,1995056,1972708,21724,13.282,18707,11.437,301119,88947,212172,4.509,15.264,254568,80033,174535,4.057,12.904,46551,2.360,25.809,15415,15506,63246
2018,5619,15706,17513,291938,288694,1806,10.349,1682,9.638,45386,11798,33588,4.087,15.721,39465,11595,27870,4.016,13.670,5921,2.051,27.340,1327,1351,7744
2018,5621,7309,11216,222033,218148,718,6.420,655,5.856,26461,8277,18184,3.794,12.130,18448,6848,11600,3.139,8.457,8013,3.673,16.913,495,501,3926
2018,5622,1218,2546,60003,59655,119,4.665,129,5.057,3624,794,2830,1.331,6.075,2919,979,1940,1.641,4.893,705,1.182,9.786,98,98,637
2018,5629,8644,10175,142886,138482,906,8.963,772,7.638,25780,8405,17375,6.069,18.616,16938,5157,11781,3.724,12.231,8842,6.385,24.462,598,619,3759
2018,6111,18690,21369,1065280,1049696,757,3.606,(D),(D),76565,15686,60879,1.494,7.294,45367,(D),45363,(D),4.322,31198,2.972,8.644,(D),(D),(D)
2018,6112,412,769,57769,58928,29,3.844,0,0.000,3912,244,3668,0.414,6.639,6099,0,6099,0.000,10.350,-2187,-3.711,13.277,0,0,0
2018,6113,2357,4238,1856433,1854216,154,3.701,(D),(D),78903,3189,75714,0.172,4.255,73995,(D),73983,(D),3.991,4908,0.265,7.981,0,0,0
2018,6114,6376,6791,60725,59664,842,12.434,804,11.872,10663,3811,6852,6.387,17.872,8581,3486,5095,5.843,14.382,2082,3.490,28.764,618,637,2668
2018,6115,6210,7655,110855,111554,594,7.708,696,9.032,15618,3751,11867,3.362,14.000,17118,5292,11826,4.744,15.345,-1500,-1.345,28.001,488,513,3706
2018,6116,43805,47325,468730,460471,5510,11.798,4264,9.130,78339,24749,53590,5.375,17.013,61844,20121,41723,4.370,13.431,16495,3.582,26.861,3644,3675,17645
2018,6117,7119,7982,115150,110462,1241,15.894,893,11.437,20620,7347,13273,6.651,18.667,10915,3792,7123,3.433,9.881,9705,8.786,19.762,735,739,2970
2018,6211,153602,207305,2685150,2665675,14684,7.045,16966,8.139,354297,122637,231660,4.601,13.291,315077,104910,210167,3.936,11.820,39220,1.471,23.640,12000,12457,60182
2018,6212,117846,128751,947046,944096,6382,4.949,6807,5.278,112858,32672,80186,3.461,11.954,106726,33289,73437,3.526,11.305,6132,0.650,22.609,5896,6007,29629
2018,6213,122534,143245,899353,881396,13808,9.737,10945,7.718,149629,49608,100021,5.628,16.976,113602,45677,67925,5.182,12.889,36027,4.087,25.778,8109,8420,28974
2018,6214,17049,41896,1025566,1010782,3367,8.158,2121,5.139,137157,40928,96229,4.049,13.569,106556,30723,75833,3.040,10.542,30601,3.027,21.084,1054,1120,12774
2018,6215,6696,17148,291760,289657,2783,16.748,1720,10.351,46847,16620,30227,5.738,16.173,42238,15987,26251,5.519,14.582,4609,1.591,29.164,679,717,7221
2018,6216,21826,31395,1529702,1490516,3469,11.146,2926,9.401,242570,54008,188562,3.623,16.274,165123,48044,117079,3.223,11.078,77447,5.196,22.156,2086,2172,28833
2018,6219,6389,11139,336907,335299,1359,12.382,1032,9.403,48204,16642,31562,4.963,14.376,44634,13178,31456,3.930,13.312,3570,1.065,26.623,506,533,6098
2018,6221,2468,5313,5513896,5497390,250,4.778,88,1.682,210582,45356,165226,0.825,3.831,178865,15878,162987,0.289,3.254,31717,0.577,6.507,32,32,6294
2018,6222,422,693,235013,233352,58,8.663,11,1.643,20489,14584,5905,6.250,8.780,16683,2312,14371,0.991,7.149,3806,1.631,14.299,5,5,1212
2018,6223,335,820,260786,261038,32,3.891,37,4.498,13582,2829,10753,1.084,5.203,14442,3231,11211,1.238,5.533,-860,-0.329,10.406,4,4,168
2018,6231,8492,15936,1581302,1589640,1060,6.693,864,5.455,145382,68839,76543,4.330,9.146,162238,58953,103285,3.709,10.206,-16856,-1.060,18.291,446,489,24931
2018,6232,9880,41331,767772,766851,1959,4.760,1607,3.905,89476,22394,67082,2.920,11.668,87774,18692,69082,2.438,11.446,1702,0.222,22.892,563,684,8651
2018,6233,17112,24914,1035343,1021012,1880,7.554,1824,7.329,121031,41625,79406,4.077,11.854,92560,35823,56737,3.509,9.066,28471,2.789,18.131,1369,1426,22706
2018,6239,2985,4955,131266,130254,300,6.033,336,6.756,16784,3270,13514,2.510,12.886,14632,5428,9204,4.167,11.233,2152,1.652,22.467,191,200,2466
2018,6241,53129,70958,1775780,1740312,7510,10.779,4939,7.089,264709,69401,195308,3.988,15.210,190375,54416,135959,3.127,10.939,74334,4.271,21.878,3606,3708,32000
2018,6242,10570,14850,211885,212214,594,3.997,616,4.145,25763,4695,21068,2.212,12.140,26226,4529,21697,2.134,12.358,-463,-0.218,24.280,356,386,2363
2018,6243,3878,7335,300598,302799,329,4.447,457,6.177,31950,4015,27935,1.326,10.552,36155,5782,30373,1.910,11.940,-4205,-1.389,21.103,194,227,1995
2018,6244,56270,71709,971320,961870,5816,8.117,5699,7.954,121740,36861,84879,3.832,12.657,103232,35637,67595,3.705,10.732,18508,1.924,21.465,4554,4663,27467
2018,7111,7597,7760,129811,129298,851,11.053,729,9.469,19952,5321,14631,4.115,15.431,18917,5044,13873,3.901,14.631,1035,0.800,29.261,575,575,3467
2018,7112,3482,3677,138016,135794,447,12.223,407,11.129,16540,3269,13271,2.407,12.180,11975,2723,9252,2.005,8.819,4565,3.362,17.637,343,343,2121
2018,7113,6397,6830,184975,179794,695,10.212,647,9.506,28002,5276,22726,2.934,15.575,17387,5236,12151,2.912,9.671,10615,5.904,19.341,537,540,3428
2018,7114,3172,3305,22855,22348,438,13.356,387,11.801,3826,1149,2677,5.142,17.120,2726,1394,1332,6.238,12.198,1100,4.922,24.396,314,317,989
2018,7115,17568,17616,53424,51931,3537,20.536,2751,15.973,14601,7646,6955,14.724,28.116,11560,5682,5878,10.942,22.261,3041,5.856,44.521,2197,2199,4693
2018,7121,6780,7286,157815,156520,293,4.034,247,3.401,12410,1117,11293,0.714,7.929,9664,1199,8465,0.766,6.174,2746,1.754,12.349,200,202,1006
2018,7131,2869,3205,215609,214797,556,17.297,575,17.888,18557,6607,11950,3.076,8.639,16771,3676,13095,1.711,7.808,1786,0.831,15.616,278,286,3015
2018,7132,1816,2838,153084,153339,195,6.894,176,6.222,9154,2433,6721,1.587,5.970,9596,2426,7170,1.582,6.258,-442,-0.288,11.940,127,137,1798
2018,7139,54901,64136,1377094,1360138,7314,11.544,5753,9.081,193212,77984,115228,5.734,14.205,158887,48951,109936,3.599,11.682,34325,2.524,23.363,4824,4934,38970
2018,7211,42079,53522,2018194,2014087,4651,8.748,3936,7.403,230979,104467,126512,5.187,11.468,223104,78458,144646,3.895,11.077,7875,0.391,22.154,2896,3020,47302
2018,7212,5521,6141,48139,47630,503,8.236,435,7.123,6894,1513,5381,3.177,14.474,5857,1726,4131,3.624,12.297,1037,2.177,24.594,356,360,1270
2018,7213,1690,1862,10752,10721,120,6.433,127,6.808,1833,730,1103,6.809,17.097,1746,407,1339,3.796,16.286,87,0.811,32.572,102,102,249
2018,7223,15961,39418,818142,818124,4236,10.838,3572,9.139,71367,29398,41969,3.593,8.723,70111,31919,38192,3.901,8.570,1256,0.154,17.139,2038,2051,11897
2018,7224,34535,35371,340404,337827,3356,9.458,3584,10.100,61195,27536,33659,8.151,18.114,56148,23579,32569,6.980,16.620,5047,1.494,33.241,3197,3203,21410
2018,7225,383922,528927,11057719,10915784,50077,9.528,43430,8.263,1688733,700443,988290,6.417,15.471,1406441,510201,896240,4.674,12.884,282292,2.586,25.769,33560,35825,389592
2018,8111,135088,150060,934047,923653,11722,7.808,11851,7.894,140464,45802,94662,4.959,15.207,119931,42007,77924,4.548,12.984,20533,2.223,25.969,9807,10101,35056
2018,8112,9619,11018,105991,105030,980,8.802,1212,10.886,16688,5892,10796,5.610,15.889,14682,6853,7829,6.525,13.979,2006,1.910,27.958,978,994,3683
2018,8113,18102,19885,205653,202548,1665,8.398,1546,7.798,29909,9187,20722,4.536,14.766,23792,7230,16562,3.570,11.746,6117,3.020,23.493,1295,1305,4953
2018,8114,17830,18541,74624,73835,1972,10.610,2062,11.094,11835,4682,7153,6.341,16.029,10291,4282,6009,5.799,13.938,1544,2.091,27.876,1774,1776,3684
2018,8121,105010,120725,739006,727084,15152,12.650,13257,11.068,135230,62543,72687,8.602,18.599,111716,48688,63028,6.696,15.365,23514,3.234,30.730,10067,10295,38538
2018,8122,13938,19787,135222,139078,656,3.299,850,4.275,11822,2569,9253,1.847,8.500,19184,3868,15316,2.781,13.794,-7362,-5.293,17.001,596,660,3168
2018,8123,26203,31220,283977,285754,1901,6.022,2599,8.233,30245,10187,20058,3.565,10.584,33948,10912,23036,3.819,11.880,-3703,-1.296,21.169,2105,2214,8681
2018,8129,32674,42334,340369,329327,6137,14.808,4357,10.513,69837,26812,43025,8.141,21.206,46685,20104,26581,6.105,14.176,23152,7.030,28.352,3273,3385,14071
2018,8131,178388,179184,1694551,1680514,7178,4.088,18,0.010,135839,21398,114441,1.273,8.083,108000,58,107942,0.003,6.427,27839,1.657,12.853,16,16,56
2018,8132,17593,19726,204634,202226,1729,8.897,1143,5.882,25219,7597,17622,3.757,12.471,20441,5072,15369,2.508,10.108,4778,2.363,20.216,927,938,3131
2018,8133,14746,17542,190114,188871,1274,7.301,1087,6.230,22345,4035,18310,2.136,11.831,19856,4656,15200,2.465,10.513,2489,1.318,21.026,776,800,2884
2018,8134,22805,24781,249090,249841,1445,5.831,1449,5.847,26559,4820,21739,1.929,10.630,28051,7928,20123,3.173,11.228,-1492,-0.597,21.261,1197,1213,6645
2018,8139,52779,54831,492296,486808,2755,5.062,1941,3.566,48574,11458,37116,2.354,9.978,37404,6593,30811,1.354,7.684,11170,2.295,15.367,1681,1700,5629
