year,vcnaics3,firms,estabs,emp,denom,estabs_entry,estabs_entry_rate,estabs_exit,estabs_exit_rate,job_creation,job_creation_births,job_creation_continuers,job_creation_rate_births,job_creation_rate,job_destruction,job_destruction_deaths,job_destruction_continuers,job_destruction_rate_deaths,job_destruction_rate,net_job_creation,net_job_creation_rate,reallocation_rate,firmdeath_firms,firmdeath_estabs,firmdeath_emp
1978,211,5249,7001,119104,116723,957,13.777,848,12.208,29591,10797,18794,9.250,25.352,24781,12612,12169,10.805,21.231,4810,4.121,42.461,387,398,1624
1978,212,7342,9841,369725,387831,1593,16.390,1350,13.890,70596,28099,42497,7.245,18.203,106326,32382,73944,8.350,27.416,-35730,-9.213,36.406,738,745,9916
1978,213,6872,7972,218503,202151,1692,22.030,1109,14.439,73704,28440,45264,14.069,36.460,41675,18025,23650,8.917,20.616,32029,15.844,41.232,637,646,5055
1978,221,5674,11799,657194,641515,928,7.967,626,5.374,82181,22114,60067,3.447,12.810,51340,13986,37354,2.180,8.003,30841,4.808,16.006,216,219,1795
1978,236,134452,135441,1168587,1076829,34678,27.053,20168,15.733,423835,154881,268954,14.383,39.360,241295,88763,152532,8.243,22.408,182540,16.952,44.816,15568,15577,64393
1978,237,35238,36233,742422,709244,6092,17.169,4590,12.936,214500,59982,154518,8.457,30.243,147104,40457,106647,5.704,20.741,67396,9.503,41.482,3393,3404,22390
1978,238,256376,259268,2167340,2014136,50890,20.366,32118,12.853,705292,220483,484809,10.947,35.017,397535,147339,250196,7.315,19.737,307757,15.280,39.475,24895,24903,103432
1978,311,22964,29006,1378953,1354343,2808,9.645,3021,10.377,205289,72180,133109,5.330,15.158,156670,70191,86479,5.183,11.568,48619,3.590,23.136,1922,1961,24533
1978,312,2491,3181,229651,226841,222,6.921,275,8.574,29707,8607,21100,3.794,13.096,23455,10674,12781,4.706,10.340,6252,2.756,20.680,147,148,2492
1978,313,3674,4822,627509,630492,408,8.435,438,9.055,56056,17663,38393,2.801,8.891,61567,27513,34054,4.364,9.765,-5511,-0.874,17.782,274,275,7253
1978,314,7853,8312,282768,272388,1132,13.850,854,10.449,54272,17733,36539,6.510,19.925,33686,15017,18669,5.513,12.367,20586,7.558,24.734,625,626,5538
1978,315,16558,18793,1214531,1203063,2495,13.309,2402,12.813,199694,73041,126653,6.071,16.599,176891,84902,91989,7.057,14.703,22803,1.895,29.407,1795,1811,43491
1978,316,2379,2791,248170,249638,255,9.083,288,10.258,31566,8099,23467,3.244,12.645,34955,16330,18625,6.541,14.002,-3389,-1.358,25.289,196,199,3563
1978,321,14709,16570,569965,545898,2126,12.965,1781,10.861,111432,35850,75582,6.567,20.413,63522,30773,32749,5.637,11.636,47910,8.776,23.273,1245,1252,12077
1978,322,3709,5731,612034,603718,549,9.796,296,5.281,58944,20851,38093,3.454,9.764,41976,18751,23225,3.106,6.953,16968,2.811,13.906,138,138,2806
1978,323,29585,30903,602528,584287,3643,11.985,2632,8.659,94468,26958,67510,4.614,16.168,58219,28387,29832,4.858,9.964,36249,6.204,19.928,1939,1946,11456
1978,324,1446,2279,452321,453049,226,9.978,198,8.742,30562,7235,23327,1.597,6.746,32562,3521,29041,0.777,7.187,-2000,-0.441,13.492,66,66,802
1978,325,7956,11500,921025,912199,1029,8.963,990,8.623,92931,24577,68354,2.694,10.188,74869,34602,40267,3.793,8.208,18062,1.980,16.415,493,497,5730
1978,326,9800,11588,714974,689333,1413,12.413,1004,8.820,113400,29926,83474,4.341,16.451,62607,25330,37277,3.675,9.082,50793,7.368,18.165,661,663,9037
1978,327,12549,15543,579589,564774,1548,10.017,1371,8.871,84289,18737,65552,3.318,14.924,54733,21205,33528,3.755,9.691,29556,5.233,19.382,870,884,6433
1978,331,4543,5686,776783,763284,419,7.374,411,7.233,79439,16189,63250,2.121,10.408,53127,23526,29601,3.082,6.960,26312,3.447,13.921,243,245,4183
1978,332,44480,48170,1737935,1671040,5118,10.927,2454,5.239,283972,67434,216538,4.035,16.994,150738,54815,95923,3.280,9.021,133234,7.973,18.041,1586,1596,19590
1978,333,24773,27392,1736170,1688029,2612,9.659,1915,7.081,249164,63667,185497,3.772,14.761,152520,64535,87985,3.823,9.035,96644,5.725,18.071,1231,1234,11311
1978,334,9564,11018,1434447,1385225,1520,14.008,1186,10.930,225810,47994,177816,3.465,16.301,127384,51076,76308,3.687,9.196,98426,7.105,18.392,763,766,13527
1978,335,4767,5831,692447,679246,656,11.369,534,9.255,102932,30296,72636,4.460,15.154,76701,43305,33396,6.375,11.292,26231,3.862,22.584,271,272,3603
1978,336,8317,9838,2083473,2040768,1153,11.216,2037,19.815,234984,51319,183665,2.515,11.514,149281,49667,99614,2.434,7.315,85703,4.200,14.630,1556,1557,13097
1978,337,14751,15619,542223,518073,2205,14.364,1669,10.872,101691,29302,72389,5.656,19.629,52633,27986,24647,5.402,10.159,49058,9.469,20.319,1228,1234,11092
1978,339,23326,24567,681242,660229,3314,13.708,2533,10.477,122511,35848,86663,5.430,18.556,80748,33915,46833,5.137,12.230,41763,6.326,24.461,1880,1885,14005
1978,423,135074,175529,2150433,2068468,23847,13.863,16820,9.778,467217,171833,295384,8.307,22.588,304083,145282,158801,7.024,14.701,163134,7.887,29.402,9819,10041,51549
1978,424,90656,116574,1536122,1500439,13949,12.058,12174,10.523,320021,110085,209936,7.337,21.328,247784,118048,129736,7.868,16.514,72237,4.814,33.028,7490,7625,46318
1978,425,24156,26718,262560,253835,3649,13.978,2424,9.285,58195,20484,37711,8.070,22.926,40913,18818,22095,7.413,16.118,17282,6.808,32.236,1473,1477,6991
1978,441,92223,110032,1304292,1252966,13157,12.157,9549,8.823,234789,80660,154129,6.438,18.739,132013,52697,79316,4.206,10.536,102776,8.203,21.072,6865,7007,35878
1978,442,40849,46649,321763,305113,7750,17.067,5273,11.612,82516,36865,45651,12.082,27.044,49080,23257,25823,7.622,16.086,33436,10.959,32.172,3743,3836,13475
1978,443,25563,32161,180214,170092,5657,17.964,4318,13.712,50991,25020,25971,14.710,29.978,31074,16544,14530,9.727,18.269,19917,11.710,36.538,2773,2842,9868
1978,444,67101,83217,719850,686770,9763,11.937,6906,8.444,158954,59894,99060,8.721,23.145,92208,40185,52023,5.851,13.426,66746,9.719,26.853,4498,4552,18116
1978,445,117002,165773,1908733,1837950,22732,13.772,21294,12.901,435580,200024,235556,10.883,23.699,295575,146509,149066,7.971,16.082,140005,7.617,32.164,13609,13855,60818
1978,446,37806,51999,484933,478488,5986,11.701,4305,8.415,96048,42853,53195,8.956,20.073,83856,43682,40174,9.129,17.525,12192,2.548,35.050,2180,2251,12628
1978,447,122704,153806,865287,832859,21880,14.017,26469,16.956,250920,103303,147617,12.403,30.128,185750,95951,89799,11.521,22.303,65170,7.825,44.605,18354,18649,61833
1978,448,86743,140954,1030920,998246,21361,15.378,17268,12.431,262551,118051,144500,11.826,26.301,198021,97880,100141,9.805,19.837,64530,6.464,39.674,8940,9406,38759
1978,451,37281,46944,276760,263679,8833,19.259,6672,14.548,80205,36950,43255,14.013,30.418,53947,26907,27040,10.204,20.459,26258,9.958,40.919,4533,4607,16428
1978,452,15672,37079,1921284,1871196,3819,10.293,3865,10.417,310277,130743,179534,6.987,16.582,211112,70583,140529,3.772,11.282,99165,5.300,22.564,1983,2050,10641
1978,453,70346,80784,399187,375947,14687,18.629,10799,13.697,120059,50199,69860,13.353,31.935,73477,36884,36593,9.811,19.545,46582,12.391,39.089,7663,7804,21760
1978,454,26240,34558,352609,343529,4586,13.380,4019,11.726,85808,42248,43560,12.298,24.978,68273,30981,37292,9.018,19.874,17535,5.104,39.748,2409,2435,11931
1978,481,1252,2630,233434,225178,389,14.654,438,16.500,39668,3837,35831,1.704,17.616,23273,5763,17510,2.559,10.335,16395,7.281,20.671,150,151,1006
1978,483,858,1202,51683,49622,197,16.589,168,14.147,14334,8045,6289,16.213,28.887,10027,5597,4430,11.279,20.207,4307,8.680,40.414,90,103,2372
1978,484,58920,67494,1040424,1002602,12598,18.982,10343,15.585,261968,95207,166761,9.496,26.129,187700,81567,106133,8.136,18.721,74268,7.408,37.443,7428,7441,29469
1978,485,11861,12642,244791,243022,1859,14.785,1722,13.695,48108,14947,33161,6.150,19.796,44376,20083,24293,8.264,18.260,3732,1.536,36.520,1394,1400,13110
1978,486,307,1454,69100,65650,189,13.390,104,7.368,14775,7094,7681,10.806,22.506,8090,3752,4338,5.715,12.323,6685,10.183,24.646,15,15,128
1978,487,847,865,13527,11819,177,20.775,151,17.723,5169,1578,3591,13.352,43.737,1756,851,905,7.201,14.858,3413,28.878,29.716,118,118,586
1978,488,9298,12514,299488,281496,2140,17.580,1458,11.977,90908,38623,52285,13.721,32.295,55331,22929,32402,8.145,19.656,35577,12.639,39.312,874,887,6471
1978,492,2079,2462,96121,94785,576,23.160,626,25.171,14210,2655,11555,2.801,14.992,11746,5706,6040,6.020,12.392,2464,2.600,24.785,476,476,1837
1978,493,5511,8568,379870,369458,958,11.333,729,8.624,73185,22695,50490,6.143,19.809,52116,14048,38068,3.802,14.106,21069,5.703,28.212,247,248,1569
1978,511,15389,17398,609073,591669,2762,16.318,1819,10.746,91442,30339,61103,5.128,15.455,57049,29190,27859,4.934,9.642,34393,5.813,19.284,1229,1236,9156
1978,512,8811,14219,185701,182534,2621,18.609,2352,16.699,57604,25244,32360,13.830,31.558,50946,27556,23390,15.096,27.910,6658,3.648,55.821,1174,1264,10228
1978,515,5170,6046,169347,162091,599,10.070,404,6.792,30751,11094,19657,6.844,18.972,16338,7245,9093,4.470,10.080,14413,8.892,20.159,275,281,3574
1978,517,3016,16901,982106,955099,968,5.754,812,4.827,161554,15960,145594,1.671,16.915,106861,8632,98229,0.904,11.188,54693,5.726,22.377,199,202,1690
1978,518,4499,5924,162913,156343,1221,21.333,820,14.327,43597,18239,25358,11.666,27.885,30594,15266,15328,9.764,19.569,13003,8.317,39.137,407,414,3687
1978,519,1941,2315,27178,27416,271,12.061,135,6.008,5058,1148,3910,4.187,18.449,5665,3801,1864,13.864,20.663,-607,-2.214,36.898,92,93,2920
1978,521,21,53,23522,23823,(D),(D),0,0.000,1112,(D),1083,(D),4.668,1697,0,1697,0.000,7.123,-585,-2.456,9.336,0,0,0
1978,522,45951,101178,1870249,1818427,8648,8.645,6361,6.359,297598,84247,213351,4.633,16.366,192818,63104,129714,3.470,10.604,104780,5.762,21.207,1701,1729,11611
1978,523,12025,15843,227551,227034,2883,18.572,2244,14.456,50755,17015,33740,7.494,22.356,49459,20012,29447,8.815,21.785,1296,0.571,43.570,1440,1514,8659
1978,524,87768,112377,1887897,1832432,14297,12.986,9739,8.846,339576,94455,245121,5.155,18.531,227214,100523,126691,5.486,12.400,112362,6.132,24.799,5445,5460,17705
1978,525,1271,1485,21000,21257,324,23.589,101,7.353,3772,2206,1566,10.378,17.745,4671,747,3924,3.514,21.974,-899,-4.229,35.490,60,60,278
1978,531,150793,154657,805309,767815,25478,16.740,20555,13.506,228837,95843,132994,12.483,29.804,152757,76514,76243,9.965,19.895,76080,9.909,39.790,16432,16451,50414
1978,532,17073,21780,196684,186644,4833,23.211,2917,14.009,64336,31740,32596,17.006,34.470,44369,20583,23786,11.028,23.772,19967,10.698,47.544,1811,1842,8705
1978,533,843,957,12204,12557,196,21.087,141,15.169,3822,1461,2361,11.635,30.437,4665,2008,2657,15.991,37.151,-843,-6.713,60.874,91,91,269
1978,541,235184,249937,2202280,2102184,42625,17.652,25699,10.643,545018,210338,334680,10.006,25.926,345876,166175,179701,7.905,16.453,199142,9.473,32.906,17877,18163,103978
1978,551,18835,35415,2364453,2300369,4520,12.917,3675,10.502,539165,169761,369404,7.380,23.438,409795,122483,287312,5.324,17.814,129370,5.624,35.629,421,457,5431
1978,561,96232,108404,1784105,1662416,24161,23.337,14411,13.920,598106,220424,377682,13.259,35.978,354242,135709,218533,8.163,21.309,243864,14.669,42.618,10513,10585,70132
1978,562,10196,10910,159055,151129,1740,16.237,1353,12.625,37398,11647,25751,7.707,24.746,21591,9195,12396,6.084,14.286,15807,10.459,28.573,1020,1020,5765
1978,611,29461,31402,1242160,1167944,4305,13.986,3062,9.948,269512,33072,236440,2.832,23.076,123397,57896,65501,4.957,10.565,146115,12.510,21.131,2252,2285,46575
1978,621,256930,266431,1394934,1320685,29562,11.406,15078,5.817,320547,115801,204746,8.768,24.271,171491,63200,108291,4.785,12.985,149056,11.286,25.970,11203,11292,42911
1978,622,4300,5261,2392538,2313734,240,4.593,169,3.234,237039,31167,205872,1.347,10.245,78906,32672,46234,1.412,3.410,158133,6.835,6.821,86,89,12776
1978,623,18127,23138,1099481,1046992,3364,15.001,1938,8.642,233383,91838,141545,8.772,22.291,126996,70308,56688,6.715,12.130,106387,10.161,24.259,1144,1191,35772
1978,624,35438,45113,642944,585240,8070,18.661,4333,10.020,218502,70049,148453,11.969,37.335,103630,35969,67661,6.146,17.707,114872,19.628,35.415,2308,2373,13089
1978,711,12189,12477,163200,156418,3138,26.225,2115,17.676,52943,21370,31573,13.662,33.847,39316,16928,22388,10.822,25.135,13627,8.712,50.271,1500,1507,9510
1978,712,1650,1763,27708,26553,157,8.969,132,7.541,5115,910,4205,3.427,19.263,2751,558,2193,2.101,10.360,2364,8.903,20.721,78,79,291
1978,713,29402,31059,468232,440199,4501,14.821,3122,10.280,113852,41055,72797,9.326,25.864,57897,20493,37404,4.655,13.152,55955,12.711,26.305,2348,2357,13515
1978,721,37930,41900,980429,936676,6035,14.442,5809,13.901,259517,115935,143582,12.377,27.706,172093,97658,74435,10.426,18.373,87424,9.333,36.745,4161,4201,52925
1978,722,248403,297955,4174596,3942125,56523,19.201,49349,16.764,1290592,705386,585206,17.894,32.738,825275,441261,384014,11.193,20.935,465317,11.804,41.870,34179,34721,248934
1978,811,129241,136181,729248,690313,24145,18.123,18243,13.693,197361,82792,114569,11.993,28.590,118946,58820,60126,8.521,17.231,78415,11.359,34.461,13901,13960,40342
1978,812,143007,163319,994119,975458,23099,14.234,21017,12.951,230995,95477,135518,9.788,23.681,192242,88996,103246,9.124,19.708,38753,3.973,39.416,15048,15310,55721
1978,813,158165,163649,1438443,1349184,14828,9.248,8218,5.125,338571,65556,273015,4.859,25.095,160247,37992,122255,2.816,11.877,178324,13.217,23.755,4851,4884,18685
1979,211,5577,7347,127400,123146,1026,14.276,706,9.823,24902,7397,17505,6.007,20.222,16449,6948,9501,5.642,13.357,8453,6.864,26.715,343,347,2111
1979,212,7096,9564,434442,401548,1450,15.118,1505,15.691,122156,25870,96286,6.443,30.421,56959,28058,28901,6.987,14.185,65197,16.236,28.370,853,860,8112
1979,213,7374,8548,248781,235326,1699,20.554,1135,13.731,72496,23794,48702,10.111,30.807,45003,20735,24268,8.811,19.124,27493,11.683,38.247,659,664,8873
1979,221,5450,11588,675077,663656,788,6.938,326,2.870,60637,21757,38880,3.278,9.137,38468,7696,30772,1.160,5.796,22169,3.340,11.593,40,40,324
1979,236,143471,144481,1323719,1254123,32855,23.442,24204,17.269,447443,147405,300038,11.754,35.678,308732,110347,198385,8.799,24.617,138711,11.060,49.235,18781,18783,83078
1979,237,36056,37078,802649,775551,5749,15.788,4421,12.141,211992,42927,169065,5.535,27.334,157386,41688,115698,5.375,20.293,54606,7.041,40.587,3261,3269,24243
1979,238,268356,271218,2425752,2300814,45819,17.245,34774,13.088,715203,199544,515659,8.673,31.085,465111,161544,303567,7.021,20.215,250092,10.870,40.430,27107,27126,118877
1979,311,21493,27311,1370922,1374272,2389,8.593,3368,12.115,184713,58148,126565,4.231,13.441,191972,89416,102556,6.506,13.969,-7259,-0.528,26.882,1844,1872,20781
1979,312,2343,3014,235633,233505,209,6.817,313,10.209,26921,6871,20050,2.943,11.529,22559,9167,13392,3.926,9.661,4362,1.868,19.322,164,165,2401
1979,313,3596,4740,624985,629404,367,7.673,453,9.471,51580,14888,36692,2.365,8.195,59598,22318,37280,3.546,9.469,-8018,-1.274,16.390,238,243,6090
1979,314,7749,8231,280676,281312,1044,12.705,1016,12.365,41548,13973,27575,4.967,14.769,42880,14655,28225,5.210,15.243,-1332,-0.473,29.539,694,694,7262
1979,315,16064,18305,1204556,1210019,2188,11.842,2531,13.698,175251,64743,110508,5.351,14.483,186622,75361,111261,6.228,15.423,-11371,-0.940,28.967,1729,1744,35793
1979,316,2215,2617,246411,247862,215,8.045,326,12.198,29133,7538,21595,3.041,11.754,32239,10110,22129,4.079,13.007,-3106,-1.253,23.507,192,193,4118
1979,321,14533,16416,583677,577697,2060,12.557,2039,12.429,93310,31565,61745,5.464,16.152,80758,31261,49497,5.411,13.979,12552,2.173,27.959,1246,1258,13319
1979,322,3632,5692,623534,620596,355,6.183,454,7.907,58268,19682,38586,3.171,9.389,52232,19275,32957,3.106,8.416,6036,0.973,16.833,211,213,4214
1979,323,29092,30429,628628,615756,3047,9.938,3508,11.442,94352,26694,67658,4.335,15.323,68313,33114,35199,5.378,11.094,26039,4.229,22.188,2167,2183,13377
1979,324,1441,2349,580081,578158,234,10.036,199,8.535,36009,4440,31569,0.768,6.228,32259,4154,28105,0.718,5.580,3750,0.649,11.159,73,73,850
1979,325,7546,11096,966977,955683,981,8.782,1129,10.107,96206,29263,66943,3.062,10.067,72913,26398,46515,2.762,7.629,23293,2.437,15.259,481,484,4260
1979,326,10643,12511,783764,765085,1397,11.306,1088,8.805,121001,31329,89672,4.095,15.815,83689,33099,50590,4.326,10.939,37312,4.877,21.877,597,604,9224
1979,327,11999,15023,593649,584424,1410,9.320,1623,10.727,86180,24290,61890,4.156,14.746,67766,25831,41935,4.420,11.595,18414,3.151,23.191,929,980,8108
1979,331,4379,5548,707315,685700,388,6.947,463,8.289,92590,24789,67801,3.615,13.503,49694,24650,25044,3.595,7.247,42896,6.256,14.494,217,218,3509
1979,332,43510,47309,1842745,1786788,4702,9.969,4414,9.359,283506,62916,220590,3.521,15.867,171270,71323,99947,3.992,9.585,112236,6.281,19.171,2480,2488,23125
1979,333,24583,27331,1862610,1796347,2388,8.725,2463,8.999,280763,74552,206211,4.150,15.630,148738,70543,78195,3.927,8.280,132025,7.350,16.560,1257,1259,12947
1979,334,9399,10990,1601864,1532328,1404,12.830,1310,11.971,259962,68867,191095,4.494,16.965,120668,51642,69026,3.370,7.875,139294,9.090,15.750,686,689,12276
1979,335,4605,5717,724882,703596,583,10.185,597,10.430,109384,44771,64613,6.363,15.546,65715,24950,40765,3.546,9.340,43669,6.207,18.680,297,299,5232
1979,336,7780,9345,2210056,2129560,1042,11.074,1171,12.445,277265,40796,236469,1.916,13.020,114926,35313,79613,1.658,5.397,162339,7.623,10.793,690,692,9086
1979,337,14599,15514,557667,548963,1866,12.001,1935,12.445,84934,25442,59492,4.635,15.472,67822,27988,39834,5.098,12.355,17112,3.117,24.709,1278,1281,11896
1979,339,22301,23501,671333,667009,2846,12.042,3110,13.160,108420,31800,76620,4.768,16.255,99278,41153,58125,6.170,14.884,9142,1.371,29.768,2051,2057,15870
1979,423,142117,184247,2349440,2264955,21887,12.063,16277,8.971,463109,163028,300081,7.198,20.447,294360,124628,169732,5.502,12.996,168749,7.450,25.993,9706,9895,50118
1979,424,92980,118657,1594144,1575858,12167,10.265,11921,10.057,291255,94300,196955,5.984,18.482,254294,108474,145820,6.883,16.137,36961,2.345,32.274,7241,7376,41382
1979,425,25527,28193,280467,273448,3319,11.988,2303,8.319,54110,18726,35384,6.848,19.788,39886,15332,24554,5.607,14.586,14224,5.202,29.173,1388,1392,6974
1979,441,93720,111755,1395210,1358479,11078,9.984,9489,8.552,223565,67328,156237,4.956,16.457,150138,57458,92680,4.230,11.052,73427,5.405,22.104,6886,6988,40669
1979,442,42737,49007,344932,335407,6721,13.973,4908,10.204,71971,28896,43075,8.615,21.458,53085,20898,32187,6.231,15.827,18886,5.631,31.654,3647,3711,14460
1979,443,24975,31763,186443,181823,4341,13.740,4002,12.667,41927,18780,23147,10.329,23.059,32752,14686,18066,8.077,18.013,9175,5.046,36.026,2670,2750,9269
1979,444,68381,85000,774249,748427,8589,10.232,6469,7.707,147572,54048,93524,7.222,19.718,96007,34126,61881,4.560,12.828,51565,6.890,25.656,4332,4389,18858
1979,445,117489,165974,2011996,1962313,20726,12.494,20546,12.386,391874,169376,222498,8.631,19.970,291665,139029,152636,7.085,14.863,100209,5.107,29.727,12649,12913,57496
1979,446,39781,55039,514943,501200,6474,12.067,3694,6.885,96220,40634,55586,8.107,19.198,68573,29378,39195,5.862,13.682,27647,5.516,27.364,2193,2227,10867
1979,447,118373,148063,851948,859839,18064,11.955,24138,15.975,199317,83296,116021,9.687,23.181,214545,98116,116429,11.411,24.952,-15228,-1.771,46.361,16060,16289,60083
1979,448,89455,147989,1083547,1060553,20308,14.030,13819,9.547,235909,106639,129270,10.055,22.244,190633,70690,119943,6.665,17.975,45276,4.269,35.950,8153,8441,32301
1979,451,39011,48988,295715,287359,7963,16.555,6190,12.869,72481,31437,41044,10.940,25.223,55798,24538,31260,8.539,19.418,16683,5.806,38.835,4246,4464,13742
1979,452,15968,37068,1940926,1933678,3560,9.557,3925,10.537,232619,109204,123415,5.647,12.030,215969,64079,151890,3.314,11.169,16650,0.861,22.338,1688,1762,8118
1979,453,74139,85094,429449,415635,14377,17.327,10139,12.219,110810,49419,61391,11.890,26.660,83064,35239,47825,8.478,19.985,27746,6.676,39.970,7360,7469,22854
1979,454,26992,35468,378551,366222,3929,11.149,3473,9.855,74697,25129,49568,6.862,20.397,49829,19458,30371,5.313,13.606,24868,6.790,27.212,2444,2477,10119
1979,481,1368,2891,263138,247885,521,19.350,124,4.605,37125,8532,28593,3.442,14.977,6757,1713,5044,0.691,2.726,30368,12.251,5.452,17,17,54
1979,483,845,1176,52431,51106,157,13.827,76,6.693,12851,5034,7817,9.850,25.146,10059,2865,7194,5.606,19.683,2792,5.463,39.366,7,7,43
1979,484,60489,69238,1122000,1076983,12865,19.044,9494,14.054,248501,86263,162238,8.010,23.074,158026,70981,87045,6.591,14.673,90475,8.401,29.346,6903,6922,27431
1979,485,12041,12687,247068,242044,1715,14.172,544,4.495,43811,12427,31384,5.134,18.100,34310,9912,24398,4.095,14.175,9501,3.925,28.350,256,262,1786
1979,486,341,1564,73451,71702,143,9.473,34,2.252,8050,3414,4636,4.761,11.227,4681,767,3914,1.070,6.528,3369,4.699,13.057,(D),(D),(D)
1979,487,873,896,11486,11441,186,22.051,81,9.603,3128,1569,1559,13.714,27.341,3048,657,2391,5.743,26.642,80,0.699,53.284,63,63,445
1979,488,10197,13489,310647,300480,2213,17.403,667,5.245,72248,22000,50248,7.322,24.044,51131,11097,40034,3.693,17.016,21117,7.028,34.033,278,296,1984
1979,492,1865,2312,103960,99319,701,31.784,488,22.127,15779,5379,10400,5.416,15.887,6653,3032,3621,3.053,6.699,9126,9.189,13.397,404,404,1510
1979,493,6123,9290,397937,390306,1018,11.177,654,7.181,72670,27042,45628,6.928,18.619,57324,14404,42920,3.690,14.687,15346,3.932,29.374,229,229,1847
1979,511,15959,18223,649155,632739,3074,17.293,2179,12.258,97449,35759,61690,5.651,15.401,64500,28204,36296,4.457,10.194,32949,5.207,20.388,1363,1369,10640
1979,512,9418,14786,199016,193511,2327,15.949,1936,13.269,57688,19626,38062,10.142,29.811,46141,16292,29849,8.419,23.844,11547,5.967,47.688,953,972,6403
1979,515,5319,6247,177751,171585,642,10.720,126,2.104,28843,12187,16656,7.103,16.810,16389,3545,12844,2.066,9.552,12454,7.258,19.103,27,29,295
1979,517,3340,16569,1016625,1000012,820,4.913,1060,6.351,189732,7894,181838,0.789,18.973,156685,26982,129703,2.698,15.668,33047,3.305,31.337,123,123,792
1979,518,4830,6245,175322,168907,1108,18.165,817,13.395,42321,17885,24436,10.589,25.056,29425,17177,12248,10.170,17.421,12896,7.635,34.842,381,383,2846
1979,519,2008,2390,28478,27947,243,10.321,172,7.305,3956,1120,2836,4.008,14.155,2893,878,2015,3.142,10.352,1063,3.804,20.703,112,112,439
1979,521,20,52,23700,23586,(D),(D),0,0.000,803,(D),640,(D),3.405,630,0,630,0.000,2.671,173,0.733,5.342,0,0,0
1979,522,46746,106372,2004440,1937634,9716,9.418,3302,3.201,264893,92035,172858,4.750,13.671,131405,32770,98635,1.691,6.782,133488,6.889,13.563,633,648,4521
1979,523,13059,17190,249041,235609,3122,19.537,702,4.393,56509,19433,37076,8.248,23.984,29789,11137,18652,4.727,12.643,26720,11.341,25.287,319,319,1483
1979,524,90635,118215,1758350,1690666,16001,14.331,2875,2.575,325967,117056,208911,6.924,19.280,190564,42302,148262,2.502,11.272,135403,8.009,22.543,744,772,4748
1979,525,1376,1584,14061,13935,148,9.642,50,3.257,2507,822,1685,5.899,17.991,2242,566,1676,4.062,16.089,265,1.902,32.178,12,12,21
1979,531,159242,163181,863330,808568,26973,17.842,2965,1.961,226377,95859,130518,11.855,27.997,117087,21946,95141,2.714,14.481,109290,13.516,28.962,1717,1747,7487
1979,532,18086,23963,234480,214281,5044,22.105,2755,12.074,75152,28124,47028,13.125,35.072,35400,16710,18690,7.798,16.520,39752,18.551,33.041,1787,1800,8641
1979,533,902,962,10860,11226,181,19.814,84,9.195,3159,1382,1777,12.311,28.141,4003,2764,1239,24.623,35.660,-844,-7.519,56.283,7,9,84
1979,541,252893,268528,2427814,2319325,44972,17.331,26888,10.362,542186,207450,334736,8.944,23.377,324270,134282,189988,5.790,13.981,217916,9.396,27.962,19512,19712,78319
1979,551,19894,36998,2510793,2442427,4730,13.064,3146,8.689,476592,169274,307318,6.931,19.513,338453,97085,241368,3.975,13.857,138139,5.656,27.714,302,308,3637
1979,561,105312,118152,2015905,1902127,25327,22.420,14953,13.237,597552,213233,384319,11.210,31.415,370349,134063,236286,7.048,19.470,227203,11.945,38.941,10888,10972,70663
1979,562,10774,11513,175355,166620,1782,15.983,1055,9.462,37645,8994,28651,5.398,22.593,20394,7334,13060,4.402,12.240,17251,10.354,24.480,805,807,4055
1979,611,29708,31668,1298235,1248932,4019,12.899,2998,9.622,197332,27220,170112,2.179,15.800,97675,21510,76165,1.722,7.821,99657,7.979,15.641,2221,2259,14156
1979,621,269667,279624,1515747,1455646,28753,10.527,15762,5.771,302677,109610,193067,7.530,20.793,183001,61508,121493,4.225,12.572,119676,8.222,25.144,11592,11660,41533
1979,622,4366,5353,2486084,2433538,229,4.268,254,4.734,200562,32868,167694,1.351,8.242,95078,43764,51314,1.798,3.907,105484,4.335,7.814,131,134,19128
1979,623,18696,24118,1165551,1137398,2652,11.197,1787,7.545,188963,72527,116436,6.377,16.614,132717,62893,69824,5.530,11.668,56246,4.945,23.337,1148,1220,37919
1979,624,38142,48897,694756,665823,7309,15.532,3632,7.718,162964,59011,103953,8.863,24.476,105287,26873,78414,4.036,15.813,57677,8.663,31.626,2455,2493,13700
1979,711,13466,13746,189419,176601,3496,26.696,2195,16.761,72453,19432,53021,11.003,41.026,46103,15113,30990,8.558,26.106,26350,14.921,52.211,1590,1593,10259
1979,712,1728,1817,29935,29036,137,7.573,121,6.689,4653,800,3853,2.755,16.025,2971,557,2414,1.918,10.232,1682,5.793,20.464,70,70,364
1979,713,30292,31997,493765,482132,4201,13.361,3093,9.837,99202,34610,64592,7.179,20.576,76474,25721,50753,5.335,15.862,22728,4.714,31.723,2319,2341,16291
1979,721,38688,42673,1040210,1017800,5730,13.472,5451,12.816,227953,96051,131902,9.437,22.397,183184,84523,98661,8.304,17.998,44769,4.399,35.996,3904,3947,46564
1979,722,254192,307998,4461473,4325977,55138,18.174,45918,15.135,1216405,684092,532313,15.814,28.119,948549,418682,529867,9.678,21.927,267856,6.192,43.854,32085,32583,245168
1979,811,135072,142249,789478,759725,24416,17.546,18219,13.093,199065,84083,114982,11.068,26.202,139100,62580,76520,8.237,18.309,59965,7.893,36.619,13845,13916,45148
1979,812,145695,167023,1040277,1021194,22597,13.678,18970,11.482,212787,92756,120031,9.083,20.837,175910,70965,104945,6.949,17.226,36877,3.611,34.452,13982,14220,48395
1979,813,154070,159722,1450016,1422809,12657,8.108,5418,3.471,246987,55313,191674,3.888,17.359,192651,30296,162355,2.129,13.540,54336,3.819,27.080,3454,3471,17080
1980,211,5890,7684,136522,131990,1079,14.368,731,9.734,28086,9579,18507,7.257,21.279,18963,5423,13540,4.109,14.367,9123,6.912,28.734,403,421,1877
1980,212,6941,9429,431431,434356,1291,13.592,1429,15.045,69247,29385,39862,6.765,15.942,74945,22761,52184,5.240,17.254,-5698,-1.312,31.885,952,978,11004
1980,213,8181,9458,286918,267853,2008,22.223,1163,12.871,84545,28116,56429,10.497,31.564,46337,18059,28278,6.742,17.299,38208,14.265,34.599,760,778,10840
1980,221,5470,11771,692744,683580,652,5.646,206,1.784,44858,13554,31304,1.983,6.562,26578,6542,20036,0.957,3.888,18280,2.674,7.776,47,52,286
1980,236,136945,137883,1220286,1251664,26222,18.637,31852,22.639,339180,115877,223303,9.258,27.098,401663,134991,266672,10.785,32.090,-62483,-4.992,54.197,24626,24633,101252
1980,237,36568,37521,789129,797668,5444,14.561,5178,13.849,171292,41413,129879,5.192,21.474,189121,41380,147741,5.188,23.709,-17829,-2.235,42.948,3714,3724,24329
1980,238,264401,267260,2391199,2418104,38815,14.414,42884,15.925,584015,171334,412681,7.085,24.152,638780,181773,457007,7.517,26.417,-54765,-2.265,48.304,33022,33033,136685
1980,311,21061,27107,1402039,1385015,2679,9.855,2835,10.429,202987,94984,108003,6.858,14.656,166759,56357,110402,4.069,12.040,36228,2.616,24.080,1850,1887,22756
1980,312,2276,2948,233710,234790,189,6.336,259,8.683,21350,7901,13449,3.365,9.093,23371,6364,17007,2.711,9.954,-2021,-0.861,18.187,151,152,2425
1980,313,3538,4663,619512,622548,346,7.354,430,9.139,49582,15124,34458,2.429,7.964,55483,17617,37866,2.830,8.912,-5901,-0.948,15.929,267,269,4878
1980,314,7469,7937,265705,272822,864,10.701,1138,14.095,33075,10394,22681,3.810,12.123,47472,17107,30365,6.270,17.400,-14397,-5.277,24.247,869,877,10134
1980,315,15502,17706,1173178,1187705,1956,10.873,2522,14.020,157833,55434,102399,4.667,13.289,186801,69037,117764,5.813,15.728,-28968,-2.439,26.578,1953,1967,40856
1980,316,2153,2529,232785,238202,210,8.186,283,11.031,25466,7426,18040,3.118,10.691,36190,13102,23088,5.500,15.193,-10724,-4.502,21.382,192,195,5547
1980,321,14296,16186,544526,563182,1834,11.271,2006,12.328,65896,24322,41574,4.319,11.701,103240,31242,71998,5.547,18.332,-37344,-6.631,23.401,1413,1414,15407
1980,322,3580,5686,633212,628415,382,6.708,400,7.024,57475,18661,38814,2.970,9.146,47911,12669,35242,2.016,7.624,9564,1.522,15.248,234,235,4792
1980,323,29180,30584,638087,633412,3313,10.866,3124,10.246,83182,27511,55671,4.343,13.132,74089,25703,48386,4.058,11.697,9093,1.436,23.394,2160,2167,15274
1980,324,1455,2362,550847,563481,259,11.012,239,10.162,26009,6017,19992,1.068,4.616,50608,14770,35838,2.621,8.981,-24599,-4.366,9.232,71,90,1851
1980,325,7514,11164,953642,944207,962,8.653,870,7.825,90603,32795,57808,3.473,9.596,71024,16578,54446,1.756,7.522,19579,2.074,15.044,471,479,4968
1980,326,10754,12716,752044,767792,1365,10.812,1183,9.370,93561,35828,57733,4.666,12.186,126390,36193,90197,4.714,16.461,-32829,-4.276,24.371,753,764,11352
1980,327,11865,14884,576264,585524,1298,8.683,1427,9.546,61838,22786,39052,3.892,10.561,80549,19902,60647,3.399,13.757,-18711,-3.196,21.122,918,933,8038
1980,331,4444,5677,705778,706572,468,8.336,343,6.109,79996,37765,42231,5.345,11.322,83219,19897,63322,2.816,11.778,-3223,-0.456,22.643,187,187,3798
1980,332,44488,48425,1851897,1849540,5172,10.800,4096,8.553,229956,71479,158477,3.865,12.433,226026,56924,169102,3.078,12.221,3930,0.212,24.441,2796,2813,29042
1980,333,24781,27696,1881997,1870291,2520,9.165,2118,7.703,224304,75203,149101,4.021,11.993,201792,60739,141053,3.248,10.789,22512,1.204,21.579,1317,1320,16665
1980,334,9598,11344,1754014,1679561,1502,13.446,1155,10.340,279368,80364,199004,4.785,16.633,129029,48037,80992,2.860,7.682,150339,8.951,15.365,731,734,17058
1980,335,4586,5742,733346,728860,537,9.396,484,8.468,81710,25805,55905,3.540,11.211,72552,19903,52649,2.731,9.954,9158,1.256,19.908,287,290,4877
1980,336,7637,9248,2034298,2119356,1013,10.926,1060,11.433,186042,55040,131002,2.597,8.778,359940,41749,318191,1.970,16.983,-173898,-8.205,17.556,729,732,11580
1980,337,14486,15452,543520,550390,1841,11.876,1941,12.521,63332,21911,41421,3.981,11.507,77087,22443,54644,4.078,14.006,-13755,-2.499,23.014,1460,1466,13713
1980,339,22313,23552,664785,667434,2856,12.148,2774,11.799,98396,38507,59889,5.769,14.742,103511,32828,70683,4.919,15.509,-5115,-0.766,29.485,2028,2034,13452
1980,423,144830,188540,2391348,2375564,21086,11.295,17373,9.306,386923,145585,241338,6.128,16.288,356199,133629,222570,5.625,14.994,30724,1.293,29.989,10828,11084,59476
1980,424,92499,118458,1608468,1605886,11738,9.886,12281,10.344,253446,90273,163173,5.621,15.782,247605,92565,155040,5.764,15.419,5841,0.364,30.837,8010,8180,46415
1980,425,26177,28969,283570,282547,3267,11.416,2563,8.956,48283,17522,30761,6.201,17.088,46370,15821,30549,5.599,16.411,1913,0.677,32.823,1646,1657,7917
1980,441,92435,110655,1280186,1339731,9995,8.985,11175,10.045,142425,57878,84547,4.320,10.631,260716,71934,188782,5.369,19.460,-118291,-8.829,21.262,8261,8391,53778
1980,442,42971,49883,345871,347827,6380,12.891,5595,11.305,62583,26137,36446,7.514,17.993,66427,21792,44635,6.265,19.098,-3844,-1.105,35.985,4288,4355,16081
1980,443,24428,31110,181569,184562,3934,12.506,4628,14.712,35914,15435,20479,8.363,19.459,42171,17222,24949,9.331,22.849,-6257,-3.390,38.918,3066,3155,10454
1980,444,69245,86399,772003,777428,8029,9.348,7018,8.171,116487,47483,69004,6.108,14.984,127582,35976,91606,4.628,16.411,-11095,-1.427,29.967,4950,5082,23815
1980,445,116040,164386,2057030,2036313,20641,12.498,22167,13.422,368871,180901,187970,8.884,18.115,325202,145553,179649,7.148,15.970,43669,2.145,31.940,13248,13496,59920
1980,446,40752,57337,533995,524268,6185,11.002,3944,7.016,94743,52682,42061,10.049,18.071,73446,23431,50015,4.469,14.009,21297,4.062,28.018,2639,2719,13429
1980,447,113057,143264,781780,817180,15949,10.954,20629,14.168,155424,75484,79940,9.237,19.020,226143,83080,143063,10.167,27.674,-70719,-8.654,38.039,14600,15018,58029
1980,448,89442,152509,1097985,1092319,19802,13.178,15306,10.186,222952,106046,116906,9.708,20.411,208441,67540,140901,6.183,19.082,14511,1.328,38.165,9794,10289,36687
1980,451,39099,49891,307239,302433,7624,15.421,6720,13.593,73579,34929,38650,11.549,24.329,62904,24091,38813,7.966,20.799,10675,3.530,41.599,4906,5067,16143
1980,452,15448,37073,1944803,1943010,3398,9.162,3431,9.251,201387,119304,82083,6.140,10.365,199567,40730,158837,2.096,10.271,1820,0.094,20.542,1784,1880,8458
1980,453,76185,87998,442775,453441,13849,15.984,11143,12.861,102194,46569,55625,10.270,22.537,121345,35489,85856,7.827,26.761,-19151,-4.223,45.075,8454,8615,25853
1980,454,26424,34843,373591,376451,3293,9.373,3876,11.032,59205,20614,38591,5.476,15.727,65009,22906,42103,6.085,17.269,-5804,-1.542,31.454,2726,2776,12112
1980,481,1417,3013,275276,268555,470,16.462,154,5.394,31020,5896,25124,2.195,11.551,17448,2470,14978,0.920,6.497,13572,5.054,12.994,19,21,92
1980,483,825,1156,54759,52698,148,13.250,70,6.267,13766,6056,7710,11.492,26.123,10078,3043,7035,5.774,19.124,3688,6.998,38.248,10,11,90
1980,484,60496,69778,1073134,1094623,11535,16.652,10520,15.187,176176,76011,100165,6.944,16.095,220716,66315,154401,6.058,20.164,-44540,-4.069,32.189,8201,8273,33155
1980,485,11666,12521,244061,241639,1745,14.673,488,4.103,43390,17862,25528,7.392,17.957,37958,8316,29642,3.442,15.709,5432,2.248,31.417,370,370,2143
1980,486,353,1600,74746,74038,113,7.186,58,3.688,7572,1985,5587,2.681,10.227,6174,1929,4245,2.605,8.339,1398,1.888,16.678,8,13,150
1980,487,865,886,12766,12015,153,17.667,113,13.048,3519,1589,1930,13.225,29.288,2002,595,1407,4.952,16.663,1517,12.626,33.325,80,80,309
1980,488,10510,13847,313982,311089,2133,16.190,788,5.981,69782,29502,40280,9.483,22.432,64638,11123,53515,3.576,20.778,5144,1.654,41.556,391,399,2553
1980,492,1817,2303,112050,106890,677,30.941,447,20.430,16148,3785,12363,3.541,15.107,5469,1488,3981,1.392,5.116,10679,9.991,10.233,362,362,1072
1980,493,6314,9686,401637,400021,990,10.392,672,7.054,58223,20831,37392,5.207,14.555,54619,13120,41499,3.280,13.654,3604,0.901,27.308,340,341,2011
1980,511,16639,19188,665347,654345,3184,17.030,2200,11.767,89723,37814,51909,5.779,13.712,67940,27747,40193,4.240,10.383,21783,3.329,20.766,1480,1501,13801
1980,512,9716,15066,195398,197757,2306,15.425,2074,13.873,46646,17932,28714,9.068,23.588,52126,17535,34591,8.867,26.359,-5480,-2.771,47.175,1149,1235,9397
1980,515,5448,6409,191561,183076,638,10.384,108,1.758,31551,11246,20305,6.143,17.234,14179,2411,11768,1.317,7.745,17372,9.489,15.490,30,32,274
1980,517,3421,16896,1056483,1036207,885,5.325,333,2.004,276950,7118,269832,0.687,26.727,236853,2841,234012,0.274,22.858,40097,3.870,45.715,181,182,1137
1980,518,5081,6658,193319,183340,1270,19.698,849,13.168,49775,24377,25398,13.296,27.149,29681,14242,15439,7.768,16.189,20094,10.960,32.378,502,505,5312
1980,519,1870,2228,26222,27384,195,8.438,361,15.621,2830,945,1885,3.451,10.335,5212,3263,1949,11.916,19.033,-2382,-8.699,20.669,131,132,1077
1980,521,19,44,20155,21928,(D),(D),10,20.833,809,(D),392,(D),3.689,4377,4073,304,18.575,19.961,-3568,-16.272,7.379,0,0,0
1980,522,46698,109302,2112035,2055639,8237,7.701,3542,3.312,246095,82615,163480,4.019,11.972,133992,32145,101847,1.564,6.518,112103,5.453,13.037,780,903,6586
1980,523,13671,18262,266197,254154,3254,19.105,794,4.662,62098,23193,38905,9.126,24.433,37983,10789,27194,4.245,14.945,24115,9.488,29.890,438,449,2224
1980,524,91570,119964,1756874,1725508,12618,10.947,3213,2.788,236652,94572,142080,5.481,13.715,172960,43831,129129,2.540,10.024,63692,3.691,20.047,1029,1077,5965
1980,525,1411,1614,14474,13392,163,10.486,44,2.830,3560,984,2576,7.348,26.584,1442,502,940,3.749,10.768,2118,15.816,21.536,13,13,72
1980,531,157691,161664,849875,823242,23699,15.631,3601,2.375,196889,85438,111451,10.378,23.916,144691,21987,122704,2.671,17.576,52198,6.341,35.152,2342,2390,8168
1980,532,18711,24948,243842,239659,4424,18.077,3473,14.191,65370,23476,41894,9.796,27.276,56918,24557,32361,10.247,23.750,8452,3.527,47.499,2149,2176,11344
1980,533,878,935,10307,10314,160,18.265,42,4.795,3181,1095,2086,10.617,30.842,3217,1560,1657,15.125,31.191,-36,-0.349,61.683,20,20,62
1980,541,264151,280378,2533389,2491715,44608,16.253,32782,11.944,500911,194089,306822,7.789,20.103,415650,178030,237620,7.145,16.681,85261,3.422,33.363,24245,24394,93452
1980,551,20456,38585,2605442,2557845,4520,12.008,2633,6.995,435392,149790,285602,5.856,17.022,338448,97239,241209,3.802,13.232,96944,3.790,26.464,363,392,4681
1980,561,112284,126406,2124375,2073863,25277,20.669,17051,13.943,533196,199082,334114,9.600,25.710,433239,122420,310819,5.903,20.890,99957,4.820,41.781,12987,13055,73325
1980,562,10889,11670,172556,173417,1626,14.223,1151,10.068,25673,7919,17754,4.566,14.804,27344,7138,20206,4.116,15.768,-1671,-0.964,29.608,881,883,5001
1980,611,28120,30118,1272876,1295320,3382,11.000,4637,15.082,142377,18045,124332,1.393,10.992,187798,96031,91767,7.414,14.498,-45421,-3.507,21.983,2651,2671,15398
1980,621,281128,291907,1576179,1556624,30259,10.590,17917,6.270,287693,113494,174199,7.291,18.482,248698,72771,175927,4.675,15.977,38995,2.505,31.954,13678,13755,48405
1980,622,4216,5300,2574641,2532658,302,5.692,313,5.900,196642,55433,141209,2.189,7.764,109550,63905,45645,2.523,4.325,87092,3.439,8.651,121,122,25372
1980,623,18468,24312,1189076,1177511,2400,9.912,2203,9.098,159067,62790,96277,5.332,13.509,135265,57866,77399,4.914,11.487,23802,2.021,22.975,1270,1310,35602
1980,624,35882,47015,676481,692554,6068,12.666,7852,16.390,124462,40622,83840,5.866,17.971,155798,72886,82912,10.524,22.496,-31336,-4.525,35.943,3398,3509,22270
1980,711,13808,14067,188287,189515,3259,23.410,2968,21.320,47984,17167,30817,9.058,25.319,50539,19858,30681,10.478,26.668,-2555,-1.348,50.639,2043,2053,11376
1980,712,1510,1596,28133,29012,77,4.521,291,17.087,3062,298,2764,1.027,10.554,4777,2200,2577,7.583,16.466,-1715,-5.911,21.109,96,96,445
1980,713,30664,32646,503722,498747,4220,13.107,3319,10.309,94936,36187,58749,7.256,19.035,84901,24868,60033,4.986,17.023,10035,2.012,34.046,2376,2393,16415
1980,721,37856,41989,1064533,1054204,4924,11.627,5649,13.338,208477,88637,119840,8.408,19.776,187579,78071,109508,7.406,17.793,20898,1.982,35.587,4053,4076,46187
1980,722,253108,311315,4565808,4541908,52193,16.852,48989,15.818,1132360,647837,484523,14.264,24.931,1083837,424265,659572,9.341,23.863,48523,1.068,47.726,36902,37559,287174
1980,811,135815,143306,768796,780892,22153,15.515,21118,14.790,156535,73481,83054,9.410,20.046,181032,69621,111411,8.916,23.183,-24497,-3.137,40.091,16361,16413,52438
1980,812,145124,167741,1036363,1039419,21977,13.142,20947,12.526,190962,88435,102527,8.508,18.372,196600,72893,123707,7.013,18.914,-5638,-0.542,36.744,16058,16294,52809
1980,813,150459,156321,1419052,1450333,9180,5.874,9104,5.825,211438,39549,171889,2.727,14.579,275231,73305,201926,5.054,18.977,-63793,-4.399,29.157,3905,3921,17837
1981,211,6801,8730,163902,150938,1603,19.403,666,8.061,41302,12739,28563,8.440,27.364,15630,7514,8116,4.978,10.355,25672,17.008,20.710,340,347,2461
1981,212,7152,9675,436010,434101,1436,15.008,1222,12.772,70523,25168,45355,5.798,16.246,66386,20540,45846,4.732,15.293,4137,0.953,30.586,748,754,8818
1981,213,10167,11620,363818,325142,3146,29.660,1120,10.559,127891,46831,81060,14.403,39.334,49874,20701,29173,6.367,15.339,78017,23.995,30.678,690,695,10917
1981,221,5481,11811,712570,702761,587,5.041,255,2.190,42333,8934,33399,1.271,6.024,22728,6490,16238,0.924,3.234,19605,2.790,6.468,57,58,143
1981,236,128091,129049,1153112,1186502,21436,16.122,29267,22.011,312570,99777,212793,8.409,26.344,378338,113153,265185,9.537,31.887,-65768,-5.543,52.688,21318,21323,78965
1981,237,36429,37422,771505,778431,5152,13.819,4870,13.063,170382,47295,123087,6.076,21.888,183365,35120,148245,4.512,23.556,-12983,-1.668,43.776,3425,3427,19480
1981,238,255459,258350,2333673,2359534,33313,12.704,41045,15.653,556940,153888,403052,6.522,23.604,607335,164691,442644,6.980,25.740,-50395,-2.136,47.208,29276,29303,117797
1981,311,21620,27525,1356265,1374115,2812,10.292,2406,8.806,152022,55808,96214,4.061,11.063,188692,71948,116744,5.236,13.732,-36670,-2.669,22.127,1365,1399,20994
1981,312,2283,2943,231524,231722,227,7.736,210,7.156,21588,7426,14162,3.205,9.316,21704,9099,12605,3.927,9.366,-116,-0.050,18.633,132,134,3067
1981,313,3663,4771,587836,603214,445,9.410,361,7.634,39298,14112,25186,2.339,6.515,69881,19803,50078,3.283,11.585,-30583,-5.070,13.030,204,209,4523
1981,314,7610,8077,249911,257863,1023,12.769,892,11.134,31508,13424,18084,5.206,12.219,47300,14835,32465,5.753,18.343,-15792,-6.124,24.438,605,609,5844
1981,315,16440,18612,1165720,1170932,2741,15.078,1874,10.309,162817,63700,99117,5.440,13.905,173021,56178,116843,4.798,14.776,-10204,-0.871,27.810,1312,1326,27573
1981,316,2245,2606,228160,230153,300,11.653,237,9.206,29606,6883,22723,2.991,12.864,33035,11308,21727,4.913,14.354,-3429,-1.490,25.727,148,151,3559
1981,321,14840,16704,507709,524962,2253,13.665,1820,11.039,66744,28788,37956,5.484,12.714,101140,29264,71876,5.575,19.266,-34396,-6.552,25.428,1253,1266,12982
1981,322,3740,5798,623012,627621,479,8.355,349,6.088,50741,24372,26369,3.883,8.085,60880,18533,42347,2.953,9.700,-10139,-1.615,16.169,138,141,3225
1981,323,32229,33691,664190,653562,5191,16.100,2292,7.109,100227,45909,54318,7.024,15.336,78227,27288,50939,4.175,11.969,22000,3.366,23.939,1492,1498,9307
1981,324,1536,2419,528870,541123,268,11.197,217,9.066,24488,6211,18277,1.148,4.525,49453,9949,39504,1.839,9.139,-24965,-4.614,9.051,74,74,1152
1981,325,8084,11762,946859,950810,1312,11.424,758,6.600,81355,28245,53110,2.971,8.556,88946,20809,68137,2.189,9.355,-7591,-0.798,17.113,365,373,3812
1981,326,11461,13444,714319,731774,1650,12.590,973,7.424,83638,31002,52636,4.237,11.429,119882,36718,83164,5.018,16.382,-36244,-4.953,22.859,578,580,8318
1981,327,12257,15354,551684,563439,1603,10.589,1171,7.736,58074,23041,35033,4.089,10.307,81626,20937,60689,3.716,14.487,-23552,-4.180,20.614,744,751,6976
1981,331,4746,5960,664736,685760,615,10.549,355,6.089,59982,26563,33419,3.874,8.747,101589,31650,69939,4.615,14.814,-41607,-6.067,17.494,184,188,5123
1981,332,47319,51351,1792157,1820594,6369,12.750,3569,7.145,208410,81054,127356,4.452,11.447,265509,57974,207535,3.184,14.584,-57099,-3.136,22.895,2379,2394,21319
1981,333,26575,29616,1810329,1844749,3526,12.283,1705,5.940,210398,81279,129119,4.406,11.405,277674,69219,208455,3.752,15.052,-67276,-3.647,22.810,1072,1076,12459
1981,334,10742,12578,1756855,1754444,2095,17.434,972,8.089,210367,74988,135379,4.274,11.991,205818,57755,148063,3.292,11.731,4549,0.259,23.462,533,536,13159
1981,335,4977,6165,714600,726624,761,12.729,388,6.490,70189,30922,39267,4.256,9.660,93741,22385,71356,3.081,12.901,-23552,-3.241,19.319,228,230,3436
1981,336,7958,9508,1941457,1986756,1210,12.918,927,9.897,186024,49382,136642,2.486,9.363,276368,64098,212270,3.226,13.911,-90344,-4.547,18.726,574,576,10146
1981,337,15106,16093,527864,536751,2232,14.136,1624,10.286,65332,29018,36314,5.406,12.172,82895,22718,60177,4.233,15.444,-17563,-3.272,24.344,1181,1185,9831
1981,339,23298,24548,653547,657053,3313,13.768,2342,9.733,93976,38131,55845,5.803,14.303,100819,33653,67166,5.122,15.344,-6843,-1.041,28.605,1578,1589,13358
1981,423,151271,196405,2422771,2405048,23897,12.414,16076,8.351,401675,164998,236677,6.860,16.701,365611,119128,246483,4.953,15.202,36064,1.500,30.404,9535,9810,49974
1981,424,94829,121071,1662532,1636034,13350,11.155,10563,8.826,286939,110145,176794,6.732,17.539,234864,78724,156140,4.812,14.356,52075,3.183,28.711,6704,6872,37460
1981,425,27533,30472,293550,288574,3868,13.020,2340,7.877,54687,22526,32161,7.806,18.951,44731,13377,31354,4.636,15.501,9956,3.450,31.001,1447,1457,6921
1981,441,90713,109148,1208877,1241151,9398,8.567,10505,9.576,152858,62005,90853,4.996,12.316,217302,69096,148206,5.567,17.508,-64444,-5.192,24.632,7237,7394,48673
1981,442,42588,50079,334754,340293,5569,11.163,5187,10.397,55363,22956,32407,6.746,16.269,66290,21520,44770,6.324,19.480,-10927,-3.211,32.538,3758,3844,14355
1981,443,23979,30883,176717,179206,3962,12.817,4022,13.011,35329,17095,18234,9.539,19.714,40386,15064,25322,8.406,22.536,-5057,-2.822,39.428,2564,2756,9122
1981,444,69830,87557,768827,769932,7584,8.721,6389,7.347,113681,45806,67875,5.949,14.765,116094,30282,85812,3.933,15.078,-2413,-0.313,29.530,4461,4557,17802
1981,445,116286,168183,2131187,2093396,20776,12.496,16932,10.184,368858,180112,188746,8.604,17.620,290613,105311,185302,5.031,13.882,78245,3.738,27.765,10905,11200,49378
1981,446,41216,59071,532183,532340,5751,9.901,3778,6.504,78604,34818,43786,6.541,14.766,78536,21486,57050,4.036,14.753,68,0.013,29.506,2389,2457,12025
1981,447,108420,139198,786703,783403,14724,10.452,18076,12.831,171312,68757,102555,8.777,21.868,165171,68135,97036,8.697,21.084,6141,0.784,42.168,11905,12192,43360
1981,448,88996,155996,1097901,1097667,19092,12.394,15180,9.855,211475,103292,108183,9.410,19.266,212061,66531,145530,6.061,19.319,-586,-0.053,38.532,8446,9383,33893
1981,451,39488,50836,313338,310650,7107,14.116,6127,12.170,65626,27451,38175,8.837,21.125,60282,22484,37798,7.238,19.405,5344,1.720,38.810,4099,4277,12927
1981,452,14876,36798,1920759,1932982,2738,7.421,2929,7.939,189441,108002,81439,5.587,9.800,213240,39677,173563,2.053,11.032,-23799,-1.231,19.601,1513,1552,7121
1981,453,78224,90367,451017,447831,12847,14.394,10621,11.900,99383,43342,56041,9.678,22.192,93065,34923,58142,7.798,20.781,6318,1.411,41.563,7264,7448,21085
1981,454,26087,34568,364050,367694,3398,9.819,3478,10.050,54433,18745,35688,5.098,14.804,61570,19842,41728,5.396,16.745,-7137,-1.941,29.608,2303,2328,9777
1981,481,1474,3194,270404,271643,473,15.720,103,3.423,19121,5495,13626,2.023,7.039,21845,1636,20209,0.602,8.042,-2724,-1.003,14.078,16,18,193
1981,483,836,1171,53158,53902,132,11.666,53,4.684,9394,3226,6168,5.985,17.428,10651,1830,8821,3.395,19.760,-1257,-2.332,34.856,11,11,19
1981,484,60072,69688,1036395,1052936,10263,14.770,9857,14.186,159530,60457,99073,5.742,15.151,192800,55662,137138,5.286,18.311,-33270,-3.160,30.302,7224,7255,27909
1981,485,11294,12146,240168,239976,1402,11.799,875,7.364,36392,12663,23729,5.277,15.165,36197,11015,25182,4.590,15.084,195,0.081,30.167,640,643,4095
1981,486,357,1747,77454,75571,218,13.117,48,2.888,8550,2877,5673,3.807,11.314,4822,628,4194,0.831,6.381,3728,4.933,12.762,(D),(D),(D)
1981,487,892,914,11965,12168,168,19.156,94,10.718,2694,874,1820,7.183,22.140,3078,1507,1571,12.385,25.296,-384,-3.156,44.280,60,60,258
1981,488,10870,14271,307796,307045,2128,15.635,807,5.929,56477,18914,37563,6.160,18.394,55122,9896,45226,3.223,17.952,1355,0.441,35.905,361,370,1933
1981,492,1934,2481,106827,109145,646,27.536,376,16.027,8037,3630,4407,3.326,7.364,12317,1418,10899,1.299,11.285,-4280,-3.921,14.727,286,286,883
1981,493,6416,9912,400103,401103,845,8.635,592,6.050,51705,19223,32482,4.793,12.891,53352,9503,43849,2.369,13.301,-1647,-0.411,25.781,268,270,1620
1981,511,18642,21379,694653,679409,4072,20.043,1946,9.579,92843,37558,55285,5.528,13.665,62434,21904,40530,3.224,9.189,30409,4.476,18.379,1312,1334,8950
1981,512,10229,15617,196940,196568,2367,15.407,1859,12.101,49767,19614,30153,9.978,25.318,48676,14263,34413,7.256,24.763,1091,0.555,49.526,1007,1047,5820
1981,515,5589,6608,199930,193852,628,9.870,138,2.169,29384,11518,17866,5.942,15.158,17390,3003,14387,1.549,8.971,11994,6.187,17.942,32,40,340
1981,517,3601,16943,1075689,1064745,891,5.299,634,3.771,237428,12713,224715,1.194,22.299,217754,5564,212190,0.523,20.451,19674,1.848,40.903,169,170,683
1981,518,5490,7188,196190,195948,1335,19.263,820,11.832,39112,16812,22300,8.580,19.960,38914,14577,24337,7.439,19.859,198,0.101,39.719,423,436,3950
1981,519,1940,2294,27962,27150,232,10.254,169,7.470,4269,1592,2677,5.864,15.724,2613,899,1714,3.311,9.624,1656,6.100,19.249,103,108,522
1981,521,20,48,20981,20551,6,13.333,0,0.000,1015,147,868,0.715,4.939,120,0,120,0.000,0.584,895,4.355,1.168,0,0,0
1981,522,46180,111417,2191469,2145301,8157,7.456,4123,3.769,253098,83822,169276,3.907,11.798,161368,36265,125103,1.690,7.522,91730,4.276,15.044,745,812,4107
1981,523,15089,20056,306951,283435,3860,20.772,913,4.913,73428,25539,47889,9.011,25.906,26167,7443,18724,2.626,9.232,47261,16.674,18.464,429,439,3293
1981,524,92390,121454,1774264,1748340,12379,10.571,3684,3.146,249210,109145,140065,6.243,14.254,196816,48849,147967,2.794,11.257,52394,2.997,22.515,1039,1090,4159
1981,525,1507,1699,14799,14188,203,12.504,52,3.203,3347,984,2363,6.935,23.590,2089,186,1903,1.311,14.724,1258,8.867,29.447,13,14,53
1981,531,154859,158969,863870,830080,21221,14.104,4205,2.795,201765,86819,114946,10.459,24.307,135555,22147,113408,2.668,16.330,66210,7.976,32.661,2310,2416,7463
1981,532,19284,25971,253691,250118,4219,16.603,3098,12.192,59905,25140,34765,10.051,23.951,52772,18880,33892,7.548,21.099,7133,2.852,42.198,1951,1979,9104
1981,533,911,963,9698,9910,183,20.390,52,5.794,2047,881,1166,8.890,20.656,2428,696,1732,7.023,24.501,-381,-3.845,41.312,26,27,81
1981,541,277210,294892,2703692,2622668,46207,16.073,31377,10.915,550057,213682,336375,8.148,20.973,387658,131451,256207,5.012,14.781,162399,6.192,29.562,21715,21901,72738
1981,551,21333,41058,2706293,2659617,5013,12.584,2570,6.451,442831,158994,283837,5.978,16.650,349624,75055,274569,2.822,13.146,93207,3.505,26.291,351,362,4226
1981,561,120229,135465,2164365,2141041,25938,19.810,16880,12.892,518674,202157,316517,9.442,24.225,471855,132167,339688,6.173,22.039,46819,2.187,44.077,12004,12126,69097
1981,562,10927,11754,172293,171152,1550,13.412,1155,9.994,27612,9485,18127,5.542,16.133,25198,7061,18137,4.126,14.723,2414,1.410,29.445,824,827,4293
1981,611,28389,30443,1339312,1310130,3352,11.084,2952,9.761,154120,25139,128981,1.919,11.764,95425,19460,75965,1.485,7.284,58695,4.480,14.567,2095,2122,10735
1981,621,295512,307186,1697836,1643580,31902,10.645,16920,5.646,327493,130462,197031,7.938,19.926,218616,67289,151327,4.094,13.301,108877,6.624,26.602,11440,11532,37767
1981,622,4215,5373,2725243,2651490,315,5.913,224,4.205,235309,57216,178093,2.158,8.875,86756,40660,46096,1.533,3.272,148553,5.603,6.544,98,104,21927
1981,623,19042,25617,1276664,1231582,2943,11.785,1652,6.616,206194,98813,107381,8.023,16.742,114507,46315,68192,3.761,9.298,91687,7.445,18.595,1035,1079,28257
1981,624,37020,48824,699249,686626,6308,13.170,4450,9.291,133886,49065,84821,7.146,19.499,108628,34166,74462,4.976,15.821,25258,3.679,31.641,2791,2832,14504
1981,711,14603,14866,201136,194664,3269,22.588,2481,17.143,57408,22746,34662,11.685,29.491,44109,13803,30306,7.091,22.659,13299,6.832,45.318,1691,1696,8358
1981,712,1461,1542,28523,28781,82,5.216,142,9.033,3304,608,2696,2.113,11.480,3762,729,3033,2.533,13.071,-458,-1.591,22.960,91,94,484
1981,713,31625,33715,520175,511456,4195,12.667,3000,9.059,95461,36308,59153,7.099,18.665,77575,20752,56823,4.057,15.167,17886,3.497,30.335,2016,2035,11867
1981,721,37379,41631,1097177,1078008,4532,10.859,4739,11.355,210032,99133,110899,9.196,19.483,172118,54290,117828,5.036,15.966,37914,3.517,31.933,3285,3319,30775
1981,722,254964,315814,4651352,4601798,48815,15.569,44278,14.122,1050468,581845,468623,12.644,22.827,951439,382177,569262,8.305,20.675,99029,2.152,41.351,29738,30441,225837
1981,811,137058,144832,773789,773606,21036,14.601,19518,13.547,162892,72761,90131,9.405,21.056,162924,62068,100856,8.023,21.060,-32,-0.004,42.112,13844,13903,39923
1981,812,144001,166700,1051322,1043091,19635,11.777,19682,11.805,198313,85444,112869,8.191,19.012,181205,70656,110549,6.774,17.372,17108,1.640,34.744,13706,14082,45117
1981,813,151890,158157,1435505,1423809,10111,6.482,5755,3.690,216369,55679,160690,3.911,15.196,193147,32825,160322,2.305,13.566,23222,1.631,27.131,3500,3524,13763
1982,211,7406,9465,183081,173388,1744,19.125,1052,11.536,52456,19174,33282,11.058,30.254,33142,13077,20065,7.542,19.114,19314,11.139,38.229,599,613,3679
1982,212,7247,9716,412362,423910,1373,14.170,1320,13.623,62608,24561,38047,5.794,14.769,85792,26473,59319,6.245,20.238,-23184,-5.469,29.538,843,846,10051
1982,213,11955,13653,426792,394752,3626,28.640,1641,12.962,151087,57207,93880,14.492,38.274,87505,36623,50882,9.277,22.167,63582,16.107,44.334,1167,1176,18387
1982,221,5857,12277,746752,729519,961,8.064,242,2.031,57183,17880,39303,2.451,7.838,23511,4423,19088,0.606,3.223,33672,4.616,6.446,128,131,514
1982,236,110239,111344,975165,1045893,16507,13.900,31328,26.380,246755,77438,169317,7.404,23.593,388729,128797,259932,12.315,37.167,-141974,-13.574,47.186,21685,21691,93577
1982,237,33544,34448,684201,704831,4649,13.243,5966,16.994,147951,36022,111929,5.111,20.991,188196,43452,144744,6.165,26.701,-40245,-5.710,41.982,4265,4271,25025
1982,238,243170,246421,2224831,2294988,31537,12.450,45321,17.891,526450,147717,378733,6.437,22.939,667688,186713,480975,8.136,29.093,-141238,-6.154,45.878,31312,31330,132831
1982,311,21445,27206,1349921,1346822,2610,9.597,2592,9.530,177736,62159,115577,4.615,13.197,170634,58999,111635,4.381,12.669,7102,0.527,25.339,1678,1709,17481
1982,312,2144,2777,223958,227248,177,6.265,273,9.664,19051,4648,14403,2.045,8.383,25547,9490,16057,4.176,11.242,-6496,-2.859,16.767,172,174,2518
1982,313,3497,4540,532706,552529,330,7.222,389,8.513,35064,14648,20416,2.651,6.346,74948,17691,57257,3.202,13.565,-39884,-7.218,12.692,238,244,5171
1982,314,7260,7694,230979,235099,786,10.061,1022,13.082,30757,9307,21450,3.959,13.083,39000,11147,27853,4.741,16.589,-8243,-3.506,26.165,801,804,7277
1982,315,18196,20383,1267287,1283145,2270,11.118,2338,11.451,169961,59002,110959,4.598,13.246,201293,61960,139333,4.829,15.687,-31332,-2.442,26.491,1803,1823,35835
1982,316,2142,2488,211829,217739,234,9.364,256,10.244,22641,5544,17097,2.546,10.398,34646,8155,26491,3.745,15.912,-12005,-5.513,20.797,189,190,3661
1982,321,14095,15867,437643,470107,1386,8.524,2172,13.358,50174,19993,30181,4.253,10.673,115374,30577,84797,6.504,24.542,-65200,-13.869,21.346,1510,1514,13893
1982,322,3782,5842,612742,621812,301,5.128,356,6.065,48970,18193,30777,2.926,7.875,66298,21044,45254,3.384,10.662,-17328,-2.787,15.751,193,199,2961
1982,323,33263,34807,685223,682793,3767,10.962,2880,8.381,90138,28892,61246,4.231,13.201,85310,27750,57560,4.064,12.494,4828,0.707,24.989,2163,2170,14018
1982,324,1489,2384,355865,384835,209,8.791,196,8.244,17073,4703,12370,1.222,4.436,75712,12999,62713,3.378,19.674,-58639,-15.237,8.873,92,100,1469
1982,325,7990,11602,889237,896299,967,8.311,1032,8.870,80436,29309,51127,3.270,8.974,94621,30774,63847,3.433,10.557,-14185,-1.583,17.948,539,542,5112
1982,326,11734,13689,683961,698496,1251,9.182,1123,8.242,77563,29615,47948,4.240,11.104,106871,29956,76915,4.289,15.300,-29308,-4.196,22.209,742,748,9814
1982,327,11852,14924,499133,523572,1139,7.547,1475,9.773,55122,25037,30085,4.782,10.528,104210,24223,79987,4.626,19.904,-49088,-9.376,21.056,960,973,8828
1982,331,4649,5825,686017,719524,417,7.153,427,7.324,50896,23795,27101,3.307,7.074,117209,23422,93787,3.255,16.290,-66313,-9.216,14.147,257,258,5053
1982,332,48619,52770,1704370,1751330,4856,9.256,4246,8.093,189794,66515,123279,3.798,10.837,283769,66514,217255,3.798,16.203,-93975,-5.366,21.674,3112,3122,24982
1982,333,25686,28800,1715906,1758129,2377,8.275,2224,7.743,183543,77571,105972,4.412,10.440,267737,58021,209716,3.300,15.229,-84194,-4.789,20.879,1567,1572,16220
1982,334,11305,13260,1790154,1777117,1744,13.469,1121,8.657,224182,64802,159380,3.646,12.615,197836,55160,142676,3.104,11.132,26346,1.483,22.265,735,736,11300
1982,335,5070,6315,686572,705403,579,9.262,452,7.230,65739,26231,39508,3.719,9.319,104076,18951,85125,2.687,14.754,-38337,-5.435,18.639,290,292,3673
1982,336,8023,9511,1793606,1870446,816,8.538,909,9.511,136354,35607,100747,1.904,7.290,289578,66411,223167,3.551,15.482,-153224,-8.192,14.580,626,628,7982
1982,337,14684,15667,494311,513573,1605,10.079,2120,13.313,54289,20448,33841,3.982,10.571,92560,26217,66343,5.105,18.023,-38271,-7.452,21.142,1593,1602,13920
1982,339,23329,24546,627255,635080,3034,12.419,2801,11.466,90021,33356,56665,5.252,14.175,105404,33890,71514,5.336,16.597,-15383,-2.422,28.349,2061,2069,12830
1982,423,153880,199414,2382481,2400959,22492,11.339,20393,10.281,406109,146358,259751,6.096,16.914,444115,145939,298176,6.078,18.497,-38006,-1.583,33.829,12623,12951,64611
1982,424,96310,123067,1707338,1695708,12994,10.566,12813,10.419,305340,100634,204706,5.935,18.007,282121,101308,180813,5.974,16.637,23219,1.369,33.275,8122,8261,45418
1982,425,27957,30881,288536,288109,3684,12.098,2823,9.271,52826,18939,33887,6.574,18.335,52141,16378,35763,5.685,18.098,685,0.238,36.195,1791,1794,9450
1982,441,89936,111487,1209564,1210759,12794,11.558,11213,10.129,191545,80015,111530,6.609,15.820,194868,68921,125947,5.692,16.095,-3323,-0.274,31.640,7870,8015,49879
1982,442,41290,49232,322234,328391,5539,11.140,6520,13.113,59274,23057,36217,7.021,18.050,71559,24204,47355,7.370,21.791,-12285,-3.741,36.100,4640,4794,15964
1982,443,22927,30168,168949,170963,4643,15.318,4927,16.255,39485,18955,20530,11.087,23.096,43319,20363,22956,11.911,25.338,-3834,-2.243,46.191,3003,3201,11649
1982,444,68469,86436,737399,750426,7197,8.275,8262,9.500,108818,40151,68667,5.350,14.501,135225,39628,95597,5.281,18.020,-26407,-3.519,29.002,5646,5774,22794
1982,445,115104,171581,2171855,2150471,22835,13.427,19805,11.645,382897,183416,199481,8.529,17.805,337450,134271,203179,6.244,15.692,45447,2.113,31.384,13810,14027,64799
1982,446,43263,64238,554975,551219,6159,9.680,4936,7.758,91782,36940,54842,6.702,16.651,83449,26657,56792,4.836,15.139,8333,1.512,30.278,3268,3340,16228
1982,447,99650,130277,757193,767451,15206,11.379,21910,16.396,170355,73530,96825,9.581,22.198,189976,87505,102471,11.402,24.754,-19621,-2.557,44.395,15516,15939,57662
1982,448,87471,157266,1118423,1116202,18156,11.551,17995,11.448,224433,99906,124527,8.951,20.107,217678,75958,141720,6.805,19.502,6755,0.605,39.003,10707,11472,39233
1982,451,39146,52796,317656,315369,8922,17.204,7048,13.591,73610,37212,36398,11.800,23.341,69912,24817,45095,7.869,22.168,3698,1.173,44.337,5021,5144,16256
1982,452,13007,34188,1850224,1873740,2616,7.565,3397,9.824,189284,86687,102597,4.626,10.102,240363,55268,185095,2.950,12.828,-51079,-2.726,20.204,1735,1790,7961
1982,453,74493,86046,439253,438253,13076,15.140,13720,15.886,107428,47549,59879,10.850,24.513,105525,44406,61119,10.133,24.079,1903,0.434,48.157,9734,10160,29225
1982,454,25510,34195,362547,367098,3350,9.686,4130,11.942,62256,22419,39837,6.107,16.959,71752,21953,49799,5.980,19.546,-9496,-2.587,33.918,2780,2813,11463
1982,481,1492,3357,264893,265299,501,15.708,166,5.205,22620,5713,16907,2.153,8.526,23453,1592,21861,0.600,8.840,-833,-0.314,17.052,87,92,623
1982,483,802,1139,54663,53512,117,10.451,78,6.967,9736,2766,6970,5.169,18.194,7606,1662,5944,3.106,14.214,2130,3.980,28.427,32,33,364
1982,484,59318,69331,1012178,1016610,10472,15.762,4689,7.058,160595,62487,98108,6.147,15.797,169396,34049,135347,3.349,16.663,-8801,-0.866,31.594,3406,3457,18353
1982,485,10756,11599,235118,233519,1303,11.542,683,6.050,38188,15344,22844,6.571,16.353,35032,7391,27641,3.165,15.002,3156,1.351,30.004,505,508,3087
1982,486,330,1825,80352,78995,183,10.313,82,4.621,8409,2475,5934,3.133,10.645,5838,2642,3196,3.345,7.390,2571,3.255,14.781,14,14,307
1982,487,882,905,11910,11913,163,18.346,130,14.631,2631,1158,1473,9.720,22.085,2576,751,1825,6.304,21.623,55,0.462,43.247,102,102,444
1982,488,10865,14354,312466,307107,2163,15.647,1102,7.972,61608,24615,36993,8.015,20.061,50737,9346,41391,3.043,16.521,10871,3.540,33.042,737,747,4176
1982,492,1868,2451,101632,103759,548,23.560,298,12.812,8933,3229,5704,3.112,8.609,13173,1203,11970,1.159,12.696,-4240,-4.086,17.219,241,242,915
1982,493,6213,9865,383479,389160,963,9.889,709,7.281,57219,21418,35801,5.504,14.703,68448,11563,56885,2.971,17.589,-11229,-2.885,29.406,299,299,1894
1982,511,19779,22817,725308,708210,3745,16.871,2506,11.290,105024,40471,64553,5.715,14.829,70276,21872,48404,3.088,9.923,34748,4.906,19.846,1815,1826,11139
1982,512,10288,15804,216684,217699,2365,15.029,2230,14.171,50845,19742,31103,9.068,23.356,52755,15749,37006,7.234,24.233,-1910,-0.877,46.711,1356,1393,8593
1982,515,5781,6864,211322,203201,846,12.903,231,3.523,32448,14447,18001,7.110,15.968,16242,2917,13325,1.436,7.993,16206,7.975,15.986,151,156,1286
1982,517,3623,17084,1076656,1074844,863,5.113,452,2.678,95646,12030,83616,1.119,8.899,94946,5570,89376,0.518,8.833,700,0.065,17.667,256,259,1613
1982,518,5666,7455,208909,202804,1252,17.192,907,12.455,47641,18324,29317,9.035,23.491,35937,10759,25178,5.305,17.720,11704,5.771,35.440,544,566,4762
1982,519,1884,2103,24559,23128,366,18.200,182,9.050,5906,3528,2378,15.255,25.537,3115,1105,2010,4.778,13.469,2791,12.068,26.938,127,127,858
1982,521,30,66,24624,22842,15,25.424,(D),(D),4009,4009,0,17.551,17.551,671,(D),670,(D),2.938,3338,14.613,5.875,(D),(D),(D)
1982,522,45208,109855,2214650,2196274,5715,5.201,5778,5.258,213245,55159,158086,2.511,9.709,176719,40306,136413,1.835,8.046,36526,1.663,16.093,1348,1557,8811
1982,523,16557,21687,351889,327531,4187,20.608,1447,7.122,85918,48558,37360,14.825,26.232,37920,11398,26522,3.480,11.578,47998,14.654,23.155,956,1000,4761
1982,524,93593,122552,2089923,1923488,13528,11.413,5492,4.633,532116,349280,182836,18.159,27.664,198625,44282,154343,2.302,10.326,333491,17.338,20.653,2929,2944,8439
1982,525,1742,1943,42397,28633,290,15.917,48,2.634,29862,26674,3188,93.158,104.292,1854,138,1716,0.482,6.475,28008,97.817,12.950,30,30,84
1982,531,145595,149907,841695,828108,19449,13.354,10928,7.503,186296,78869,107427,9.524,22.497,159409,37768,121641,4.561,19.250,26887,3.247,38.500,8550,8590,24003
1982,532,20324,27576,261999,259381,4696,17.395,3535,13.095,61460,25482,35978,9.824,23.695,56091,20658,35433,7.964,21.625,5369,2.070,43.250,2405,2446,10592
1982,533,912,970,11043,10330,197,21.589,82,8.986,2993,1165,1828,11.278,28.974,1550,581,969,5.624,15.005,1443,13.969,30.010,65,65,283
1982,541,278221,296887,2616683,2579693,48843,16.746,38397,13.165,560928,236057,324871,9.151,21.744,487644,180346,307298,6.991,18.903,73284,2.841,37.806,28525,28679,105769
1982,551,22083,42667,2766875,2737171,4852,11.604,3145,7.521,538382,200797,337585,7.336,19.669,475376,119371,356005,4.361,17.367,63006,2.302,34.735,468,481,5595
1982,561,132091,149460,2397371,2356860,27769,19.202,18086,12.506,575540,205204,370336,8.707,24.420,495531,138594,356937,5.880,21.025,80009,3.395,42.050,13604,13667,79153
1982,562,10630,11465,168155,165625,1518,13.599,913,8.179,29308,9522,19786,5.749,17.695,24169,6742,17427,4.071,14.593,5139,3.103,29.185,669,669,4019
1982,611,30350,32771,1444391,1387130,5731,18.256,2973,9.471,220335,104947,115388,7.566,15.884,104415,17098,87317,1.233,7.527,115920,8.357,15.055,2232,2246,10269
1982,621,308559,321405,1830992,1769601,35732,11.364,21771,6.924,377816,155773,222043,8.803,21.350,256983,82966,174017,4.688,14.522,120833,6.828,29.044,16639,16758,58424
1982,622,4150,5444,2875697,2789739,457,8.620,172,3.244,265303,98586,166717,3.534,9.510,92323,28853,63470,1.034,3.309,172980,6.201,6.619,87,90,18264
1982,623,19716,27124,1330908,1309668,3273,12.349,2032,7.667,200192,96334,103858,7.356,15.286,157909,64666,93243,4.938,12.057,42283,3.229,24.114,1312,1351,36925
1982,624,42970,55298,747199,736831,10782,20.454,5611,10.645,185748,97085,88663,13.176,25.209,164814,44973,119841,6.104,22.368,20934,2.841,44.736,3500,3897,29020
1982,711,14928,15239,199608,195186,3699,24.536,3373,22.373,58377,25431,32946,13.029,29.908,49350,17543,31807,8.988,25.284,9027,4.625,50.567,2498,2503,12377
1982,712,181,184,3022,2965,37,15.812,137,58.547,955,556,399,18.755,32.215,869,739,130,24.928,29.314,86,2.901,58.627,98,98,392
1982,713,34107,36734,561062,547452,5697,16.012,3390,9.528,108732,41429,67303,7.568,19.861,81778,21786,59992,3.980,14.938,26954,4.924,29.876,2547,2566,16311
1982,721,36158,40708,1126736,1111904,4736,11.553,5310,12.953,219657,96150,123507,8.647,19.755,190884,74393,116491,6.691,17.167,28773,2.588,34.335,3910,3959,47666
1982,722,251451,315618,4734638,4695117,49524,15.678,50039,15.841,1146227,605163,541064,12.889,24.413,1060895,435766,625129,9.281,22.596,85332,1.817,45.191,37346,37941,285401
1982,811,135988,143908,758504,756909,20921,14.518,21306,14.786,167276,71185,96091,9.405,22.100,164030,67911,96119,8.972,21.671,3246,0.429,43.342,16102,16147,48695
1982,812,143015,166353,1095713,1090108,21092,12.615,22769,13.619,225580,99322,126258,9.111,20.693,213499,85976,127523,7.887,19.585,12081,1.108,39.170,16615,16842,53920
1982,813,167897,174358,1582341,1507435,26508,16.111,6861,4.170,349861,174787,175074,11.595,23.209,198783,24589,174194,1.631,13.187,151078,10.022,26.374,3959,4004,14615
1983,211,7719,9784,170308,176711,1415,14.591,1243,12.817,33849,14471,19378,8.189,19.155,46736,14159,32577,8.013,26.448,-12887,-7.293,38.310,844,849,5174
1983,212,6744,9134,328274,370556,1029,10.879,1678,17.741,38535,17132,21403,4.623,10.399,123956,28706,95250,7.747,33.451,-85421,-23.052,20.798,1099,1104,11492
1983,213,11367,12893,297972,362450,1989,15.038,2656,20.081,53865,24918,28947,6.875,14.861,182364,48578,133786,13.403,50.314,-128499,-35.453,29.723,1862,1871,23936
1983,221,5599,12022,748383,740879,615,5.248,10,0.085,52058,15352,36706,2.072,7.027,36863,51,36812,0.007,4.976,15195,2.051,9.951,8,8,47
1983,236,112069,113133,951667,972175,21122,18.744,20234,17.956,269779,89363,180416,9.192,27.750,311926,90827,221099,9.343,32.085,-42147,-4.335,55.500,13922,13930,63973
1983,237,33635,34511,624422,654218,4852,14.063,4834,14.011,130760,34817,95943,5.322,19.987,189544,36721,152823,5.613,28.973,-58784,-8.985,39.974,3486,3492,21792
1983,238,246397,249627,2217285,2244235,37464,15.101,34378,13.857,557208,166907,390301,7.437,24.828,611170,156972,454198,6.994,27.233,-53962,-2.404,49.657,24399,24422,116313
1983,311,22068,27704,1324271,1345435,2685,9.764,2274,8.270,147263,43956,103307,3.267,10.945,189357,65284,124073,4.852,14.074,-42094,-3.129,21.891,1440,1465,20624
1983,312,2108,2729,216727,220695,167,6.057,223,8.089,18707,4992,13715,2.262,8.476,27004,8688,18316,3.937,12.236,-8297,-3.759,16.953,130,132,1940
1983,313,3626,4656,507463,524703,315,6.705,399,8.493,37058,10207,26851,1.945,7.063,71076,22951,48125,4.374,13.546,-34018,-6.483,14.125,222,223,4262
1983,314,7351,7813,233590,236126,868,11.106,873,11.170,34841,11447,23394,4.848,14.755,39812,14777,25035,6.258,16.861,-4971,-2.105,29.511,677,684,8895
1983,315,15175,17095,1064699,1092479,1979,11.356,2644,15.171,138277,46441,91836,4.251,12.657,194436,76347,118089,6.988,17.798,-56159,-5.141,25.314,2117,2140,44118
1983,316,2180,2536,198715,207143,234,9.200,249,9.790,19235,5773,13462,2.787,9.286,35942,7952,27990,3.839,17.351,-16707,-8.065,18.572,192,194,2906
1983,321,14043,15777,455682,447532,1622,10.223,1799,11.339,82879,23632,59247,5.281,18.519,66316,26319,39997,5.881,14.818,16563,3.701,29.636,1262,1266,11755
1983,322,3763,5745,581410,591474,263,4.545,346,5.979,39792,13524,26268,2.286,6.728,60044,23292,36752,3.938,10.152,-20252,-3.424,13.455,187,196,3123
1983,323,34472,36039,678273,679012,4182,11.831,2801,7.924,84176,27194,56982,4.005,12.397,85225,27085,58140,3.989,12.551,-1049,-0.154,24.794,2204,2209,14350
1983,324,1481,2353,273804,315058,186,7.823,235,9.884,15524,4791,10733,1.521,4.927,98286,20099,78187,6.379,31.196,-82762,-26.269,9.855,105,107,1337
1983,325,8272,11969,913345,929220,963,8.080,863,7.241,78620,34782,43838,3.743,8.461,110267,29206,81061,3.143,11.867,-31647,-3.406,16.922,473,480,4420
1983,326,11711,13665,665574,671731,1245,9.153,1119,8.227,86187,29293,56894,4.361,12.831,98439,31310,67129,4.661,14.655,-12252,-1.824,25.661,737,743,10150
1983,327,11813,14836,478967,491284,1177,7.896,1318,8.842,57356,17757,39599,3.614,11.675,82343,26683,55660,5.431,16.761,-24987,-5.086,23.349,850,855,7783
1983,331,4586,5717,572443,632108,375,6.482,511,8.833,35046,12922,22124,2.044,5.544,154420,29572,124848,4.678,24.429,-119374,-18.885,11.089,295,297,5235
1983,332,48235,52329,1527893,1630360,4127,7.827,4918,9.328,160409,54798,105611,3.361,9.839,366078,79113,286965,4.852,22.454,-205669,-12.615,19.678,3449,3470,35031
1983,333,25992,29011,1386703,1564095,1937,6.600,2614,8.906,107641,40701,66940,2.602,6.882,463365,93399,369966,5.971,29.625,-355724,-22.743,13.764,1701,1707,17447
1983,334,11858,13859,1751598,1779866,1700,12.466,1257,9.217,193625,57614,136011,3.237,10.879,248450,72924,175526,4.097,13.959,-54825,-3.080,21.757,848,851,14099
1983,335,5178,6370,620872,656553,540,8.463,561,8.792,51373,14737,36636,2.245,7.825,120889,31733,89156,4.833,18.413,-69516,-10.588,15.649,325,325,5489
1983,336,8206,9706,1718109,1758801,963,9.961,887,9.175,164408,25481,138927,1.449,9.348,246260,47506,198754,2.701,14.002,-81852,-4.654,18.695,615,618,13783
1983,337,14678,15664,492132,495574,1723,10.974,1796,11.439,66718,21593,45125,4.357,13.463,73216,27533,45683,5.556,14.774,-6498,-1.311,26.926,1344,1358,13405
1983,339,24074,25298,616413,630699,3114,12.439,2588,10.338,74961,26361,48600,4.180,11.885,103681,28264,75417,4.481,16.439,-28720,-4.554,23.771,1952,1955,13060
1983,423,156359,201293,2289779,2333973,22890,11.425,20991,10.478,359398,128783,230615,5.518,15.399,446837,144680,302157,6.199,19.145,-87439,-3.746,30.797,13197,13538,73260
1983,424,97167,123438,1669718,1690869,13019,10.563,12639,10.255,254659,83834,170825,4.958,15.061,296069,100487,195582,5.943,17.510,-41410,-2.449,30.122,8213,8398,49727
1983,425,28169,30985,279577,283739,3416,11.109,2948,9.587,45481,15911,29570,5.608,16.029,53590,17110,36480,6.030,18.887,-8109,-2.858,32.058,1876,1880,8739
1983,441,91144,113522,1232311,1221074,11377,10.116,9273,8.245,184188,64139,120049,5.253,15.084,161808,59347,102461,4.860,13.251,22380,1.833,26.503,6727,6828,44222
1983,442,41245,49387,319894,321202,5930,12.026,5776,11.714,61182,24960,36222,7.771,19.048,63320,24150,39170,7.519,19.713,-2138,-0.666,38.096,4087,4271,15808
1983,443,23848,31065,174165,173421,4520,14.598,4317,13.942,40148,17443,22705,10.058,23.151,38504,17313,21191,9.983,22.203,1644,0.948,44.405,2627,2784,9915
1983,444,69431,87157,746999,747483,7555,8.673,7454,8.557,115631,37605,78026,5.031,15.469,116805,37657,79148,5.038,15.626,-1174,-0.157,30.939,4827,4965,21086
1983,445,117541,172815,2221199,2195585,19846,11.529,18505,10.750,381109,176396,204713,8.034,17.358,331603,135321,196282,6.163,15.103,49506,2.255,30.206,11791,12209,60063
1983,446,42678,61534,551694,548914,6259,10.288,4862,7.992,86064,36598,49466,6.667,15.679,80090,28127,51963,5.124,14.591,5974,1.088,29.181,2855,2993,15005
1983,447,97981,129496,746770,752641,16677,12.842,17402,13.401,165459,79094,86365,10.509,21.984,177376,74163,103213,9.854,23.567,-11917,-1.583,43.968,11450,11718,45048
1983,448,87377,156777,1109764,1121726,16858,10.735,17386,11.071,218036,93593,124443,8.344,19.438,243455,98260,145195,8.760,21.704,-25419,-2.266,38.875,9437,10220,39768
1983,451,39156,53267,326682,320886,7340,13.899,6422,12.161,70667,29239,41428,9.112,22.022,59505,24052,35453,7.495,18.544,11162,3.478,37.088,4521,4697,15349
1983,452,13068,33496,1746780,1800132,2779,8.210,3488,10.304,160960,72106,88854,4.006,8.942,266152,95483,170669,5.304,14.785,-105192,-5.844,17.883,1405,1449,6564
1983,453,80254,94938,477652,468119,15583,16.835,10832,11.702,121161,61590,59571,13.157,25.883,102547,36995,65552,7.903,21.906,18614,3.976,43.812,7668,7894,24966
1983,454,25869,34382,360944,362746,3741,10.905,3586,10.453,63387,21646,41741,5.967,17.474,67154,24317,42837,6.704,18.513,-3767,-1.038,34.948,2267,2303,10299
1983,481,1507,3414,272016,264202,471,14.788,13,0.408,33860,12557,21303,4.753,12.816,17884,39,17845,0.015,6.769,15976,6.047,13.538,13,13,39
1983,483,772,1112,48667,49358,99,9.313,(D),(D),7739,3345,4394,6.777,15.679,9020,(D),9004,(D),18.275,-1281,-2.595,31.359,0,0,0
1983,484,60050,69883,970926,957665,10876,16.823,412,0.637,160228,54959,105269,5.739,16.731,134906,1821,133085,0.190,14.087,25322,2.644,28.174,307,307,1267
1983,485,10791,11648,232360,226124,1493,13.665,49,0.448,36157,11654,24503,5.154,15.990,23208,145,23063,0.064,10.263,12949,5.727,20.527,39,39,113
1983,486,341,1925,80947,79684,201,11.014,(D),(D),8361,4540,3821,5.698,10.493,5944,(D),5943,(D),7.459,2417,3.033,14.919,(D),(D),(D)
1983,487,887,907,12721,12033,161,18.710,68,7.902,3292,1895,1397,15.748,27.358,1952,465,1487,3.864,16.222,1340,11.136,32.444,54,54,297
1983,488,11164,14667,287034,289033,2208,16.108,289,2.108,48371,18221,30150,6.304,16.735,52671,1710,50961,0.592,18.223,-4300,-1.488,33.471,244,246,1323
1983,492,2180,2788,111767,105366,830,34.714,36,1.506,21451,7541,13910,7.157,20.359,8916,146,8770,0.139,8.462,12535,11.897,16.924,35,35,143
1983,493,6154,9678,366265,374730,870,8.946,963,9.903,51710,14610,37100,3.899,13.799,68407,19577,48830,5.224,18.255,-16697,-4.456,27.599,301,318,2803
1983,511,20274,23436,735940,736133,3001,12.932,2540,10.946,80335,22203,58132,3.016,10.913,80462,28188,52274,3.829,10.930,-127,-0.017,21.826,1865,1879,12537
1983,512,10346,15681,205729,211735,2678,17.181,2490,15.975,46310,17915,28395,8.461,21.872,57743,16767,40976,7.919,27.271,-11433,-5.400,43.743,1321,1403,8783
1983,515,6006,7087,217042,208515,823,12.318,12,0.180,31985,13805,18180,6.621,15.339,14663,50,14613,0.024,7.032,17322,8.307,14.064,9,9,46
1983,517,4028,15534,1061699,963208,1964,13.473,50,0.343,501660,45242,456418,4.697,52.082,302014,263,301751,0.027,31.355,199646,20.727,62.710,41,41,229
1983,518,5819,7588,221598,216676,1224,16.323,1045,13.936,49088,17442,31646,8.050,22.655,39310,13856,25454,6.395,18.142,9778,4.513,36.285,634,641,5222
1983,519,2085,2512,29566,29468,289,11.830,151,6.181,3987,1524,2463,5.172,13.530,3737,1045,2692,3.546,12.682,250,0.848,25.364,101,101,415
1983,521,37,75,24518,24478,10,14.286,0,0.000,742,384,358,1.569,3.031,680,0,680,0.000,2.778,62,0.253,5.556,0,0,0
1983,522,44752,110576,2243092,2192734,7861,7.353,512,0.479,277052,83989,193063,3.830,12.635,177130,3914,173216,0.178,8.078,99922,4.557,16.156,390,390,2101
1983,523,19100,24580,382734,347025,5782,26.543,189,0.868,107332,51586,55746,14.865,30.929,36776,1213,35563,0.350,10.598,70556,20.332,21.195,130,130,784
1983,524,100848,130247,1981383,1870088,20329,16.903,368,0.306,391681,170371,221310,9.110,20.945,171037,1736,169301,0.093,9.146,220644,11.799,18.292,299,299,1273
1983,525,1850,2055,36903,35282,314,16.509,8,0.421,6504,3203,3301,9.078,18.434,3148,24,3124,0.068,8.922,3356,9.512,17.845,5,5,8
1983,531,146891,151387,852914,815231,21870,15.449,2220,1.568,190995,87374,103621,10.718,23.428,116648,8390,108258,1.029,14.309,74347,9.120,28.617,1720,1725,6434
1983,532,21820,29217,267154,265787,5192,18.219,3755,13.176,66864,26811,40053,10.087,25.157,65089,24569,40520,9.244,24.489,1775,0.668,48.978,2345,2403,11473
1983,533,901,960,10872,10412,153,17.259,6,0.677,2726,1024,1702,9.835,26.183,1781,21,1760,0.202,17.106,945,9.077,34.212,6,6,21
1983,541,314513,335281,2923647,2888355,57688,17.867,32867,10.180,570728,241221,329507,8.352,19.760,501947,156783,345164,5.428,17.378,68781,2.381,34.757,23447,23699,96989
1983,551,22650,42538,2715940,2730201,4428,10.494,3740,8.864,451618,145615,306003,5.333,16.542,480030,105748,374282,3.873,17.582,-28412,-1.041,33.083,298,314,4041
1983,561,128252,144342,2235893,2217160,27803,19.912,18380,13.163,543497,185192,358305,8.353,24.513,504732,153503,351229,6.923,22.765,38765,1.748,45.530,13722,13835,93566
1983,562,10533,11424,165179,162592,1474,13.509,449,4.115,25937,8459,17478,5.203,15.952,20725,2113,18612,1.300,12.747,5212,3.206,25.493,306,306,1321
1983,611,30880,33083,1470336,1440358,4111,12.769,2337,7.259,153679,30304,123375,2.104,10.670,93890,11888,82002,0.825,6.519,59789,4.151,13.037,1709,1749,7878
1983,621,322936,337528,1938697,1883868,33925,10.297,17808,5.405,358316,135805,222511,7.209,19.020,247852,69699,178153,3.700,13.157,110464,5.864,26.313,13219,13387,49400
1983,622,4129,5525,3286501,3053637,380,7.121,(D),(D),561172,429351,131821,14.060,18.377,93849,(D),93836,(D),3.073,467323,15.304,6.147,0,0,0
1983,623,20332,28367,1367686,1351899,3204,11.546,1971,7.103,191235,84594,106641,6.257,14.146,157933,67185,90748,4.970,11.682,33302,2.463,23.365,1172,1250,37946
1983,624,45657,58788,784773,768901,8314,14.580,4788,8.396,174035,64742,109293,8.420,22.634,140426,32380,108046,4.211,18.263,33609,4.371,36.526,2988,3087,18125
1983,711,16827,17113,202827,197017,4504,27.742,2749,16.932,60249,26456,33793,13.428,30.581,48627,16826,31801,8.540,24.682,11622,5.899,49.363,1972,1980,10498
1983,712,1990,2131,32161,31753,197,9.591,43,2.093,3412,721,2691,2.271,10.745,2620,287,2333,0.904,8.251,792,2.494,16.502,22,22,216
1983,713,34553,37183,544761,542352,5662,15.616,3811,10.511,98992,41618,57374,7.674,18.252,93532,28142,65390,5.189,17.246,5460,1.007,34.491,2842,2888,19832
1983,721,36899,41561,1105274,1115515,5075,12.328,4286,10.411,183905,88343,95562,7.919,16.486,204986,72359,132627,6.487,18.376,-21081,-1.890,32.972,2974,3011,38524
1983,722,261820,327611,4887677,4812088,54995,17.102,42913,13.345,1171211,631805,539406,13.130,24.339,1016950,428022,588928,8.895,21.133,154261,3.206,42.266,30129,30853,256231
1983,811,141918,150410,769651,767204,24567,16.690,18147,12.328,169212,82978,86234,10.816,22.056,164159,61650,102509,8.036,21.397,5053,0.659,42.794,13527,13615,44599
1983,812,141036,165693,1066690,1057006,21812,13.299,18457,11.253,215772,90341,125431,8.547,20.414,198026,79064,118962,7.480,18.735,17746,1.679,37.469,13081,13404,53944
1983,813,173997,180407,1602168,1570975,16369,9.393,4093,2.349,245711,64943,180768,4.134,15.641,183950,20181,163769,1.285,11.709,61761,3.931,23.419,2532,2587,11532
1984,211,7920,9916,187693,177242,1271,12.839,1238,12.506,53260,9529,43731,5.376,30.049,33762,11049,22713,6.234,19.049,19498,11.001,38.097,793,808,4456
1984,212,6759,9184,331823,330196,1199,13.077,1169,12.749,59658,18240,41418,5.524,18.067,56166,18263,37903,5.531,17.010,3492,1.058,34.020,821,826,8465
1984,213,11016,12773,292656,293785,2126,16.622,2160,16.888,69569,24432,45137,8.316,23.680,72465,25965,46500,8.838,24.666,-2896,-0.986,47.360,1621,1630,14245
1984,221,5738,12230,755846,749541,702,5.891,76,0.638,42278,11760,30518,1.569,5.641,29703,315,29388,0.042,3.963,12575,1.678,7.926,58,58,220
1984,236,124271,125359,1112924,1034827,27690,23.045,17282,14.383,394415,124645,269770,12.045,38.114,237642,73203,164439,7.074,22.964,156773,15.150,45.929,12440,12446,54453
1984,237,35309,36269,664556,644796,6260,17.684,4519,12.766,182227,47199,135028,7.320,28.261,144092,32825,111267,5.091,22.347,38135,5.914,44.694,3420,3425,23050
1984,238,263197,266405,2509934,2363585,47273,18.328,30316,11.754,779734,214526,565208,9.076,32.989,488078,141969,346109,6.007,20.650,291656,12.340,41.300,22644,22662,109152
1984,311,22170,27716,1330644,1327937,2711,9.809,2555,9.245,156052,39931,116121,3.007,11.751,151093,51612,99481,3.887,11.378,4959,0.373,22.756,1734,1754,18006
1984,312,2070,2699,213891,214978,187,6.907,204,7.535,19503,5131,14372,2.387,9.072,21689,5879,15810,2.735,10.089,-2186,-1.017,18.144,132,132,1671
1984,313,3599,4621,526973,515838,316,6.818,344,7.422,60249,14663,45586,2.843,11.680,38091,12863,25228,2.494,7.384,22158,4.296,14.769,237,237,4483
1984,314,7354,7810,254634,244584,895,11.467,885,11.339,45668,10908,34760,4.460,18.672,25699,12899,12800,5.274,10.507,19969,8.164,21.014,695,699,6783
1984,315,14701,16612,1126391,1096334,1839,10.903,2350,13.932,190424,54452,135972,4.967,17.369,130855,57129,73726,5.211,11.936,59569,5.433,23.871,1999,2014,38204
1984,316,2080,2401,188946,193748,189,7.678,310,12.594,20428,5125,15303,2.645,10.544,30021,9767,20254,5.041,15.495,-9593,-4.951,21.087,230,234,4010
1984,321,14247,15939,508107,482407,1741,10.972,1599,10.077,102991,22954,80037,4.758,21.349,51712,20527,31185,4.255,10.720,51279,10.630,21.439,1172,1179,9109
1984,322,3765,5757,601824,592166,294,5.116,273,4.751,54600,12756,41844,2.154,9.220,35144,13293,21851,2.245,5.935,19456,3.286,11.870,160,163,2697
1984,323,35131,36719,722657,701556,3729,10.249,3061,8.413,111875,26342,85533,3.755,15.947,69146,28531,40615,4.067,9.856,42729,6.091,19.712,2438,2440,14366
1984,324,1459,2341,267152,270402,222,9.510,209,8.953,23351,4895,18456,1.810,8.636,29987,7733,22254,2.860,11.090,-6636,-2.454,17.271,94,95,1422
1984,325,8220,11863,895360,897303,961,8.137,856,7.248,84749,28599,56150,3.187,9.445,87586,36652,50934,4.085,9.761,-2837,-0.316,18.890,465,479,5325
1984,326,11988,14084,761514,721473,1231,8.797,1050,7.503,141092,29834,111258,4.135,19.556,61782,26829,34953,3.719,8.563,79310,10.993,17.127,719,726,9174
1984,327,11654,14752,510382,494102,1178,7.982,1189,8.057,84684,17913,66771,3.625,17.139,52313,19707,32606,3.988,10.588,32371,6.551,21.175,803,813,5932
1984,331,4546,5644,629397,600752,372,6.571,406,7.172,101469,25581,75888,4.258,16.890,44748,23318,21430,3.881,7.449,56721,9.442,14.897,232,236,3393
1984,332,48375,52378,1656497,1591841,4410,8.423,4362,8.332,293304,60914,232390,3.827,18.425,164611,67693,96918,4.252,10.341,128693,8.085,20.682,3273,3287,30791
1984,333,25768,28649,1445001,1416551,1998,6.942,2262,7.859,219547,44423,175124,3.136,15.499,162748,62620,100128,4.421,11.489,56799,4.010,22.978,1545,1553,13221
1984,334,12163,14227,1922617,1840119,1658,11.797,1314,9.349,326700,78956,247744,4.291,17.754,162109,53634,108475,2.915,8.810,164591,8.945,17.619,876,879,10733
1984,335,5241,6437,676309,648526,578,9.038,494,7.725,108729,20320,88409,3.133,16.766,52908,19169,33739,2.956,8.158,55821,8.607,16.316,330,331,3803
1984,336,8289,9806,1939125,1841156,953,9.765,859,8.802,309071,52263,256808,2.839,16.787,113135,44591,68544,2.422,6.145,195936,10.642,12.290,588,589,6622
1984,337,14988,15951,551241,521679,1951,12.346,1654,10.467,107226,23010,84216,4.411,20.554,47699,23834,23865,4.569,9.143,59527,11.411,18.287,1263,1290,12927
1984,339,24237,25474,652061,632508,2918,11.509,2680,10.570,113283,29733,83550,4.701,17.910,74483,30305,44178,4.791,11.776,38800,6.134,23.552,2088,2093,13367
1984,423,159967,205379,2477625,2384979,24227,11.918,20028,9.852,497815,166669,331146,6.988,20.873,311859,127447,184412,5.344,13.076,185956,7.797,26.152,13399,13700,65063
1984,424,98465,125033,1735097,1705004,13226,10.633,11939,9.598,288586,82476,206110,4.837,16.926,228528,82773,145755,4.855,13.403,60058,3.522,26.807,8266,8444,49389
1984,425,28896,31755,298370,289726,3674,11.732,2797,8.931,57882,19704,38178,6.801,19.978,40636,14235,26401,4.913,14.026,17246,5.953,28.051,1897,1904,8377
1984,441,94347,117811,1377333,1307218,12722,10.987,8676,7.493,259122,80649,178473,6.170,19.822,119068,48171,70897,3.685,9.109,140054,10.714,18.217,6467,6600,35779
1984,442,42210,50737,347785,333843,6712,13.413,5317,10.626,76780,27444,49336,8.221,22.999,48756,21458,27298,6.428,14.604,28024,8.394,29.209,3882,4012,14549
1984,443,24574,32277,194119,184012,5516,17.453,4173,13.203,52251,24875,27376,13.518,28.395,31767,15758,16009,8.564,17.264,20484,11.132,34.527,2862,3025,10534
1984,444,70664,88639,808213,778003,8334,9.479,6904,7.852,151400,49426,101974,6.353,19.460,90763,30895,59868,3.971,11.666,60637,7.794,23.332,5024,5094,20393
1984,445,117725,172051,2308909,2265148,19422,11.267,20066,11.641,394523,170196,224327,7.514,17.417,308682,131823,176859,5.820,13.627,85841,3.790,27.255,13855,14140,64491
1984,446,44420,64582,591133,572182,7055,11.170,4207,6.661,107468,44492,62976,7.776,18.782,68363,25667,42696,4.486,11.948,39105,6.834,23.896,2878,2967,15002
1984,447,95714,127894,785411,766537,15579,12.106,17158,13.333,182143,77949,104194,10.169,23.762,144455,70641,73814,9.216,18.845,37688,4.917,37.690,11814,12065,46694
1984,448,87937,159786,1134065,1122372,19269,12.172,16313,10.305,234932,108821,126111,9.696,20.932,208053,72358,135695,6.447,18.537,26879,2.395,37.074,9988,10582,38749
1984,451,39905,54172,341994,335798,7421,13.799,6635,12.338,69998,30465,39533,9.072,20.845,57450,23963,33487,7.136,17.108,12548,3.737,34.217,4751,4963,15631
1984,452,13273,34148,1874892,1810770,3437,10.163,2779,8.217,245169,96957,148212,5.354,13.539,118157,38706,79451,2.138,6.525,127012,7.014,13.050,1425,1460,5861
1984,453,83887,98651,519039,499080,15595,16.102,11990,12.380,127368,52477,74891,10.515,25.521,87365,40063,47302,8.027,17.505,40003,8.015,35.010,8910,9114,28278
1984,454,26395,34967,374929,367342,3916,11.296,3319,9.574,65297,22972,42325,6.254,17.776,49903,19859,30044,5.406,13.585,15394,4.191,27.170,2338,2361,9412
1984,481,1491,3492,282848,276774,469,14.329,31,0.947,32360,4313,28047,1.558,11.692,20893,102,20791,0.037,7.549,11467,4.143,15.098,27,27,96
1984,483,763,1087,48768,47523,105,10.096,11,1.058,8832,3970,4862,8.354,18.585,6556,34,6522,0.072,13.795,2276,4.789,27.591,9,9,24
1984,484,62773,72543,1065143,990092,12454,18.589,1364,2.036,234622,63131,171491,6.376,23.697,84047,4645,79402,0.469,8.489,150575,15.208,16.978,1088,1088,3672
1984,485,10770,11606,228088,220175,1642,15.096,184,1.692,37216,12967,24249,5.889,16.903,21361,806,20555,0.366,9.702,15855,7.201,19.404,156,156,717
1984,486,343,1942,78408,78119,129,6.858,7,0.372,6105,1653,4452,2.116,7.815,5438,319,5119,0.408,6.961,667,0.854,13.922,4,4,48
1984,487,915,940,13714,12981,181,20.440,72,8.131,3311,990,2321,7.627,25.507,1818,276,1542,2.126,14.005,1493,11.501,28.010,51,51,178
1984,488,11562,15207,302914,287807,2542,17.936,474,3.344,70813,22911,47902,7.961,24.604,40878,2112,38766,0.734,14.203,29935,10.401,28.407,392,392,1627
1984,492,2559,3378,114050,107295,1095,38.080,90,3.130,23357,9175,14182,8.551,21.769,9965,473,9492,0.441,9.287,13392,12.481,18.575,78,78,455
1984,493,6210,9634,380671,373704,762,7.897,792,8.208,62423,15688,46735,4.198,16.704,47973,13909,34064,3.722,12.837,14450,3.867,25.674,289,298,2359
1984,511,20498,23760,773836,753933,3008,12.746,2686,11.382,112117,34719,77398,4.605,14.871,72786,29286,43500,3.884,9.654,39331,5.217,19.308,2022,2038,13869
1984,512,10834,15944,217835,212029,2601,16.471,2296,14.539,55514,16633,38881,7.845,26.182,43564,15217,28347,7.177,20.546,11950,5.636,41.093,1285,1346,7249
1984,515,6262,7362,227460,217225,965,13.950,76,1.099,34559,16036,18523,7.382,15.909,14086,758,13328,0.349,6.485,20473,9.425,12.969,66,66,716
1984,517,4725,18971,1071291,1006833,5482,33.614,157,0.963,374314,269757,104557,26.793,37.177,234826,1114,233712,0.111,23.323,139488,13.854,46.646,139,139,704
1984,518,5862,7753,237443,229976,1192,15.552,1015,13.243,47620,17294,30326,7.520,20.707,32701,10745,21956,4.672,14.219,14919,6.487,28.439,634,642,3936
1984,519,2228,2661,31292,30403,393,15.238,229,8.879,5600,2253,3347,7.410,18.419,3827,2144,1683,7.052,12.588,1773,5.832,25.175,172,172,1174
1984,521,36,77,24131,24281,(D),(D),0,0.000,516,(D),431,(D),2.125,819,0,819,0.000,3.373,-303,-1.248,4.250,0,0,0
1984,522,45297,112849,2330140,2259015,8432,7.730,911,0.835,321365,101594,219771,4.497,14.226,179842,5514,174328,0.244,7.961,141523,6.265,15.922,779,780,4818
1984,523,20704,26893,456331,416172,5919,24.453,545,2.252,135475,47563,87912,11.429,32.553,53890,3191,50699,0.767,12.949,81585,19.604,25.898,411,411,2038
1984,524,103268,132340,1979720,1903913,17191,13.800,1658,1.331,339730,131161,208569,6.889,17.844,188193,7778,180415,0.409,9.885,151537,7.959,19.769,1327,1327,5841
1984,525,1917,2139,36226,34719,294,14.627,36,1.791,6639,2478,4161,7.137,19.122,3892,222,3670,0.639,11.210,2747,7.912,22.420,25,25,180
1984,531,151773,156720,916080,852233,25516,17.472,4148,2.840,229771,97878,131893,11.485,26.961,102324,12919,89405,1.516,12.007,127447,14.954,24.013,3269,3271,10031
1984,532,24232,33440,338182,304013,8077,25.791,3831,12.233,123343,74482,48861,24.500,40.572,51793,21331,30462,7.016,17.036,71550,23.535,34.073,2583,2666,13452
1984,533,926,971,11862,10992,164,18.232,21,2.335,2992,972,2020,8.843,27.220,1246,42,1204,0.382,11.336,1746,15.884,22.671,19,19,40
1984,541,335022,356548,3200857,3064857,60163,17.428,37501,10.863,716668,265117,451551,8.650,23.383,443997,170128,273869,5.551,14.487,272671,8.897,28.973,27560,27785,111154
1984,551,23391,43595,2822048,2761986,4524,10.607,2636,6.180,480803,150285,330518,5.441,17.408,360750,76630,284120,2.774,13.061,120053,4.347,26.123,394,408,5006
1984,561,138053,154871,2584167,2412393,30260,20.362,17738,11.936,721651,211401,510250,8.763,29.914,376670,128472,248198,5.326,15.614,344981,14.300,31.228,13627,13727,81626
1984,562,10527,11464,175697,166430,1458,13.252,535,4.863,34721,8460,26261,5.083,20.862,16071,2909,13162,1.748,9.656,18650,11.206,19.313,435,435,2145
1984,611,32217,34521,1497957,1472325,4473,13.329,2548,7.593,157805,27558,130247,1.872,10.718,106802,13339,93463,0.906,7.254,51003,3.464,14.508,1966,1993,10039
1984,621,332350,347743,2098223,2017185,31552,9.210,21233,6.198,400374,143580,256794,7.118,19.848,237614,81215,156399,4.026,11.779,162760,8.069,23.559,16166,16372,60022
1984,622,4136,5633,3371217,3348723,288,5.239,16,0.291,321681,223326,98355,6.669,9.606,278904,7265,271639,0.217,8.329,42777,1.277,16.657,10,10,7203
1984,623,21063,29499,1405333,1386459,3172,10.959,2063,7.127,185346,73814,111532,5.324,13.368,148079,71937,76142,5.189,10.680,37267,2.688,21.361,1322,1355,43087
1984,624,49060,62878,826956,805108,8885,14.588,4943,8.116,157550,50670,106880,6.294,19.569,113996,31809,82187,3.951,14.159,43554,5.410,28.318,3440,3534,19285
1984,711,18339,18604,219411,211336,4887,27.487,3238,18.212,64246,24478,39768,11.583,30.400,48134,16734,31400,7.918,22.776,16112,7.624,45.552,2395,2399,11114
1984,712,2134,2283,36176,35481,244,10.993,117,5.271,4287,772,3515,2.176,12.083,2846,620,2226,1.747,8.021,1441,4.061,16.043,88,88,437
1984,713,34596,37306,560717,549494,5156,13.918,4634,12.509,106282,38837,67445,7.068,19.342,83848,30121,53727,5.482,15.259,22434,4.083,30.518,3610,3660,20884
1984,721,37280,42084,1186099,1148405,5483,13.106,4987,11.920,238561,112186,126375,9.769,20.773,163399,70387,93012,6.129,14.228,75162,6.545,28.457,3593,3638,44404
1984,722,266068,334162,5202933,5050073,56134,16.961,49721,15.023,1257728,667493,590235,13.217,24.905,952056,472889,479167,9.364,18.852,305672,6.053,37.705,36584,37264,286363
1984,811,149219,157861,854354,812140,26491,17.183,19108,12.394,216765,91668,125097,11.287,26.691,131842,60590,71252,7.461,16.234,84923,10.457,32.468,14654,14735,44535
1984,812,143185,168076,1107339,1088687,22214,13.322,19552,11.726,223211,93550,129661,8.593,20.503,185219,77687,107532,7.136,17.013,37992,3.490,34.026,14578,14985,54562
1984,813,212492,218964,1780681,1684425,47471,24.017,4861,2.459,367329,148162,219167,8.796,21.807,175501,20381,155120,1.210,10.419,191828,11.388,20.838,3209,3220,12724
1985,211,8049,9971,164569,164859,1282,12.886,1238,12.443,30901,10018,20883,6.077,18.744,31393,13305,18088,8.071,19.042,-492,-0.298,37.488,828,842,4970
1985,212,6593,9042,319290,325797,1128,12.369,1283,14.069,50245,20027,30218,6.147,15.422,63512,22551,40961,6.922,19.494,-13267,-4.072,30.844,909,918,11318
1985,213,10972,12693,289135,290550,1963,15.388,2090,16.384,64010,17612,46398,6.062,22.031,67041,27782,39259,9.562,23.074,-3031,-1.043,44.061,1513,1514,14189
1985,221,5746,12180,761807,754211,605,5.072,103,0.863,43352,8269,35083,1.096,5.748,28301,972,27329,0.129,3.752,15051,1.996,7.505,85,85,907
1985,236,130208,131314,1218794,1166604,27394,21.342,21477,16.732,409432,129410,280022,11.093,35.096,304649,111313,193336,9.542,26.114,104783,8.982,52.228,15338,15344,82092
1985,237,36889,37890,720337,704290,6557,17.670,4993,13.455,210869,74221,136648,10.538,29.941,179181,44169,135012,6.271,25.441,31688,4.499,50.883,3795,3807,30041
1985,238,277081,280345,2709451,2605848,50048,18.313,35939,13.150,811353,236621,574732,9.080,31.136,605301,200826,404475,7.707,23.229,206052,7.907,46.457,27031,27042,153020
1985,311,21995,27458,1326571,1326096,2940,10.711,2920,10.638,168873,45088,123785,3.400,12.735,168354,68861,99493,5.193,12.695,519,0.039,25.391,2048,2075,28711
1985,312,2057,2654,209924,211086,204,7.668,217,8.156,18714,6264,12450,2.968,8.866,20760,5992,14768,2.839,9.835,-2046,-0.969,17.731,140,141,2316
1985,313,3554,4544,476584,502008,375,8.195,439,9.594,35928,15372,20556,3.062,7.157,86770,30826,55944,6.141,17.285,-50842,-10.128,14.314,299,301,5366
1985,314,7571,8025,253336,254357,1176,14.863,950,12.007,39705,17870,21835,7.026,15.610,41818,15151,26667,5.957,16.441,-2113,-0.831,31.220,742,746,8459
1985,315,14929,16751,1041773,1083577,2618,15.695,2476,14.844,140458,59609,80849,5.501,12.962,222764,90818,131946,8.381,20.558,-82306,-7.596,25.925,2038,2055,51600
1985,316,2043,2324,164068,175950,232,9.843,298,12.643,17445,6111,11334,3.473,9.915,41423,14193,27230,8.066,23.542,-23978,-13.628,19.829,208,210,5694
1985,321,14687,16355,502545,504959,2231,13.821,1806,11.188,76588,28457,48131,5.636,15.167,81303,32063,49240,6.350,16.101,-4715,-0.934,30.334,1353,1356,17309
1985,322,3770,5791,603320,602779,432,7.497,374,6.491,59117,24243,34874,4.022,9.807,57908,27455,30453,4.555,9.607,1209,0.201,19.214,214,214,6423
1985,323,37078,38697,752118,735882,5263,13.953,3307,8.767,115433,36015,79418,4.894,15.686,82482,36961,45521,5.023,11.209,32951,4.478,22.417,2598,2609,22258
1985,324,1439,2328,234873,250062,200,8.574,209,8.960,13170,4742,8428,1.896,5.267,44021,17946,26075,7.177,17.604,-30851,-12.337,10.533,113,118,2967
1985,325,8310,12048,916439,920606,1218,10.190,1027,8.592,90301,37733,52568,4.099,9.809,98318,46436,51882,5.044,10.680,-8017,-0.871,19.618,580,590,8256
1985,326,12345,14488,795744,778419,1572,11.012,1146,8.028,127408,50405,77003,6.475,16.368,92679,37398,55281,4.804,11.906,34729,4.461,23.812,796,805,15266
1985,327,11752,14967,517433,514023,1548,10.418,1332,8.964,77040,30554,46486,5.944,14.988,70688,26156,44532,5.088,13.752,6352,1.236,27.504,914,920,10345
1985,331,4575,5647,622159,626054,476,8.434,469,8.310,65414,27828,37586,4.445,10.449,73255,29347,43908,4.688,11.701,-7841,-1.252,20.897,268,268,5958
1985,332,50217,54180,1702902,1678185,6069,11.387,4300,8.068,252189,73803,178386,4.398,15.027,202524,81868,120656,4.878,12.068,49665,2.959,24.136,3213,3234,39706
1985,333,26150,28928,1461671,1450583,2642,9.183,2327,8.088,199790,60647,139143,4.181,13.773,177863,71745,106118,4.946,12.261,21927,1.512,24.523,1609,1613,22287
1985,334,12820,14919,1970912,1938621,2159,14.838,1421,9.766,292523,79488,213035,4.100,15.089,228069,80222,147847,4.138,11.764,64454,3.325,23.529,958,967,22317
1985,335,5438,6661,669742,674157,767,11.700,556,8.481,75843,25608,50235,3.799,11.250,83935,28615,55320,4.245,12.450,-8092,-1.200,22.500,341,344,6703
1985,336,8636,10147,2010728,1974846,1294,12.969,956,9.581,262622,93542,169080,4.737,13.298,189766,89082,100684,4.511,9.609,72856,3.689,19.218,652,659,13843
1985,337,15925,16941,576089,563742,2767,16.804,1817,11.035,94587,33077,61510,5.867,16.778,70165,27541,42624,4.885,12.446,24422,4.332,24.893,1438,1448,17419
1985,339,24861,25978,631537,640209,3582,13.933,3042,11.833,92863,33229,59634,5.190,14.505,110329,49908,60421,7.796,17.233,-17466,-2.728,29.010,2285,2295,21354
1985,423,161750,207945,2591933,2541477,25039,12.115,22492,10.883,490090,169383,320707,6.665,19.284,390759,182752,208007,7.191,15.375,99331,3.908,30.751,15318,15670,99724
1985,424,98268,124688,1766212,1753827,13486,10.796,13950,11.167,300252,92072,208180,5.250,17.120,275188,113980,161208,6.499,15.691,25064,1.429,31.381,9858,10069,69330
1985,425,29687,32549,306942,302217,3983,12.391,3174,9.874,57858,18540,39318,6.135,19.145,48578,19138,29440,6.333,16.074,9280,3.071,32.148,2130,2139,11528
1985,441,95685,118092,1434542,1405407,13088,11.096,12814,10.863,246767,86017,160750,6.120,17.558,186893,91952,94941,6.543,13.298,59874,4.260,26.596,7803,7996,53395
1985,442,42220,51379,361935,354597,6960,13.639,6266,12.279,74777,29801,44976,8.404,21.088,60233,28687,31546,8.090,16.986,14544,4.102,33.973,4721,4908,21059
1985,443,24021,31824,207539,200749,5162,16.130,5517,17.240,54474,23333,31141,11.623,27.135,40820,23597,17223,11.754,20.334,13654,6.802,40.668,3795,4015,17426
1985,444,70794,89171,844104,826330,8714,9.799,8228,9.252,149109,51151,97958,6.190,18.045,113866,48320,65546,5.848,13.780,35243,4.265,27.559,6001,6131,31736
1985,445,115461,168977,2393865,2351456,19170,11.244,22191,13.016,423227,184407,238820,7.842,17.999,337347,163112,174235,6.937,14.346,85880,3.652,28.693,15751,16199,81714
1985,446,45166,67134,632713,611951,8021,12.175,5518,8.376,119681,55597,64084,9.085,19.557,77412,33342,44070,5.448,12.650,42269,6.907,25.300,3888,4010,22315
1985,447,92605,124741,816500,801376,14882,11.783,17992,14.246,189149,80294,108855,10.020,23.603,158752,84531,74221,10.548,19.810,30397,3.793,39.620,12220,12612,53767
1985,448,85569,158797,1187138,1160901,18981,11.917,19940,12.519,262585,107354,155231,9.247,22.619,211694,95434,116260,8.221,18.235,50891,4.384,36.471,12114,13139,54811
1985,451,39554,52107,346565,344595,7434,13.984,9539,17.944,75651,32480,43171,9.426,21.954,70638,38628,32010,11.210,20.499,5013,1.455,40.998,5599,5840,19233
1985,452,12823,33957,1945220,1908195,3064,8.995,3278,9.623,210645,79929,130716,4.189,11.039,139107,49445,89662,2.591,7.290,71538,3.749,14.580,1833,1883,10553
1985,453,85016,99794,549276,533933,15659,15.784,14491,14.606,132184,56385,75799,10.560,24.757,101619,49851,51768,9.337,19.032,30565,5.725,38.064,10957,11187,36701
1985,454,26186,34548,381338,376746,3639,10.479,3999,11.515,71137,19654,51483,5.217,18.882,62027,29136,32891,7.734,16.464,9110,2.418,32.928,2858,2928,15515
1985,481,1455,3597,311719,294355,489,14.506,37,1.098,54071,6345,47726,2.156,18.369,19630,187,19443,0.064,6.669,34441,11.700,13.338,31,31,171
1985,483,723,1041,48134,47772,99,9.910,15,1.502,7898,1528,6370,3.199,16.533,7319,50,7269,0.105,15.321,579,1.212,30.641,12,12,43
1985,484,64009,73638,1103585,1052248,12399,18.104,2097,3.062,213481,64331,149150,6.114,20.288,111593,9114,102479,0.866,10.605,101888,9.683,21.210,1711,1711,6340
1985,485,10643,11432,227051,220124,1557,14.430,273,2.530,33746,9184,24562,4.172,15.330,19638,1077,18561,0.489,8.921,14108,6.409,17.843,244,244,1013
1985,486,349,1969,78388,76938,164,8.675,7,0.370,7289,3354,3935,4.359,9.474,4511,104,4407,0.135,5.863,2778,3.611,11.726,4,4,95
1985,487,935,962,13918,13589,195,21.300,102,11.141,2982,986,1996,7.256,21.944,2254,389,1865,2.863,16.587,728,5.357,33.174,84,84,359
1985,488,11707,15362,292698,282530,2482,17.165,677,4.682,63242,21234,42008,7.516,22.384,42538,2880,39658,1.019,15.056,20704,7.328,30.112,564,564,2366
1985,492,2886,3841,127569,119093,1105,32.746,172,5.097,24401,7259,17142,6.095,20.489,7492,1801,5691,1.512,6.291,16909,14.198,12.582,143,143,489
1985,493,6261,9792,402239,391302,919,9.436,813,8.348,68686,21562,47124,5.510,17.553,47011,15876,31135,4.057,12.014,21675,5.539,24.028,363,372,3655
1985,511,20760,24011,814947,797311,3362,14.073,3119,13.056,117201,33758,83443,4.234,14.700,81597,38715,42882,4.856,10.234,35604,4.466,20.468,2291,2315,19071
1985,512,11277,16345,234199,226031,2878,17.831,2468,15.291,83631,46533,37098,20.587,37.000,70947,39748,31199,17.585,31.388,12684,5.612,62.776,1577,1634,9727
1985,515,6253,7386,230925,220095,935,13.428,89,1.278,36379,19032,17347,8.647,16.529,14759,882,13877,0.401,6.706,21620,9.823,13.411,73,73,764
1985,517,4871,19772,1017432,1016009,3146,17.125,343,1.867,194384,86692,107692,8.533,19.132,193108,1997,191111,0.197,19.007,1276,0.126,38.013,302,302,1781
1985,518,5911,7869,257119,245852,1295,16.573,1185,15.165,66166,25534,40632,10.386,26.913,42470,22667,19803,9.220,17.275,23696,9.638,34.549,702,715,8388
1985,519,2338,2779,34890,32797,383,14.141,242,8.935,7264,2421,4843,7.382,22.148,3007,1238,1769,3.775,9.169,4257,12.980,18.337,183,183,991
1985,521,42,81,24895,24722,6,7.643,(D),(D),867,244,623,0.987,3.507,523,(D),522,(D),2.116,344,1.391,4.231,(D),(D),(D)
1985,522,44887,113781,2379442,2310803,8832,8.027,1326,1.205,337302,96768,240534,4.188,14.597,199187,11093,188094,0.480,8.620,138115,5.977,17.240,1180,1181,10127
1985,523,19961,26780,484325,456168,5147,20.846,968,3.921,108564,38374,70190,8.412,23.799,52900,5258,47642,1.153,11.597,55664,12.203,23.193,765,765,4370
1985,524,101927,130389,1968280,1871770,15387,12.414,2497,2.015,359631,110387,249244,5.897,19.213,167555,10609,156946,0.567,8.952,192076,10.262,17.903,1977,1977,7804
1985,525,1866,2115,20558,18032,298,15.024,35,1.765,6867,2794,4073,15.495,38.083,1768,125,1643,0.693,9.805,5099,28.278,19.610,20,20,90
1985,531,151621,157335,964033,899101,25348,17.189,5604,3.800,247043,106601,140442,11.856,27.477,117676,18182,99494,2.022,13.088,129367,14.388,26.176,4713,4716,15161
1985,532,28154,37708,376660,357912,8935,25.088,4748,13.332,104918,44678,60240,12.483,29.314,68317,29970,38347,8.374,19.088,36601,10.226,38.175,3042,3112,15679
1985,533,924,962,11972,11195,163,18.192,31,3.460,3104,1202,1902,10.737,27.728,1525,95,1430,0.849,13.623,1579,14.105,27.246,27,27,82
1985,541,351403,373823,3462640,3328836,63603,17.457,44625,12.248,786908,291559,495349,8.759,23.639,517869,217980,299889,6.548,15.557,269039,8.082,31.114,33714,33951,150756
1985,551,23728,43776,2971387,2888703,4275,9.882,3241,7.492,550797,158827,391970,5.498,19.067,387705,116168,271537,4.021,13.421,163092,5.646,26.843,522,535,6957
1985,561,146478,164362,2972592,2775720,32764,20.678,20940,13.216,880888,258792,622096,9.323,31.735,486805,170364,316441,6.138,17.538,394083,14.198,35.076,16319,16476,116252
1985,562,10370,11360,188568,178340,1487,13.633,582,5.336,37306,10684,26622,5.991,20.918,16968,3224,13744,1.808,9.514,20338,11.404,19.029,459,459,2601
1985,611,32538,34946,1518624,1495942,4274,12.432,3142,9.139,175037,27649,147388,1.848,11.701,129148,24229,104919,1.620,8.633,45889,3.068,17.266,2430,2451,10801
1985,621,338598,354624,2247506,2176319,33031,9.407,26048,7.418,462989,161181,301808,7.406,21.274,320563,127068,193495,5.839,14.730,142426,6.544,29.459,20354,20669,90582
1985,622,4081,5609,3434822,3342799,338,6.203,18,0.330,502206,347091,155115,10.383,15.024,321888,29475,292413,0.882,9.629,180318,5.394,19.259,14,14,1394
1985,623,21575,30560,1476385,1440113,3487,11.614,2417,8.050,223922,89747,134175,6.232,15.549,151454,74752,76702,5.191,10.517,72468,5.032,21.034,1694,1741,54035
1985,624,51309,65527,889149,858532,8447,13.154,5827,9.074,173835,51134,122701,5.956,20.248,112296,41591,70705,4.844,13.080,61539,7.168,26.160,4295,4351,29845
1985,711,19948,20239,236837,229978,5314,27.393,3634,18.733,82123,35826,46297,15.578,35.709,68181,31502,36679,13.698,29.647,13942,6.062,59.294,2813,2820,25960
1985,712,2235,2386,38579,37362,253,10.844,147,6.301,5713,1023,4690,2.738,15.291,3266,867,2399,2.321,8.742,2447,6.549,17.483,96,96,461
1985,713,34805,37520,583480,570906,5172,13.885,4627,12.422,118012,39389,78623,6.899,20.671,92689,32017,60672,5.608,16.235,25323,4.436,32.471,3525,3578,23951
1985,721,37098,42069,1250842,1220633,5436,12.912,5496,13.055,261441,129124,132317,10.578,21.418,201552,97032,104520,7.949,16.512,59889,4.906,33.024,4018,4078,62329
1985,722,265306,336116,5448599,5329726,57581,17.177,55783,16.641,1365186,739918,625268,13.883,25.615,1124287,569971,554316,10.694,21.095,240899,4.520,42.189,41556,42555,350966
1985,811,154065,163039,917264,888434,27514,17.142,22446,13.985,222836,94992,127844,10.692,25.082,165811,78952,86859,8.887,18.663,57025,6.419,37.327,17546,17680,59443
1985,812,142354,167464,1136979,1119539,22991,13.738,22775,13.609,234184,95795,138389,8.557,20.918,198974,93094,105880,8.315,17.773,35210,3.145,35.546,17493,17901,69727
1985,813,216534,223022,1854968,1800143,19340,8.899,7957,3.661,309009,71013,237996,3.945,17.166,200243,34988,165255,1.944,11.124,108766,6.042,22.247,4378,4407,23445
1986,211,7857,9645,152345,158953,1104,11.253,1436,14.637,24231,7654,16577,4.815,15.244,37712,11183,26529,7.035,23.725,-13481,-8.481,30.488,980,990,4319
1986,212,6494,8855,306356,313189,1034,11.551,1227,13.707,49172,15979,33193,5.102,15.700,63167,24918,38249,7.956,20.169,-13995,-4.469,31.401,762,766,7958
1986,213,10225,11858,236413,262700,1445,11.768,2288,18.633,43896,20195,23701,7.687,16.710,96037,23695,72342,9.020,36.558,-52141,-19.848,33.419,1685,1701,14863
1986,221,5707,12121,763261,757708,634,5.348,100,0.844,49782,15495,34287,2.045,6.570,37941,394,37547,0.052,5.007,11841,1.563,10.015,85,85,373
1986,236,136166,137304,1282093,1250933,27947,20.811,21924,16.326,399652,130938,268714,10.467,31.948,336915,111109,225806,8.882,26.933,62737,5.015,53.866,15806,15816,80710
1986,237,37870,38852,702092,698963,6253,16.304,5252,13.694,180767,45006,135761,6.439,25.862,173544,42340,131204,6.058,24.829,7223,1.033,49.658,3919,3925,25959
1986,238,289608,292649,2833350,2767079,49862,17.410,37347,13.041,784905,233147,551758,8.426,28.366,652545,206413,446132,7.460,23.582,132360,4.783,47.165,27584,27616,152262
1986,311,21683,27163,1318769,1315018,2860,10.533,2838,10.452,172120,57314,114806,4.358,13.089,164603,55065,109538,4.187,12.517,7517,0.572,25.034,1978,2004,20688
1986,312,2007,2562,198531,202456,196,7.585,240,9.288,19899,6129,13770,3.027,9.829,27898,11933,15965,5.894,13.780,-7999,-3.951,19.658,138,140,3054
1986,313,3438,4453,467944,468458,372,8.310,419,9.360,56987,25977,31010,5.545,12.165,58297,21425,36872,4.574,12.444,-1310,-0.280,24.330,277,280,4923
1986,314,7456,7915,248391,249589,1005,12.630,1090,13.698,38558,12444,26114,4.986,15.449,40757,18250,22507,7.312,16.330,-2199,-0.881,30.897,865,871,9246
1986,315,14502,16242,1006970,1016264,2199,13.364,2625,15.953,158877,47928,110949,4.716,15.633,176402,76306,100096,7.508,17.358,-17525,-1.724,31.267,2147,2155,45174
1986,316,1889,2152,144973,152535,164,7.367,312,14.016,16220,6073,10147,3.981,10.634,31178,12442,18736,8.157,20.440,-14958,-9.806,21.267,233,237,4783
1986,321,14519,16178,506139,501748,1766,10.867,1911,11.760,83176,27940,55236,5.569,16.577,74323,30754,43569,6.129,14.813,8853,1.764,29.626,1406,1412,14141
1986,322,3739,5748,597396,598511,382,6.642,388,6.747,56784,20481,36303,3.422,9.488,58583,26486,32097,4.425,9.788,-1799,-0.301,18.975,207,210,4980
1986,323,38078,39730,764517,754826,4625,11.803,3538,9.029,105448,30159,75289,3.995,13.970,86054,30660,55394,4.062,11.401,19394,2.569,22.801,2807,2816,20528
1986,324,1394,2308,210442,220782,215,9.303,221,9.563,10416,2440,7976,1.105,4.718,31319,6779,24540,3.070,14.185,-20903,-9.468,9.436,112,112,789
1986,325,8281,12054,886536,899345,1112,9.251,1045,8.693,84364,32339,52025,3.596,9.381,109008,38913,70095,4.327,12.121,-24644,-2.740,18.761,562,569,9659
1986,326,12227,14421,781944,785275,1317,9.137,1302,9.033,109122,34778,74344,4.429,13.896,115648,52407,63241,6.674,14.727,-6526,-0.831,27.792,924,932,14223
1986,327,11614,14912,496780,505243,1337,8.955,1374,9.203,66251,19892,46359,3.937,13.113,83047,30661,52386,6.069,16.437,-16796,-3.324,26.225,918,944,9978
1986,331,4457,5461,576169,593407,400,7.245,520,9.419,51584,22690,28894,3.824,8.693,86177,30957,55220,5.217,14.522,-34593,-5.830,17.386,306,309,8435
1986,332,50068,53898,1670526,1679236,4774,8.850,4866,9.020,228976,63709,165267,3.794,13.636,247308,85333,161975,5.082,14.727,-18332,-1.092,27.271,3523,3538,36713
1986,333,25950,28687,1396819,1420681,2315,8.054,2430,8.454,172920,72966,99954,5.136,12.172,220054,76126,143928,5.358,15.489,-47134,-3.318,24.343,1651,1658,23447
1986,334,12685,14827,1867671,1909226,1686,11.376,1674,11.295,210723,81800,128923,4.284,11.037,293353,84549,208804,4.428,15.365,-82630,-4.328,22.074,1147,1152,17106
1986,335,5480,6699,652695,659196,628,9.417,567,8.503,67118,21250,45868,3.224,10.182,80204,27587,52617,4.185,12.167,-13086,-1.985,20.364,319,320,5263
1986,336,8603,10207,2006704,1989519,1105,10.900,966,9.529,228636,82552,146084,4.149,11.492,194814,73844,120970,3.712,9.792,33822,1.700,19.584,695,699,14110
1986,337,16202,17253,569093,569221,2429,14.212,2106,12.322,83694,29366,54328,5.159,14.703,84482,32744,51738,5.752,14.842,-788,-0.138,29.407,1647,1657,16463
1986,339,24945,26021,622706,623422,3237,12.495,3007,11.607,97210,32878,64332,5.274,15.593,98127,41370,56757,6.636,15.740,-917,-0.147,31.186,2279,2289,17002
1986,423,164067,211989,2626402,2615346,26119,12.425,22583,10.743,453662,166500,287162,6.366,17.346,430460,166013,264447,6.348,16.459,23202,0.887,32.918,14801,15156,84146
1986,424,98455,124543,1794660,1782120,13975,11.214,14125,11.335,311384,96165,215219,5.396,17.473,285676,108904,176772,6.111,16.030,25708,1.443,32.060,9567,9717,55379
1986,425,30558,33373,307827,306691,4022,12.204,3191,9.682,55637,19325,36312,6.301,18.141,53098,19848,33250,6.472,17.313,2539,0.828,34.626,2101,2107,10705
1986,441,97446,122011,1516109,1476016,14546,12.111,10734,8.937,269093,104806,164287,7.101,18.231,188991,66528,122463,4.507,12.804,80102,5.427,25.608,7737,7886,47987
1986,442,42991,53404,378915,370421,7715,14.726,5691,10.862,83749,36749,47000,9.921,22.609,66997,24103,42894,6.507,18.087,16752,4.522,36.173,4146,4294,16687
1986,443,23250,31275,214690,211052,4818,15.296,5263,16.709,54423,24965,29458,11.829,25.787,47806,22743,25063,10.776,22.651,6617,3.135,45.303,3644,3834,15419
1986,444,71208,90337,875685,860774,9070,10.101,7979,8.886,158491,63894,94597,7.423,18.413,129467,44392,85075,5.157,15.041,29024,3.372,30.082,5577,5696,24608
1986,445,114512,168757,2494018,2445713,20627,12.215,20836,12.339,456959,207750,249209,8.494,18.684,361642,146920,214722,6.007,14.787,95317,3.897,29.574,14426,14862,76440
1986,446,45653,68403,636617,635540,7918,11.691,6571,9.702,112570,53827,58743,8.469,17.713,110323,45623,64700,7.179,17.359,2247,0.354,34.718,3849,3948,21225
1986,447,90424,124962,837302,826939,16247,13.017,15950,12.779,195505,91234,104271,11.033,23.642,175515,76166,99349,9.211,21.225,19990,2.417,42.449,10833,11140,47948
1986,448,85703,162998,1251486,1222307,22455,13.958,18221,11.326,289165,131398,157767,10.750,23.657,230092,89532,140560,7.325,18.824,59073,4.833,37.649,10648,11483,45140
1986,451,39988,53441,362425,354510,8071,15.300,6694,12.689,84099,37020,47079,10.443,23.723,68559,27216,41343,7.677,19.339,15540,4.384,38.678,4780,4914,17002
1986,452,12567,34296,1992760,1970496,3349,9.807,3056,8.949,267747,131023,136724,6.649,13.588,223874,58129,165745,2.950,11.361,43873,2.226,22.723,1669,1718,9638
1986,453,86691,102266,567930,558421,16640,16.479,14061,13.925,134949,60842,74107,10.895,24.166,115647,49379,66268,8.843,20.710,19302,3.457,41.419,10344,10626,35197
1986,454,25466,34023,386373,383337,4122,12.031,4598,13.421,80524,37543,42981,9.794,21.006,76548,31950,44598,8.335,19.969,3976,1.037,39.938,3158,3182,13285
1986,481,1328,3421,317373,305675,333,10.185,30,0.918,46298,6075,40223,1.987,15.146,23089,125,22964,0.041,7.553,23209,7.593,15.107,22,22,110
1986,483,706,1061,45035,45639,118,11.689,15,1.486,6456,2666,3790,5.842,14.146,7612,34,7578,0.074,16.679,-1156,-2.533,28.292,13,13,31
1986,484,64172,74302,1122876,1086807,12268,17.699,2290,3.304,217779,77125,140654,7.096,20.038,145475,8982,136493,0.826,13.386,72304,6.653,26.771,1798,1798,7081
1986,485,9796,10682,227110,218991,1249,12.258,264,2.591,41218,15036,26182,6.866,18.822,24365,902,23463,0.412,11.126,16853,7.696,22.252,228,228,741
1986,486,325,1836,76563,75412,91,5.075,5,0.279,7267,3172,4095,4.206,9.636,5152,49,5103,0.065,6.832,2115,2.805,13.664,3,3,45
1986,487,932,963,14380,13799,189,20.455,111,12.013,3199,1192,2007,8.639,23.184,2075,489,1586,3.544,15.038,1124,8.146,30.076,83,83,359
1986,488,11666,15343,294894,286136,2432,16.804,691,4.775,60605,20430,40175,7.140,21.180,42371,3533,38838,1.235,14.808,18234,6.372,29.616,575,577,2801
1986,492,3210,4191,144420,133584,1114,29.838,199,5.330,30552,11114,19438,8.320,22.871,9494,890,8604,0.666,7.107,21058,15.764,14.214,162,162,747
1986,493,6408,9945,401569,401710,1036,10.503,873,8.851,62825,20672,42153,5.146,15.639,63423,17553,45870,4.370,15.788,-598,-0.149,31.279,358,361,3508
1986,511,20446,23615,833605,825101,2938,12.347,3297,13.856,114807,33763,81044,4.092,13.914,98235,41569,56666,5.038,11.906,16572,2.008,23.812,2382,2398,19231
1986,512,11393,16431,253509,243733,2893,17.657,2800,17.089,70623,24274,46349,9.959,28.976,52011,19761,32250,8.108,21.339,18612,7.636,42.679,1653,1715,8783
1986,515,5786,6796,221074,214691,598,9.155,70,1.072,35274,11824,23450,5.507,16.430,23351,563,22788,0.262,10.877,11923,5.554,21.753,57,57,326
1986,517,4683,18377,924704,921548,2160,12.364,347,1.986,122772,40248,82524,4.367,13.322,118440,2035,116405,0.221,12.852,4332,0.470,25.705,323,323,1932
1986,518,5983,7858,254544,255455,1220,15.519,1227,15.608,52402,18910,33492,7.402,20.513,54254,25650,28604,10.041,21.238,-1852,-0.725,41.026,612,618,4827
1986,519,2335,2801,37240,35371,347,12.484,304,10.937,9360,5028,4332,14.215,26.462,5314,1686,3628,4.767,15.024,4046,11.439,30.047,223,223,1054
1986,521,44,81,25647,25117,7,9.032,0,0.000,1464,298,1166,1.186,5.829,397,0,397,0.000,1.581,1067,4.248,3.161,0,0,0
1986,522,42897,110702,2417868,2335921,8187,7.635,1255,1.170,384353,117283,267070,5.021,16.454,220706,7764,212942,0.332,9.448,163647,7.006,18.897,1096,1098,7100
1986,523,19454,25605,460094,422438,3989,16.579,900,3.741,117211,31457,85754,7.447,27.746,42604,5570,37034,1.319,10.085,74607,17.661,20.171,678,678,3606
1986,524,98132,124600,2012752,1924420,11203,9.327,2242,1.866,326083,79674,246409,4.140,16.944,148226,9723,138503,0.505,7.702,177857,9.242,15.405,1658,1658,7151
1986,525,1865,2081,18642,17875,209,10.481,35,1.755,4812,1405,3407,7.860,26.920,3182,168,3014,0.940,17.801,1630,9.119,35.603,19,19,49
1986,531,142206,147937,947359,903155,18892,13.384,5323,3.771,215148,77497,137651,8.581,23.822,126634,18063,108571,2.000,14.021,88514,9.801,28.043,4436,4437,14882
1986,532,32820,43634,415478,391316,11123,27.387,5083,12.515,128505,58556,69949,14.964,32.839,79923,31899,48024,8.152,20.424,48582,12.415,40.848,3357,3461,19524
1986,533,855,891,11821,10975,123,14.471,41,4.824,3332,1143,2189,10.415,30.360,1588,140,1448,1.276,14.469,1744,15.891,28.938,32,32,113
1986,541,367095,391293,3679165,3565088,64341,16.873,44426,11.650,801476,295866,505610,8.299,22.481,571585,213669,357916,5.993,16.033,229891,6.448,32.066,33040,33238,145179
1986,551,24059,44163,3025647,2988098,5093,11.762,3369,7.780,550636,187581,363055,6.278,18.428,474331,119648,354683,4.004,15.874,76305,2.554,31.748,517,568,6049
1986,561,154014,173332,3239152,3096241,34062,20.375,21742,13.006,873101,310508,562593,10.029,28.199,588585,182890,405695,5.907,19.010,284516,9.189,38.019,16467,16573,116075
1986,562,9907,10842,190345,184805,1190,11.266,631,5.974,30727,7519,23208,4.069,16.627,19596,4124,15472,2.232,10.604,11131,6.023,21.207,478,478,3040
1986,611,32921,35617,1568251,1541598,4414,12.657,2926,8.390,175406,29427,145979,1.909,11.378,122074,14987,107087,0.972,7.919,53332,3.460,15.837,2255,2292,10723
1986,621,345429,364393,2419079,2338047,35100,9.765,25201,7.011,510852,180858,329994,7.735,21.850,348130,110949,237181,4.745,14.890,162722,6.960,29.780,19367,19563,79968
1986,622,4463,6019,3599942,3557408,378,6.470,24,0.411,285460,142001,143459,3.992,8.024,199789,2591,197198,0.073,5.616,85671,2.408,11.232,4,4,157
1986,623,22279,32349,1576691,1528697,4419,14.045,2648,8.416,270409,127818,142591,8.361,17.689,173436,74128,99308,4.849,11.345,96973,6.344,22.691,1712,1790,49340
1986,624,53412,68734,936095,912533,9319,13.884,6088,9.071,180594,61122,119472,6.698,19.790,133588,38776,94812,4.249,14.639,47006,5.151,29.279,4201,4273,23579
1986,711,20566,20866,246007,241815,4786,23.296,4142,20.162,68904,23283,45621,9.628,28.495,60547,20607,39940,8.522,25.039,8357,3.456,50.077,3144,3147,14814
1986,712,2299,2452,41099,39861,239,9.872,177,7.311,5344,1227,4117,3.078,13.407,2850,667,2183,1.673,7.150,2494,6.257,14.300,125,125,511
1986,713,35706,38873,608937,594437,5922,15.565,4271,11.225,124337,52351,71986,8.807,20.917,95227,34349,60878,5.778,16.020,29110,4.897,32.039,3149,3186,23799
1986,721,37254,42602,1333232,1292968,5856,13.825,5367,12.671,291100,147748,143352,11.427,22.514,209999,89541,120458,6.925,16.242,81101,6.272,32.483,3848,3900,56320
1986,722,268306,344548,5765537,5614640,62061,18.237,53583,15.745,1483216,870164,613052,15.498,26.417,1182252,530207,652045,9.443,21.057,300964,5.360,42.113,38858,39738,343818
1986,811,158746,169174,966141,942034,28757,17.310,22670,13.646,232180,110333,121847,11.712,24.647,184464,78169,106295,8.298,19.581,47716,5.065,39.163,17262,17357,58478
1986,812,142532,168251,1159663,1143426,24517,14.655,22613,13.517,242181,111034,131147,9.711,21.180,209432,92384,117048,8.080,18.316,32749,2.864,36.632,16558,17031,65237
1986,813,219168,225735,1903366,1866075,15505,7.016,6054,2.739,275997,59358,216639,3.181,14.790,201419,24763,176656,1.327,10.794,74578,3.997,21.587,3454,3492,14757
1987,211,7318,8971,131317,143302,922,9.780,1835,19.464,19671,7332,12339,5.116,13.727,43671,15836,27835,11.051,30.475,-24000,-16.748,27.454,1206,1218,5771
1987,212,6267,8542,285974,297431,1137,13.160,1332,15.418,48526,20435,28091,6.871,16.315,71349,29944,41405,10.068,23.988,-22823,-7.673,32.630,775,787,9533
1987,213,8331,9807,165894,197664,1285,12.001,3085,28.813,33187,15752,17435,7.969,16.790,96707,35769,60938,18.096,48.925,-63520,-32.135,33.579,2063,2075,17776
1987,221,5639,11854,756298,749690,633,5.465,90,0.777,44029,13662,30367,1.822,5.873,30903,386,30517,0.051,4.122,13126,1.751,8.244,75,75,334
1987,236,142611,143807,1307939,1284516,29826,21.285,22470,16.035,408887,140493,268394,10.937,31.832,362415,132607,229808,10.324,28.214,46472,3.618,56.428,16362,16368,88782
1987,237,38045,39061,707595,704634,6531,16.884,5771,14.919,184563,47106,137457,6.685,26.193,179433,58393,121040,8.287,25.465,5130,0.728,50.929,4452,4458,35176
1987,238,305966,309355,2947533,2885700,54195,17.973,38562,12.788,814660,255855,558805,8.866,28.231,691132,216300,474832,7.496,23.950,123528,4.281,47.900,28987,29001,158905
1987,311,21254,26727,1321470,1315918,2935,10.994,2872,10.758,178412,52722,125690,4.006,13.558,166046,62665,103381,4.762,12.618,12366,0.940,25.237,1961,1981,22067
1987,312,1875,2396,180802,185570,233,9.610,290,11.961,17028,5213,11815,2.809,9.176,26012,11373,14639,6.129,14.017,-8984,-4.841,18.352,197,200,5069
1987,313,3303,4257,459177,466677,346,7.990,493,11.384,50512,11419,39093,2.447,10.824,65898,43634,22264,9.350,14.121,-15386,-3.297,21.648,275,282,6758
1987,314,7222,7662,240957,242174,936,12.116,1063,13.760,39366,11970,27396,4.943,16.255,42094,21623,20471,8.929,17.382,-2728,-1.126,32.511,837,838,8951
1987,315,14309,15952,993748,1000980,2370,14.791,2512,15.677,161124,57885,103239,5.783,16.097,177093,74000,103093,7.393,17.692,-15969,-1.595,32.193,2033,2056,45085
1987,316,1825,2053,131254,136832,180,8.567,276,13.137,14524,3218,11306,2.352,10.614,25869,12444,13425,9.094,18.906,-11345,-8.291,21.229,174,177,2949
1987,321,14519,16138,517879,511768,1892,11.737,1857,11.519,84842,22889,61953,4.473,16.578,72280,36759,35521,7.183,14.124,12562,2.455,28.247,1305,1314,18913
1987,322,3696,5643,572651,575418,345,6.096,377,6.662,43262,11507,31755,2.000,7.518,48690,17970,30720,3.123,8.462,-5428,-0.943,15.037,221,222,5223
1987,323,39912,41669,798298,791239,5063,12.360,3653,8.918,108051,31526,76525,3.984,13.656,94014,34237,59777,4.327,11.882,14037,1.774,23.764,2883,2886,21345
1987,324,1324,2205,176704,190130,203,9.083,263,11.767,13370,3865,9505,2.033,7.032,39879,18653,21226,9.811,20.975,-26509,-13.943,14.064,111,114,1461
1987,325,8364,12006,880764,893159,958,7.877,1270,10.442,85885,32671,53214,3.658,9.616,110663,44781,65882,5.014,12.390,-24778,-2.774,19.232,618,629,7559
1987,326,11636,14003,812960,804399,1394,9.993,1287,9.226,114663,38319,76344,4.764,14.254,97538,36333,61205,4.517,12.126,17125,2.129,24.251,848,858,13656
1987,327,11642,14991,500300,501821,1425,9.488,1481,9.861,68255,18837,49418,3.754,13.601,71851,28167,43684,5.613,14.318,-3596,-0.717,27.203,885,902,9295
1987,331,4309,5270,561369,572958,433,8.126,550,10.322,54429,28472,25957,4.969,9.500,78665,29718,48947,5.187,13.730,-24236,-4.230,18.999,282,288,8215
1987,332,50103,53832,1604708,1632478,5015,9.323,4931,9.167,194911,57268,137643,3.508,11.940,250526,85242,165284,5.222,15.346,-55615,-3.407,23.879,3488,3523,36188
1987,333,25315,27903,1310046,1354989,2133,7.573,2655,9.427,145977,53921,92056,3.979,10.773,236409,90771,145638,6.699,17.447,-90432,-6.674,21.547,1721,1729,19148
1987,334,12195,14266,1789233,1832679,1696,11.845,1801,12.578,177871,58302,119569,3.181,9.706,265604,116097,149507,6.335,14.493,-87733,-4.787,19.411,1115,1135,26742
1987,335,5671,6833,625464,638472,608,8.882,632,9.233,63788,22381,41407,3.505,9.991,90661,38173,52488,5.979,14.200,-26873,-4.209,19.981,332,334,5199
1987,336,8947,10579,1932950,1946665,1066,10.077,1065,10.068,190804,57486,133318,2.953,9.802,219493,60779,158714,3.122,11.275,-28689,-1.474,19.603,750,753,10888
1987,337,16689,17770,586106,581299,2364,13.415,2068,11.735,87299,25906,61393,4.457,15.018,77751,33404,44347,5.746,13.375,9548,1.643,26.751,1599,1608,17938
1987,339,25370,26448,631918,630173,3343,12.712,3043,11.571,96499,28102,68397,4.459,15.313,92661,38898,53763,6.173,14.704,3838,0.609,29.408,2295,2303,16746
1987,423,167814,216217,2672602,2669098,26184,12.123,25717,11.907,502718,187293,315425,7.017,18.835,494291,205296,288995,7.692,18.519,8427,0.316,37.038,15396,15823,91992
1987,424,98644,125294,1877133,1847789,15025,11.987,15116,12.060,360325,118149,242176,6.394,19.500,301590,119730,181860,6.480,16.322,58735,3.179,32.643,9757,9951,62119
1987,425,30427,32930,309130,307736,4164,12.732,3714,11.356,60214,22885,37329,7.437,19.567,57358,23972,33386,7.790,18.639,2856,0.928,37.277,2313,2325,12791
1987,441,99337,125903,1590006,1556180,14960,12.044,11579,9.322,286791,118804,167987,7.634,18.429,219179,82045,137134,5.272,14.084,67612,4.345,28.169,7969,8145,58311
1987,442,44315,55614,405066,396389,7796,14.177,6551,11.913,93590,36855,56735,9.298,23.611,76069,32881,43188,8.295,19.190,17521,4.420,38.381,4247,4424,18553
1987,443,20042,27249,187450,193235,4215,14.873,6397,22.572,45883,19686,26197,10.188,23.745,57423,33039,24384,17.098,29.717,-11540,-5.972,47.489,3845,4106,19103
1987,444,71190,90596,910068,889575,9065,10.017,8871,9.802,179735,65196,114539,7.329,20.205,139604,59843,79761,6.727,15.693,40131,4.511,31.387,5866,5986,29894
1987,445,112171,154110,2520004,2469315,20520,13.163,24086,15.450,490094,238030,252064,9.640,19.847,388999,188811,200188,7.646,15.753,101095,4.094,31.507,14735,15185,84919
1987,446,47382,73774,698763,673855,7525,10.299,6101,8.350,147359,56174,91185,8.336,21.868,96411,37195,59216,5.520,14.307,50948,7.561,28.615,3900,4009,21529
1987,447,87476,135941,946571,926062,16593,12.256,15482,11.435,227918,100434,127484,10.845,24.612,185993,75030,110963,8.102,20.084,41925,4.527,40.169,10260,10504,46757
1987,448,85085,166685,1293706,1276104,23752,14.392,20451,12.392,304685,149016,155669,11.677,23.876,268381,105974,162407,8.304,21.031,36304,2.845,42.063,11144,12000,48730
1987,451,40025,53892,376386,366971,8244,15.421,7378,13.801,90336,40294,50042,10.980,24.617,71179,31404,39775,8.558,19.396,19157,5.220,38.793,4995,5181,18550
1987,452,11704,33521,1977048,1983021,3292,9.796,3461,10.299,233133,113581,119552,5.728,11.756,246974,90245,156729,4.551,12.454,-13841,-0.698,23.513,1676,1726,10885
1987,453,83903,98334,541951,540171,16552,16.981,14831,15.215,135004,58526,76478,10.835,24.993,131073,67617,63456,12.518,24.265,3931,0.728,48.530,10585,10883,38113
1987,454,25234,33385,389198,389624,3632,10.747,4456,13.185,79787,24523,55264,6.294,20.478,80173,41328,38845,10.607,20.577,-386,-0.099,40.956,2767,2789,13775
1987,481,1026,3129,310983,297047,465,15.974,29,0.996,45835,9820,36015,3.306,15.430,17478,223,17255,0.075,5.884,28357,9.546,11.768,26,26,216
1987,483,602,944,44117,42147,115,12.856,16,1.789,10719,3403,7316,8.074,25.432,6798,130,6668,0.308,16.129,3921,9.303,32.259,14,14,118
1987,484,67224,77805,1073670,1016146,14288,19.908,2218,3.090,235761,85611,150150,8.425,23.201,120831,10163,110668,1.000,11.891,114930,11.310,23.782,1763,1763,8515
1987,485,9382,9969,219369,207576,1513,16.212,240,2.572,41253,14357,26896,6.917,19.874,17708,862,16846,0.415,8.531,23545,11.343,17.062,205,205,698
1987,486,317,1791,74722,74640,102,5.854,5,0.287,7109,1479,5630,1.982,9.524,6923,32,6891,0.043,9.275,186,0.249,18.550,5,5,32
1987,487,909,946,13829,13051,198,21.951,110,12.195,3947,1061,2886,8.130,30.243,2418,436,1982,3.341,18.527,1529,11.716,37.055,86,86,251
1987,488,11738,15074,274147,260159,2669,18.922,731,5.183,67950,25426,42524,9.773,26.119,40288,4459,35829,1.714,15.486,27662,10.633,30.972,607,607,3774
1987,492,5303,6848,399300,367820,1492,24.099,178,2.875,88427,19294,69133,5.246,24.041,25313,649,24664,0.176,6.882,63114,17.159,13.764,142,142,467
1987,493,6191,9805,400949,398725,1171,12.065,972,10.015,73004,28284,44720,7.094,18.309,67853,27890,39963,6.995,17.018,5151,1.292,34.035,372,377,3801
1987,511,16570,19241,740259,739989,2445,12.380,3463,17.534,92338,30850,61488,4.169,12.478,91699,46999,44700,6.351,12.392,639,0.086,24.784,2484,2510,20678
1987,512,11442,16209,241621,248530,2845,17.481,2977,18.292,56211,21667,34544,8.718,22.617,68900,22603,46297,9.095,27.723,-12689,-5.106,45.235,1701,1762,8736
1987,515,5528,6758,220078,208616,1167,18.806,62,0.999,44835,27638,17197,13.248,21.492,21330,311,21019,0.149,10.225,23505,11.267,20.449,54,54,256
1987,517,4668,21150,1036496,1004512,4178,21.734,325,1.691,255876,169787,86089,16.902,25.473,190939,1967,188972,0.196,19.008,64937,6.465,38.016,302,302,1791
1987,518,5463,7164,241620,238469,1127,15.574,1272,17.578,55431,22547,32884,9.455,23.245,49021,22267,26754,9.338,20.557,6410,2.688,41.113,656,664,5522
1987,519,2257,2723,36798,36636,334,12.302,318,11.713,5076,2055,3021,5.609,13.855,4803,2228,2575,6.082,13.110,273,0.745,26.220,222,223,1442
1987,521,44,82,24565,24851,4,5.000,0,0.000,596,194,402,0.781,2.398,1144,0,1144,0.000,4.603,-548,-2.205,4.797,0,0,0
1987,522,41347,111428,2480209,2405590,8423,7.811,1251,1.160,362792,107966,254826,4.488,15.081,213198,10826,202372,0.450,8.863,149594,6.219,17.725,1071,1071,8582
1987,523,19576,26620,502908,459200,5462,22.492,790,3.253,125942,47682,78260,10.384,27.426,38603,4948,33655,1.078,8.407,87339,19.020,16.813,637,637,4109
1987,524,98717,125126,2015546,1931894,17297,14.722,2030,1.728,348822,124458,224364,6.442,18.056,178011,8209,169802,0.425,9.214,170811,8.842,18.429,1558,1558,6033
1987,525,1860,2095,19648,17658,356,18.412,33,1.707,5870,2360,3510,13.365,33.243,1849,266,1583,1.506,10.471,4021,22.772,20.942,20,20,84
1987,531,143469,150375,984222,919585,24532,17.437,5164,3.670,254583,113883,140700,12.384,27.685,125429,21071,104358,2.291,13.640,129154,14.045,27.279,4419,4422,16435
1987,532,36419,48341,408225,408209,11346,24.575,7003,15.168,117148,56964,60184,13.955,28.698,118970,59112,59858,14.481,29.144,-1822,-0.446,57.396,4076,4203,23620
1987,533,752,783,11734,10466,174,24.455,31,4.357,3842,1834,2008,17.524,36.711,1336,124,1212,1.185,12.766,2506,23.945,25.532,24,24,98
1987,541,385016,411885,3972781,3878478,66447,16.474,49355,12.237,882957,321347,561610,8.285,22.766,692828,281617,411211,7.261,17.863,190129,4.902,35.727,36197,36410,171579
1987,551,24020,43747,2976730,2996466,5303,12.262,4305,9.954,551311,177702,373609,5.930,18.399,592082,166141,425941,5.545,19.759,-40771,-1.361,36.797,526,556,9626
1987,561,165098,185790,3411431,3322211,37707,21.050,24383,13.612,951480,367189,584291,11.053,28.640,771775,268192,503583,8.073,23.231,179705,5.409,46.462,18055,18341,144986
1987,562,8679,9600,130150,121268,1395,15.109,661,7.159,31189,9898,21291,8.162,25.719,13428,3673,9755,3.029,11.073,17761,14.646,22.146,491,491,2603
1987,611,33434,37000,1611225,1579707,4442,12.225,3111,8.562,180692,32853,147839,2.080,11.438,116889,20285,96604,1.284,7.399,63803,4.039,14.799,2356,2384,13231
1987,621,349691,371035,2592201,2514428,34919,9.494,28433,7.731,561948,192318,369630,7.649,22.349,407078,142727,264351,5.676,16.190,154870,6.159,32.379,21463,21660,95484
1987,622,5040,6869,4031697,4253202,1021,16.036,17,0.267,759153,536652,222501,12.618,17.849,1196884,724,1196160,0.017,28.141,-437731,-10.292,35.698,11,11,464
1987,623,22832,34310,1646148,1615397,4666,13.910,3133,9.340,284656,142096,142560,8.796,17.621,224778,111254,113524,6.887,13.915,59878,3.707,27.829,1949,2033,68851
1987,624,55376,70987,963969,942555,8529,12.191,6483,9.266,182031,53431,128600,5.669,19.313,140271,39908,100363,4.234,14.882,41760,4.431,29.764,4451,4507,24366
1987,711,19506,19841,242596,238846,4561,22.937,4648,23.375,73821,24301,49520,10.174,30.907,66770,23253,43517,9.736,27.955,7051,2.952,55.911,3643,3645,17352
1987,712,2693,2885,53062,51746,239,8.399,160,5.623,6778,1235,5543,2.387,13.099,4153,748,3405,1.446,8.026,2625,5.073,16.051,109,109,581
1987,713,37427,41493,658680,641493,6643,16.483,4263,10.577,141363,60348,81015,9.407,22.037,106699,35849,70850,5.588,16.633,34664,5.404,33.266,3150,3171,25306
1987,721,37054,42625,1334511,1335526,6121,14.433,5688,13.412,266959,138210,128749,10.349,19.989,268495,125682,142813,9.411,20.104,-1536,-0.115,39.978,3965,4054,69473
1987,722,272984,357839,6096504,5949071,66754,18.981,54444,15.481,1569771,877400,692371,14.749,26.387,1277779,583415,694364,9.807,21.479,291992,4.908,42.957,40027,40871,374156
1987,811,166127,177507,1017704,1004278,29928,17.126,24411,13.969,242554,114784,127770,11.430,24.152,215015,93825,121190,9.343,21.410,27539,2.742,42.820,17935,18049,64595
1987,812,137408,163889,1092714,1082800,24444,14.964,23375,14.309,240704,108625,132079,10.032,22.230,220964,103762,117202,9.583,20.407,19740,1.823,40.813,17178,17536,69948
1987,813,221662,228231,1938901,1900641,15885,7.118,5734,2.570,281076,62797,218279,3.304,14.788,205226,25313,179913,1.332,10.798,75850,3.991,21.595,3668,3691,15582
1988,211,7155,8733,124691,128233,1039,11.737,1278,14.437,21842,6880,14962,5.365,17.033,29155,9958,19197,7.766,22.736,-7313,-5.703,34.066,821,832,3323
1988,212,6221,8533,294464,292164,1126,13.180,1147,13.425,54946,22746,32200,7.785,18.807,50845,18475,32370,6.324,17.403,4101,1.404,34.806,756,762,9115
1988,213,8139,9309,162241,163058,1321,13.839,1794,18.794,46815,10924,35891,6.699,28.711,48224,24334,23890,14.924,29.575,-1409,-0.864,57.421,1097,1107,6710
1988,221,6046,12654,771111,762828,966,7.926,35,0.287,50573,19888,30685,2.607,6.630,33810,172,33638,0.023,4.432,16763,2.197,8.864,27,27,129
1988,236,145437,146646,1338839,1328003,27621,19.011,24906,17.142,392855,122074,270781,9.192,29.582,370106,130434,239672,9.822,27.869,22749,1.713,55.739,18514,18525,93634
1988,237,38157,39242,710588,716757,5775,14.778,5447,13.939,169245,44797,124448,6.250,23.613,183371,60313,123058,8.415,25.583,-14126,-1.971,47.225,4238,4261,29564
1988,238,312969,316381,3018512,2988702,50273,16.061,43523,13.905,765938,225173,540765,7.534,25.628,706302,219308,486994,7.338,23.632,59636,1.995,47.265,33232,33262,171454
1988,311,21596,27066,1358500,1345246,3020,11.216,2738,10.169,188169,64191,123978,4.772,13.988,163093,65273,97820,4.852,12.124,25076,1.864,24.247,1835,1858,21727
1988,312,1871,2417,184437,182949,235,9.735,229,9.486,24522,8138,16384,4.448,13.404,21263,6837,14426,3.737,11.622,3259,1.781,23.245,142,144,2463
1988,313,3546,4549,479914,472109,493,11.092,284,6.390,55146,23416,31730,4.960,11.681,39999,12271,27728,2.599,8.472,15147,3.208,16.945,174,176,4071
1988,314,7320,7764,248841,246149,940,12.154,880,11.378,39535,14877,24658,6.044,16.061,33987,14119,19868,5.736,13.807,5548,2.254,27.615,670,685,9032
1988,315,14403,16062,984609,996404,2540,15.820,2528,15.745,157024,62186,94838,6.241,15.759,179847,78173,101674,7.846,18.050,-22823,-2.291,31.518,2116,2125,47021
1988,316,1851,2076,136491,134890,213,10.263,212,10.214,20774,5915,14859,4.385,15.401,17361,7095,10266,5.260,12.870,3413,2.530,25.741,150,150,2187
1988,321,14895,16564,542432,533865,1971,12.021,1635,9.972,86827,33070,53757,6.194,16.264,69614,27395,42219,5.131,13.040,17213,3.224,26.079,1215,1224,13203
1988,322,3775,5770,591204,585341,382,6.656,320,5.576,52526,17877,34649,3.054,8.974,40730,12852,27878,2.196,6.958,11796,2.015,13.917,209,212,4977
1988,323,40959,42815,834361,820594,4922,11.637,3881,9.176,118968,37816,81152,4.608,14.498,91393,35485,55908,4.324,11.137,27575,3.360,22.275,3114,3119,22537
1988,324,1309,2188,178266,177968,194,8.873,191,8.735,19204,5596,13608,3.144,10.791,17980,9776,8204,5.493,10.103,1224,0.688,20.206,94,97,3054
1988,325,8561,12325,898873,895247,1193,9.779,941,7.714,106493,40712,65781,4.548,11.895,100315,46498,53817,5.194,11.205,6178,0.690,22.411,521,530,7742
1988,326,11910,14355,858161,838904,1403,9.871,1119,7.873,131158,42563,88595,5.074,15.634,93433,36799,56634,4.387,11.138,37725,4.497,22.275,758,763,14250
1988,327,11731,15195,510695,507843,1453,9.605,1317,8.706,74157,23463,50694,4.620,14.602,68197,26104,42093,5.140,13.429,5960,1.174,26.858,864,881,11224
1988,331,4398,5368,614439,595482,472,8.841,414,7.754,91680,42532,49148,7.142,15.396,53871,24731,29140,4.153,9.047,37809,6.349,18.093,250,254,5926
1988,332,50976,54783,1668073,1643333,5093,9.355,4409,8.099,251811,72462,179349,4.409,15.323,200841,70135,130706,4.268,12.222,50970,3.102,24.443,3269,3280,33707
1988,333,25654,28221,1365710,1345645,2258,8.018,2141,7.602,207443,66196,141247,4.919,15.416,166830,77481,89349,5.758,12.398,40613,3.018,24.796,1480,1490,24950
1988,334,12790,14925,1817200,1811304,2030,13.834,1528,10.413,234705,80524,154181,4.446,12.958,223543,85010,138533,4.693,12.342,11162,0.616,24.683,1032,1043,18147
1988,335,5718,6901,633302,632188,663,9.635,624,9.068,90133,36734,53399,5.811,14.257,86929,44446,42483,7.031,13.750,3204,0.507,27.501,398,405,9664
1988,336,9205,10909,1941687,1929491,1194,11.061,965,8.940,223820,79159,144661,4.103,11.600,202241,64292,137949,3.332,10.482,21579,1.118,20.963,665,667,13944
1988,337,17175,18344,617107,605488,2470,13.636,2010,11.096,100654,37524,63130,6.197,16.624,77915,30122,47793,4.975,12.868,22739,3.755,25.736,1556,1567,17038
1988,339,25993,27135,663996,654118,3454,12.855,2920,10.868,109005,33282,75723,5.088,16.664,89554,31774,57780,4.858,13.691,19451,2.974,27.382,2286,2296,18553
1988,423,170105,219392,2753250,2718645,25866,11.863,23170,10.626,508773,175382,333391,6.451,18.714,440538,188732,251806,6.942,16.204,68235,2.510,32.409,15201,15772,91623
1988,424,99569,126911,1905162,1899432,14867,11.769,13694,10.840,335301,112837,222464,5.941,17.653,324454,118449,206005,6.236,17.082,10847,0.571,34.163,9369,9540,60323
1988,425,31366,33914,308333,310028,4088,12.215,3193,9.541,61738,25248,36490,8.144,19.914,66406,33085,33321,10.672,21.419,-4668,-1.506,39.827,2119,2131,23684
1988,441,98956,125625,1624953,1613164,12351,9.806,13001,10.322,257724,102676,155048,6.365,15.976,234062,86809,147253,5.381,14.509,23662,1.467,29.019,9107,9449,61942
1988,442,45099,57211,425635,417476,7482,13.235,6125,10.834,91118,38381,52737,9.194,21.826,74643,28431,46212,6.810,17.880,16475,3.946,35.759,4323,4552,19600
1988,443,21503,29773,209615,199029,5590,19.545,3246,11.349,56805,31116,25689,15.634,28.541,35451,14716,20735,7.394,17.812,21354,10.729,35.624,2103,2203,9579
1988,444,71652,91400,936108,924970,8518,9.345,8020,8.799,162365,57992,104373,6.270,17.554,140977,50863,90114,5.499,15.241,21388,2.312,30.483,5371,5514,25469
1988,445,111479,153592,2572427,2548838,20030,13.012,20710,13.454,472775,234373,238402,9.195,18.549,427184,195512,231672,7.671,16.760,45591,1.789,33.520,13851,14257,73957
1988,446,48267,75829,711570,707973,8266,11.023,6582,8.778,133430,62066,71364,8.767,18.847,125557,47437,78120,6.700,17.735,7873,1.112,35.469,3905,4040,19623
1988,447,86518,137539,956622,954584,16735,12.228,15371,11.231,215888,101458,114430,10.629,22.616,211294,82696,128598,8.663,22.135,4594,0.481,44.269,9471,9898,47798
1988,448,85494,170404,1324791,1313838,22655,13.419,19507,11.554,303811,137123,166688,10.437,23.124,279447,100315,179132,7.635,21.270,24364,1.854,42.539,10814,11601,45732
1988,451,40801,55271,398669,388701,7956,14.547,6800,12.433,90959,39562,51397,10.178,23.401,71193,28729,42464,7.391,18.316,19766,5.085,36.631,4799,5005,17506
1988,452,11698,33922,2067651,2024490,3354,9.939,3001,8.893,291205,122110,169095,6.032,14.384,209442,78464,130978,3.876,10.345,81763,4.039,20.691,1531,1648,14370
1988,453,87016,102022,568736,556448,17061,17.006,13661,13.617,141213,63112,78101,11.342,25.378,116649,50081,66568,9.000,20.963,24564,4.414,41.926,9579,10102,35248
1988,454,25880,34173,413121,401567,4155,12.285,3453,10.209,95017,31547,63470,7.856,23.662,70543,29143,41400,7.257,17.567,24474,6.095,35.134,2289,2329,15222
1988,481,1500,3614,435458,412680,503,14.932,12,0.356,68975,9321,59654,2.259,16.714,22850,113,22737,0.027,5.537,46125,11.177,11.074,10,10,109
1988,483,617,942,44385,44520,119,12.526,135,14.211,8157,1328,6829,2.983,18.322,8372,3659,4713,8.219,18.805,-215,-0.483,36.644,55,55,561
1988,484,67770,79157,1132053,1103706,13638,17.379,12276,15.643,267859,95092,172767,8.616,24.269,209704,79528,130176,7.206,19.000,58155,5.269,38.000,9402,9516,49137
1988,485,10623,11393,242359,230831,1927,18.394,94,0.897,49180,23882,25298,10.346,21.306,26090,781,25309,0.338,11.303,23090,10.003,22.605,79,79,741
1988,486,354,1986,75756,75197,239,12.784,6,0.321,10161,3591,6570,4.775,13.513,9171,78,9093,0.104,12.196,990,1.317,24.392,6,6,78
1988,487,1069,1094,12921,12672,254,24.817,113,11.041,3162,1269,1893,10.014,24.953,2694,793,1901,6.258,21.259,468,3.693,42.519,87,87,388
1988,488,12794,16657,289143,280150,3306,20.951,1551,9.829,71894,30229,41665,10.790,25.663,53669,18150,35519,6.479,19.157,18225,6.505,38.314,1135,1151,9528
1988,492,5203,7808,364397,346884,1720,23.370,824,11.196,74926,31159,43767,8.983,21.600,37660,6713,30947,1.935,10.857,37266,10.743,21.713,656,657,4058
1988,493,6277,9807,403950,403116,1131,11.531,1133,11.552,74360,24197,50163,6.002,18.446,73074,29281,43793,7.264,18.127,1286,0.319,36.255,403,414,3617
1988,511,17015,19830,740912,735254,2846,14.608,2150,11.036,92720,36199,56521,4.923,12.611,81583,31501,50082,4.284,11.096,11137,1.515,22.192,1634,1642,16592
1988,512,11549,16239,250242,245824,2944,18.117,2965,18.247,83631,44871,38760,18.253,34.021,75175,24233,50942,9.858,30.581,8456,3.440,61.162,1785,1916,10999
1988,515,6233,7821,246992,233839,1092,14.984,26,0.357,45033,22852,22181,9.773,19.258,18664,269,18395,0.115,7.982,26369,11.277,15.963,16,16,221
1988,517,5897,23881,1079013,1059724,2691,11.903,145,0.641,111049,41952,69097,3.959,10.479,73488,1346,72142,0.127,6.935,37561,3.544,13.869,114,114,679
1988,518,5465,7294,258460,250627,1167,16.132,1047,14.473,65349,29391,35958,11.727,26.074,49123,18999,30124,7.581,19.600,16226,6.474,39.200,638,647,5799
1988,519,2435,2890,35805,36759,399,14.174,249,8.845,6476,2693,3783,7.326,17.617,8782,5547,3235,15.090,23.891,-2306,-6.273,35.235,168,168,579
1988,521,47,86,24883,24748,4,4.762,0,0.000,951,64,887,0.259,3.843,708,0,708,0.000,2.861,243,0.982,5.722,0,0,0
1988,522,43711,121266,2550636,2505228,12140,10.509,644,0.557,387105,157935,229170,6.304,15.452,294654,3850,290804,0.154,11.762,92451,3.690,23.523,458,459,3155
1988,523,21928,29585,488084,477819,5544,20.567,285,1.057,99738,41650,58088,8.717,20.874,77874,1562,76312,0.327,16.298,21864,4.576,32.596,243,243,1240
1988,524,107103,142434,2054537,1987138,22778,17.336,698,0.531,344960,134792,210168,6.783,17.360,207257,3522,203735,0.177,10.430,137703,6.930,20.860,568,568,2591
1988,525,2185,2423,22866,21866,268,11.667,16,0.697,4876,2176,2700,9.952,22.300,2816,68,2748,0.311,12.879,2060,9.421,25.757,9,9,45
1988,531,158863,167404,1081942,1019644,26029,16.707,2810,1.804,267474,126227,141247,12.380,26.232,142628,10759,131869,1.055,13.988,124846,12.244,27.976,2280,2299,8055
1988,532,37770,51776,440435,424956,10142,20.245,6784,13.542,124257,55964,68293,13.169,29.240,92761,38023,54738,8.948,21.828,31496,7.412,43.657,4798,5009,24555
1988,533,950,1029,16083,14224,287,32.193,12,1.346,6481,3608,2873,25.366,45.565,2797,38,2759,0.267,19.665,3684,25.901,39.329,11,11,36
1988,541,401018,430242,4248849,4130510,69793,16.570,51690,12.272,933820,356416,577404,8.629,22.608,698425,267553,430872,6.477,16.909,235395,5.699,33.818,38379,38762,165937
1988,551,25464,47163,3036287,3008226,8213,18.155,4361,9.640,647321,219551,427770,7.298,21.518,591395,175780,415615,5.843,19.659,55926,1.859,39.319,442,492,9432
1988,561,175857,199144,3720122,3571648,39444,20.572,24635,12.848,1104673,420202,684471,11.765,30.929,805823,283662,522161,7.942,22.562,298850,8.367,45.123,18645,18839,157529
1988,562,9404,10564,150147,139895,1781,17.759,710,7.080,37964,16979,20985,12.137,27.138,17199,4726,12473,3.378,12.294,20765,14.843,24.589,536,537,3779
1988,611,35179,39128,1684661,1661342,5019,13.197,2826,7.431,179879,34884,144995,2.100,10.827,133308,17117,116191,1.030,8.024,46571,2.803,16.048,2106,2141,12391
1988,621,355184,379065,2669068,2634226,34648,9.232,27125,7.227,519233,181083,338150,6.874,19.711,449741,144107,305634,5.471,17.073,69492,2.638,34.146,20416,20757,95789
1988,622,4412,6281,4062851,4004839,316,5.008,374,5.927,371781,141274,230507,3.528,9.283,257684,129333,128351,3.229,6.434,114097,2.849,12.869,163,173,71392
1988,623,23880,36889,1709189,1677933,5297,14.881,2710,7.613,268878,122916,145962,7.325,16.024,207375,81255,126120,4.843,12.359,61503,3.665,24.718,1634,1697,45394
1988,624,57822,74689,1013133,988894,9677,13.281,6022,8.265,196525,66092,130433,6.683,19.873,148014,40235,107779,4.069,14.968,48511,4.906,29.935,4023,4107,23661
1988,711,21380,21727,254766,250103,5894,28.246,4173,19.999,77614,28269,49345,11.303,31.033,68126,25015,43111,10.002,27.239,9488,3.794,54.478,3102,3111,16751
1988,712,2831,3057,56006,54352,329,11.061,164,5.514,7572,1551,6021,2.854,13.932,4303,966,3337,1.777,7.917,3269,6.015,15.834,110,113,517
1988,713,39235,43330,685445,672058,6965,16.422,5130,12.095,143036,56579,86457,8.419,21.283,116019,45092,70927,6.710,17.263,27017,4.020,34.527,3847,3931,30773
1988,721,37557,43798,1368120,1352022,6177,14.284,5069,11.722,287243,136675,150568,10.109,21.245,256205,122864,133341,9.087,18.950,31038,2.296,37.900,3530,3634,68969
1988,722,278450,368071,6292552,6202928,63357,17.443,53657,14.773,1511240,807812,703428,13.023,24.363,1338908,545469,793439,8.794,21.585,172332,2.778,43.170,37406,38364,340675
1988,811,170130,182305,1081917,1054073,28993,16.102,24500,13.607,258750,115147,143603,10.924,24.548,203703,86232,117471,8.181,19.325,55047,5.222,38.651,18607,18832,63251
1988,812,139879,167541,1104954,1089456,25092,15.184,20526,12.421,243753,118089,125664,10.839,22.374,212656,88927,123729,8.163,19.519,31097,2.854,39.039,14718,15046,58374
1988,813,229863,236922,2021516,1981577,16049,6.945,4391,1.900,291146,63952,227194,3.227,14.693,211436,19442,191994,0.981,10.670,79710,4.023,21.340,2909,2922,12403
1989,211,6919,8421,116763,121392,856,9.980,1168,13.618,16750,4890,11860,4.028,13.798,25956,10118,15838,8.335,21.382,-9206,-7.584,27.597,796,805,3457
1989,212,6091,8451,289775,291964,1015,11.947,1105,13.006,45533,18282,27251,6.262,15.595,49710,20537,29173,7.034,17.026,-4177,-1.431,31.191,750,758,8776
1989,213,7829,8974,160285,161409,1161,12.688,1514,16.546,45213,19447,25766,12.048,28.011,47884,21322,26562,13.210,29.666,-2671,-1.655,56.023,1005,1024,10204
1989,221,6312,12914,767664,765405,860,6.837,189,1.503,41913,14739,27174,1.926,5.476,37689,2864,34825,0.374,4.924,4224,0.552,9.848,63,63,348
1989,236,148744,149947,1372493,1356681,27354,18.433,24261,16.348,391074,125842,265232,9.276,28.826,360328,116492,243836,8.587,26.560,30746,2.266,53.119,17983,18005,86784
1989,237,38098,39178,696828,702114,5312,13.555,5333,13.609,156069,42822,113247,6.099,22.228,166873,44848,122025,6.388,23.767,-10804,-1.539,44.457,4156,4162,27463
1989,238,318102,321322,3126260,3071191,47629,14.942,42487,13.329,807938,222303,585635,7.238,26.307,696942,230200,466742,7.495,22.693,110996,3.614,45.386,32669,32711,172482
1989,311,21628,27026,1383700,1372485,2821,10.457,2722,10.090,172943,48338,124605,3.522,12.601,151366,51418,99948,3.746,11.029,21577,1.572,22.057,1877,1922,22146
1989,312,1833,2343,177269,179919,210,8.870,259,10.940,17221,4669,12552,2.595,9.572,22488,8897,13591,4.945,12.499,-5267,-2.927,19.143,170,170,2281
1989,313,3593,4568,476034,478223,435,9.528,430,9.418,46605,13568,33037,2.837,9.745,51157,15597,35560,3.261,10.697,-4552,-0.952,19.491,256,263,4286
1989,314,7519,7961,255326,252238,1042,13.246,853,10.843,40985,13016,27969,5.160,16.249,34457,12694,21763,5.033,13.661,6528,2.588,27.321,699,703,7047
1989,315,14357,15973,983593,982614,2443,15.264,2508,15.670,156696,57269,99427,5.828,15.947,154729,66898,87831,6.808,15.747,1967,0.200,31.493,2114,2130,42305
1989,316,1808,2024,131154,133794,188,9.175,238,11.615,13355,2026,11329,1.514,9.982,18608,6749,11859,5.044,13.908,-5253,-3.926,19.964,188,189,2716
1989,321,14887,16589,543132,540935,1801,10.866,1772,10.691,81643,24018,57625,4.440,15.093,77071,31059,46012,5.742,14.248,4572,0.845,28.495,1324,1328,14112
1989,322,3731,5733,593877,592205,323,5.618,356,6.192,45953,10011,35942,1.690,7.760,42911,15585,27326,2.632,7.246,3042,0.514,14.492,229,232,5580
1989,323,41607,43545,850287,842518,4754,11.008,4037,9.348,110617,29492,81125,3.500,13.129,94873,34955,59918,4.149,11.261,15744,1.869,22.521,3168,3191,21706
1989,324,1286,2203,158998,168131,170,7.729,163,7.411,9939,3417,6522,2.032,5.911,28367,18955,9412,11.274,16.872,-18428,-10.961,11.823,81,82,489
1989,325,8532,12357,919062,907122,1024,8.294,1002,8.116,92898,24554,68344,2.707,10.241,68930,27063,41867,2.983,7.599,23968,2.642,15.198,562,572,7736
1989,326,12034,14534,892135,875247,1405,9.734,1206,8.355,128624,34512,94112,3.943,14.696,94427,36875,57552,4.213,10.789,34197,3.907,21.577,781,797,12971
1989,327,11647,15267,514488,512848,1403,9.214,1324,8.695,65864,17524,48340,3.417,12.843,62411,21642,40769,4.220,12.170,3453,0.673,24.339,862,871,10200
1989,331,4402,5414,637115,625969,442,8.192,405,7.506,64988,20633,44355,3.296,10.382,42707,17625,25082,2.816,6.823,22281,3.559,13.645,252,256,5483
1989,332,51804,55620,1716753,1691785,5184,9.388,4384,7.939,245116,64240,180876,3.797,14.489,195335,74040,121295,4.376,11.546,49781,2.943,23.092,3259,3298,33038
1989,333,25839,28411,1406326,1385605,2265,8.000,2068,7.304,184208,43855,140353,3.165,13.294,142446,62295,80151,4.496,10.280,41762,3.014,20.561,1453,1459,18861
1989,334,13181,15291,1818725,1817819,1859,12.305,1492,9.876,240115,80792,159323,4.444,13.209,239769,86932,152837,4.782,13.190,346,0.019,26.380,978,986,20338
1989,335,5708,6871,632748,632886,563,8.176,593,8.612,69145,17895,51250,2.828,10.925,68611,32093,36518,5.071,10.841,534,0.084,21.682,365,372,4306
1989,336,9332,11090,1961582,1936500,1145,10.409,966,8.781,245452,99535,145917,5.140,12.675,193714,55029,138685,2.842,10.003,51738,2.672,20.007,656,663,15533
1989,337,17573,18689,613866,615727,2437,13.146,2134,11.512,83071,26863,56208,4.363,13.492,87031,34811,52220,5.654,14.135,-3960,-0.643,26.983,1647,1667,17340
1989,339,26575,27615,686667,674657,3362,12.275,2909,10.621,109886,31188,78698,4.623,16.288,85863,36419,49444,5.398,12.727,24023,3.561,25.454,2187,2188,15550
1989,423,171132,221567,2848918,2802698,24909,11.303,22544,10.229,524984,174117,350867,6.212,18.731,432176,187923,244253,6.705,15.420,92808,3.311,30.840,14833,15367,87471
1989,424,100025,127786,1956340,1933327,14299,11.223,13554,10.638,334820,106005,228815,5.483,17.318,288383,115907,172476,5.995,14.916,46437,2.402,29.833,9610,9826,64096
1989,425,31868,34443,313664,310297,3759,11.005,3187,9.330,56638,17880,38758,5.762,18.253,49857,20479,29378,6.600,16.068,6781,2.185,32.135,2161,2172,11014
1989,441,97681,124765,1653635,1638721,11290,9.022,12032,9.615,252819,93013,159806,5.676,15.428,222987,91267,131720,5.569,13.607,29832,1.820,27.215,8866,9219,67409
1989,442,45179,58031,440578,433464,7000,12.153,6133,10.648,88207,33519,54688,7.733,20.349,74225,28102,46123,6.483,17.124,13982,3.226,34.247,4453,4735,19256
1989,443,22748,32185,234947,222536,5833,18.812,3477,11.214,63199,32740,30459,14.712,28.399,38096,16086,22010,7.228,17.119,25103,11.280,34.238,2418,2573,10389
1989,444,71796,92269,957794,948013,8224,8.951,7442,8.100,153857,57371,96486,6.052,16.229,134868,43958,90910,4.637,14.226,18989,2.003,28.453,5341,5499,27978
1989,445,110613,152512,2705984,2639476,18004,11.762,19107,12.483,460041,209570,250471,7.940,17.429,329370,145441,183929,5.510,12.479,130671,4.951,24.957,13548,13927,75038
1989,446,48542,77201,742743,727540,7675,10.030,6319,8.258,136467,57769,78698,7.940,18.757,106837,41122,65715,5.652,14.685,29630,4.073,29.369,3999,4176,22194
1989,447,85404,137669,984143,970139,14695,10.679,14559,10.581,213812,91936,121876,9.477,22.039,185022,79139,105883,8.157,19.072,28790,2.968,38.143,9182,9744,48019
1989,448,84680,173082,1358076,1342964,22359,13.018,19701,11.471,293494,131337,162157,9.780,21.854,265171,100129,165042,7.456,19.745,28323,2.109,39.490,11209,12379,51690
1989,451,41702,57146,415533,407138,8372,14.887,6553,11.653,88880,43286,45594,10.632,21.830,71412,28420,42992,6.980,17.540,17468,4.290,35.080,4769,4952,17597
1989,452,11610,34589,2103341,2087602,3367,9.816,2790,8.134,280993,125597,155396,6.016,13.460,254078,62223,191855,2.981,12.171,26915,1.289,24.342,1441,1550,13291
1989,453,90132,105412,600905,585416,16713,16.086,13686,13.172,142458,61581,80877,10.519,24.334,111788,48825,62963,8.340,19.095,30670,5.239,38.191,10072,10876,36149
1989,454,26576,35024,415171,414533,4343,12.554,3483,10.068,75130,28532,46598,6.883,18.124,73420,21807,51613,5.261,17.711,1710,0.413,35.423,2428,2497,12694
1989,481,1551,3669,417652,421497,480,13.795,101,2.903,52727,9159,43568,2.173,12.509,61115,2584,58531,0.613,14.500,-8388,-1.990,25.019,22,22,67
1989,483,647,973,45096,44510,148,15.489,113,11.826,8470,2581,5889,5.799,19.029,7232,2393,4839,5.376,16.248,1238,2.781,32.496,59,60,752
1989,484,68715,80071,1157303,1143582,12812,16.093,11895,14.941,231428,75531,155897,6.605,20.237,203276,92783,110493,8.113,17.775,28152,2.462,35.551,9066,9165,51013
1989,485,10816,11745,248362,236522,1991,18.360,189,1.743,44277,17095,27182,7.228,18.720,20410,1227,19183,0.519,8.629,23867,10.091,17.258,142,142,561
1989,486,348,2111,71481,71540,296,14.859,58,2.912,10033,4241,5792,5.928,14.024,10133,692,9441,0.967,14.164,-100,-0.140,28.049,7,8,264
1989,487,1108,1138,14343,13635,231,21.125,142,12.986,3850,1744,2106,12.791,28.236,2535,863,1672,6.329,18.592,1315,9.644,37.184,103,105,700
1989,488,13775,17626,306063,296065,3047,17.959,1727,10.179,66892,23471,43421,7.928,22.594,47452,15206,32246,5.136,16.028,19440,6.566,32.055,1142,1236,9681
1989,492,5163,7914,402887,380409,1226,15.795,922,11.878,85528,28382,57146,7.461,22.483,41062,11436,29626,3.006,10.794,44466,11.689,21.588,741,751,4483
1989,493,6320,10046,421337,414091,1164,11.703,965,9.702,79988,36079,43909,8.713,19.317,66255,20200,46055,4.878,16.000,13733,3.316,32.000,400,408,3303
1989,511,17917,20892,764686,752303,3284,16.088,2325,11.390,99498,34822,64676,4.629,13.226,75076,30883,44193,4.105,9.979,24422,3.246,19.959,1725,1749,15161
1989,512,11814,16233,225221,237739,2664,16.377,2731,16.789,52032,20214,31818,8.503,21.886,75569,24286,51283,10.215,31.787,-23537,-9.900,43.772,1549,1632,9315
1989,515,6302,7951,252397,241197,1100,14.792,71,0.955,42605,21320,21285,8.839,17.664,19765,1085,18680,0.450,8.195,22840,9.469,16.389,36,36,161
1989,517,6079,26133,1091077,1057187,4748,19.804,432,1.802,195058,63594,131464,6.015,18.451,125660,7074,118586,0.669,11.886,69398,6.564,23.773,224,232,1723
1989,518,5455,7611,274801,272047,1352,18.129,1045,14.013,56739,22036,34703,8.100,20.856,51284,21082,30202,7.749,18.851,5455,2.005,37.702,625,632,6385
1989,519,2643,3104,38930,37697,415,13.710,261,8.622,6284,2262,4022,6.000,16.670,3893,1334,2559,3.539,10.327,2391,6.343,20.654,203,203,961
1989,521,47,85,25420,24950,6,7.273,(D),(D),1301,82,1219,0.329,5.214,371,(D),368,(D),1.487,930,3.727,2.974,0,0,0
1989,522,43919,124357,2591999,2529978,12060,10.120,1686,1.415,396522,157779,238743,6.236,15.673,272583,14256,258327,0.563,10.774,123939,4.899,21.548,743,744,5704
1989,523,22043,30671,511798,496160,5696,20.215,709,2.516,117946,54830,63116,11.051,23.772,88049,8607,79442,1.735,17.746,29897,6.026,35.492,490,490,2186
1989,524,108940,145907,2180240,2065557,26202,19.388,4672,3.457,425996,195236,230760,9.452,20.624,204903,19816,185087,0.959,9.920,221093,10.704,19.840,1201,1201,5430
1989,525,2154,2384,25694,24532,221,9.659,29,1.267,6842,3375,3467,13.758,27.890,4570,106,4464,0.432,18.629,2272,9.261,37.257,14,14,44
1989,531,161802,170808,1122187,1060800,26401,16.536,4099,2.567,260702,114811,145891,10.823,24.576,138342,16067,122275,1.515,13.041,122360,11.535,26.083,3335,3359,11084
1989,532,37972,53114,471218,455773,8805,16.798,7411,14.139,126422,49824,76598,10.932,27.738,95546,39556,55990,8.679,20.964,30876,6.774,41.927,5152,5493,25732
1989,533,1009,1056,14385,13042,237,24.830,34,3.562,4236,1380,2856,10.581,32.480,1513,170,1343,1.303,11.601,2723,20.879,23.202,20,20,85
1989,541,412211,442851,4525152,4384349,66567,15.296,51239,11.774,985908,356206,629702,8.124,22.487,706153,295098,411055,6.731,16.106,279755,6.381,32.212,38356,38765,165728
1989,551,26500,49590,3159336,3093660,6859,14.309,3546,7.398,620752,242372,378380,7.834,20.065,492494,107605,384889,3.478,15.919,128258,4.146,31.839,559,586,9903
1989,561,184388,210206,4049082,3878646,39797,19.597,25532,12.573,1134384,410908,723476,10.594,29.247,796900,269014,527886,6.936,20.546,337484,8.701,41.092,19529,19771,163955
1989,562,9996,11280,171271,159883,1836,17.085,769,7.156,42537,14094,28443,8.815,26.605,20002,5632,14370,3.523,12.510,22535,14.095,25.021,587,588,3892
1989,611,36584,40768,1746048,1704219,5118,12.900,2929,7.383,199686,42938,156748,2.520,11.717,115871,17565,98306,1.031,6.799,83815,4.918,13.598,2181,2238,12740
1989,621,359952,385744,2836945,2752756,33921,8.872,27114,7.092,553796,183956,369840,6.683,20.118,383933,130886,253047,4.755,13.947,169863,6.171,27.894,20975,21400,90190
1989,622,4128,6066,4154962,4093904,288,4.716,369,6.043,290131,75173,214958,1.836,7.087,166946,81824,85122,1.999,4.078,123185,3.009,8.156,215,220,39440
1989,623,24923,39301,1813961,1762372,5209,13.665,2848,7.471,291011,126629,164382,7.185,16.512,187554,86936,100618,4.933,10.642,103457,5.870,21.284,1733,1868,53108
1989,624,60635,78597,1083282,1049964,9984,13.019,6166,8.040,200279,67874,132405,6.464,19.075,133770,38330,95440,3.651,12.740,66509,6.334,25.481,4384,4466,25118
1989,711,23548,23882,269085,264101,6015,26.206,4156,18.107,76295,30582,45713,11.580,28.889,65378,20838,44540,7.890,24.755,10917,4.134,49.510,3075,3089,14410
1989,712,2956,3224,60822,58408,314,9.995,149,4.743,9033,1181,7852,2.022,15.465,4143,647,3496,1.108,7.093,4890,8.372,14.187,115,116,529
1989,713,39495,43844,725527,705871,6233,14.321,5591,12.846,147748,50189,97559,7.110,20.931,108423,42782,65641,6.061,15.360,39325,5.571,30.720,4383,4479,32489
1989,721,37950,44627,1450462,1410791,5881,13.300,5060,11.444,290974,137566,153408,9.751,20.625,213274,105828,107446,7.501,15.117,77700,5.508,30.235,3639,3724,64627
1989,722,283773,377320,6502807,6399429,61906,16.608,52763,14.155,1470783,769680,701103,12.027,22.983,1261023,555435,705588,8.679,19.705,209760,3.278,39.410,38370,39644,359103
1989,811,174628,187782,1155509,1119305,28952,15.643,23541,12.720,275674,124998,150676,11.167,24.629,203568,90074,113494,8.047,18.187,72106,6.442,36.374,18047,18360,66600
1989,812,141750,171452,1141386,1122359,25631,15.140,21318,12.592,254292,122075,132217,10.877,22.657,216491,93114,123377,8.296,19.289,37801,3.368,38.578,16154,16775,65893
1989,813,233933,241295,2102116,2048250,15745,6.674,4982,2.112,299392,59788,239604,2.919,14.617,192748,21059,171689,1.028,9.410,106644,5.207,18.821,3296,3348,13519
1990,211,6830,8251,120068,118233,873,10.475,1040,12.478,21778,8843,12935,7.479,18.420,18196,6047,12149,5.114,15.390,3582,3.030,30.780,666,679,3037
1990,212,5937,8364,290209,288930,921,10.951,1013,12.045,46883,15809,31074,5.472,16.226,44464,17753,26711,6.144,15.389,2419,0.837,30.778,692,700,7551
1990,213,7882,8938,166948,164032,1265,14.104,1327,14.795,39598,10142,29456,6.183,24.140,33398,15391,18007,9.383,20.361,6200,3.780,40.721,871,882,6639
1990,221,6400,13151,773002,766195,921,7.228,104,0.816,48198,16355,31843,2.135,6.291,34952,1218,33734,0.159,4.562,13246,1.729,9.124,88,88,896
1990,236,152756,153923,1395329,1382024,28616,18.828,24741,16.279,387868,125755,262113,9.099,28.065,360741,116035,244706,8.396,26.102,27127,1.963,52.205,18348,18360,88582
1990,237,37906,39005,731040,713594,5054,12.925,5250,13.426,183541,38403,145138,5.382,25.721,148188,41835,106353,5.863,20.766,35353,4.954,41.533,4100,4107,29934
1990,238,323756,326974,3184088,3156689,47971,14.801,42240,13.033,796802,222315,574487,7.043,25.242,742676,228424,514252,7.236,23.527,54126,1.715,47.054,32568,32610,180279
1990,311,21526,26825,1389238,1384023,2683,10.006,2662,9.927,153124,36489,116635,2.636,11.064,142677,43123,99554,3.116,10.309,10447,0.755,20.618,1896,1924,21745
1990,312,1833,2310,177334,176077,216,9.363,210,9.103,22572,11372,11200,6.459,12.819,20098,7723,12375,4.386,11.414,2474,1.405,22.829,142,143,1463
1990,313,3725,4702,463131,469510,480,10.347,354,7.631,43002,15783,27219,3.362,9.159,55783,17246,38537,3.673,11.881,-12781,-2.722,18.318,246,248,5537
1990,314,7504,7956,255764,255403,1003,12.608,1002,12.595,40670,18850,21820,7.381,15.924,40635,17130,23505,6.707,15.910,35,0.014,31.820,828,833,9354
1990,315,14350,15922,930310,955358,2473,15.511,2516,15.781,129990,52509,77481,5.496,13.606,180852,68457,112395,7.166,18.930,-50862,-5.324,27.213,2071,2098,42717
1990,316,1747,1957,125996,128328,175,8.792,242,12.158,12384,3082,9302,2.402,9.650,17156,5786,11370,4.509,13.369,-4772,-3.719,19.301,184,190,3178
1990,321,14785,16522,533616,538995,1660,10.025,1732,10.460,64563,19474,45089,3.613,11.978,75685,24495,51190,4.545,14.042,-11122,-2.063,23.957,1329,1335,15326
1990,322,3697,5759,598814,595862,335,5.835,300,5.225,44415,13645,30770,2.290,7.454,38464,10957,27507,1.839,6.455,5951,0.999,12.910,198,198,3539
1990,323,42086,44086,852733,850788,4508,10.289,3966,9.052,102616,30629,71987,3.600,12.061,99107,34690,64417,4.077,11.649,3509,0.412,23.298,3222,3230,22838
1990,324,1287,2210,157800,158209,169,7.677,152,6.904,8022,1713,6309,1.083,5.071,8862,1793,7069,1.133,5.601,-840,-0.531,10.141,82,82,686
1990,325,8647,12520,928701,925873,1029,8.267,883,7.094,78366,20099,58267,2.171,8.464,72095,19254,52841,2.080,7.787,6271,0.677,15.573,539,542,6780
1990,326,12155,14729,880836,886487,1320,9.027,1106,7.564,97903,29933,67970,3.377,11.044,109019,31396,77623,3.542,12.298,-11116,-1.254,22.088,766,772,11757
1990,327,11725,15531,511865,513089,1463,9.497,1210,7.855,61445,19377,42068,3.777,11.976,63727,16542,47185,3.224,12.420,-2282,-0.445,23.951,811,825,7636
1990,331,4457,5483,615323,625416,420,7.706,354,6.495,37104,11856,25248,1.896,5.933,57664,15168,42496,2.425,9.220,-20560,-3.287,11.865,232,233,4105
1990,332,52408,56241,1677837,1697218,4759,8.506,4172,7.457,183500,52357,131143,3.085,10.812,222041,66480,155561,3.917,13.083,-38541,-2.271,21.624,3208,3220,30443
1990,333,25919,28501,1398123,1400039,2052,7.214,1939,6.817,144596,40014,104582,2.858,10.328,147714,41128,106586,2.938,10.551,-3118,-0.223,20.656,1429,1434,15363
1990,334,13554,15675,1770128,1792798,1770,11.428,1396,9.013,190380,65705,124675,3.665,10.619,235793,70601,165192,3.938,13.152,-45413,-2.533,21.238,929,933,12513
1990,335,5696,6864,613407,622570,509,7.408,522,7.598,53432,16047,37385,2.578,8.582,71589,15950,55639,2.562,11.499,-18157,-2.916,17.165,357,364,5129
1990,336,9417,11205,1910861,1949194,1099,9.866,968,8.690,163436,62746,100690,3.219,8.385,238828,59714,179114,3.064,12.253,-75392,-3.868,16.770,723,727,11814
1990,337,17669,18745,597785,605235,2343,12.516,2292,12.244,74227,24970,49257,4.126,12.264,88750,29434,59316,4.863,14.664,-14523,-2.400,24.528,1816,1839,18881
1990,339,26851,27961,692033,687638,3342,12.043,2922,10.529,96577,32834,63743,4.775,14.045,87841,25754,62087,3.745,12.774,8736,1.270,25.549,2331,2334,14811
1990,423,172279,224251,2887875,2864797,24279,10.897,21398,9.604,467766,155191,312575,5.417,16.328,422012,160293,261719,5.595,14.731,45754,1.597,29.462,14669,15188,90625
1990,424,100243,128510,2014059,1985963,14073,10.979,13419,10.469,334932,113756,221176,5.728,16.865,279594,104924,174670,5.283,14.079,55338,2.786,28.157,9624,9871,63533
1990,425,32486,35150,322661,320485,3829,11.008,3094,8.895,57416,19704,37712,6.148,17.915,52541,16495,36046,5.147,16.394,4875,1.521,32.788,2207,2222,10720
1990,441,96083,123217,1607805,1631034,10641,8.583,12156,9.805,208784,82122,126662,5.035,12.801,254355,98563,155792,6.043,15.595,-45571,-2.794,25.601,8920,9301,74906
1990,442,45023,58270,440437,440281,6506,11.195,6193,10.657,80778,32183,48595,7.310,18.347,80704,28213,52491,6.408,18.330,74,0.017,36.660,4543,4885,20690
1990,443,23856,34105,251343,243458,5863,17.684,3961,11.947,62938,32190,30748,13.222,25.852,47149,19342,27807,7.945,19.366,15789,6.485,38.733,2608,2852,12935
1990,444,71631,92361,968934,963055,7442,8.060,7374,7.987,144436,48191,96245,5.004,14.998,133193,41843,91350,4.345,13.830,11243,1.167,27.661,5433,5653,27918
1990,445,109081,151163,2800186,2755299,17805,11.727,19133,12.602,444900,198918,245982,7.219,16.147,354206,153695,200511,5.578,12.855,90694,3.292,25.711,13460,13785,73348
1990,446,48583,78401,752094,748293,7986,10.260,6851,8.802,117930,57080,60850,7.628,15.760,110629,43374,67255,5.796,14.784,7301,0.976,29.568,4242,4411,22598
1990,447,83257,136300,979929,981990,13054,9.530,14402,10.514,187756,81157,106599,8.265,19.120,191773,78278,113495,7.971,19.529,-4017,-0.409,38.240,9541,10065,50529
1990,448,82745,172999,1375720,1367823,20102,11.614,20282,11.718,277559,121219,156340,8.862,20.292,259698,101179,158519,7.397,18.986,17861,1.306,37.972,11575,13004,53863
1990,451,42225,58259,436292,426083,7479,12.954,6435,11.145,91030,35044,55986,8.225,21.364,70996,25390,45606,5.959,16.663,20034,4.702,33.325,4885,5122,18191
1990,452,11439,34977,2161136,2132818,3203,9.208,2820,8.107,257207,102035,155172,4.784,12.059,202542,42989,159553,2.016,9.496,54665,2.563,18.993,1416,1486,9609
1990,453,92243,108319,636505,619562,16297,15.237,13576,12.693,150871,68724,82147,11.092,24.351,117464,49358,68106,7.967,18.959,33407,5.392,37.918,10471,10897,37633
1990,454,27015,35778,431680,423373,4227,11.936,3500,9.883,77336,25571,51765,6.040,18.267,60467,20667,39800,4.882,14.282,16869,3.984,28.564,2609,2656,13460
1990,481,1590,3830,469000,432115,567,15.898,40,1.122,94735,19159,75576,4.434,21.924,19841,701,19140,0.162,4.592,74894,17.332,9.183,22,22,345
1990,483,650,969,45359,44896,130,13.492,119,12.351,7744,2426,5318,5.404,17.249,6734,2576,4158,5.738,14.999,1010,2.250,29.999,69,76,1294
1990,484,68976,80462,1173164,1168405,12423,15.481,11990,14.942,224051,73500,150551,6.291,19.176,216209,79372,136837,6.793,18.505,7842,0.671,37.009,9308,9433,54492
1990,485,10905,11840,264800,253251,1699,15.259,288,2.587,46360,16481,29879,6.508,18.306,23537,1190,22347,0.470,9.294,22823,9.012,18.588,241,241,1036
1990,486,353,2112,70014,70358,136,6.645,5,0.244,6446,1535,4911,2.182,9.162,7087,381,6706,0.542,10.073,-641,-0.911,18.324,3,3,354
1990,487,1192,1228,16971,15420,267,22.928,140,12.022,5469,1732,3737,11.233,35.468,2463,683,1780,4.429,15.973,3006,19.495,31.947,108,108,538
1990,488,14753,18647,323857,312800,3245,18.070,1866,10.391,69077,24011,45066,7.676,22.083,46815,16042,30773,5.129,14.966,22262,7.117,29.933,1294,1308,8616
1990,492,5212,8098,418579,406870,1259,15.923,877,11.091,53349,17288,36061,4.249,13.112,29434,7793,21641,1.915,7.234,23915,5.878,14.469,716,727,4954
1990,493,6466,10328,435109,428217,1093,10.727,816,8.008,74883,28800,46083,6.726,17.487,60683,16041,44642,3.746,14.171,14200,3.316,28.342,390,403,3897
1990,511,18569,21815,798454,781007,3334,15.606,2430,11.375,108325,38762,69563,4.963,13.870,73643,29190,44453,3.737,9.429,34682,4.441,18.858,1858,1878,14902
1990,512,11922,16619,261860,242995,2792,17.021,2361,14.393,84637,29142,55495,11.993,34.831,46360,22929,23431,9.436,19.079,38277,15.752,38.157,1543,1582,10444
1990,515,6415,8051,252139,244467,1052,13.923,62,0.821,36848,17172,19676,7.024,15.073,21834,329,21505,0.135,8.931,15014,6.142,17.863,52,52,239
1990,517,6381,26191,1107462,1083606,2903,11.645,380,1.524,141827,46916,94911,4.330,13.088,94686,2577,92109,0.238,8.738,47141,4.350,17.476,336,336,2155
1990,518,5501,7740,291145,283059,1243,16.176,1131,14.719,62021,26688,35333,9.428,21.911,45321,18976,26345,6.704,16.011,16700,5.900,32.022,623,632,5591
1990,519,2678,3067,37134,37952,311,10.109,330,10.726,5327,2010,3317,5.296,14.036,6788,4491,2297,11.833,17.886,-1461,-3.850,28.072,206,206,1079
1990,521,48,83,25188,25341,3,3.681,0,0.000,575,30,545,0.118,2.269,877,0,877,0.000,3.461,-302,-1.192,4.538,0,0,0
1990,522,43972,126865,2659986,2583806,11665,9.587,1285,1.056,406573,153670,252903,5.947,15.735,254929,11329,243600,0.438,9.866,151644,5.869,19.733,1079,1082,9054
1990,523,22551,33432,516894,495341,7273,24.070,842,2.787,128135,54320,73815,10.966,25.868,83413,4890,78523,0.987,16.840,44722,9.029,33.679,693,693,3523
1990,524,111222,149785,2321878,2247857,18625,13.148,2374,1.676,389805,139421,250384,6.202,17.341,241234,17085,224149,0.760,10.732,148571,6.609,21.463,1801,1802,9819
1990,525,2248,2460,38105,33243,294,12.618,34,1.459,12031,2812,9219,8.459,36.192,2733,188,2545,0.566,8.221,9298,27.970,16.443,21,21,102
1990,531,163625,173485,1158176,1101407,25744,15.687,6995,4.262,267429,124814,142615,11.332,24.281,154361,22889,131472,2.078,14.015,113068,10.266,28.030,5860,5862,18649
1990,532,37732,53746,495684,483276,8031,15.039,7340,13.745,117459,48041,69418,9.941,24.305,93068,37263,55805,7.711,19.258,24391,5.047,38.516,5286,5636,28835
1990,533,1046,1120,17640,16185,230,22.505,34,3.327,4866,1378,3488,8.514,30.066,1836,245,1591,1.514,11.344,3030,18.722,22.688,28,28,233
1990,541,424031,456210,4765355,4647529,66176,14.757,50633,11.291,938732,333323,605409,7.172,20.199,705150,251896,453254,5.420,15.173,233582,5.026,30.345,38525,38853,173422
1990,551,27566,51802,3233682,3180213,6867,13.690,3581,7.139,556198,187683,368515,5.902,17.489,448395,94731,353664,2.979,14.100,107803,3.390,28.199,625,651,8721
1990,561,192790,220113,4361880,4207993,39835,18.650,26795,12.545,1167661,409730,757931,9.737,27.749,860222,283929,576293,6.747,20.443,307439,7.306,40.885,20461,20771,173186
1990,562,10400,11785,187463,176910,1797,15.863,884,7.803,43768,14098,29670,7.969,24.740,22763,5924,16839,3.349,12.867,21005,11.873,25.734,726,727,4616
1990,611,38230,42602,1818846,1772545,5481,13.265,2918,7.062,209157,54704,154453,3.086,11.800,116447,18121,98326,1.022,6.569,92710,5.230,13.139,2170,2211,12192
1990,621,365159,392847,3042781,2944833,32857,8.441,25664,6.593,566255,178792,387463,6.071,19.229,369074,128954,240120,4.379,12.533,197181,6.696,25.066,20264,20612,88859
1990,622,4143,6158,4313467,4250432,241,3.926,203,3.307,262510,51053,211457,1.201,6.176,136458,48232,88226,1.135,3.210,126052,2.966,6.421,99,116,24025
1990,623,26063,41431,1896919,1857516,5019,12.419,2982,7.379,271702,110163,161539,5.931,14.627,193829,84772,109057,4.564,10.435,77873,4.192,20.870,1717,1823,40080
1990,624,63551,83067,1157137,1121076,10721,13.251,6407,7.919,205786,69417,136369,6.192,18.356,133573,38435,95138,3.428,11.915,72213,6.441,23.829,4741,4838,26846
1990,711,23274,23642,295385,281714,4312,18.228,4339,18.342,81838,23599,58239,8.377,29.050,54867,22769,32098,8.082,19.476,26971,9.574,38.952,3395,3404,16377
1990,712,3068,3334,63464,62103,321,9.791,210,6.405,7784,1681,6103,2.707,12.534,5053,838,4215,1.349,8.137,2731,4.398,16.273,144,147,611
1990,713,40109,44362,757232,741227,6178,14.001,5707,12.933,144954,51486,93468,6.946,19.556,112248,42915,69333,5.790,15.144,32706,4.412,30.287,4295,4375,31881
1990,721,38109,45085,1492003,1472118,5408,12.056,4955,11.046,265798,115483,150315,7.845,18.055,224688,99290,125398,6.745,15.263,41110,2.793,30.526,3536,3639,63340
1990,722,287581,384070,6656203,6579452,60487,15.888,53786,14.127,1432989,753467,679522,11.452,21.780,1280534,548467,732067,8.336,19.463,152455,2.317,38.925,39349,40447,360481
1990,811,179144,193179,1192770,1177383,28362,14.884,23113,12.129,252789,107188,145601,9.104,21.470,222150,89931,132219,7.638,18.868,30639,2.602,37.736,18201,18418,68310
1990,812,142081,172138,1162445,1153404,23733,13.840,22412,13.070,240357,107280,133077,9.301,20.839,222284,94934,127350,8.231,19.272,18073,1.567,38.544,16781,17267,64841
1990,813,237975,245496,2174562,2128490,15584,6.479,5630,2.341,300954,60536,240418,2.844,14.139,208586,23487,185099,1.103,9.800,92368,4.340,19.599,3832,3845,15413
1991,211,6894,8264,116552,117222,940,11.310,1034,12.441,19046,8110,10936,6.918,16.248,20504,8444,12060,7.203,17.492,-1458,-1.244,32.496,664,676,3209
1991,212,5789,8223,276263,283361,832,9.972,1072,12.849,36987,14040,22947,4.955,13.053,50962,18581,32381,6.557,17.985,-13975,-4.932,26.106,696,703,9138
1991,213,8619,9698,182233,177979,1314,13.660,1156,12.018,45344,16524,28820,9.284,25.477,36779,15198,21581,8.539,20.665,8565,4.812,41.330,824,833,7441
1991,221,6524,13897,774448,770728,1276,9.578,126,0.946,56512,26138,30374,3.391,7.332,48989,1283,47706,0.166,6.356,7523,0.976,12.712,102,102,346
1991,236,150849,152010,1228471,1313838,25126,16.361,28257,18.399,275280,93937,181343,7.150,20.952,446543,136691,309852,10.404,33.988,-171263,-13.035,41.905,19857,19872,100172
1991,237,37365,38494,677824,708638,4237,10.787,5806,14.782,132403,31774,100629,4.484,18.684,194386,48212,146174,6.803,27.431,-61983,-8.747,37.368,4427,4442,35743
1991,238,322760,326063,2843939,3025186,42060,12.795,47382,14.414,594203,180649,413554,5.972,19.642,957850,261652,696198,8.649,31.663,-363647,-12.021,39.284,34598,34648,198096
1991,311,21788,27023,1393889,1393791,2444,9.020,2590,9.559,157736,39512,118224,2.835,11.317,156681,57604,99077,4.133,11.241,1055,0.076,22.483,1826,1856,31997
1991,312,1824,2284,173148,174389,152,6.576,207,8.955,13986,1882,12104,1.079,8.020,16372,3820,12552,2.191,9.388,-2386,-1.368,16.040,151,152,1694
1991,313,3859,4847,436321,447947,522,10.850,450,9.354,35343,12887,22456,2.877,7.890,58175,16125,42050,3.600,12.987,-22832,-5.097,15.780,303,307,9297
1991,314,7352,7774,233385,244608,828,10.484,1075,13.612,27407,8519,18888,3.483,11.204,49827,18206,31621,7.443,20.370,-22420,-9.166,22.409,867,882,9910
1991,315,14445,15922,872231,902725,2504,15.622,2717,16.951,125920,47838,78082,5.299,13.949,187029,82700,104329,9.161,20.718,-61109,-6.769,27.898,2196,2232,51825
1991,316,1734,1935,112922,118717,167,8.497,228,11.600,9659,3381,6278,2.848,8.136,21525,6951,14574,5.855,18.131,-11866,-9.995,16.272,174,176,4142
1991,321,14757,16443,467823,500703,1561,9.404,1875,11.295,44595,15156,29439,3.027,8.906,110161,35291,74870,7.048,22.001,-65566,-13.095,17.813,1390,1398,21075
1991,322,3695,5719,583879,591006,280,4.853,381,6.604,36272,8351,27921,1.413,6.137,50548,20919,29629,3.540,8.553,-14276,-2.416,12.275,230,231,7048
1991,323,42541,44500,817687,834325,4059,9.100,4268,9.569,85127,26574,58553,3.185,10.203,118082,46094,71988,5.525,14.153,-32955,-3.950,20.406,3423,3437,31906
1991,324,1316,2273,152896,155683,162,7.132,159,7.000,7516,1696,5820,1.089,4.828,13091,2957,10134,1.899,8.409,-5575,-3.581,9.656,80,86,1268
1991,325,8847,12728,919773,923135,899,7.033,1008,7.886,74553,19736,54817,2.138,8.076,80893,29286,51607,3.172,8.763,-6340,-0.687,16.152,619,632,11466
1991,326,12325,14953,832068,856571,1254,8.410,1169,7.840,79136,24452,54684,2.855,9.239,128154,37532,90622,4.382,14.961,-49018,-5.723,18.477,840,857,19990
1991,327,11478,15436,463278,487797,1216,7.819,1446,9.298,41291,15258,26033,3.128,8.465,90462,25064,65398,5.138,18.545,-49171,-10.080,16.930,940,958,13429
1991,331,4416,5433,579186,597494,311,5.652,449,8.161,30713,9251,21462,1.548,5.140,67057,20175,46882,3.377,11.223,-36344,-6.083,10.281,319,323,10256
1991,332,52201,56009,1570273,1626493,3989,7.073,4774,8.464,149172,40942,108230,2.517,9.171,261173,82986,178187,5.102,16.057,-112001,-6.886,18.343,3648,3671,52596
1991,333,26400,28981,1317311,1358136,1922,6.606,2151,7.393,111931,33619,78312,2.475,8.242,194257,61077,133180,4.497,14.303,-82326,-6.062,16.483,1562,1572,31295
1991,334,14045,16064,1648868,1708117,1541,9.549,1688,10.460,154505,52710,101795,3.086,9.045,273374,101200,172174,5.925,16.004,-118869,-6.959,18.091,1157,1176,35987
1991,335,5747,6873,567063,590637,434,6.230,621,8.914,38453,9446,29007,1.599,6.510,85718,29663,56055,5.022,14.513,-47265,-8.002,13.021,403,405,10410
1991,336,9541,11300,1762261,1836650,912,8.006,1094,9.604,141149,64715,76434,3.524,7.685,290415,56007,234408,3.049,15.812,-149266,-8.127,15.370,782,794,18695
1991,337,17171,18202,535042,566630,1976,10.724,2423,13.150,54278,19231,35047,3.394,9.579,117661,41209,76452,7.273,20.765,-63383,-11.186,19.158,1872,1886,27473
1991,339,26109,27222,660083,675353,2815,10.289,3087,11.284,79027,21611,57416,3.200,11.702,109239,42771,66468,6.333,16.175,-30212,-4.474,23.403,2445,2453,22407
1991,423,163418,216214,2699281,2753215,23968,11.093,23650,10.946,406569,156175,250394,5.672,14.767,515973,201382,314591,7.314,18.741,-109404,-3.974,29.534,15640,16185,117151
1991,424,97978,126535,1938145,1958024,13970,11.014,14576,11.492,285170,101240,183930,5.171,14.564,326217,131512,194705,6.717,16.661,-41047,-2.096,29.128,10108,10346,79681
1991,425,31784,34430,301453,308288,3798,11.092,3417,9.980,46256,16437,29819,5.332,15.004,60016,21538,38478,6.986,19.468,-13760,-4.463,30.008,2284,2294,13451
1991,441,89365,116634,1476560,1528947,9641,8.160,12680,10.732,177019,72395,104624,4.735,11.578,281330,115339,165991,7.544,18.400,-104311,-6.822,23.156,9397,9742,92122
1991,442,41904,55719,404223,416479,6557,11.737,6847,12.257,68304,30465,37839,7.315,16.400,92803,32284,60519,7.752,22.283,-24499,-5.882,32.801,4758,5098,22759
1991,443,24009,35268,255855,252850,5862,17.017,4222,12.256,57275,29270,28005,11.576,22.652,50726,21109,29617,8.348,20.062,6549,2.590,40.123,2860,3025,13833
1991,444,67638,88416,907301,928432,6596,7.401,8009,8.987,117772,42663,75109,4.595,12.685,160433,55351,105082,5.962,17.280,-42661,-4.595,25.370,5671,5864,35456
1991,445,106498,147111,2749599,2771629,15592,10.457,19583,13.134,359689,171328,188361,6.181,12.978,404395,153668,250727,5.544,14.591,-44706,-1.613,25.955,13061,13458,84173
1991,446,49549,79606,781761,777747,6470,8.078,7449,9.300,122611,45279,77332,5.822,15.765,113473,47632,65841,6.124,14.590,9138,1.175,29.180,4584,4774,26111
1991,447,79863,133285,939555,961401,12718,9.428,15931,11.810,171876,77608,94268,8.072,17.878,214869,86976,127893,9.047,22.350,-42993,-4.472,35.755,9900,10416,53276
1991,448,78630,168408,1345268,1357765,17945,10.528,22016,12.917,256625,117247,139378,8.635,18.901,281476,113772,167704,8.379,20.731,-24851,-1.830,37.801,11623,13497,58155
1991,451,42869,59633,440816,442630,7167,12.035,7008,11.768,83975,37361,46614,8.441,18.972,86892,31732,55160,7.169,19.631,-2917,-0.659,37.944,5195,5435,21356
1991,452,11645,35133,2118816,2151052,2866,8.091,3448,9.734,208178,103842,104336,4.827,9.678,278573,69832,208741,3.246,12.951,-70395,-3.273,19.356,1460,1596,10151
1991,453,95482,112217,635068,643896,14851,13.237,14796,13.188,128825,57614,71211,8.948,20.007,146865,57220,89645,8.887,22.809,-18040,-2.802,40.014,11287,11620,42140
1991,454,27257,35959,419363,425574,4183,11.604,4360,12.095,71437,26324,45113,6.186,16.786,83539,34781,48758,8.173,19.630,-12102,-2.844,33.572,2907,3041,19579
1991,481,1633,4217,488659,472182,789,20.555,32,0.834,76565,14779,61786,3.130,16.215,43206,153,43053,0.032,9.150,33359,7.065,18.301,27,27,132
1991,483,666,1005,50972,47927,137,13.783,115,11.569,12764,4426,8338,9.235,26.632,6532,3167,3365,6.608,13.629,6232,13.003,27.258,65,68,1689
1991,484,67962,79010,1106766,1139070,11481,14.392,13008,16.306,186836,64759,122077,5.685,16.403,251679,108663,143016,9.540,22.095,-64843,-5.693,32.805,9444,9587,70605
1991,485,10763,12247,264747,255777,2250,19.948,315,2.793,56921,33338,23583,13.034,22.254,38858,1441,37417,0.563,15.192,18063,7.062,30.384,262,263,1179
1991,486,364,2178,69841,67707,200,9.599,11,0.528,9290,4449,4841,6.571,13.721,5020,20,5000,0.030,7.414,4270,6.307,14.829,10,10,19
1991,487,1327,1374,17875,17644,290,22.351,137,10.559,4187,1949,2238,11.047,23.731,3774,1076,2698,6.099,21.390,413,2.341,42.781,110,110,684
1991,488,15850,19963,316854,314146,3397,17.661,1941,10.091,65777,26240,39537,8.353,20.938,60841,17962,42879,5.718,19.367,4936,1.571,38.734,1350,1398,10001
1991,492,5087,8097,438552,428480,1177,14.667,1033,12.872,55320,14279,41041,3.332,12.911,33803,15002,18801,3.501,7.889,21517,5.022,15.778,737,746,5259
1991,493,6477,10565,433210,435569,1153,11.093,811,7.803,69493,25678,43815,5.895,15.955,74740,19579,55161,4.495,17.159,-5247,-1.205,31.909,403,412,7062
1991,511,19206,22578,786885,794702,2956,13.172,2683,11.956,76428,25255,51173,3.178,9.617,92452,33264,59188,4.186,11.634,-16024,-2.016,19.234,2025,2053,22207
1991,512,11311,15989,254844,257573,2402,14.968,2520,15.703,47722,19357,28365,7.515,18.528,53750,24101,29649,9.357,20.868,-6028,-2.340,37.055,1532,1580,9632
1991,515,6171,8301,252231,245342,1292,16.769,99,1.285,39982,22973,17009,9.364,16.296,26170,757,25413,0.309,10.667,13812,5.630,21.333,73,73,317
1991,517,6133,29598,1095322,1076823,6588,24.801,519,1.954,219253,132253,87000,12.282,20.361,183325,3913,179412,0.363,17.025,35928,3.336,34.049,438,440,2962
1991,518,5521,7794,280927,291457,1296,16.575,1346,17.214,52375,20933,31442,7.182,17.970,73768,33757,40011,11.582,25.310,-21393,-7.340,35.940,607,618,9192
1991,519,2615,3047,37202,38249,344,11.290,344,11.290,5795,3296,2499,8.617,15.151,7865,2501,5364,6.539,20.563,-2070,-5.412,30.302,227,241,2003
1991,521,44,78,24886,24981,5,6.623,0,0.000,629,232,397,0.929,2.518,826,0,826,0.000,3.307,-197,-0.789,5.036,0,0,0
1991,522,42310,142342,2604680,2570799,26528,20.423,1635,1.259,543781,342072,201709,13.306,21.152,475745,16148,459597,0.628,18.506,68036,2.646,37.011,1318,1333,12916
1991,523,21592,34218,543638,522185,6952,22.156,1271,4.051,122906,57617,65289,11.034,23.537,81921,11348,70573,2.173,15.688,40985,7.849,31.376,937,939,9807
1991,524,112174,157078,2479298,2442348,21804,14.754,3224,2.182,452367,208013,244354,8.517,18.522,384570,33258,351312,1.362,15.746,67797,2.776,31.492,2382,2387,24500
1991,525,2877,3192,48337,46425,374,12.358,43,1.421,12608,4104,8504,8.840,27.158,8964,611,8353,1.316,19.309,3644,7.849,38.618,26,26,305
1991,531,154669,170617,1065356,1041572,27531,17.076,8751,5.428,254580,138846,115734,13.330,24.442,206951,33234,173717,3.191,19.869,47629,4.573,39.738,7238,7248,27927
1991,532,36697,54332,487034,487857,8733,16.245,7582,14.104,118214,64344,53870,13.189,24.231,120691,51619,69072,10.581,24.739,-2477,-0.508,48.463,5087,5420,32129
1991,533,1064,1177,15123,14559,311,29.732,49,4.685,3459,1687,1772,11.588,23.759,2315,197,2118,1.353,15.901,1144,7.858,31.803,40,40,144
1991,541,423111,459400,4673197,4689686,65745,14.486,54633,12.038,825179,312872,512307,6.671,17.596,860870,327329,533541,6.980,18.357,-35691,-0.761,35.191,41216,41628,214282
1991,551,28441,54328,3204695,3210672,6924,13.139,3664,6.953,516271,188134,328137,5.860,16.080,528393,119806,408587,3.731,16.457,-12122,-0.378,32.160,694,718,7638
1991,561,197946,227506,4318513,4332473,38950,17.493,29254,13.139,1060478,421794,638684,9.736,24.477,1086499,371050,715449,8.564,25.078,-26021,-0.601,48.955,22026,22357,245713
1991,562,10315,11850,193100,185842,1701,14.782,1016,8.829,40765,14146,26619,7.612,21.935,26751,5764,20987,3.102,14.395,14014,7.541,28.789,794,795,4530
1991,611,40764,45354,1879417,1850386,5463,12.330,3370,7.606,193806,43639,150167,2.358,10.474,136936,24995,111941,1.351,7.400,56870,3.073,14.801,2408,2476,17868
1991,621,367644,398523,3165822,3104486,32534,8.215,27517,6.948,559833,185722,374111,5.982,18.033,435732,153573,282159,4.947,14.036,124101,3.997,28.071,21590,21950,110341
1991,622,4137,6232,4398760,4358460,238,3.821,231,3.709,268178,67919,200259,1.558,6.153,185832,77596,108236,1.780,4.264,82346,1.889,8.527,132,136,47842
1991,623,26652,43523,1963094,1931399,5119,12.024,3216,7.554,266635,103127,163508,5.339,13.805,204075,86694,117381,4.489,10.566,62560,3.239,21.132,2003,2073,49896
1991,624,64480,85645,1187151,1165821,10946,13.074,7101,8.482,208198,72726,135472,6.238,17.858,165545,52518,113027,4.505,14.200,42653,3.659,28.400,5024,5147,37375
1991,711,19724,20145,269009,273283,3562,17.408,4195,20.502,60361,21018,39343,7.691,22.087,69269,25033,44236,9.160,25.347,-8908,-3.260,44.175,3240,3248,17912
1991,712,3079,3370,63731,63375,278,8.340,205,6.150,7475,1943,5532,3.066,11.795,6787,1510,5277,2.383,10.709,688,1.086,21.419,164,165,1347
1991,713,40756,45004,776218,765905,5645,12.563,5501,12.243,139986,56617,83369,7.392,18.277,119767,44035,75732,5.749,15.637,20219,2.640,31.275,4245,4371,32359
1991,721,37423,44743,1470709,1481853,5120,11.462,4974,11.135,239760,125986,113774,8.502,16.180,261656,101777,159879,6.868,17.657,-21896,-1.478,32.359,3602,3663,66608
1991,722,287613,386294,6494755,6568798,57536,14.959,54174,14.085,1263937,699779,564158,10.653,19.242,1410211,571874,838337,8.706,21.468,-146274,-2.227,38.483,39178,40609,382840
1991,811,179268,194641,1141405,1165138,26655,13.764,24695,12.752,218064,102304,115760,8.780,18.716,264874,105570,159304,9.061,22.733,-46810,-4.018,37.431,18758,18973,80804
1991,812,141918,173531,1144509,1157064,22107,12.745,21966,12.663,221926,103287,118639,8.927,19.180,246856,94382,152474,8.157,21.335,-24930,-2.155,38.360,16467,16958,67493
1991,813,244971,253132,2228999,2195103,15490,6.234,6146,2.474,293464,61371,232093,2.796,13.369,225882,29586,196296,1.348,10.290,67582,3.079,20.581,4123,4141,21749
1992,211,6841,8081,116194,117733,782,9.481,1116,13.531,26643,6564,20079,5.575,22.630,29187,9986,19201,8.482,24.791,-2544,-2.161,45.260,631,634,3797
1992,212,5326,7730,259538,266704,773,9.808,1075,13.640,36140,14978,21162,5.616,13.551,50193,18580,31613,6.967,18.820,-14053,-5.269,27.101,672,687,7808
1992,213,7893,8930,148638,162926,1089,11.882,1560,17.020,26340,11210,15130,6.880,16.167,55164,18116,37048,11.119,33.858,-28824,-17.692,32.334,1034,1041,6871
1992,221,5718,13624,771759,760487,1113,8.501,51,0.390,82183,41118,41065,5.407,10.807,58904,711,58193,0.093,7.746,23279,3.061,15.491,40,40,181
1992,236,148476,149565,1138334,1166021,26502,17.658,27550,18.356,294156,99676,194480,8.548,25.227,350463,114775,235688,9.843,30.056,-56307,-4.829,50.455,19494,19506,82656
1992,237,34384,35426,650764,664363,3887,10.720,5557,15.325,135294,26038,109256,3.919,20.364,162203,40104,122099,6.036,24.415,-26909,-4.050,40.729,4176,4188,26622
1992,238,316097,319473,2709411,2758054,42510,13.227,46324,14.414,629963,172556,457407,6.256,22.841,726539,212690,513849,7.712,26.342,-96576,-3.502,45.682,33878,33903,161899
1992,311,21152,26131,1388809,1389455,2409,9.176,2654,10.109,145130,36054,109076,2.595,10.445,147216,48619,98597,3.499,10.595,-2086,-0.150,20.890,1699,1724,20160
1992,312,1739,2210,168734,170164,158,7.159,152,6.887,12795,2276,10519,1.338,7.519,15947,3248,12699,1.909,9.372,-3152,-1.852,15.038,112,112,1406
1992,313,3704,4650,441264,439474,393,8.400,450,9.618,41167,9110,32057,2.073,9.367,37800,13794,24006,3.139,8.601,3367,0.766,17.202,317,318,3506
1992,314,6893,7313,232530,230918,723,9.730,959,12.905,33704,7538,26166,3.264,14.596,30346,10735,19611,4.649,13.141,3358,1.454,26.283,782,783,8118
1992,315,13939,15386,873656,872196,2436,15.664,2767,17.792,141545,48954,92591,5.613,16.229,138940,67287,71653,7.715,15.930,2605,0.299,31.860,2324,2341,45054
1992,316,1680,1870,111340,112052,180,9.577,199,10.588,12963,2772,10191,2.474,11.569,14427,5596,8831,4.994,12.875,-1464,-1.307,23.137,142,143,1739
1992,321,14329,15974,472846,469008,1472,9.120,1806,11.189,67145,15708,51437,3.349,14.316,59401,21520,37881,4.588,12.665,7744,1.651,25.331,1353,1355,11695
1992,322,3636,5677,587753,587357,289,5.072,331,5.809,42624,14631,27993,2.491,7.257,41331,11358,29973,1.934,7.037,1293,0.220,14.074,198,202,3690
1992,323,42080,44101,815820,821326,3677,8.281,4277,9.633,92454,29335,63119,3.572,11.257,103961,33886,70075,4.126,12.658,-11507,-1.401,22.513,3482,3490,22437
1992,324,1126,2041,150583,151100,108,5.185,192,9.217,10318,2303,8015,1.524,6.829,11276,4264,7012,2.822,7.463,-958,-0.634,13.657,82,82,861
1992,325,8509,12331,939819,928239,836,6.744,966,7.793,100769,42417,58352,4.570,10.856,77607,25796,51811,2.779,8.361,23162,2.495,16.721,553,560,6629
1992,326,12262,14912,856334,848152,1088,7.289,1117,7.483,103115,22164,80951,2.613,12.158,86376,26546,59830,3.130,10.184,16739,1.974,20.368,767,776,10377
1992,327,11188,15052,454333,457619,1016,6.682,1320,8.682,51507,13539,37968,2.959,11.255,57892,17183,40709,3.755,12.651,-6385,-1.395,22.511,789,797,7059
1992,331,4169,5142,563062,570295,272,5.206,438,8.383,38305,11274,27031,1.977,6.717,52579,14091,38488,2.471,9.220,-14274,-2.503,13.433,279,280,3387
1992,332,50803,54458,1516799,1536322,3811,6.945,4648,8.470,160528,40073,120455,2.608,10.449,199723,53125,146598,3.458,13.000,-39195,-2.551,20.898,3420,3442,27581
1992,333,25543,28058,1253587,1275142,1781,6.315,2068,7.333,114928,27978,86950,2.194,9.013,157837,44162,113675,3.463,12.378,-42909,-3.365,18.026,1428,1439,13065
1992,334,13631,15566,1537773,1599458,1489,9.522,1631,10.430,131489,36704,94785,2.295,8.221,254214,85277,168937,5.332,15.894,-122725,-7.673,16.442,1110,1117,19945
1992,335,5396,6493,546177,550200,448,6.846,550,8.405,49792,14540,35252,2.643,9.050,57944,16143,41801,2.934,10.531,-8152,-1.482,18.100,356,360,4079
1992,336,9439,11209,1793492,1797484,830,7.341,1024,9.057,199268,65543,133725,3.646,11.086,207700,86792,120908,4.829,11.555,-8432,-0.469,22.172,724,729,9197
1992,337,16926,17890,530340,535817,1830,10.073,2386,13.133,63902,14426,49476,2.692,11.926,74994,26163,48831,4.883,13.996,-11092,-2.070,23.852,1805,1814,15743
1992,339,25660,26768,658364,653128,2620,9.745,2855,10.619,90883,25603,65280,3.920,13.915,80604,27205,53399,4.165,12.341,10279,1.574,24.682,2221,2223,15334
1992,423,172990,224086,2699760,2733191,22975,10.230,23955,10.667,412648,135478,277170,4.957,15.098,479146,170468,308678,6.237,17.531,-66498,-2.433,30.195,14098,14853,79935
1992,424,100971,129212,1998378,1988647,13794,10.638,14710,11.344,349871,108835,241036,5.473,17.593,330675,133322,197353,6.704,16.628,19196,0.965,33.256,9121,9311,53625
1992,425,32028,34430,290311,294286,3808,11.099,3569,10.402,48693,16369,32324,5.562,16.546,56661,22610,34051,7.683,19.254,-7968,-2.708,33.092,2201,2229,10675
1992,441,86956,112916,1445237,1451360,9254,8.109,11665,10.222,199360,68466,130894,4.717,13.736,210870,88650,122220,6.108,14.529,-11510,-0.793,27.472,7613,7974,63146
1992,442,44434,58475,416641,418993,6528,11.132,6860,11.698,75938,30307,45631,7.233,18.124,80938,28876,52062,6.892,19.317,-5000,-1.193,36.248,4209,4499,17273
1992,443,25342,36338,267743,263018,5268,14.552,4993,13.793,64736,32546,32190,12.374,24.613,55644,24750,30894,9.410,21.156,9092,3.457,42.312,2861,3073,12839
1992,444,67779,88037,903605,902966,6266,7.051,7937,8.931,139262,46194,93068,5.116,15.423,139280,49231,90049,5.452,15.425,-18,-0.002,30.845,5010,5166,24400
1992,445,102302,140785,2685951,2703970,15007,10.557,17745,12.483,333574,148655,184919,5.498,12.336,369237,127146,242091,4.702,13.655,-35663,-1.319,24.673,11538,11922,62503
1992,446,45289,76000,746833,748115,7117,9.353,7306,9.601,114239,50896,63343,6.803,15.270,116259,46977,69282,6.279,15.540,-2020,-0.270,30.541,4118,4281,21183
1992,447,75729,128510,899485,917558,11360,8.715,15052,11.547,160737,68544,92193,7.470,17.518,196721,80612,116109,8.785,21.440,-35984,-3.922,35.036,8190,8717,43517
1992,448,75407,164428,1328234,1341762,17712,10.639,21821,13.107,243860,114591,129269,8.540,18.175,270463,106465,163998,7.935,20.157,-26603,-1.983,36.349,10360,11812,44735
1992,451,40328,57391,434162,431027,7142,12.412,7439,12.929,87973,35895,52078,8.328,20.410,81524,32272,49252,7.487,18.914,6449,1.496,37.828,4901,5174,17847
1992,452,10878,34428,2067507,2085054,3235,9.364,3470,10.045,203847,96920,106927,4.648,9.777,241719,71477,170242,3.428,11.593,-37872,-1.816,19.553,1395,1488,9563
1992,453,89394,106633,601292,602644,15895,14.896,16037,15.029,139509,65064,74445,10.796,23.150,141706,63277,78429,10.500,23.514,-2197,-0.365,46.299,11231,11584,37731
1992,454,27080,35413,409841,413430,3702,10.379,4213,11.812,76549,26939,49610,6.516,18.516,83201,26088,57113,6.310,20.125,-6652,-1.609,37.031,2491,2541,13917
1992,481,1712,4233,456841,470996,454,11.310,16,0.399,37607,5283,32324,1.122,7.985,68108,63,68045,0.013,14.460,-30501,-6.476,15.969,11,11,45
1992,483,653,999,51690,51885,121,12.179,110,11.072,8902,2321,6581,4.473,17.157,9170,1935,7235,3.729,17.674,-268,-0.517,34.314,64,64,847
1992,484,68530,79913,1125046,1116867,12195,15.324,11526,14.484,214646,71202,143444,6.375,19.219,197367,79253,118114,7.096,17.671,17279,1.547,35.343,8564,8668,47217
1992,485,11133,12794,270106,258559,1811,15.157,119,0.996,53674,19821,33853,7.666,20.759,30413,729,29684,0.282,11.763,23261,8.996,23.525,92,92,642
1992,486,221,2076,58156,57494,303,15.736,(D),(D),9341,6076,3265,10.568,16.247,7991,(D),7977,(D),13.899,1350,2.348,27.798,(D),(D),(D)
1992,487,1520,1602,19101,18340,304,19.987,142,9.336,4783,1688,3095,9.204,26.080,3219,928,2291,5.060,17.552,1564,8.528,35.104,103,103,657
1992,488,17810,22389,319134,315069,3560,16.445,2079,9.603,66418,24334,42084,7.723,21.080,58625,17214,41411,5.464,18.607,7793,2.473,37.214,1422,1457,8893
1992,492,4803,7989,417375,419023,1271,16.342,848,10.903,40657,13086,27571,3.123,9.703,44784,6403,38381,1.528,10.688,-4127,-0.985,19.406,702,706,4798
1992,493,6370,10515,440950,437641,980,9.341,933,8.893,79130,33919,45211,7.750,18.081,72427,16885,55542,3.858,16.549,6703,1.532,33.099,335,344,3534
1992,511,20010,23806,804118,858715,3009,12.788,2458,10.446,91889,31035,60854,3.614,10.701,203878,32228,171650,3.753,23.742,-111989,-13.041,21.402,1801,1809,13790
1992,512,11173,16011,237885,247897,2595,16.291,2431,15.261,56518,27976,28542,11.285,22.799,76072,45997,30075,18.555,30.687,-19554,-7.888,45.598,1368,1461,19874
1992,515,6078,8180,240249,235617,885,11.416,30,0.387,34651,14916,19735,6.331,14.707,25188,414,24774,0.176,10.690,9463,4.016,21.381,16,16,49
1992,517,6333,29833,1071377,1047133,3766,13.402,301,1.071,157444,65010,92434,6.208,15.036,108800,2214,106586,0.211,10.390,48644,4.645,20.781,222,224,1248
1992,518,5060,7349,268289,274207,1062,14.349,1166,15.755,55972,20564,35408,7.499,20.412,66760,28037,38723,10.225,24.347,-10788,-3.934,40.825,526,536,17234
1992,519,2419,2840,34286,34776,239,8.460,209,7.398,3891,1082,2809,3.111,11.189,4804,1436,3368,4.129,13.814,-913,-2.625,22.378,142,142,732
1992,521,14,44,24095,24068,(D),(D),(D),(D),623,(D),622,(D),2.588,576,(D),524,(D),2.393,47,0.195,4.786,0,0,0
1992,522,42097,144400,2541673,2512430,12739,9.201,837,0.605,427655,134160,293495,5.340,17.022,371175,4915,366260,0.196,14.774,56480,2.248,29.547,556,557,2861
1992,523,24227,38469,546235,522634,6976,19.804,487,1.383,106274,36321,69953,6.950,20.334,57915,3103,54812,0.594,11.081,48359,9.253,22.163,349,349,1498
1992,524,113192,157527,2516072,2443635,16479,10.984,1477,0.984,423090,138514,284576,5.668,17.314,277925,9793,268132,0.401,11.373,145165,5.941,22.747,1044,1044,6407
1992,525,2482,2626,54875,51051,298,11.982,20,0.804,13636,2964,10672,5.806,26.711,5673,102,5571,0.200,11.113,7963,15.598,22.225,6,6,36
1992,531,155955,173258,1069713,1030288,23234,14.167,4719,2.877,238030,101936,136094,9.894,23.103,159554,15072,144482,1.463,15.486,78476,7.617,30.973,3732,3736,12082
1992,532,36449,55218,475289,484636,7778,14.084,7791,14.108,102180,45211,56969,9.329,21.084,119685,41624,78061,8.589,24.696,-17505,-3.612,42.168,4825,5257,25266
1992,533,1317,1462,22067,20531,268,19.978,27,2.013,5542,1620,3922,7.891,26.993,2516,108,2408,0.526,12.255,3026,14.739,24.509,18,18,76
1992,541,431870,469441,4641025,4626626,63211,13.640,51182,11.044,857513,304791,552722,6.588,18.534,823793,331496,492297,7.165,17.805,33720,0.729,35.611,35999,36323,221163
1992,551,28338,53264,3191270,3191839,4892,9.200,4708,8.854,563373,151543,411830,4.748,17.650,563139,124687,438452,3.906,17.643,234,0.007,35.286,442,465,5804
1992,561,198574,229242,4512801,4417258,38044,16.901,29765,13.223,1170283,429742,740541,9.729,26.493,976015,342239,633776,7.748,22.095,194268,4.398,44.191,21713,21950,204578
1992,562,10370,12092,203416,200625,1377,11.540,1057,8.859,38937,13563,25374,6.760,19.408,33106,7991,25115,3.983,16.501,5831,2.906,33.003,780,786,4541
1992,611,41138,46458,1941365,1903126,5505,12.162,3118,6.888,198081,35465,162616,1.864,10.408,121142,17292,103850,0.909,6.365,76939,4.043,12.731,2208,2256,12429
1992,621,371640,405243,3410681,3297988,33095,8.239,25959,6.463,645394,196381,449013,5.955,19.569,419709,136530,283179,4.140,12.726,225685,6.843,25.452,18727,19051,84932
1992,622,3800,6070,4631830,4524206,365,6.062,267,4.434,497817,190545,307272,4.212,11.003,281754,65395,216359,1.445,6.228,216063,4.776,12.455,139,140,40865
1992,623,26645,45179,2064079,2012000,5044,11.437,2888,6.549,289509,118763,170746,5.903,14.389,186241,73456,112785,3.651,9.257,103268,5.133,18.513,1811,1885,44902
1992,624,68515,90600,1256484,1227000,10515,11.851,6766,7.626,222648,65790,156858,5.362,18.146,163668,43477,120191,3.543,13.339,58980,4.807,26.678,4497,4603,26236
1992,711,19622,20063,265524,268075,3674,18.359,3571,17.845,70060,22053,48007,8.226,26.135,74199,36633,37566,13.665,27.678,-4139,-1.544,52.269,2560,2565,13866
1992,712,3019,3315,66757,65533,258,7.890,168,5.138,8906,1569,7337,2.394,13.590,6398,973,5425,1.485,9.763,2508,3.827,19.526,98,98,293
1992,713,41498,45783,814897,795254,5775,12.725,4977,10.966,160546,58045,102501,7.299,20.188,121132,46383,74749,5.832,15.232,39414,4.956,30.464,3668,3720,30812
1992,721,37042,44309,1467246,1479328,4832,10.903,4852,10.948,217108,100346,116762,6.783,14.676,241444,111466,129978,7.535,16.321,-24336,-1.645,29.352,2971,3033,60597
1992,722,293045,393633,6665645,6592749,58456,14.944,53500,13.677,1395117,707901,687216,10.738,21.161,1252984,555792,697192,8.430,19.005,142133,2.156,38.011,36163,37171,325228
1992,811,182318,199144,1142822,1149839,25839,13.022,24406,12.300,219945,95714,124231,8.324,19.128,233845,89780,144065,7.808,20.337,-13900,-1.209,38.257,17762,17901,61717
1992,812,139465,171499,1119475,1124035,21215,12.354,21659,12.613,211718,91079,120639,8.103,18.836,220667,91248,129419,8.118,19.632,-8949,-0.796,37.671,14759,15151,61433
1992,813,251418,259609,2298717,2254947,15755,6.192,5438,2.137,322253,58606,263647,2.599,14.291,235028,21918,213110,0.972,10.423,87225,3.868,20.846,3261,3275,13414
1993,211,6901,8093,100543,109691,766,9.396,884,10.844,16503,6847,9656,6.242,15.045,34936,5911,29025,5.389,31.850,-18433,-16.805,30.090,565,566,1954
1993,212,5119,7482,246771,253348,659,8.631,965,12.639,30860,11087,19773,4.376,12.181,44205,17584,26621,6.941,17.448,-13345,-5.267,24.362,585,601,7093
1993,213,7460,8441,138402,139905,1207,14.152,1383,16.215,37403,13693,23710,9.787,26.735,40358,15099,25259,10.792,28.847,-2955,-2.112,53.469,922,925,6131
1993,221,6039,14058,759085,765329,906,6.516,598,4.301,59297,17110,42187,2.236,7.748,72132,9691,62441,1.266,9.425,-12835,-1.677,15.496,221,225,1354
1993,236,148367,149474,1146658,1135849,27150,18.307,24816,16.733,310638,102043,208595,8.984,27.349,288602,97118,191484,8.550,25.408,22036,1.940,50.817,17674,17678,71424
1993,237,35018,36088,642379,648908,4550,12.626,4448,12.343,134444,27939,106505,4.306,20.718,148079,32155,115924,4.955,22.820,-13635,-2.101,41.437,3381,3384,20660
1993,238,319903,323201,2743291,2722121,47334,14.781,41387,12.924,678223,186055,492168,6.835,24.915,636085,191644,444441,7.040,23.367,42138,1.548,46.735,30772,30795,149475
1993,311,21100,25938,1406486,1395436,2371,9.170,2209,8.543,152371,41624,110747,2.983,10.919,129366,41354,88012,2.964,9.271,23005,1.649,18.541,1531,1581,17160
1993,312,1737,2205,167148,168192,155,7.026,157,7.117,14749,2774,11975,1.649,8.769,16584,3167,13417,1.883,9.860,-1835,-1.091,17.538,105,105,1080
1993,313,3906,4850,437442,438789,511,10.713,351,7.358,38042,10996,27046,2.506,8.670,40741,11199,29542,2.552,9.285,-2699,-0.615,17.340,251,256,4551
1993,314,6891,7300,233885,232716,806,11.021,832,11.377,32868,10161,22707,4.366,14.124,30575,11743,18832,5.046,13.138,2293,0.985,26.277,653,654,6248
1993,315,13834,15250,850987,860558,2596,16.946,2735,17.853,126852,47340,79512,5.501,14.741,145395,63893,81502,7.425,16.895,-18543,-2.155,29.481,2289,2306,45790
1993,316,1682,1880,116545,113646,200,10.707,176,9.422,19946,8952,10994,7.877,17.551,14129,4272,9857,3.759,12.432,5817,5.119,24.865,132,132,1509
1993,321,14575,16220,494139,484480,1651,10.210,1552,9.598,71573,17624,53949,3.638,14.773,52155,18036,34119,3.723,10.765,19418,4.008,21.530,1182,1192,10465
1993,322,3663,5687,589475,588140,304,5.349,296,5.209,43960,15107,28853,2.569,7.474,41483,16024,25459,2.725,7.053,2477,0.421,14.107,175,179,3497
1993,323,41652,43646,813841,815091,3562,8.121,3994,9.106,92997,25023,67974,3.070,11.409,95737,31430,64307,3.856,11.746,-2740,-0.336,22.819,3288,3299,19248
1993,324,1129,2080,141909,145624,152,7.364,120,5.814,8130,2058,6072,1.413,5.583,15496,3160,12336,2.170,10.641,-7366,-5.058,11.166,58,59,646
1993,325,8707,12541,910348,921096,944,7.565,818,6.556,76378,19579,56799,2.126,8.292,96804,38363,58441,4.165,10.510,-20426,-2.218,16.584,457,467,4476
1993,326,12338,15042,889327,871985,1114,7.436,993,6.628,109917,26234,83683,3.009,12.605,75270,22726,52544,2.606,8.632,34647,3.973,17.264,697,702,8574
1993,327,11188,15003,455488,454438,1073,7.133,1151,7.652,48856,11353,37503,2.498,10.751,46703,12234,34469,2.692,10.277,2153,0.474,20.554,735,744,5379
1993,331,4159,5116,557025,559713,284,5.522,338,6.572,39933,9395,30538,1.679,7.135,45770,11236,34534,2.007,8.177,-5837,-1.043,14.269,217,218,3282
1993,332,51276,54880,1520366,1520426,4269,7.802,3945,7.210,176270,39108,137162,2.572,11.593,176603,54807,121796,3.605,11.615,-333,-0.022,23.187,2919,2942,23012
1993,333,25780,28241,1251393,1253066,1966,6.976,1851,6.568,129773,31409,98364,2.507,10.356,133064,40277,92787,3.214,10.619,-3291,-0.263,20.713,1312,1325,12985
1993,334,13820,15720,1509523,1527381,1511,9.655,1372,8.766,146687,40504,106183,2.652,9.604,180662,43282,137380,2.834,11.828,-33975,-2.224,19.208,937,945,12393
1993,335,5347,6436,555886,550180,426,6.596,471,7.293,61913,20106,41807,3.654,11.253,49277,12384,36893,2.251,8.957,12636,2.297,17.913,318,320,3879
1993,336,9581,11313,1774139,1795194,1022,9.075,920,8.169,170103,48869,121234,2.722,9.475,212725,59105,153620,3.292,11.850,-42622,-2.374,18.951,629,636,9596
1993,337,17327,18256,547679,539613,2178,11.970,2057,11.305,78726,20722,58004,3.840,14.589,62209,22666,39543,4.200,11.528,16517,3.061,23.057,1551,1573,14147
1993,339,26188,27312,680352,669786,2941,10.870,2427,8.971,96120,27338,68782,4.082,14.351,74545,21568,52977,3.220,11.130,21575,3.221,22.259,1879,1885,10427
1993,423,174462,225652,2732363,2711415,23176,10.306,21626,9.617,430748,129288,301460,4.768,15.886,388987,138606,250381,5.112,14.346,41761,1.540,28.693,14242,14688,74225
1993,424,102378,129998,2021405,2008213,13655,10.526,13106,10.103,308398,97922,210476,4.876,15.357,281431,96350,185081,4.798,14.014,26967,1.343,28.028,9003,9176,53999
1993,425,32789,35161,293971,292151,3789,10.887,3074,8.832,50398,15447,34951,5.287,17.251,46676,16382,30294,5.607,15.977,3722,1.274,31.953,2046,2059,10125
1993,441,87236,112972,1480331,1462663,9345,8.276,9239,8.182,204526,65011,139515,4.445,13.983,169582,62554,107028,4.277,11.594,34944,2.389,23.188,6476,6755,46230
1993,442,44664,58703,437100,427477,5888,10.031,5878,10.014,86267,29694,56573,6.946,20.181,67224,24914,42310,5.828,15.726,19043,4.455,31.452,3875,4105,16104
1993,443,26082,37234,281699,274485,5179,14.075,4301,11.689,63304,29423,33881,10.719,23.063,48981,20005,28976,7.288,17.845,14323,5.218,35.689,2800,2929,12726
1993,444,67668,88100,924113,913328,6399,7.254,6621,7.506,141739,51358,90381,5.623,15.519,121207,36992,84215,4.050,13.271,20532,2.248,26.542,4625,4774,20959
1993,445,102840,141500,2733082,2712092,15594,11.047,14910,10.563,364886,171381,193505,6.319,13.454,323996,113043,210953,4.168,11.946,40890,1.508,23.893,10038,10304,54013
1993,446,45104,75946,749858,748055,6480,8.530,6518,8.580,105434,45213,60221,6.044,14.094,103308,40332,62976,5.392,13.810,2126,0.284,27.620,3777,4021,19851
1993,447,74334,124995,881539,889964,10168,8.028,13492,10.652,158758,58076,100682,6.526,17.839,176298,81237,95061,9.128,19.810,-17540,-1.971,35.677,7240,7625,38417
1993,448,74019,160396,1349575,1338677,15967,9.836,19850,12.228,274749,102624,172125,7.666,20.524,252720,102275,150445,7.640,18.878,22029,1.646,37.757,9093,10018,38229
1993,451,40758,57722,447351,440721,6945,12.066,6617,11.496,93358,39740,53618,9.017,21.183,79734,31632,48102,7.177,18.092,13624,3.091,36.183,4282,4487,16469
1993,452,10729,34840,2187790,2126516,3051,8.814,2601,7.514,291386,130894,160492,6.155,13.703,172263,45964,126299,2.161,8.101,119123,5.602,16.201,1241,1338,7269
1993,453,90926,108211,626863,614264,14958,13.919,13465,12.530,142470,63888,78582,10.401,23.194,117357,46709,70648,7.604,19.105,25113,4.088,38.211,10017,10325,33681
1993,454,27553,35798,414279,411571,4066,11.423,3662,10.288,72964,23871,49093,5.800,17.728,67040,23378,43662,5.680,16.289,5924,1.439,32.578,2372,2403,12255
1993,481,1746,4214,459045,455359,473,11.622,185,4.545,42585,7525,35060,1.653,9.352,34875,1748,33127,0.384,7.659,7710,1.693,15.318,123,126,638
1993,483,679,1034,48484,49882,143,14.068,108,10.625,7398,2144,5254,4.298,14.831,9917,2607,7310,5.226,19.881,-2519,-5.050,29.662,63,63,1047
1993,484,70645,81947,1150459,1138791,13004,16.049,11159,13.772,208330,65873,142457,5.784,18.294,185697,71989,113708,6.322,16.307,22633,1.987,32.613,8434,8544,48401
1993,485,11531,13208,278349,274391,1795,13.797,1399,10.753,48008,18181,29827,6.626,17.496,40106,15484,24622,5.643,14.616,7902,2.880,29.233,1093,1110,9303
1993,486,229,2048,54477,56228,167,8.099,195,9.457,5281,2383,2898,4.238,9.392,8817,2132,6685,3.792,15.681,-3536,-6.289,18.784,22,27,286
1993,487,1595,1671,20258,19813,258,15.670,209,12.694,4786,1405,3381,7.091,24.156,3915,1140,2775,5.754,19.760,871,4.396,39.520,155,155,848
1993,488,18645,23225,329038,325033,3294,14.422,2524,11.051,64742,21045,43697,6.475,19.919,56659,17607,39052,5.417,17.432,8083,2.487,34.864,1715,1764,9008
1993,492,5159,8312,441120,429413,1197,14.710,848,10.421,54348,8547,45801,1.990,12.656,29449,9622,19827,2.241,6.858,24899,5.798,13.716,536,538,6209
1993,493,6400,10435,421261,431450,870,8.285,1001,9.533,64435,16074,48361,3.726,14.935,85476,24044,61432,5.573,19.811,-21041,-4.877,29.869,324,332,3301
1993,511,20544,24493,817293,809717,3113,12.895,2409,9.979,101954,38068,63886,4.701,12.591,87277,33806,53471,4.175,10.779,14677,1.813,21.557,1746,1754,15011
1993,512,11525,16130,258483,256736,2362,14.695,2250,13.998,56759,15472,41287,6.026,22.108,53944,22740,31204,8.857,21.012,2815,1.096,42.023,1268,1298,11700
1993,515,6254,8333,241456,241116,883,10.685,745,9.015,34304,13917,20387,5.772,14.227,33646,15120,18526,6.271,13.954,658,0.273,27.909,491,516,5575
1993,517,6941,29973,1058802,1066193,3779,12.637,3642,12.179,165035,60430,104605,5.668,15.479,178761,58699,120062,5.505,16.766,-13726,-1.287,30.958,674,702,6292
1993,518,5059,7200,277024,272916,858,11.791,1011,13.894,53232,15221,38011,5.577,19.505,44907,15346,29561,5.623,16.455,8325,3.050,32.909,513,519,5415
1993,519,2540,2943,38147,36328,315,10.819,252,8.655,7985,5216,2769,14.358,21.980,4082,1606,2476,4.421,11.237,3903,10.744,22.473,137,206,1229
1993,521,17,47,23943,24020,4,8.696,(D),(D),442,22,420,0.092,1.840,613,(D),545,(D),2.552,-171,-0.712,3.680,(D),(D),(D)
1993,522,42831,141535,2461975,2497027,12102,8.467,14890,10.418,426856,131278,295578,5.257,17.095,501747,234304,267443,9.383,20.094,-74891,-2.999,34.189,2720,3313,27536
1993,523,25924,40132,534042,529545,6837,17.201,6070,15.271,112622,42727,69895,8.069,21.268,104881,44476,60405,8.399,19.806,7741,1.462,39.612,2982,3015,14396
1993,524,114287,157339,2465831,2491511,16431,10.452,16148,10.272,399534,123834,275700,4.970,16.036,451404,187651,263753,7.532,18.118,-51870,-2.082,32.072,8778,8957,85000
1993,525,2431,2612,53079,51553,295,11.447,225,8.731,13922,5762,8160,11.177,27.005,10791,2622,8169,5.086,20.932,3131,6.073,41.864,136,137,969
1993,531,160356,177672,1094226,1084491,23912,13.615,19825,11.288,234352,97297,137055,8.972,21.609,214880,82128,132752,7.573,19.814,19472,1.795,39.628,14398,14642,54160
1993,532,36522,55322,492217,484769,6672,12.054,6731,12.160,110794,34770,76024,7.172,22.855,96110,41036,55074,8.465,19.826,14684,3.029,39.652,4356,4542,22236
1993,533,1421,1565,18917,19960,285,18.781,190,12.521,4613,1486,3127,7.445,23.111,6647,3862,2785,19.349,33.302,-2034,-10.190,46.222,132,132,1352
1993,541,447282,484250,4826381,4776679,65564,13.776,48940,10.283,885079,304698,580381,6.379,18.529,790268,228840,561428,4.791,16.544,94811,1.985,33.089,34094,35891,138022
1993,551,28213,51178,3137460,3166005,4540,8.700,6554,12.559,531591,137584,394007,4.346,16.791,590489,164135,426354,5.184,18.651,-58898,-1.860,33.581,860,905,12059
1993,561,207542,237822,4871967,4679336,39646,17.109,27462,11.851,1336485,424351,912134,9.069,28.561,948619,338724,609895,7.239,20.273,387866,8.289,40.545,19755,20245,199469
1993,562,11031,12827,228488,220707,1716,13.774,978,7.850,46102,14246,31856,6.455,20.888,30670,10126,20544,4.588,13.896,15432,6.992,27.793,670,676,4514
1993,611,42823,48105,2010877,1966881,5773,12.315,3320,7.082,219292,50813,168479,2.583,11.149,130910,19789,111121,1.006,6.656,88382,4.494,13.311,2359,2416,13699
1993,621,375030,410607,3619403,3518588,32323,7.924,26896,6.594,685425,227808,457617,6.474,19.480,485100,163978,321122,4.660,13.787,200325,5.693,27.574,20207,20698,99226
1993,622,3746,5994,4634339,4632224,240,3.982,306,5.077,287570,54341,233229,1.173,6.208,287849,126736,161113,2.736,6.214,-279,-0.006,12.416,84,85,24717
1993,623,27538,46714,2143112,2101580,4600,10.016,3022,6.580,283073,100053,183020,4.761,13.470,200219,80550,119669,3.833,9.527,82854,3.942,19.054,1567,1629,36153
1993,624,71830,94626,1325589,1290187,11325,12.229,7291,7.873,245083,73219,171864,5.675,18.996,174624,45916,128708,3.559,13.535,70459,5.461,27.070,4701,4811,27355
1993,711,19955,20407,272946,269908,3614,17.854,3285,16.228,70263,22752,47511,8.430,26.032,64054,21907,42147,8.116,23.732,6209,2.300,47.464,2322,2326,15470
1993,712,3196,3496,71960,69350,349,10.245,170,4.990,11128,1839,9289,2.652,16.046,5802,835,4967,1.204,8.366,5326,7.680,16.733,105,105,407
1993,713,43010,47369,855784,834599,6019,12.911,4520,9.696,159249,62712,96537,7.514,19.081,116548,35557,80991,4.260,13.965,42701,5.116,27.929,3370,3431,25169
1993,721,37682,44733,1462933,1461233,4677,10.509,4222,9.486,209425,89328,120097,6.113,14.332,204865,89846,115019,6.149,14.020,4560,0.312,28.040,2719,2793,45466
1993,722,300845,400709,6781741,6723875,56729,14.283,49687,12.510,1364604,682029,682575,10.143,20.295,1247268,504838,742430,7.508,18.550,117336,1.745,37.100,33716,34843,298786
1993,811,185543,201982,1159047,1151570,25023,12.466,22525,11.221,220891,86645,134246,7.524,19.182,205746,77812,127934,6.757,17.867,15145,1.315,35.733,16640,16824,55484
1993,812,140833,172167,1135905,1127518,20053,11.687,18876,11.001,218103,83831,134272,7.435,19.344,202300,81657,120643,7.242,17.942,15803,1.402,35.884,13087,13571,50285
1993,813,253838,261930,2340695,2301690,15104,5.871,5750,2.235,307166,52495,254671,2.281,13.345,229771,24265,205506,1.054,9.983,77395,3.363,19.965,3786,3824,15019
1994,211,6736,8022,100655,100801,800,9.911,899,11.138,18134,7481,10653,7.422,17.990,18675,6977,11698,6.922,18.527,-541,-0.537,35.980,605,613,2502
1994,212,4995,7361,241484,244659,666,8.950,826,11.101,32331,11769,20562,4.810,13.215,38739,14595,24144,5.965,15.834,-6408,-2.619,26.429,513,520,5866
1994,213,7414,8425,151285,146214,1069,12.618,1163,13.728,38754,11317,27437,7.740,26.505,28384,10270,18114,7.024,19.413,10370,7.092,38.825,800,804,5625
1994,221,6003,14126,740789,750509,821,5.853,623,4.441,42874,15573,27301,2.075,5.713,62219,8441,53778,1.125,8.290,-19345,-2.578,11.425,270,285,1466
1994,236,153052,154236,1197984,1171416,28962,19.127,23333,15.409,330305,106667,223638,9.106,28.197,277208,90722,186486,7.745,23.664,53097,4.533,47.329,16772,16778,68357
1994,237,35898,36998,651984,647770,5017,13.732,4091,11.197,140892,31550,109342,4.871,21.750,133183,28993,104190,4.476,20.560,7709,1.190,41.120,3083,3091,20065
1994,238,331324,334588,2893541,2822209,49932,15.164,39333,11.945,740123,200330,539793,7.098,26.225,597417,186368,411049,6.604,21.168,142706,5.057,42.337,29524,29541,144694
1994,311,21189,25965,1425233,1420083,2448,9.445,2357,9.094,147459,41942,105517,2.953,10.384,137242,42960,94282,3.025,9.664,10217,0.719,19.329,1651,1684,18423
1994,312,1767,2219,160323,163543,190,8.617,162,7.347,12556,3006,9550,1.838,7.678,18903,4004,14899,2.448,11.558,-6347,-3.881,15.355,109,109,1221
1994,313,4299,5242,445662,445418,700,13.784,373,7.345,41082,10920,30162,2.452,9.223,40670,13142,27528,2.950,9.131,412,0.092,18.262,259,266,5408
1994,314,6972,7383,242402,238726,886,12.050,825,11.221,36849,10676,26173,4.472,15.436,29362,11310,18052,4.738,12.299,7487,3.136,24.599,646,655,6253
1994,315,13880,15258,808659,833072,2704,17.695,2751,18.002,117633,48805,68828,5.858,14.120,166624,69554,97070,8.349,20.001,-48991,-5.881,28.241,2334,2350,48660
1994,316,1635,1808,108490,112726,158,8.557,235,12.727,11315,2280,9035,2.023,10.038,19712,10662,9050,9.458,17.487,-8397,-7.449,20.075,164,164,3449
1994,321,14811,16514,526783,512829,1678,10.237,1434,8.748,77228,20399,56829,3.978,15.059,49019,16687,32332,3.254,9.559,28209,5.501,19.117,1129,1141,11027
1994,322,3708,5754,585788,589100,316,5.506,287,5.000,38261,10544,27717,1.790,6.495,44873,16812,28061,2.854,7.617,-6612,-1.122,12.990,177,182,3544
1994,323,41083,43056,821521,820529,3353,7.731,3978,9.173,98169,28123,70046,3.427,11.964,95507,34997,60510,4.265,11.640,2662,0.324,23.279,3276,3289,21258
1994,324,1101,2027,139983,140630,115,5.640,139,6.817,7936,2261,5675,1.608,5.643,9404,2690,6714,1.913,6.687,-1468,-1.044,11.286,61,62,896
1994,325,8736,12607,903022,906764,899,7.162,789,6.286,82812,33097,49715,3.650,9.133,90067,33072,56995,3.647,9.933,-7255,-0.800,18.265,496,502,5494
1994,326,12553,15363,929817,912714,1215,7.969,981,6.434,116031,28502,87529,3.123,12.713,81612,29183,52429,3.197,8.942,34419,3.771,17.883,697,702,11607
1994,327,11190,15133,468084,463341,1127,7.468,1044,6.918,55861,13744,42117,2.966,12.056,46079,14084,31995,3.040,9.945,9782,2.111,19.890,671,684,6231
1994,331,4207,5186,572255,565848,341,6.597,307,5.939,50003,16435,33568,2.904,8.837,37778,8053,29725,1.423,6.676,12225,2.160,13.353,202,202,2633
1994,332,51746,55446,1569391,1547449,4114,7.445,3738,6.765,195106,42830,152276,2.768,12.608,151511,43131,108380,2.787,9.791,43595,2.817,19.582,2856,2871,24244
1994,333,26030,28533,1286632,1274080,2023,7.107,1888,6.633,144482,30744,113738,2.413,11.340,118942,35922,83020,2.819,9.336,25540,2.005,18.671,1383,1388,13566
1994,334,14024,15928,1481687,1498742,1581,9.989,1379,8.713,155654,40683,114971,2.714,10.386,189177,60851,128326,4.060,12.622,-33523,-2.237,20.771,951,958,13997
1994,335,5432,6510,566221,562360,480,7.402,429,6.616,59782,12721,47061,2.262,10.631,51686,22420,29266,3.987,9.191,8096,1.440,18.382,273,276,4624
1994,336,9665,11435,1775957,1785243,1033,9.073,935,8.212,179899,45971,133928,2.575,10.077,200293,53722,146571,3.009,11.219,-20394,-1.142,20.154,679,684,11533
1994,337,17425,18363,575619,562736,2125,11.588,2074,11.310,85468,27841,57627,4.947,15.188,60293,20700,39593,3.678,10.714,25175,4.474,21.429,1612,1618,13894
1994,339,26532,27667,683102,682691,2878,10.471,2515,9.150,84448,23345,61103,3.420,12.370,83704,29502,54202,4.321,12.261,744,0.109,24.522,1937,1944,14503
1994,423,177009,228653,2809646,2783453,23421,10.288,21444,9.419,443770,129527,314243,4.653,15.943,390551,141601,248950,5.087,14.031,53219,1.912,28.062,14344,14921,77761
1994,424,102902,130805,2069881,2054412,13700,10.485,13427,10.276,307180,91543,215637,4.456,14.952,275457,100912,174545,4.912,13.408,31723,1.544,26.816,9394,9588,55551
1994,425,33532,35872,300717,298998,3792,10.664,3164,8.898,49627,16288,33339,5.448,16.598,46431,17482,28949,5.847,15.529,3196,1.069,31.058,2154,2179,10118
1994,441,88191,114793,1579606,1535934,10145,8.888,8835,7.741,231711,71771,159940,4.673,15.086,144044,54889,89155,3.574,9.378,87667,5.708,18.757,6246,6482,38369
1994,442,45003,59794,457242,448253,6652,11.205,5797,9.765,86092,35075,51017,7.825,19.206,68570,24801,43769,5.533,15.297,17522,3.909,30.594,3968,4193,15721
1994,443,27243,39035,314464,298906,5803,15.185,4165,10.899,78932,39338,39594,13.161,26.407,47145,20077,27068,6.717,15.773,31787,10.634,31.545,2906,2991,13074
1994,444,68083,88831,969796,952781,6969,7.860,6640,7.489,160537,63848,96689,6.701,16.849,126174,49988,76186,5.247,13.243,34363,3.607,26.485,4592,4768,24233
1994,445,102631,141392,2802485,2770918,14581,10.302,14876,10.510,375055,169891,205164,6.131,13.535,313150,116842,196308,4.217,11.301,61905,2.234,22.603,10464,10661,55475
1994,446,44886,76974,770767,761774,6961,9.090,6168,8.055,118078,47464,70614,6.231,15.500,99549,41195,58354,5.408,13.068,18529,2.432,26.136,3696,4079,21937
1994,447,73081,123378,904106,895386,9896,7.960,11770,9.468,169709,59588,110121,6.655,18.954,150359,63202,87157,7.059,16.793,19350,2.161,33.585,7087,7385,35414
1994,448,72250,159617,1346777,1351386,17282,10.790,18373,11.471,243172,123256,119916,9.121,17.994,253116,86065,167051,6.369,18.730,-9944,-0.736,35.989,9335,10464,38342
1994,451,41091,57723,457360,454208,6853,11.861,6965,12.055,88914,40276,48638,8.867,19.576,82839,33667,49172,7.412,18.238,6075,1.337,36.476,4424,4657,17502
1994,452,10695,35096,2248856,2218781,3141,8.982,2890,8.264,269267,119542,149725,5.388,12.136,212949,58008,154941,2.614,9.598,56318,2.538,19.195,1286,1395,5909
1994,453,91764,110432,664305,648353,14790,13.485,13279,12.107,146317,63949,82368,9.863,22.568,114230,43963,70267,6.781,17.619,32087,4.949,35.237,10213,10471,32834
1994,454,27479,35630,434456,426485,4500,12.627,4515,12.669,83561,29458,54103,6.907,19.593,67279,29144,38135,6.834,15.775,16282,3.818,31.550,3170,3196,16172
1994,481,1844,4496,469589,463046,638,15.008,148,3.482,35043,7830,27213,1.691,7.568,22061,1037,21024,0.224,4.764,12982,2.804,9.529,110,110,758
1994,483,722,1089,48784,48713,157,14.910,85,8.072,7506,2252,5254,4.623,15.409,7624,1624,6000,3.334,15.651,-118,-0.242,30.818,56,56,362
1994,484,72762,84406,1201307,1176525,13819,16.601,11494,13.808,234041,74086,159955,6.297,19.893,183532,77871,105661,6.619,15.600,50509,4.293,31.199,8789,8948,46778
1994,485,11908,13632,294838,287074,2035,15.151,1634,12.165,51590,18877,32713,6.576,17.971,36570,16144,20426,5.624,12.739,15020,5.232,25.478,1231,1249,9442
1994,486,228,2246,54493,55110,297,13.652,156,7.171,7013,3894,3119,7.066,12.725,8219,2207,6012,4.005,14.914,-1206,-2.188,25.451,17,17,78
1994,487,1636,1715,20577,20416,271,16.045,219,12.966,5163,1792,3371,8.778,25.290,4824,1540,3284,7.543,23.629,339,1.661,47.258,167,168,1287
1994,488,19383,24140,341980,335282,3558,15.021,2652,11.196,69692,24444,45248,7.291,20.786,56121,18824,37297,5.614,16.738,13571,4.048,33.477,1886,1961,11238
1994,492,5392,8609,448465,444726,1174,13.879,874,10.332,41537,9131,32406,2.053,9.340,35588,6735,28853,1.514,8.002,5949,1.338,16.004,645,655,4360
1994,493,6525,10664,434845,429704,1112,10.512,940,8.886,77274,31033,46241,7.222,17.983,66786,22730,44056,5.290,15.542,10488,2.441,31.085,332,343,3774
1994,511,21187,25249,833152,827857,3308,13.291,2587,10.394,99372,32100,67272,3.877,12.004,87800,34505,53295,4.168,10.606,11572,1.398,21.211,1883,1904,13680
1994,512,12192,16704,231179,238559,2549,15.475,2084,12.652,51116,17017,34099,7.133,21.427,66612,23622,42990,9.902,27.923,-15496,-6.496,42.854,1218,1280,16087
1994,515,6441,8543,262443,252679,999,11.826,808,9.565,49338,14861,34477,5.881,19.526,30394,12525,17869,4.957,12.029,18944,7.497,24.057,555,589,6771
1994,517,7673,31396,1065148,1063329,4596,14.975,3187,10.384,179177,69812,109365,6.565,16.851,177364,63048,114316,5.929,16.680,1813,0.171,33.360,835,896,7617
1994,518,5001,7142,285747,283380,876,12.199,954,13.285,49968,19418,30550,6.852,17.633,45689,18280,27409,6.451,16.123,4279,1.510,32.246,543,546,4016
1994,519,2562,3001,40930,39528,261,8.791,197,6.635,6007,1775,4232,4.490,15.197,3284,1092,2192,2.763,8.308,2723,6.889,16.616,143,143,704
1994,521,15,45,22982,23796,(D),(D),(D),(D),339,(D),293,(D),1.425,1928,(D),1925,(D),8.102,-1589,-6.678,2.849,(D),(D),(D)
1994,522,44441,147024,2562586,2511465,17164,11.894,11737,8.133,519812,248352,271460,9.889,20.698,415462,163209,252253,6.499,16.543,104350,4.155,33.085,2717,3197,25706
1994,523,26395,43403,571309,547272,10024,24.182,6121,14.767,142949,60330,82619,11.024,26.120,93661,58412,35249,10.673,17.114,49288,9.006,34.228,3207,3236,33117
1994,524,113145,157040,2292603,2381134,16649,10.580,17290,10.988,361388,130209,231179,5.468,15.177,534872,294296,240576,12.359,22.463,-173484,-7.286,30.354,10689,10878,196510
1994,525,2653,2901,61255,60232,367,13.037,195,6.927,14778,7363,7415,12.225,24.535,12535,2359,10176,3.917,20.811,2243,3.724,41.623,109,111,634
1994,531,164212,182168,1106279,1097707,24379,13.541,20128,11.180,227941,102384,125557,9.327,20.765,212035,87815,124220,8.000,19.316,15906,1.449,38.632,14854,15243,58415
1994,532,36196,56117,515252,505801,7433,13.323,6780,12.153,112933,44130,68803,8.725,22.328,95799,35421,60378,7.003,18.940,17134,3.387,37.880,4404,4692,20441
1994,533,1553,1694,19175,18957,340,20.789,223,13.635,4589,2446,2143,12.903,24.207,4137,2078,2059,10.962,21.823,452,2.384,43.646,144,148,678
1994,541,463728,502384,4957471,4884451,68308,13.863,49006,9.946,892558,310384,582174,6.355,18.273,745066,244809,500257,5.012,15.254,147492,3.020,30.508,35347,35775,147944
1994,551,28406,51174,3136996,3148617,4871,9.511,4953,9.671,476745,149824,326921,4.758,15.141,500428,146420,354008,4.650,15.894,-23683,-0.752,30.283,965,1022,13837
1994,561,216229,247906,5304055,5086779,41497,17.237,27185,11.292,1418704,451178,967526,8.870,27.890,985159,340545,644614,6.695,19.367,433545,8.523,38.734,20646,21005,226296
1994,562,11632,13619,252660,244563,1869,14.108,1127,8.507,49237,13683,35554,5.595,20.133,33001,10948,22053,4.477,13.494,16236,6.639,26.988,801,810,7004
1994,611,44987,50358,2071896,2039276,6409,13.089,3619,7.391,198149,37247,160902,1.826,9.717,133232,19067,114165,0.935,6.533,64917,3.183,13.067,2650,2783,13476
1994,621,375449,414701,3793409,3707443,32853,7.956,29282,7.092,674886,240913,433973,6.498,18.204,503390,176623,326767,4.764,13.578,171496,4.626,27.156,22256,22889,113182
1994,622,3680,6006,4627206,4624017,284,4.755,217,3.633,214829,60271,154558,1.303,4.646,204409,62821,141588,1.359,4.421,10420,0.225,8.841,100,103,36041
1994,623,28249,48825,2205537,2178063,5085,10.628,3129,6.540,274596,109000,165596,5.004,12.607,219794,91492,128302,4.201,10.091,54802,2.516,20.183,1823,1980,46884
1994,624,74990,99646,1417595,1379915,11684,11.997,7173,7.365,240954,76320,164634,5.531,17.462,165858,41937,123921,3.039,12.019,75096,5.442,24.039,5119,5258,27909
1994,711,20646,21078,278221,276585,3880,18.692,3238,15.600,63605,21765,41840,7.869,22.997,60281,21630,38651,7.820,21.795,3324,1.202,43.589,2287,2305,14550
1994,712,3392,3711,74212,73547,354,9.805,153,4.238,8084,1303,6781,1.772,10.992,6855,961,5894,1.307,9.321,1229,1.671,18.641,96,96,484
1994,713,44419,49054,915674,886460,6319,13.099,4694,9.730,182096,72621,109475,8.192,20.542,123011,40396,82615,4.557,13.877,59085,6.665,27.753,3635,3740,31462
1994,721,38467,45803,1527414,1503519,5076,11.195,4155,9.164,247152,114486,132666,7.615,16.438,197253,85640,111613,5.696,13.119,49899,3.319,26.239,2889,2949,53859
1994,722,305657,407037,7028131,6916378,56874,14.067,51420,12.718,1431020,775822,655198,11.217,20.690,1208928,508635,700293,7.354,17.479,222092,3.211,34.958,36886,38205,332573
1994,811,188299,204821,1196733,1180099,24931,12.253,22239,10.930,234019,86615,147404,7.340,19.830,200406,79467,120939,6.734,16.982,33613,2.848,33.964,16903,17151,56790
1994,812,141108,172183,1134578,1136213,20286,11.786,20170,11.718,209468,92787,116681,8.166,18.436,211401,84876,126525,7.470,18.606,-1933,-0.170,36.871,13848,14438,57301
1994,813,258808,267004,2381235,2354044,16229,6.198,5911,2.257,304823,60266,244557,2.560,12.949,250313,26045,224268,1.106,10.633,54510,2.316,21.267,4025,4052,17384
1995,211,6488,7693,100071,99801,607,7.728,931,11.852,17088,7266,9822,7.280,17.122,16113,5446,10667,5.457,16.145,975,0.977,32.290,626,635,2235
1995,212,4892,7268,238769,240959,656,8.969,748,10.227,33383,9547,23836,3.962,13.854,37895,12304,25591,5.106,15.727,-4512,-1.873,27.708,476,477,5830
1995,213,7380,8372,150354,150515,1047,12.469,1096,13.053,32765,8092,24673,5.376,21.769,33531,13456,20075,8.940,22.278,-766,-0.509,43.537,739,743,5374
1995,221,6136,14498,721065,731612,984,6.877,606,4.235,41807,14148,27659,1.934,5.714,63287,6275,57012,0.858,8.650,-21480,-2.936,11.429,236,238,1259
1995,236,159372,160692,1279450,1237448,29825,18.937,23430,14.877,343619,114195,229424,9.228,27.768,259514,92706,166808,7.492,20.972,84105,6.797,41.943,17105,17117,71007
1995,237,36925,38002,687933,669810,4989,13.308,3962,10.569,146798,29845,116953,4.456,21.916,110156,27883,82273,4.163,16.446,36642,5.471,32.892,2996,3012,20374
1995,238,345534,348927,3108287,3000822,53626,15.695,39140,11.455,780609,220932,559677,7.362,26.013,565240,178058,387182,5.934,18.836,215369,7.177,37.672,29893,29927,140182
1995,311,21214,25830,1448410,1436317,2380,9.232,2281,8.848,145581,30689,114892,2.137,10.136,121077,37959,83118,2.643,8.430,24504,1.706,16.859,1595,1621,15255
1995,312,1836,2270,159216,159265,222,9.931,153,6.844,15260,2405,12855,1.510,9.582,15403,4248,11155,2.667,9.671,-143,-0.090,19.163,106,106,877
1995,313,4564,5512,444055,444249,672,12.478,419,7.780,37335,8658,28677,1.949,8.404,37425,11146,26279,2.509,8.424,-90,-0.020,16.808,331,333,4745
1995,314,7108,7541,249765,245715,911,12.213,747,10.015,37396,10620,26776,4.322,15.219,29038,11219,17819,4.566,11.818,8358,3.402,23.636,614,614,7263
1995,315,13884,15177,791362,799255,2509,16.496,2575,16.930,120548,43436,77112,5.435,15.083,135229,58666,76563,7.340,16.919,-14681,-1.837,30.165,2168,2176,38478
1995,316,1643,1806,104953,106652,163,9.023,164,9.078,10919,2301,8618,2.157,10.238,14493,4152,10341,3.893,13.589,-3574,-3.351,20.476,119,120,1473
1995,321,14983,16689,553402,539116,1736,10.488,1463,8.839,79116,22362,56754,4.148,14.675,50595,19412,31183,3.601,9.385,28521,5.290,18.770,1150,1158,10695
1995,322,3713,5800,594525,590070,323,5.598,263,4.558,43758,12392,31366,2.100,7.416,34794,8231,26563,1.395,5.897,8964,1.519,11.793,177,178,2639
1995,323,40425,42345,839676,828209,3161,7.413,3754,8.804,102318,27625,74693,3.336,12.354,79584,29233,50351,3.530,9.609,22734,2.745,19.218,3174,3184,20170
1995,324,1082,2013,135057,137785,92,4.566,96,4.764,6806,1119,5687,0.812,4.940,12259,4460,7799,3.237,8.897,-5453,-3.958,9.879,39,39,355
1995,325,8767,12623,902675,901563,874,6.952,771,6.133,72268,18962,53306,2.103,8.016,69541,16245,53296,1.802,7.713,2727,0.302,15.427,481,481,4828
1995,326,12784,15682,971285,949859,1253,8.070,943,6.073,119254,24082,95172,2.535,12.555,76536,25542,50994,2.689,8.058,42718,4.497,16.115,637,642,9795
1995,327,11123,15190,484923,476124,1156,7.634,1062,7.013,60287,13662,46625,2.869,12.662,42440,13045,29395,2.740,8.914,17847,3.748,17.827,733,740,5693
1995,331,4174,5173,590318,579513,337,6.535,304,5.895,53030,7988,45042,1.378,9.151,31536,13149,18387,2.269,5.442,21494,3.709,10.884,217,219,3688
1995,332,52350,56100,1658583,1609984,4331,7.776,3523,6.325,226019,44355,181664,2.755,14.039,128932,41140,87792,2.555,8.008,97087,6.030,16.017,2742,2752,22434
1995,333,26293,28831,1344280,1306775,2098,7.324,1725,6.022,165374,30918,134456,2.366,12.655,90453,28656,61797,2.193,6.922,74921,5.733,13.844,1280,1282,10603
1995,334,14126,16174,1558366,1516853,1721,10.762,1356,8.480,228132,76085,152047,5.016,15.040,142382,39817,102565,2.625,9.387,85750,5.653,18.773,964,965,13350
1995,335,5444,6531,584819,573991,496,7.625,443,6.811,64428,13738,50690,2.393,11.225,42551,11970,30581,2.085,7.413,21877,3.811,14.826,301,303,3127
1995,336,9747,11564,1796779,1788869,1018,8.868,849,7.396,178185,37844,140341,2.116,9.961,162399,43942,118457,2.456,9.078,15786,0.882,18.157,611,613,9921
1995,337,17554,18491,586542,577860,2072,11.248,1932,10.488,75099,18179,56920,3.146,12.996,57545,18936,38609,3.277,9.958,17554,3.038,19.917,1504,1511,13944
1995,339,26797,27939,698882,689805,2850,10.267,2492,8.977,97096,29188,67908,4.231,14.076,78535,28856,49679,4.183,11.385,18561,2.691,22.770,1952,1960,14011
1995,423,180042,233321,2973318,2891927,24524,10.614,19974,8.645,508081,162144,345937,5.607,17.569,345046,126352,218694,4.369,11.931,163035,5.638,23.863,13710,14230,76167
1995,424,103951,132005,2124422,2096256,14023,10.671,12838,9.769,323243,100247,222996,4.782,15.420,266876,96493,170383,4.603,12.731,56367,2.689,25.462,9156,9411,56611
1995,425,34615,37104,316139,308007,4216,11.564,2925,8.023,57326,18806,38520,6.106,18.612,40848,14797,26051,4.804,13.262,16478,5.350,26.524,2077,2090,9602
1995,441,89078,116967,1658368,1619236,10405,8.979,8222,7.096,223143,73592,149551,4.545,13.781,145912,48743,97169,3.010,9.011,77231,4.770,18.022,6005,6204,35472
1995,442,45411,60578,476304,466755,6632,11.025,5785,9.617,89146,36288,52858,7.775,19.099,69812,26895,42917,5.762,14.957,19334,4.142,29.914,3857,4207,16908
1995,443,28539,41033,357430,335391,6151,15.365,4148,10.362,92632,45098,47534,13.446,27.619,49099,19566,29533,5.834,14.639,43533,12.980,29.279,2841,3026,12781
1995,444,68445,90148,1029676,999344,7422,8.293,6119,6.837,172863,74607,98256,7.466,17.298,112504,39972,72532,4.000,11.258,60359,6.040,22.516,4309,4471,19687
1995,445,102817,141065,2864625,2833398,14421,10.214,14660,10.384,391747,164787,226960,5.816,13.826,326171,124277,201894,4.386,11.512,65576,2.314,23.023,10165,10365,48698
1995,446,44371,77864,797019,782765,7553,9.755,6680,8.627,135963,58875,77088,7.521,17.370,106781,47103,59678,6.018,13.642,29182,3.728,27.283,3883,4150,20959
1995,447,71748,121874,907316,905279,9041,7.377,10395,8.482,155742,56417,99325,6.232,17.204,151955,61815,90140,6.828,16.785,3787,0.418,33.571,6605,6992,36092
1995,448,70384,154551,1309485,1330573,16925,10.777,21904,13.948,239521,115972,123549,8.716,18.001,278092,146007,132085,10.973,20.900,-38571,-2.899,36.003,8964,10149,39294
1995,451,41323,58026,491425,474437,7099,12.261,6842,11.817,108152,48943,59209,10.316,22.796,72999,31475,41524,6.634,15.386,35153,7.409,30.773,4490,4682,16923
1995,452,10653,34819,2381329,2315142,3227,9.229,3523,10.075,293715,141473,152242,6.111,12.687,162466,56509,105957,2.441,7.018,131249,5.669,14.035,1249,1581,7456
1995,453,93108,112716,699974,682969,15293,13.702,13089,11.727,150792,67856,82936,9.935,22.079,117205,46312,70893,6.781,17.161,33587,4.918,34.322,10093,10430,34381
1995,454,28644,36541,448770,441691,4430,12.279,3506,9.718,76209,25331,50878,5.735,17.254,61428,26505,34923,6.001,13.907,14781,3.346,27.815,2217,2241,11795
1995,481,1924,4618,470985,466927,588,13.338,169,3.834,41618,8336,33282,1.785,8.913,33874,635,33239,0.136,7.255,7744,1.659,14.509,119,119,361
1995,483,753,1124,50086,49367,136,12.308,98,8.869,7784,2455,5329,4.973,15.768,6080,1214,4866,2.459,12.316,1704,3.452,24.632,56,59,612
1995,484,76466,88401,1278305,1239520,15230,17.616,11336,13.112,254548,86315,168233,6.964,20.536,177746,69447,108299,5.603,14.340,76802,6.196,28.680,8742,8866,43911
1995,485,12156,13893,306304,300413,1952,14.185,1688,12.267,53530,17012,36518,5.663,17.819,41455,18924,22531,6.299,13.799,12075,4.019,27.599,1376,1402,12142
1995,486,234,2403,51763,52978,281,12.091,123,5.293,4625,2226,2399,4.202,8.730,7093,973,6120,1.837,13.389,-2468,-4.659,17.460,14,15,160
1995,487,1660,1738,21597,20981,258,14.952,233,13.503,4280,1116,3164,5.319,20.400,3075,1253,1822,5.972,14.656,1205,5.743,29.313,170,170,788
1995,488,20095,25197,365187,353015,3565,14.449,2518,10.205,73997,27236,46761,7.715,20.961,49511,18263,31248,5.173,14.025,24486,6.936,28.050,1867,1923,11298
1995,492,5675,9084,492339,470675,1544,17.495,1027,11.637,72631,13477,59154,2.863,15.431,29504,13101,16403,2.783,6.268,43127,9.163,12.537,730,766,6876
1995,493,6588,10889,460414,447484,1041,9.658,820,7.608,80312,23951,56361,5.352,17.947,54428,14764,39664,3.299,12.163,25884,5.784,24.326,324,328,3708
1995,511,21918,26193,858304,843836,3663,14.264,2636,10.265,119428,46418,73010,5.501,14.153,89613,34166,55447,4.049,10.620,29815,3.533,21.239,1863,1885,16115
1995,512,12875,17278,255690,243234,2605,15.317,2063,12.130,65449,33241,32208,13.666,26.908,41969,14536,27433,5.976,17.255,23480,9.653,34.509,1329,1376,9187
1995,515,6562,8717,262623,262582,1058,12.262,881,10.210,40475,15416,25059,5.871,15.414,39798,13961,25837,5.317,15.156,677,0.258,30.313,623,683,9271
1995,517,8683,32419,1091165,1077910,4463,13.980,3475,10.885,191776,70360,121416,6.527,17.791,166222,49006,117216,4.546,15.421,25554,2.371,30.842,941,998,9997
1995,518,5011,7834,322980,307536,1551,20.739,840,11.232,66156,27578,38578,8.967,21.512,36038,11052,24986,3.594,11.718,30118,9.793,23.437,467,474,4911
1995,519,2619,3078,37796,39341,255,8.380,185,6.080,5133,1768,3365,4.494,13.047,8440,4643,3797,11.802,21.453,-3307,-8.406,26.095,141,142,823
1995,521,14,49,22604,22796,(D),(D),3,6.316,548,(D),464,(D),2.404,948,81,867,0.355,4.159,-400,-1.755,4.808,3,3,81
1995,522,43530,149787,2522770,2541999,15440,10.407,12601,8.493,366029,152984,213045,6.018,14.399,402059,135524,266535,5.331,15.817,-36030,-1.417,28.799,4091,5074,48236
1995,523,27295,45528,572476,570672,7577,17.056,5369,12.086,105690,44985,60705,7.883,18.520,101394,35265,66129,6.180,17.767,4296,0.753,35.535,2891,2953,17048
1995,524,113217,158352,2206491,2248277,15861,10.057,14576,9.242,281510,99818,181692,4.440,12.521,365312,147687,217625,6.569,16.249,-83802,-3.727,25.042,8954,9130,91588
1995,525,2779,3184,64778,62653,482,15.793,218,7.143,14198,6494,7704,10.365,22.662,9899,2379,7520,3.797,15.800,4299,6.862,31.600,125,125,669
1995,531,166311,186180,1119847,1112421,25159,13.660,21168,11.493,230481,110824,119657,9.962,20.719,214692,83981,130711,7.549,19.300,15789,1.419,38.599,15818,16130,60461
1995,532,36123,56946,545966,530135,7215,12.765,6367,11.265,117218,38354,78864,7.235,22.111,86503,37100,49403,6.998,16.317,30715,5.794,32.634,4262,4627,21643
1995,533,1670,1823,21560,20029,343,19.572,202,11.526,6724,3554,3170,17.745,33.572,3612,1589,2023,7.934,18.034,3112,15.538,36.069,140,140,785
1995,541,483572,524295,5191008,5068236,73275,14.299,49578,9.675,977511,364030,613481,7.183,19.287,730808,237654,493154,4.689,14.419,246703,4.868,28.839,36021,36481,143276
1995,551,28556,51726,3207995,3171350,5025,9.771,4433,8.619,528494,175024,353470,5.519,16.665,454966,123514,331452,3.895,14.346,73528,2.319,28.692,1010,1046,12767
1995,561,227662,261624,5827469,5573764,44851,17.751,26926,10.657,1553133,566995,986138,10.173,27.865,1044350,332992,711358,5.974,18.737,508783,9.128,37.474,20577,21065,219149
1995,562,12197,14325,270110,261609,1922,13.756,1216,8.703,49223,14758,34465,5.641,18.816,32067,9344,22723,3.572,12.258,17156,6.558,24.515,884,900,5447
1995,611,47067,52715,2129382,2094692,6598,12.873,3680,7.180,200025,42162,157863,2.013,9.549,130846,19249,111597,0.919,6.247,69179,3.303,12.493,2768,2860,14754
1995,621,374521,417454,3983225,3888155,34168,8.213,31354,7.536,742730,273987,468743,7.047,19.102,551182,212601,338581,5.468,14.176,191548,4.926,28.352,23818,24548,137270
1995,622,3605,5972,4563982,4584772,265,4.433,276,4.617,220064,62676,157388,1.367,4.800,262148,84758,177390,1.849,5.718,-42084,-0.918,9.600,104,111,39164
1995,623,29172,51264,2301077,2250937,5335,10.663,2875,5.746,293916,113027,180889,5.021,13.057,193910,75900,118010,3.372,8.615,100006,4.443,17.229,1813,1968,49873
1995,624,78210,104103,1500912,1459332,11882,11.665,7405,7.269,249516,80359,169157,5.507,17.098,166595,41363,125232,2.834,11.416,82921,5.682,22.832,5450,5571,29358
1995,711,21625,22071,281893,280162,4048,18.759,3065,14.203,62376,23472,38904,8.378,22.264,58948,16444,42504,5.869,21.041,3428,1.224,42.081,2174,2182,12042
1995,712,3589,3913,77342,75956,374,9.809,174,4.563,8603,1769,6834,2.329,11.326,5831,859,4972,1.131,7.677,2772,3.650,15.354,112,112,582
1995,713,45682,50603,980049,944006,6323,12.693,4747,9.529,196231,78820,117411,8.350,20.787,123795,42001,81794,4.449,13.114,72436,7.673,26.228,3699,3771,30219
1995,721,39156,46559,1530946,1523724,5114,11.078,4322,9.362,224363,100900,123463,6.622,14.725,210520,97177,113343,6.378,13.816,13843,0.908,27.632,2867,2938,51365
1995,722,311528,417740,7314985,7169559,60756,14.732,50072,12.142,1557537,832243,725294,11.608,21.724,1269073,534685,734388,7.458,17.701,288464,4.023,35.402,36688,38003,341257
1995,811,192620,209321,1259817,1233863,26434,12.764,21974,10.611,254228,100818,153410,8.171,20.604,201826,76561,125265,6.205,16.357,52402,4.247,32.714,16699,16997,56793
1995,812,142351,173875,1166266,1150312,20342,11.770,18240,10.554,214939,90598,124341,7.876,18.685,182067,73209,108858,6.364,15.828,32872,2.858,31.655,13487,14104,54673
1995,813,262665,270929,2444248,2402860,16280,6.126,5950,2.239,307474,57558,249916,2.395,12.796,224525,23235,201290,0.967,9.344,82949,3.452,18.688,4123,4155,15291
1996,211,6325,7510,92701,95556,662,8.693,873,11.463,13075,4767,8308,4.989,13.683,19118,7718,11400,8.077,20.007,-6043,-6.324,27.366,574,580,2282
1996,212,4731,7075,225310,230628,583,8.135,767,10.702,26731,6711,20020,2.910,11.591,36881,14588,22293,6.325,15.992,-10150,-4.401,23.181,495,498,7205
1996,213,7009,8096,153084,150752,961,11.797,1061,13.025,35520,7949,27571,5.273,23.562,30984,12366,18618,8.203,20.553,4536,3.009,41.106,757,779,7846
1996,221,6204,14958,691832,708306,1210,8.211,768,5.211,51182,26186,24996,3.697,7.226,84187,12976,71211,1.832,11.886,-33005,-4.660,14.452,265,274,1790
1996,236,162028,163407,1293604,1279619,27631,17.057,24800,15.309,318876,104506,214370,8.167,24.920,290197,95271,194926,7.445,22.678,28679,2.241,45.357,18076,18079,73443
1996,237,37637,38705,684309,679569,4840,12.629,4079,10.643,136953,33705,103248,4.960,20.153,129180,27809,101371,4.092,19.009,7773,1.144,38.018,3048,3061,19287
1996,238,353443,356743,3213674,3155978,49342,13.974,42048,11.908,728226,198877,529349,6.302,23.074,613200,192551,420649,6.101,19.430,115026,3.645,38.860,31962,31988,147228
1996,311,20901,25343,1448518,1443070,2273,8.942,2427,9.548,157753,38132,119621,2.642,10.932,146273,45330,100943,3.141,10.136,11480,0.796,20.272,1691,1710,19664
1996,312,1906,2361,161711,160468,242,10.458,148,6.396,16206,2961,13245,1.845,10.099,13555,4492,9063,2.799,8.447,2651,1.652,16.894,105,106,1712
1996,313,4559,5507,411147,427869,575,10.429,588,10.665,26164,9338,16826,2.182,6.115,59657,15223,44434,3.558,13.943,-33493,-7.828,12.230,463,463,5282
1996,314,7043,7446,231266,237657,842,11.255,912,12.191,26447,8835,17612,3.718,11.128,39440,13093,26347,5.509,16.595,-12993,-5.467,22.256,738,766,9236
1996,315,13522,14716,712661,749844,2366,15.827,2832,18.944,95861,41858,54003,5.582,12.784,169518,70865,98653,9.451,22.607,-73657,-9.823,25.568,2371,2396,42520
1996,316,1592,1734,90823,96719,153,8.701,202,11.487,6166,1328,4838,1.373,6.375,18097,5754,12343,5.949,18.711,-11931,-12.336,12.750,152,152,1901
1996,321,14764,16513,542676,544924,1424,8.582,1584,9.546,62087,16558,45529,3.039,11.394,66436,18394,48042,3.376,12.192,-4349,-0.798,22.787,1263,1267,11544
1996,322,3690,5769,573868,582057,290,5.036,269,4.671,31878,7969,23909,1.369,5.477,48009,15022,32987,2.581,8.248,-16131,-2.771,10.954,164,167,3772
1996,323,39742,41688,823042,827683,2928,6.961,3683,8.755,83205,21853,61352,2.640,10.053,92590,30788,61802,3.720,11.187,-9385,-1.134,20.106,3044,3049,18950
1996,324,1086,2036,128762,131785,109,5.375,93,4.586,6643,1378,5265,1.046,5.041,12560,3560,9000,2.701,9.531,-5917,-4.490,10.082,51,52,2141
1996,325,8749,12611,888572,893365,874,6.943,828,6.578,68063,15402,52661,1.724,7.619,77608,20812,56796,2.330,8.687,-9545,-1.068,15.237,506,509,6496
1996,326,12655,15626,965747,968309,1177,7.576,998,6.424,98729,26934,71795,2.782,10.196,104043,24716,79327,2.552,10.745,-5314,-0.549,20.392,718,734,12906
1996,327,11120,15340,482855,483483,1221,8.000,1065,6.978,52078,15906,36172,3.290,10.771,53237,15451,37786,3.196,11.011,-1159,-0.240,21.543,683,715,6402
1996,331,4107,5100,576458,579397,277,5.427,286,5.603,40311,12624,27687,2.179,6.957,46368,15294,31074,2.640,8.003,-6057,-1.045,13.915,196,198,4149
1996,332,53111,56877,1649671,1641952,4261,7.550,3375,5.980,179876,40641,139235,2.475,10.955,165239,45411,119828,2.766,10.064,14637,0.891,20.127,2607,2623,24670
1996,333,26329,28903,1358900,1344596,1974,6.855,1763,6.122,140292,31733,108559,2.360,10.434,111824,29967,81857,2.229,8.317,28468,2.117,16.633,1325,1333,14391
1996,334,13908,15839,1542244,1550936,1400,8.842,1390,8.779,177875,34886,142989,2.249,11.469,195500,90448,105052,5.832,12.605,-17625,-1.136,22.938,985,990,14058
1996,335,5381,6477,569349,576396,436,6.732,435,6.717,43830,9210,34620,1.598,7.604,57272,14373,42899,2.494,9.936,-13442,-2.332,15.208,290,296,4446
1996,336,9756,11701,1716710,1744915,1082,9.323,891,7.677,138432,45140,93292,2.587,7.933,195926,52897,143029,3.031,11.228,-57494,-3.295,15.867,630,633,13045
1996,337,17684,18592,572188,579646,1936,10.377,2067,11.079,58671,16914,41757,2.918,10.122,74106,24176,49930,4.171,12.785,-15435,-2.663,20.244,1573,1587,15402
1996,339,27067,28229,687332,686519,2795,9.947,2534,9.018,83619,23405,60214,3.409,12.180,82182,24148,58034,3.517,11.971,1437,0.209,23.942,2016,2023,15778
1996,423,183501,237944,3009212,2986888,25380,10.740,22099,9.352,469877,156441,313436,5.238,15.731,426823,161803,265020,5.417,14.290,43054,1.441,28.580,14513,15037,85871
1996,424,103523,131278,2098695,2097807,14106,10.748,14043,10.700,313988,91269,222719,4.351,14.967,311378,115173,196205,5.490,14.843,2610,0.124,29.686,9717,9970,65200
1996,425,34989,37486,306044,307965,4153,11.206,3305,8.917,47548,15697,31851,5.097,15.439,51472,18856,32616,6.123,16.714,-3924,-1.274,30.879,2215,2226,10692
1996,441,88789,118644,1706095,1671011,11682,9.958,9015,7.685,251948,109040,142908,6.525,15.078,185474,63526,121948,3.802,11.100,66474,3.978,22.199,6227,6376,42503
1996,442,45430,61049,480608,476513,6533,10.753,5944,9.784,83371,36802,46569,7.723,17.496,75445,26795,48650,5.623,15.833,7926,1.663,31.665,4044,4380,17571
1996,443,29045,41413,375134,365094,6062,14.750,5431,13.215,89477,45977,43500,12.593,24.508,69240,29900,39340,8.190,18.965,20237,5.543,37.930,3328,3507,16389
1996,444,62344,84466,1005001,990813,6894,8.167,6797,8.052,160494,59537,100957,6.009,16.198,133842,49010,84832,4.946,13.508,26652,2.690,27.017,4477,4616,23179
1996,445,101989,139730,2899692,2873324,14415,10.293,15052,10.748,373017,157133,215884,5.469,12.982,317656,126192,191464,4.392,11.055,55361,1.927,22.111,10516,10713,58366
1996,446,43170,77591,785102,786199,6868,8.868,6580,8.496,122486,52708,69778,6.704,15.580,125784,46618,79166,5.930,15.999,-3298,-0.419,31.159,4066,4271,22724
1996,447,69851,120366,904845,903860,9580,7.924,10634,8.796,159902,61053,98849,6.755,17.691,157969,62106,95863,6.871,17.477,1933,0.214,34.954,6659,7046,37034
1996,448,67308,150608,1237530,1271041,14597,9.601,17456,11.481,215533,98515,117018,7.751,16.957,283186,89776,193410,7.063,22.280,-67653,-5.323,33.914,8841,10126,40363
1996,451,40897,58314,507870,497455,7043,12.137,6469,11.148,102327,47731,54596,9.595,20.570,80926,31083,49843,6.248,16.268,21401,4.302,32.536,4532,4734,17818
1996,452,10478,35228,2424231,2402285,3167,9.049,2709,7.740,284080,111826,172254,4.655,11.825,245571,62722,182849,2.611,10.222,38509,1.603,20.445,1301,1379,7167
1996,453,93326,113373,709783,698058,15384,13.700,13216,11.770,149404,69576,79828,9.967,21.403,127056,51350,75706,7.356,18.201,22348,3.201,36.403,10265,10513,34512
1996,454,30406,38150,455889,454126,4782,12.737,3568,9.504,77004,29190,47814,6.428,16.957,73199,28347,44852,6.242,16.119,3805,0.838,32.237,2392,2422,12031
1996,481,2011,4664,490934,471598,552,12.373,147,3.295,57758,18918,38840,4.011,12.247,20243,966,19277,0.205,4.292,37515,7.955,8.585,107,114,807
1996,483,794,1181,53625,52169,147,12.640,111,9.544,10810,3610,7200,6.920,20.721,8144,1828,6316,3.504,15.611,2666,5.110,31.222,60,65,983
1996,484,77863,89739,1296549,1288314,14345,16.134,12688,14.271,214284,73075,141209,5.672,16.633,198373,72061,126312,5.593,15.398,15911,1.235,30.796,9584,9708,49238
1996,485,12279,14039,313125,308202,1960,14.045,1792,12.841,48658,19888,28770,6.453,15.788,39059,17308,21751,5.616,12.673,9599,3.115,25.346,1456,1469,10939
1996,486,229,2275,49533,51085,170,7.260,303,12.940,5277,2063,3214,4.038,10.330,8302,2530,5772,4.953,16.252,-3025,-5.922,20.660,23,23,111
1996,487,1678,1756,21314,21158,275,15.878,227,13.106,3758,1124,2634,5.313,17.762,3405,1247,2158,5.894,16.094,353,1.668,32.187,179,179,1028
1996,488,21068,26433,376933,370836,3707,14.321,2611,10.087,70375,24436,45939,6.589,18.977,58057,18302,39755,4.935,15.656,12318,3.322,31.311,1913,1976,11070
1996,492,5949,9478,532124,512487,1433,15.439,1040,11.205,93593,15303,78290,2.986,18.263,53426,34513,18913,6.734,10.425,40167,7.838,20.850,770,791,5919
1996,493,6713,11293,472137,466174,1245,11.213,866,7.799,81487,29374,52113,6.301,17.480,68929,22563,46366,4.840,14.786,12558,2.694,29.572,318,324,3473
1996,511,22635,27179,856329,849607,3659,13.719,2643,9.910,104423,32594,71829,3.836,12.291,91826,27555,64271,3.243,10.808,12597,1.483,21.616,1955,1993,15828
1996,512,13548,17915,262449,260979,2809,15.972,2153,12.242,60539,18999,41540,7.280,23.197,56350,29967,26383,11.483,21.592,4189,1.605,43.184,1372,1398,7597
1996,515,6499,8743,257396,259072,1029,11.819,956,10.980,38835,17965,20870,6.934,14.990,41970,14339,27631,5.535,16.200,-3135,-1.210,29.980,698,748,8992
1996,517,10103,33948,1138081,1117196,6350,19.112,4904,14.760,259868,117557,142311,10.523,23.261,219029,90458,128571,8.097,19.605,40839,3.655,39.211,1294,1420,14622
1996,518,4952,8319,336089,328786,1572,19.594,980,12.215,59152,24944,34208,7.587,17.991,44121,11258,32863,3.424,13.419,15031,4.572,26.839,466,475,3169
1996,519,2845,3467,46546,45319,334,9.850,182,5.367,7102,1899,5203,4.190,15.671,4735,944,3791,2.083,10.448,2367,5.223,20.896,139,139,513
1996,521,16,47,22738,22711,(D),(D),(D),(D),582,(D),549,(D),2.563,565,(D),475,(D),2.488,17,0.075,4.976,0,0,0
1996,522,44171,153553,2531499,2523872,15909,10.504,11722,7.739,409698,167608,242090,6.641,16.233,394547,137520,257027,5.449,15.633,15151,0.600,31.265,3041,3856,32280
1996,523,28747,47422,608186,588253,7100,15.311,5000,10.782,119469,39356,80113,6.690,20.309,79818,33151,46667,5.636,13.569,39651,6.740,27.137,2729,2749,13198
1996,524,114058,159176,2242440,2219486,16049,10.117,14969,9.436,332953,125304,207649,5.646,15.001,285745,97540,188205,4.395,12.874,47208,2.127,25.749,8163,8420,36809
1996,525,2954,3400,73663,69337,427,12.979,207,6.292,16912,4981,11931,7.184,24.391,7988,1263,6725,1.822,11.521,8924,12.870,23.041,115,116,700
1996,531,168329,188854,1117187,1113810,23849,12.716,21251,11.331,214513,94483,120030,8.483,19.259,207391,81900,125491,7.353,18.620,7122,0.639,37.240,15629,16031,59830
1996,532,34986,56416,522144,532437,6772,11.973,7059,12.481,105130,36805,68325,6.913,19.745,122796,41100,81696,7.719,23.063,-17666,-3.318,39.490,4549,5057,26266
1996,533,1424,1532,16556,16381,284,18.454,298,19.363,4834,1426,3408,8.705,29.511,4456,2881,1575,17.588,27.203,378,2.308,54.406,194,212,1234
1996,541,501888,544487,5431497,5329383,75193,14.104,52447,9.838,1008506,359416,649090,6.744,18.924,805931,276944,528987,5.197,15.122,202575,3.801,30.245,38420,38881,158364
1996,551,28235,51664,3183720,3188999,4851,9.410,4622,8.966,508205,150407,357798,4.716,15.936,519257,154447,364810,4.843,16.283,-11052,-0.347,31.872,1023,1075,16028
1996,561,228721,265188,6017270,5828803,44706,17.344,29842,11.578,1577233,536178,1041055,9.199,27.059,1205699,395045,810654,6.777,20.685,371534,6.374,41.370,22174,22561,239970
1996,562,12471,14644,270362,269513,1776,12.281,1410,9.750,49401,17766,31635,6.592,18.330,48036,19064,28972,7.073,17.823,1365,0.506,35.647,1001,1022,7168
1996,611,48793,54610,2105680,2083597,6830,12.820,4166,7.819,185975,42719,143256,2.050,8.926,141896,21892,120004,1.051,6.810,44079,2.116,13.620,3236,3288,15928
1996,621,370415,416532,4081163,4025024,34253,8.228,33819,8.123,738176,275818,462358,6.853,18.340,625851,255152,370699,6.339,15.549,112325,2.791,31.098,24910,25739,155750
1996,622,3343,5708,4458118,4472648,179,3.114,259,4.506,244253,80261,163992,1.794,5.461,269397,69694,199703,1.558,6.023,-25144,-0.562,10.922,108,112,32656
1996,623,29765,53213,2335107,2312871,5421,10.385,3391,6.496,273836,103767,170069,4.487,11.840,229173,83385,145788,3.605,9.909,44663,1.931,19.817,2064,2215,48150
1996,624,80651,107988,1520415,1503531,12233,11.541,8254,7.787,228209,80606,147603,5.361,15.178,194747,50199,144548,3.339,12.953,33462,2.226,25.905,5997,6183,34345
1996,711,22313,22772,287291,279046,4165,18.726,3105,13.960,75137,26096,49041,9.352,26.926,58633,18504,40129,6.631,21.012,16504,5.914,42.024,2213,2225,13261
1996,712,3715,4047,77169,76819,331,8.319,195,4.901,7406,1119,6287,1.457,9.641,6867,672,6195,0.875,8.939,539,0.702,17.879,134,134,561
1996,713,46284,51360,1015853,998122,6080,11.950,5117,10.057,181763,73900,107863,7.404,18.210,146070,44621,101449,4.470,14.634,35693,3.576,29.269,3987,4038,34546
1996,721,39851,47706,1566043,1549176,5340,11.323,4251,9.014,255672,146521,109151,9.458,16.504,221729,103853,117876,6.704,14.313,33943,2.191,28.625,2975,3043,63799
1996,722,315344,425580,7461391,7372852,60439,14.347,51796,12.296,1485468,813448,672020,11.033,20.148,1306760,538308,768452,7.301,17.724,178708,2.424,35.448,38058,39236,341569
1996,811,195925,213695,1298492,1276043,26793,12.675,22157,10.482,252937,101493,151444,7.954,19.822,207259,82831,124428,6.491,16.242,45678,3.580,32.485,16978,17283,61729
1996,812,141738,173251,1174595,1163700,20305,11.748,19482,11.272,218865,96340,122525,8.279,18.808,196571,79528,117043,6.834,16.892,22294,1.916,33.784,14256,14744,57354
1996,813,267133,275499,2499981,2463194,16102,5.952,6150,2.273,305270,55425,249845,2.250,12.393,231042,24938,206104,1.012,9.380,74228,3.013,18.760,4344,4387,16903
1997,211,6198,7340,98571,95241,726,9.804,856,11.560,27534,7985,19549,8.384,28.910,20728,7034,13694,7.385,21.764,6806,7.146,43.527,532,537,2360
1997,212,4539,6845,225958,225585,613,8.905,691,10.038,32805,11342,21463,5.028,14.542,31816,10776,21040,4.777,14.104,989,0.438,28.208,399,412,5133
1997,213,7008,8118,156738,155253,1103,13.600,1088,13.415,40939,16636,24303,10.715,26.369,37463,21466,15997,13.826,24.130,3476,2.239,48.261,688,692,6608
1997,221,6148,14887,687013,694491,925,6.216,915,6.148,55304,18765,36539,2.702,7.963,69777,12164,57613,1.751,10.047,-14473,-2.084,15.926,312,316,2458
1997,236,166000,167377,1338357,1310445,28604,17.319,24177,14.638,333054,104716,228338,7.991,25.415,276693,100749,175944,7.688,21.114,56361,4.301,42.229,17604,17612,74560
1997,237,39473,40409,734823,716194,4824,12.028,4221,10.524,164827,31977,132850,4.465,23.014,127540,31532,96008,4.403,17.808,37287,5.206,35.616,3100,3104,18389
1997,238,364818,368166,3437820,3330920,50834,13.984,41517,11.421,818031,218881,599150,6.571,24.559,605995,203788,402207,6.118,18.193,212036,6.366,36.386,31875,31925,154965
1997,311,20750,25096,1440029,1447445,2416,9.623,2435,9.699,146891,34062,112829,2.353,10.148,161716,56916,104800,3.932,11.173,-14825,-1.024,20.297,1760,1792,23019
1997,312,1991,2454,168059,166501,281,11.686,182,7.569,15736,3505,12231,2.105,9.451,12868,3022,9846,1.815,7.729,2868,1.723,15.457,131,134,1929
1997,313,4244,5107,401634,404257,472,9.099,633,12.202,39560,10932,28628,2.704,9.786,45124,17618,27506,4.358,11.162,-5564,-1.376,19.572,470,477,6265
1997,314,7206,7592,238482,237645,787,10.317,859,11.261,31473,9085,22388,3.823,13.244,29791,11172,18619,4.701,12.536,1682,0.708,25.072,670,672,7687
1997,315,13428,14505,680550,700365,2335,15.867,2757,18.735,105285,40002,65283,5.712,15.033,144781,69393,75388,9.908,20.672,-39496,-5.639,30.066,2343,2361,44984
1997,316,1580,1713,89514,90264,147,8.507,177,10.243,10161,2914,7247,3.228,11.257,11496,4550,6946,5.041,12.736,-1335,-1.479,22.514,143,143,1498
1997,321,14341,16055,558091,549548,1428,8.883,1468,9.132,73046,15518,57528,2.824,13.292,55667,17668,37999,3.215,10.130,17379,3.162,20.259,1149,1153,10185
1997,322,3606,5672,572881,573195,290,5.084,355,6.223,47899,19575,28324,3.415,8.357,48669,23041,25628,4.020,8.491,-770,-0.134,16.713,188,190,3675
1997,323,38425,40293,823855,828073,2668,6.531,3779,9.251,92769,23594,69175,2.849,11.203,101441,39898,61543,4.818,12.250,-8672,-1.047,22.406,3069,3076,21077
1997,324,1100,2067,128182,129072,118,5.685,135,6.504,10530,5309,5221,4.113,8.158,12229,3980,8249,3.084,9.475,-1699,-1.316,16.317,60,63,737
1997,325,8852,12606,889279,890373,917,7.260,965,7.641,82659,16615,66044,1.866,9.284,83267,25543,57724,2.869,9.352,-608,-0.068,18.567,541,557,6783
1997,326,12670,15667,991988,981473,1112,7.106,1075,6.870,117698,29156,88542,2.971,11.992,96539,32369,64170,3.298,9.836,21159,2.156,19.672,728,745,15928
1997,327,10987,15309,491021,486228,1098,7.181,1061,6.939,60122,14219,45903,2.924,12.365,50265,14129,36136,2.906,10.338,9857,2.027,20.676,700,707,6483
1997,331,3947,4962,578025,577999,275,5.530,297,5.972,43643,12103,31540,2.094,7.551,43474,9646,33828,1.669,7.521,169,0.029,15.043,202,204,4114
1997,332,54112,57924,1691181,1667433,4373,7.593,3705,6.433,200414,42094,158320,2.524,12.019,152960,46028,106932,2.760,9.173,47454,2.846,18.347,2776,2785,24787
1997,333,26284,28867,1396904,1385441,1995,6.926,1873,6.502,152173,39571,112602,2.856,10.984,128073,36324,91749,2.622,9.244,24100,1.740,18.488,1387,1393,15914
1997,334,13990,15906,1574350,1560573,1394,8.775,1354,8.523,186252,45215,141037,2.897,11.935,159580,52159,107421,3.342,10.226,26672,1.709,20.451,932,934,13001
1997,335,5407,6458,571096,570006,424,6.544,467,7.207,50302,11032,39270,1.935,8.825,48213,17829,30384,3.128,8.458,2089,0.366,16.917,288,289,4250
1997,336,10159,12044,1780570,1751327,1046,8.689,1035,8.597,199426,43366,156060,2.476,11.387,138554,54132,84422,3.091,7.911,60872,3.476,15.823,619,624,9792
1997,337,18046,18936,593842,589228,1966,10.386,1954,10.322,73205,17416,55789,2.956,12.424,63808,24390,39418,4.139,10.829,9397,1.595,21.658,1484,1489,12951
1997,339,27566,28715,702353,699298,2733,9.519,2722,9.481,91639,26656,64983,3.812,13.104,84984,29755,55229,4.255,12.153,6655,0.952,24.306,2160,2180,17587
1997,423,180944,231690,2975430,2933263,23703,10.215,24410,10.520,528926,156539,372387,5.337,18.032,444319,177749,266570,6.060,15.148,84607,2.884,30.295,15295,15918,92594
1997,424,103182,129983,2122317,2109795,14261,10.921,15466,11.844,354568,102416,252152,4.854,16.806,330273,136047,194226,6.448,15.654,24295,1.152,31.309,10172,10424,68769
1997,425,33751,36123,288875,286231,4061,11.314,3602,10.035,53347,16679,36668,5.827,18.638,48330,22432,25898,7.837,16.885,5017,1.753,33.770,2348,2366,10936
1997,441,88743,115796,1731980,1712146,10724,9.292,9960,8.630,238049,82015,156034,4.790,13.904,198292,73091,125201,4.269,11.581,39757,2.322,23.163,6742,6997,46049
1997,442,43718,59896,485078,482255,6825,11.424,6517,10.909,91011,36478,54533,7.564,18.872,85896,30867,55029,6.401,17.811,5115,1.061,35.623,4055,4400,17228
1997,443,31828,48759,427593,424692,6395,13.218,5636,11.650,92232,42323,49909,9.966,21.717,86797,33887,52910,7.979,20.438,5435,1.280,40.875,3350,3509,16300
1997,444,66188,91727,1157720,1128033,6796,7.430,6271,6.856,184074,77063,107011,6.832,16.318,126616,46442,80174,4.117,11.224,57458,5.094,22.449,4030,4220,21520
1997,445,98818,134571,2864956,2868029,14801,10.926,16581,12.240,411961,203945,208016,7.111,14.364,418510,140467,278043,4.898,14.592,-6549,-0.228,28.728,11069,11365,58257
1997,446,41279,78281,892935,836506,8358,10.771,6994,9.013,224213,68143,156070,8.146,26.804,112961,48021,64940,5.741,13.504,111252,13.300,27.008,4062,4493,26166
1997,447,65689,118055,906073,908523,10079,8.494,11278,9.505,164464,64812,99652,7.134,18.102,167732,63805,103927,7.023,18.462,-3268,-0.360,36.205,7066,7527,39553
1997,448,65309,144444,1230488,1237727,15509,10.501,22003,14.898,245657,103952,141705,8.399,19.847,256129,114118,142011,9.220,20.693,-10472,-0.846,39.695,8271,9812,37022
1997,451,38872,55621,488987,495473,6082,10.788,7593,13.468,91556,36754,54802,7.418,18.479,103598,40787,62811,8.232,20.909,-12042,-2.430,36.957,4681,5119,22044
1997,452,9090,33776,2507582,2459927,3261,9.611,3566,10.510,356231,92492,263739,3.760,14.481,265737,71723,194014,2.916,10.803,90494,3.679,21.605,1441,1819,12020
1997,453,94106,116313,748978,732729,16303,14.119,14610,12.653,169214,74141,95073,10.118,23.094,137073,54125,82948,7.387,18.707,32141,4.386,37.414,10728,11074,36838
1997,454,32130,39638,486091,478759,4908,12.467,4367,11.093,89881,33425,56456,6.982,18.774,75556,29928,45628,6.251,15.782,14325,2.992,31.563,2907,3005,15701
1997,481,2057,4603,515845,505713,492,11.062,181,4.070,50827,7974,42853,1.577,10.051,30869,832,30037,0.165,6.104,19958,3.947,12.208,112,115,603
1997,483,1231,1678,70947,68776,183,11.114,120,7.288,12743,4453,8290,6.475,18.528,8307,2272,6035,3.304,12.078,4436,6.450,24.157,56,56,1031
1997,484,79001,90623,1324382,1310386,14776,16.396,13766,15.276,247769,84983,162786,6.485,18.908,220008,89557,130451,6.834,16.790,27761,2.119,33.579,10369,10517,53341
1997,485,12642,14385,326905,321550,2003,14.003,1841,12.871,64792,23842,40950,7.415,20.150,54517,23785,30732,7.397,16.954,10275,3.195,33.909,1330,1348,11608
1997,486,188,2265,47488,49138,221,9.721,238,10.468,6077,2675,3402,5.444,12.367,9328,3115,6213,6.339,18.983,-3251,-6.616,24.734,29,29,648
1997,487,1587,1665,22611,22044,246,14.608,284,16.865,5771,2384,3387,10.815,26.180,4749,2256,2493,10.234,21.544,1022,4.636,43.088,201,201,972
1997,488,21986,27609,402152,386967,4049,14.916,3122,11.501,92084,38709,53375,10.003,23.796,62821,26135,36686,6.754,16.234,29263,7.562,32.468,2069,2115,14152
1997,492,6117,9871,530656,529886,1458,14.993,1165,11.980,58121,14559,43562,2.748,10.969,55614,12628,42986,2.383,10.495,2507,0.473,20.991,868,892,9119
1997,493,6405,11586,499677,487653,1543,13.618,1033,9.117,105700,39686,66014,8.138,21.675,81470,25304,56166,5.189,16.707,24230,4.969,33.413,395,415,5321
1997,511,24413,29586,946909,928518,3823,13.125,2907,9.980,157903,49107,108796,5.289,17.006,120321,44348,75973,4.776,12.958,37582,4.048,25.917,2102,2124,19975
1997,512,13821,18235,270386,262371,2772,15.352,2414,13.370,69901,39688,30213,15.127,26.642,54787,19640,35147,7.486,20.881,15114,5.761,41.763,1494,1560,8159
1997,515,6122,8425,267319,264139,1038,12.073,1384,16.097,55101,20810,34291,7.878,20.861,48337,25503,22834,9.655,18.300,6764,2.561,36.600,900,946,12375
1997,517,11103,35030,1178144,1153261,6005,17.501,4569,13.316,255705,98089,157616,8.505,22.172,203868,77406,126462,6.712,17.678,51837,4.495,35.355,1540,1607,16125
1997,518,4169,7399,305042,304428,1429,19.237,1488,20.031,64881,30322,34559,9.960,21.312,63483,23905,39578,7.852,20.853,1398,0.459,41.706,558,566,6138
1997,519,2712,3327,47100,47294,261,7.840,265,7.960,8407,2829,5578,5.982,17.776,8430,1829,6601,3.867,17.825,-23,-0.049,35.552,190,194,807
1997,521,12,42,22130,22401,0,0.000,(D),(D),171,0,171,0.000,0.763,729,(D),697,(D),3.254,-558,-2.491,1.527,0,0,0
1997,522,45343,160111,2592344,2569201,22765,14.513,16251,10.361,573967,268012,305955,10.432,22.340,525100,256477,268623,9.983,20.438,48867,1.902,40.877,3281,4028,34151
1997,523,31654,51124,727620,687446,9252,18.616,6401,12.880,197972,57782,140190,8.405,28.798,113942,44885,69057,6.529,16.575,84030,12.224,33.149,2886,2923,16646
1997,524,116463,159438,2295365,2285392,17703,11.092,18026,11.295,356386,132732,223654,5.808,15.594,336189,136400,199789,5.968,14.710,20197,0.884,29.421,7965,8133,34991
1997,525,3159,3900,73119,66116,659,17.922,213,5.793,24438,14201,10237,21.479,36.963,11082,2536,8546,3.836,16.762,13356,20.201,33.523,124,124,1655
1997,531,171737,193630,1138555,1131411,25090,13.034,22814,11.852,246479,99969,146510,8.836,21.785,232671,110822,121849,9.795,20.565,13808,1.220,41.129,16243,16582,70466
1997,532,33117,57437,553183,532007,8663,15.304,7001,12.368,135880,56447,79433,10.610,25.541,94124,38931,55193,7.318,17.692,41756,7.849,35.385,4550,4978,25174
1997,533,1627,1749,18789,18831,284,16.560,216,12.595,5101,2112,2989,11.216,27.089,5242,2650,2592,14.073,27.838,-141,-0.749,54.178,153,153,2123
1997,541,518998,562463,5652670,5503479,80442,14.582,58821,10.663,1203893,423586,780307,7.697,21.875,903090,343486,559604,6.241,16.409,300803,5.466,32.819,42043,42653,201681
1997,551,27804,50221,3177821,3189393,5062,9.941,6458,12.683,594592,171243,423349,5.369,18.643,613219,223181,390038,6.998,19.227,-18627,-0.584,37.286,1304,1406,24581
1997,561,239132,279269,6651826,6398179,48196,17.745,32874,12.103,1888373,713218,1175155,11.147,29.514,1381871,476846,905025,7.453,21.598,506502,7.916,43.196,23583,23984,267927
1997,562,12791,15173,280815,278144,1940,12.930,1602,10.677,61156,23208,37948,8.344,21.987,55838,17755,38083,6.383,20.075,5318,1.912,40.150,1109,1142,9393
1997,611,50205,56352,2198837,2151720,6791,12.323,4300,7.803,226834,43965,182869,2.043,10.542,132013,21477,110536,0.998,6.135,94821,4.407,12.270,3243,3278,15591
1997,621,368359,422118,4318783,4224810,41946,10.001,36534,8.711,931247,378850,552397,8.967,22.042,740853,302493,438360,7.160,17.536,190394,4.507,35.072,25580,26487,175094
1997,622,3170,5573,4463867,4476745,307,5.488,350,6.256,377232,121633,255599,2.717,8.426,402774,122257,280517,2.731,8.997,-25542,-0.571,16.853,147,165,60650
1997,623,29003,54143,2404416,2367701,6133,11.565,3907,7.368,348892,149695,199197,6.322,14.735,275230,101335,173895,4.280,11.624,73662,3.111,23.249,2350,2449,58192
1997,624,85301,114420,1651405,1618379,12340,10.909,9737,8.608,287223,79733,207490,4.927,17.748,221819,62038,159781,3.833,13.706,65404,4.041,27.412,6495,6675,38428
1997,711,23282,23699,304433,296891,4188,17.951,3450,14.788,75369,24813,50556,8.358,25.386,60694,21463,39231,7.229,20.443,14675,4.943,40.886,2458,2467,14717
1997,712,4682,5049,89887,86635,366,7.355,220,4.421,12261,1669,10592,1.926,14.152,5635,939,4696,1.084,6.504,6626,7.648,13.009,140,140,604
1997,713,46931,52162,1114930,1097286,5879,11.307,5542,10.659,197429,73812,123617,6.727,17.992,162886,63230,99656,5.762,14.844,34543,3.148,29.689,4134,4180,42811
1997,721,40768,49681,1624298,1604057,6521,13.321,5067,10.351,285021,142124,142897,8.860,17.769,245170,103813,141357,6.472,15.284,39851,2.484,30.569,3338,3406,60339
1997,722,317120,430918,7608826,7548548,62713,14.631,58122,13.560,1608966,875143,733823,11.594,21.315,1482570,623733,858837,8.263,19.640,126396,1.674,39.281,40788,42302,380229
1997,811,196326,214274,1297473,1285486,26086,12.231,24106,11.302,254767,99966,154801,7.777,19.819,231152,101062,130090,7.862,17.982,23615,1.837,35.963,17759,18042,65105
1997,812,140235,172117,1197264,1186430,20936,12.157,21121,12.265,236194,96646,139548,8.146,19.908,215493,91706,123787,7.730,18.163,20701,1.745,36.326,14759,15340,58225
1997,813,262650,269679,2421651,2379132,15008,5.655,6392,2.409,310215,51644,258571,2.171,13.039,225299,30445,194854,1.280,9.470,84916,3.569,18.940,4319,4344,19369
1998,211,6089,7265,95253,97924,644,8.801,748,10.223,16532,5622,10910,5.741,16.883,21866,5128,16738,5.237,22.330,-5334,-5.447,33.765,463,469,1624
1998,212,4446,6756,222297,224134,534,7.833,657,9.637,29770,7877,21893,3.514,13.282,33342,11193,22149,4.994,14.876,-3572,-1.594,26.565,367,380,4927
1998,213,7054,8123,171433,164587,1046,12.864,1063,13.073,46564,13741,32823,8.349,28.292,32893,16440,16453,9.989,19.985,13671,8.306,39.970,676,712,8469
1998,221,6179,15440,688461,688295,1402,9.245,851,5.612,69525,34205,35320,4.970,10.101,69691,10706,58985,1.555,10.125,-166,-0.024,20.202,278,286,2071
1998,236,168604,170000,1401649,1375079,26721,15.828,24365,14.432,338444,107930,230514,7.849,24.613,285221,95494,189727,6.945,20.742,53223,3.871,41.484,17265,17273,66129
1998,237,40093,41146,768110,757982,4752,11.636,4141,10.139,157710,35975,121735,4.746,20.807,137414,30973,106441,4.086,18.129,20296,2.678,36.258,3010,3021,18300
1998,238,370902,374654,3597675,3524899,49170,13.244,42400,11.420,801782,221463,580319,6.283,22.746,655137,202827,452310,5.754,18.586,146645,4.160,37.172,31721,31745,152698
1998,311,20992,25394,1452201,1450922,2332,9.225,2104,8.323,146222,46116,100106,3.178,10.078,142689,36595,106094,2.522,9.834,3533,0.244,19.669,1506,1529,14047
1998,312,2001,2489,170295,170092,253,10.198,237,9.553,14753,3713,11040,2.183,8.674,14318,3292,11026,1.935,8.418,435,0.256,16.836,182,190,1722
1998,313,4058,4921,391976,396316,346,6.925,497,9.947,30871,8722,22149,2.201,7.789,39342,14051,25291,3.545,9.927,-8471,-2.137,15.579,360,369,5153
1998,314,7117,7501,231071,235518,724,9.607,794,10.536,26254,7651,18603,3.249,11.147,35372,13918,21454,5.910,15.019,-9118,-3.871,22.295,612,618,7286
1998,315,13159,14132,631948,658527,1855,12.930,2285,15.927,84366,28387,55979,4.311,12.811,137451,52447,85004,7.964,20.872,-53085,-8.061,25.623,1795,1816,33346
1998,316,1581,1704,80983,85199,157,9.176,171,9.994,5999,1487,4512,1.745,7.041,14636,6090,8546,7.148,17.179,-8637,-10.137,14.082,120,120,1062
1998,321,14520,16247,577563,570730,1466,9.059,1339,8.274,72762,19097,53665,3.346,12.749,59085,18305,40780,3.207,10.353,13677,2.396,20.705,998,1002,9403
1998,322,3652,5747,571474,573795,303,5.282,281,4.899,43525,14967,28558,2.608,7.585,47525,18518,29007,3.227,8.283,-4000,-0.697,15.171,151,153,2865
1998,323,37703,39534,835693,834223,2457,6.152,3262,8.168,93627,20459,73168,2.452,11.223,90503,30734,59769,3.684,10.849,3124,0.374,21.698,2587,2598,19595
1998,324,1117,2139,128599,129350,182,8.611,131,6.198,12684,3311,9373,2.560,9.806,13851,5889,7962,4.553,10.708,-1167,-0.902,19.612,54,56,537
1998,325,9002,12878,906560,898995,1027,8.034,836,6.540,88032,29662,58370,3.299,9.792,73526,18451,55075,2.052,8.179,14506,1.614,16.357,511,518,6736
1998,326,12696,15765,1015256,1006125,1080,6.860,1039,6.599,119990,33191,86799,3.299,11.926,101936,37622,64314,3.739,10.132,18054,1.794,20.263,686,702,17079
1998,327,11036,15477,498954,495331,1119,7.254,1016,6.586,56831,15531,41300,3.135,11.473,49477,12650,36827,2.554,9.989,7354,1.485,19.977,621,629,6033
1998,331,4052,5114,596368,589538,320,6.305,243,4.788,49878,15440,34438,2.619,8.461,36112,9150,26962,1.552,6.125,13766,2.335,12.251,155,155,1927
1998,332,55434,59425,1783877,1745594,4616,7.849,3390,5.764,223827,55945,167882,3.205,12.822,147206,42341,104865,2.426,8.433,76621,4.389,16.866,2526,2538,21850
1998,333,26433,29100,1435646,1422980,1783,6.126,1796,6.170,150694,35558,115136,2.499,10.590,125447,39796,85651,2.797,8.816,25247,1.774,17.632,1292,1301,14928
1998,334,14182,16215,1637528,1608980,1459,9.050,1272,7.890,214820,54779,160041,3.405,13.351,158458,51241,107217,3.185,9.848,56362,3.503,19.697,844,853,12004
1998,335,5495,6587,581521,578772,483,7.373,411,6.274,57745,11974,45771,2.069,9.977,51549,16952,34597,2.929,8.907,6196,1.071,17.813,236,237,2517
1998,336,10263,12261,1847637,1822168,1021,8.373,888,7.282,176793,47148,129645,2.587,9.702,126346,30681,95665,1.684,6.934,50447,2.769,13.868,610,617,9988
1998,337,18160,19050,613616,604893,1946,10.235,1874,9.856,81020,18551,62469,3.067,13.394,63691,24301,39390,4.017,10.529,17329,2.865,21.059,1419,1432,13581
1998,339,27805,28991,722368,717622,2831,9.794,2659,9.199,97458,27896,69562,3.887,13.581,88097,34474,53623,4.804,12.276,9361,1.304,24.552,2032,2039,13661
1998,423,181531,233052,3116936,3066445,22941,9.849,22669,9.733,538183,166603,371580,5.433,17.551,434709,165391,269318,5.394,14.176,103474,3.374,28.353,14643,15149,87659
1998,424,103293,130549,2179522,2162537,13692,10.487,13722,10.510,338717,104627,234090,4.838,15.663,303327,107352,195975,4.964,14.026,35390,1.637,28.053,9332,9671,57382
1998,425,33957,36331,292931,292249,3431,9.459,3310,9.126,48845,16420,32425,5.619,16.714,47141,17428,29713,5.963,16.130,1704,0.583,32.261,2186,2222,9719
1998,441,89233,116655,1767709,1761279,9979,8.558,9877,8.471,238313,91515,146798,5.196,13.531,223644,74775,148869,4.245,12.698,14669,0.833,25.396,6394,6724,45775
1998,442,44385,59847,511810,501005,5778,9.613,6295,10.473,97681,36149,61532,7.215,19.497,76036,30306,45730,6.049,15.177,21645,4.320,30.353,3554,3788,15190
1998,443,32678,49530,436600,434286,5662,11.467,5357,10.849,82165,32077,50088,7.386,18.920,77663,32226,45437,7.420,17.883,4502,1.037,35.766,3248,3407,14644
1998,444,66201,91898,1176707,1169393,5573,6.059,5731,6.231,157402,45200,112202,3.865,13.460,142459,45981,96478,3.932,12.182,14943,1.278,24.365,3685,3842,18949
1998,445,98806,134253,2908695,2895053,14017,10.404,14970,11.111,404885,168104,236781,5.807,13.985,372495,156491,216004,5.405,12.867,32390,1.119,25.733,9858,10152,59552
1998,446,41255,79235,937542,917463,6907,8.751,6289,7.968,172972,65456,107516,7.134,18.853,133631,47566,86065,5.185,14.565,39341,4.288,29.131,3400,3705,20738
1998,447,65437,117832,940319,926546,9482,8.028,10039,8.500,181033,63139,117894,6.814,19.538,153294,55891,97403,6.032,16.545,27739,2.994,33.089,5715,6361,32617
1998,448,64927,145247,1289832,1264189,14323,9.866,14172,9.762,251322,94655,156667,7.487,19.880,201485,74594,126891,5.901,15.938,49837,3.942,31.876,6643,7319,26540
1998,451,38694,55432,519575,506578,5855,10.517,6337,11.383,100751,44880,55871,8.859,19.889,75193,31404,43789,6.199,14.843,25558,5.045,29.687,3991,4313,15897
1998,452,9121,34386,2521533,2514060,3368,9.870,2840,8.323,238011,95178,142833,3.786,9.467,222425,44491,177934,1.770,8.847,15586,0.620,17.694,1054,1197,5630
1998,453,95536,118324,800925,779004,14424,12.258,13112,11.143,171314,68325,102989,8.771,21.991,127216,47771,79445,6.132,16.331,44098,5.661,32.661,9562,9799,32700
1998,454,32715,40190,503179,496632,4773,11.944,4319,10.807,87143,29212,57931,5.882,17.547,74318,28307,46011,5.700,14.964,12825,2.582,29.929,3093,3147,14554
1998,481,2107,4766,532560,524137,582,12.520,347,7.465,51030,9041,41989,1.725,9.736,34750,4198,30552,0.801,6.630,16280,3.106,13.260,205,217,2603
1998,483,1246,1716,71974,71640,239,14.104,196,11.567,13606,5660,7946,7.901,18.992,12950,6532,6418,9.118,18.077,656,0.916,36.153,104,121,2576
1998,484,81372,93154,1385784,1359067,14874,16.170,12534,13.626,245351,76102,169249,5.600,18.053,192411,74098,118313,5.452,14.158,52940,3.895,28.315,9430,9611,44313
1998,485,12794,14602,338916,335706,1838,12.651,1690,11.633,56903,19199,37704,5.719,16.950,50764,16615,34149,4.949,15.122,6139,1.829,30.243,1320,1349,10746
1998,486,194,2446,45807,46435,372,15.676,226,9.524,7662,3117,4545,6.713,16.500,8776,2990,5786,6.439,18.900,-1114,-2.399,33.001,8,12,160
1998,487,1644,1718,23055,23000,242,14.227,208,12.228,5077,2103,2974,9.143,22.074,4965,1986,2979,8.635,21.587,112,0.487,43.174,155,156,1225
1998,488,22632,29046,457261,431056,4219,14.867,2884,10.163,114420,63909,50511,14.826,26.544,64933,21721,43212,5.039,15.064,49487,11.480,30.127,1964,2030,11956
1998,492,6403,10386,531406,530904,1680,16.580,1173,11.577,62903,24851,38052,4.681,11.848,58493,14131,44362,2.662,11.018,4410,0.831,22.035,790,800,4639
1998,493,6495,11911,505616,503298,1325,11.248,1062,9.016,91601,35751,55850,7.103,18.200,88082,34794,53288,6.913,17.501,3519,0.699,35.002,336,356,4165
1998,511,24323,29794,980137,963751,3388,11.437,3047,10.286,150272,45859,104413,4.758,15.592,116618,39549,77069,4.104,12.100,33654,3.492,24.201,2128,2163,15565
1998,512,14279,18625,279067,275401,2716,14.710,2393,12.961,65469,29916,35553,10.863,23.772,57898,24963,32935,9.064,21.023,7571,2.749,42.046,1439,1518,9404
1998,515,5895,8410,270478,270572,1028,12.133,1153,13.609,44178,18886,25292,6.980,16.328,44294,23248,21046,8.592,16.371,-116,-0.043,32.655,759,827,12019
1998,517,11790,39329,1267511,1226754,9064,24.338,4891,13.133,328435,156050,172385,12.721,26.773,244955,116175,128780,9.470,19.968,83480,6.805,39.935,1595,1685,15935
1998,518,4524,8125,325624,317297,1505,19.358,804,10.342,73730,27501,46229,8.667,23.237,57258,21042,36216,6.632,18.046,16472,5.191,36.091,382,389,3631
1998,519,2824,3450,51892,49869,358,10.623,198,5.875,8898,3060,5838,6.136,17.843,4935,1315,3620,2.637,9.896,3963,7.947,19.792,129,135,708
1998,521,15,44,21936,22033,3,6.977,(D),(D),488,42,446,0.191,2.215,683,(D),664,(D),3.100,-195,-0.885,4.430,0,0,0
1998,522,47607,162255,2669106,2641120,18459,11.436,16762,10.385,519167,194415,324752,7.361,19.657,471343,207304,264039,7.849,17.846,47824,1.811,35.693,2903,3434,29711
1998,523,33363,54720,729514,736837,9824,18.526,6440,12.145,154206,56582,97624,7.679,20.928,171004,59394,111610,8.061,23.208,-16798,-2.280,41.856,2895,2953,15922
1998,524,116981,161835,2326027,2309181,18937,11.819,15710,9.805,408180,142645,265535,6.177,17.676,378376,154047,224329,6.671,16.386,29804,1.291,32.771,7462,7627,29302
1998,525,2052,2831,38917,37133,610,22.295,420,15.351,13918,7597,6321,20.459,37.481,10207,4300,5907,11.580,27.488,3711,9.994,54.975,263,267,2264
1998,531,174957,197372,1175693,1168307,24446,12.479,21493,10.972,250000,102786,147214,8.798,21.398,234083,99986,134097,8.558,20.036,15917,1.362,40.072,14755,15151,62542
1998,532,32503,57382,590404,573751,6940,12.074,7132,12.408,128393,44576,83817,7.769,22.378,95083,42173,52910,7.350,16.572,33310,5.806,33.144,3958,4814,24790
1998,533,1671,1789,19906,19778,231,12.959,218,12.230,4166,1452,2714,7.342,21.064,3909,1014,2895,5.127,19.765,257,1.299,39.530,143,143,723
1998,541,542549,588988,6214123,5966453,84618,14.695,58281,10.121,1367246,512739,854507,8.594,22.916,869393,315927,553466,5.295,14.571,497853,8.344,29.143,40183,40581,163603
1998,551,28047,50203,3244225,3217932,5487,10.884,5910,11.723,617858,180006,437852,5.594,19.200,565592,195945,369647,6.089,17.576,52266,1.624,35.153,1126,1198,17317
1998,561,245113,289522,7409588,7070873,45651,16.182,30826,10.927,1972192,663810,1308382,9.388,27.892,1283904,408287,875617,5.774,18.158,688288,9.734,36.315,22007,22513,224982
1998,562,12944,15662,290899,288963,2009,12.971,1661,10.724,53195,21764,31431,7.532,18.409,49422,19476,29946,6.740,17.103,3773,1.306,34.206,1201,1220,10951
1998,611,51774,57986,2333986,2284261,6546,11.515,4272,7.515,244443,50388,194055,2.206,10.701,144706,24068,120638,1.054,6.335,99737,4.366,12.670,3114,3146,14153
1998,621,369930,425409,4430307,4401375,35341,8.323,33722,7.942,773696,264500,509196,6.009,17.579,714942,258887,456055,5.882,16.244,58754,1.335,32.487,23279,24059,143610
1998,622,4169,6686,4932586,4901351,277,4.171,188,2.831,318694,83374,235320,1.701,6.502,257610,78356,179254,1.599,5.256,61084,1.246,10.512,54,54,31906
1998,623,29757,56555,2500761,2458698,6216,11.221,3897,7.035,350983,139345,211638,5.667,14.275,263249,106155,157094,4.318,10.707,87734,3.568,21.414,2068,2232,47582
1998,624,87393,116948,1740085,1704400,11656,10.061,9463,8.168,302742,85315,217427,5.006,17.762,231461,62588,168873,3.672,13.580,71281,4.182,27.160,6266,6450,35771
1998,711,24268,24722,311798,310438,4214,17.346,3358,13.822,72788,27647,45141,8.906,23.447,69273,24003,45270,7.732,22.315,3515,1.132,44.629,2234,2243,12098
1998,712,4824,5185,94866,92923,343,6.679,244,4.751,11475,1438,10037,1.548,12.349,7552,957,6595,1.030,8.127,3923,4.222,16.254,144,144,656
1998,713,47546,52901,1164174,1139069,5864,11.152,5231,9.948,203235,70920,132315,6.226,17.842,152839,52779,100060,4.634,13.418,50396,4.424,26.836,3720,3813,36685
1998,721,41852,51175,1687980,1666695,6017,11.909,4715,9.332,298608,152695,145913,9.162,17.916,252491,115102,137389,6.906,15.149,46117,2.767,30.298,2955,3041,48098
1998,722,319197,431669,7752626,7697962,52367,12.128,52602,12.182,1510371,694698,815673,9.024,19.620,1395266,580732,814534,7.544,18.125,115105,1.495,36.250,34770,35787,310533
1998,811,197922,215955,1321791,1314736,24062,11.171,22957,10.658,241048,93420,147628,7.106,18.334,226522,88310,138212,6.717,17.229,14526,1.105,34.459,16720,16951,58340
1998,812,142274,175008,1245048,1226751,22577,13.004,19803,11.406,251122,110901,140221,9.040,20.470,213170,90658,122512,7.390,17.377,37952,3.094,34.754,13280,13962,55095
1998,813,265493,272846,2470582,2440847,14932,5.571,5337,1.991,300557,54175,246382,2.220,12.314,240824,21120,219704,0.865,9.866,59733,2.447,19.733,3580,3608,13456
1999,211,5698,6875,85693,90595,563,7.966,948,13.414,11722,5130,6592,5.663,12.939,21544,6375,15169,7.037,23.781,-9822,-10.842,25.878,570,581,2833
1999,212,4344,6756,215771,219545,616,9.117,617,9.132,24561,8418,16143,3.834,11.187,32322,9842,22480,4.483,14.722,-7761,-3.535,22.374,367,380,4034
1999,213,6629,7699,143995,157168,731,9.242,1152,14.565,22234,5823,16411,3.705,14.147,47888,15028,32860,9.562,30.469,-25654,-16.323,28.293,776,798,9373
1999,221,6161,15938,662661,670553,1564,9.967,1073,6.838,68422,31504,36918,4.698,10.204,83246,22892,60354,3.414,12.415,-14824,-2.211,20.408,279,301,2254
1999,236,173302,174822,1501881,1453258,27395,15.885,22658,13.139,367581,109775,257806,7.554,25.294,270646,90305,180341,6.214,18.623,96935,6.670,37.247,16368,16376,67015
1999,237,40645,41772,814428,788595,4991,12.079,4087,9.891,176998,38979,138019,4.943,22.445,125056,35712,89344,4.529,15.858,51942,6.587,31.716,3050,3058,25104
1999,238,378758,382719,3848960,3718099,49349,13.042,40697,10.755,877374,217037,660337,5.837,23.597,615768,200922,414846,5.404,16.561,261606,7.036,33.123,30341,30371,148880
1999,311,20498,24828,1457195,1455180,2030,8.130,2311,9.256,148528,34850,113678,2.395,10.207,145249,52121,93128,3.582,9.982,3279,0.225,19.963,1671,1699,20157
1999,312,2017,2507,166908,168460,207,8.247,213,8.486,13439,1587,11852,0.942,7.978,16410,5225,11185,3.102,9.741,-2971,-1.764,15.955,153,155,2124
1999,313,3916,4758,371033,381345,330,6.825,485,10.030,29555,10811,18744,2.835,7.750,49607,11871,37736,3.113,13.008,-20052,-5.258,15.500,374,376,4648
1999,314,7004,7393,228209,229739,642,8.629,736,9.892,29280,10758,18522,4.683,12.745,32093,11095,20998,4.829,13.969,-2813,-1.224,25.490,558,570,6792
1999,315,12430,13266,548631,587031,1684,12.301,2533,18.502,71047,25506,45541,4.345,12.103,148258,64624,83634,11.009,25.256,-77211,-13.153,24.206,1950,1969,32481
1999,316,1502,1612,74026,77394,117,7.048,213,12.831,6769,1738,5031,2.246,8.746,13522,4402,9120,5.688,17.472,-6753,-8.725,17.492,152,152,1904
1999,321,14513,16316,594498,586097,1388,8.504,1401,8.583,74041,18595,55446,3.173,12.633,57543,19092,38451,3.257,9.818,16498,2.815,19.636,1074,1077,12508
1999,322,3615,5747,564328,566805,293,5.097,296,5.149,48836,19985,28851,3.526,8.616,54156,22066,32090,3.893,9.555,-5320,-0.939,17.232,166,168,3936
1999,323,36638,38457,829043,832437,2275,5.840,3273,8.402,84622,22593,62029,2.714,10.166,91377,35853,55524,4.307,10.977,-6755,-0.811,20.331,2557,2573,21525
1999,324,1098,2164,124147,125002,139,6.447,123,5.705,9542,2843,6699,2.274,7.633,11217,4047,7170,3.238,8.973,-1675,-1.340,15.267,56,59,902
1999,325,8959,12861,894779,900078,838,6.502,891,6.914,78129,24002,54127,2.667,8.680,88425,27749,60676,3.083,9.824,-10296,-1.144,17.361,531,537,8729
1999,326,12509,15710,1025390,1020913,1027,6.527,1078,6.851,112682,29020,83662,2.843,11.037,103165,32056,71109,3.140,10.105,9517,0.932,20.210,698,706,12894
1999,327,10953,15602,505255,502366,1069,6.876,958,6.162,58660,13222,45438,2.632,11.677,52525,13321,39204,2.652,10.456,6135,1.221,20.911,625,632,6407
1999,331,4101,5196,574250,584167,340,6.563,309,5.965,38441,10449,27992,1.789,6.580,58545,16596,41949,2.841,10.022,-20104,-3.441,13.161,183,190,3692
1999,332,55058,59235,1762105,1774339,3768,6.351,3954,6.665,176957,44434,132523,2.504,9.973,201393,55603,145790,3.134,11.350,-24436,-1.377,19.946,2926,2938,29762
1999,333,26083,28791,1391734,1416775,1610,5.563,1913,6.610,113834,28321,85513,1.999,8.035,164224,39637,124587,2.798,11.591,-50390,-3.557,16.069,1373,1381,15726
1999,334,13886,15934,1576918,1607144,1259,7.842,1500,9.343,175202,56578,118624,3.520,10.901,234056,71337,162719,4.439,14.563,-58854,-3.662,21.803,1006,1017,20069
1999,335,5467,6558,566742,574992,432,6.568,471,7.161,45991,11408,34583,1.984,7.999,62263,19543,42720,3.399,10.828,-16272,-2.830,15.997,296,300,4759
1999,336,10146,12206,1862525,1858158,931,7.599,1023,8.350,159527,39060,120467,2.102,8.585,150723,39024,111699,2.100,8.111,8804,0.474,16.223,698,702,14342
1999,337,18128,19013,627221,620162,1700,8.942,1695,8.916,73147,14100,59047,2.274,11.795,58557,18493,40064,2.982,9.442,14590,2.353,18.884,1292,1301,10739
1999,339,27738,28970,715183,718763,2652,9.148,2691,9.283,88338,23777,64561,3.308,12.290,94791,24654,70137,3.430,13.188,-6453,-0.898,24.581,2075,2082,14075
1999,423,179738,233341,3172561,3146022,21756,9.318,22059,9.447,499841,156106,343735,4.962,15.888,446322,167289,279033,5.317,14.187,53519,1.701,28.374,14794,15600,96215
1999,424,101933,129172,2212307,2204194,11880,9.143,13406,10.317,312277,90014,222263,4.084,14.167,296288,111760,184528,5.070,13.442,15989,0.725,26.884,9291,9584,57163
1999,425,33700,36015,288574,290484,2992,8.283,3202,8.865,40605,11526,29079,3.968,13.978,44224,17124,27100,5.895,15.224,-3619,-1.246,27.957,2202,2224,10771
1999,441,88355,116511,1812505,1787440,9790,8.399,9879,8.476,244485,79553,164932,4.451,13.678,195050,75359,119691,4.216,10.912,49435,2.766,21.825,6712,7126,52131
1999,442,44307,60149,529759,521420,5585,9.308,5289,8.815,91075,33124,57951,6.353,17.467,74965,27503,47462,5.275,14.377,16110,3.090,28.754,3377,3665,14583
1999,443,32801,49863,460339,447704,5486,11.038,5164,10.390,91506,34279,57227,7.657,20.439,66254,31016,35238,6.928,14.799,25252,5.640,29.597,3429,3606,17542
1999,444,65507,91266,1226536,1199202,5457,5.967,5830,6.375,175075,62977,112098,5.252,14.599,122191,41641,80550,3.472,10.189,52884,4.410,20.379,4009,4219,23531
1999,445,99102,135342,2982989,2946911,15104,11.188,14433,10.691,403327,191704,211623,6.505,13.686,332527,120116,212411,4.076,11.284,70800,2.403,22.568,9467,9659,52272
1999,446,40373,78033,933254,935669,5741,7.305,6846,8.712,146206,42386,103820,4.530,15.626,151668,55209,96459,5.900,16.210,-5462,-0.584,31.252,3582,4001,23731
1999,447,63340,115268,927001,932606,8645,7.424,10998,9.445,159450,58609,100841,6.284,17.097,171525,62919,108606,6.747,18.392,-12075,-1.295,34.195,6121,6534,32958
1999,448,63073,142461,1290779,1291935,12128,8.432,14885,10.348,223098,79554,143544,6.158,17.269,222670,79665,143005,6.166,17.235,428,0.033,34.471,6650,7389,28239
1999,451,37815,54435,527763,523885,5154,9.388,6082,11.079,82240,36436,45804,6.955,15.698,74122,29908,44214,5.709,14.149,8118,1.550,28.297,3966,4287,16159
1999,452,9202,35681,2486289,2503739,3326,9.492,2045,5.836,224587,64422,160165,2.573,8.970,261286,33532,227754,1.339,10.436,-36699,-1.466,17.940,1046,1132,5089
1999,453,95440,118714,828467,822582,14000,11.805,13768,11.609,160408,68231,92177,8.295,19.501,149641,54440,95201,6.618,18.192,10767,1.309,36.383,9652,10055,35750
1999,454,32707,40443,526833,516361,4688,11.640,4351,10.803,97150,33754,63396,6.537,18.814,75798,28034,47764,5.429,14.679,21352,4.135,29.359,3173,3237,18569
1999,481,2217,4828,553105,538295,566,12.186,199,4.285,49513,8445,41068,1.569,9.198,19989,996,18993,0.185,3.713,29524,5.485,7.427,131,133,452
1999,483,1248,1710,68985,70544,199,11.631,201,11.748,10926,3059,7867,4.336,15.488,13491,7771,5720,11.016,19.124,-2565,-3.636,30.976,106,110,1702
1999,484,83845,96141,1448059,1420732,15737,16.619,12846,13.566,286198,116269,169929,8.184,20.144,229146,83135,146011,5.852,16.129,57052,4.016,32.257,9707,9890,50203
1999,485,12798,14768,359388,350795,1845,12.531,1756,11.927,62411,21478,40933,6.123,17.791,44797,19966,24831,5.692,12.770,17614,5.021,25.540,1348,1363,11473
1999,486,192,2401,43205,44531,218,8.999,261,10.774,5558,2197,3361,4.934,12.481,8197,2340,5857,5.255,18.407,-2639,-5.926,24.962,15,17,93
1999,487,1668,1745,23392,23279,239,13.787,216,12.460,4171,1320,2851,5.670,17.918,3971,1412,2559,6.066,17.059,200,0.859,34.117,163,163,1263
1999,488,23045,28991,440847,433770,3580,12.460,3060,10.651,82755,32385,50370,7.466,19.078,67811,26242,41569,6.050,15.633,14944,3.445,31.266,2067,2166,15260
1999,492,6611,10730,575053,553287,1435,13.583,1104,10.450,72810,16681,56129,3.015,13.160,31308,9810,21498,1.773,5.659,41502,7.501,11.317,855,872,6669
1999,493,6615,12212,531068,518630,1256,10.390,1008,8.339,102660,43132,59528,8.317,19.794,77904,26919,50985,5.190,15.021,24756,4.773,30.042,319,381,7225
1999,511,23585,29337,989823,987345,3094,10.495,3380,11.465,143271,47136,96135,4.774,14.511,138713,48868,89845,4.949,14.049,4558,0.462,28.098,2340,2396,23975
1999,512,14421,18928,275609,277610,2883,15.349,2593,13.805,66768,31226,35542,11.248,24.051,69250,19482,49768,7.018,24.945,-2482,-0.894,48.102,1510,1587,8329
1999,515,5698,8323,278036,274801,1045,12.458,1175,14.008,51122,27528,23594,10.017,18.603,45680,25466,20214,9.267,16.623,5442,1.980,33.246,727,789,11823
1999,517,13009,42173,1325467,1301457,9537,23.328,6956,17.015,349082,162849,186233,12.513,26.822,304091,148632,155459,11.420,23.365,44991,3.457,46.731,1744,1869,20809
1999,518,4966,8950,345076,335395,1585,18.555,769,9.003,69698,27168,42530,8.100,20.781,50937,16945,33992,5.052,15.187,18761,5.594,30.374,427,433,3333
1999,519,3010,3672,58137,54897,430,12.052,222,6.222,12157,4861,7296,8.855,22.145,5654,2250,3404,4.099,10.299,6503,11.846,20.599,146,148,1318
1999,521,14,43,22876,22385,(D),(D),0,0.000,1109,(D),1007,(D),4.954,113,0,113,0.000,0.505,996,4.449,1.010,0,0,0
1999,522,49423,166547,2763043,2720305,21658,13.161,17698,10.754,543567,218633,324934,8.037,19.982,461660,220772,240888,8.116,16.971,81907,3.011,33.942,3740,4902,49967
1999,523,34579,58048,764095,737192,9701,17.211,6336,11.241,160775,50272,110503,6.819,21.809,108807,48612,60195,6.594,14.760,51968,7.049,29.519,3140,3267,17721
1999,524,117132,164770,2358182,2361738,19418,11.907,16048,9.840,403771,163351,240420,6.917,17.096,412941,154244,258697,6.531,17.485,-9170,-0.388,34.193,7910,8182,34151
1999,525,1320,2048,58567,47930,651,34.962,279,14.984,27158,4800,22358,10.015,56.662,5300,2802,2498,5.846,11.058,21858,45.604,22.116,47,154,1836
1999,531,178740,203701,1213115,1197999,27227,13.544,21881,10.885,257746,119009,138737,9.934,21.515,228761,99120,129641,8.274,19.095,28985,2.419,38.191,15703,16162,63080
1999,532,31052,58994,616025,607308,7843,13.456,6425,11.023,122251,56501,65750,9.304,20.130,103906,40582,63324,6.682,17.109,18345,3.021,34.219,3905,4412,24954
1999,533,1681,1798,22541,21332,229,12.761,222,12.371,5253,2653,2600,12.437,24.625,2879,1084,1795,5.082,13.496,2374,11.129,26.992,151,151,700
1999,541,559919,610736,6583141,6411749,84336,14.065,62126,10.361,1340705,462836,877869,7.219,20.910,995887,356818,639069,5.565,15.532,344818,5.378,31.064,43314,43894,190778
1999,551,28056,51439,3244237,3251947,6733,13.270,5332,10.509,570685,211006,359679,6.489,17.549,583195,189667,393528,5.832,17.934,-12510,-0.385,35.098,1282,1353,25691
1999,561,246093,292973,7953101,7681218,42044,14.590,32449,11.260,2105824,686045,1419779,8.931,27.415,1550548,509207,1041341,6.629,20.186,555276,7.229,40.372,22757,23208,267858
1999,562,12739,15425,290585,291125,1888,12.142,2137,13.743,55846,19465,36381,6.686,19.183,56108,30561,25547,10.498,19.273,-262,-0.090,38.366,1452,1494,13364
1999,611,52938,59467,2425859,2376559,6659,11.423,4315,7.402,241390,54679,186711,2.301,10.157,144180,22201,121979,0.934,6.067,97210,4.090,12.134,3161,3222,15011
1999,621,368495,423269,4403668,4421839,35067,8.267,36922,8.704,769262,265041,504221,5.994,17.397,803137,351376,451761,7.946,18.163,-33875,-0.766,34.794,24210,25362,174940
1999,622,4057,6579,4915667,4923646,221,3.334,320,4.828,288466,75469,212997,1.533,5.859,309117,123325,185792,2.505,6.278,-20651,-0.419,11.718,81,84,19394
1999,623,29887,58424,2529558,2520374,6230,10.840,4323,7.522,333450,134439,199011,5.334,13.230,315502,131178,184324,5.205,12.518,17948,0.712,25.036,2372,2610,64438
1999,624,88311,119242,1812854,1781612,11605,9.820,9474,8.017,278081,83609,194472,4.693,15.608,215724,59153,156571,3.320,12.108,62357,3.500,24.217,6437,6621,37471
1999,711,25008,25482,326876,318868,4192,16.680,3491,13.891,72537,24612,47925,7.719,22.748,56263,18980,37283,5.952,17.645,16274,5.104,35.289,2355,2368,12469
1999,712,4987,5377,100226,97544,362,6.836,199,3.758,11180,1370,9810,1.405,11.462,5715,818,4897,0.839,5.859,5465,5.603,11.718,129,129,689
1999,713,47811,53424,1191808,1174875,5592,10.517,5089,9.571,194690,59575,135115,5.071,16.571,159007,51249,107758,4.362,13.534,35683,3.037,27.068,3775,3836,35253
1999,721,42003,51927,1720077,1710360,5494,10.659,4723,9.163,245220,114420,130800,6.690,14.337,227017,99372,127645,5.810,13.273,18203,1.064,26.546,3191,3296,48718
1999,722,318987,433018,7917154,7835716,51905,12.005,50602,11.703,1504499,768484,736015,9.807,19.201,1342833,551497,791336,7.038,17.137,161666,2.063,34.275,33737,35633,323952
1999,811,197199,215232,1334753,1328005,22451,10.415,23112,10.722,238140,88478,149662,6.662,17.932,225022,92907,132115,6.996,16.944,13118,0.988,33.889,16599,16965,60755
1999,812,141931,175480,1260288,1254237,19951,11.423,18307,10.482,220305,93806,126499,7.479,17.565,208231,82968,125263,6.615,16.602,12074,0.963,33.204,13224,13708,54794
1999,813,267388,274997,2539051,2494258,14763,5.460,5543,2.050,302355,52199,250156,2.093,12.122,213090,23544,189546,0.944,8.543,89265,3.579,17.086,3579,3605,13905
2000,211,5653,6895,79128,81673,707,10.265,692,10.047,14089,6000,8089,7.346,17.250,19499,6119,13380,7.492,23.874,-5410,-6.624,34.501,415,417,1489
2000,212,4321,6755,209177,213593,609,9.007,622,9.199,27602,12253,15349,5.737,12.923,36885,11918,24967,5.580,17.269,-9283,-4.346,25.845,370,384,4661
2000,213,6503,7701,165271,157252,880,11.409,904,11.720,43328,12309,31019,7.828,27.553,27572,7633,19939,4.854,17.534,15756,10.020,35.067,595,608,3304
2000,221,6404,16468,647767,654896,1624,10.030,1071,6.615,71576,32801,38775,5.009,10.929,86396,23276,63120,3.554,13.192,-14820,-2.263,21.859,301,321,2568
2000,236,174249,175862,1573427,1536025,24156,13.790,22775,13.002,365585,92916,272669,6.049,23.801,289775,95446,194329,6.214,18.865,75810,4.935,37.731,16343,16374,67163
2000,237,41536,42875,896073,854632,5301,12.523,4209,9.944,208609,52066,156543,6.092,24.409,125383,30340,95043,3.550,14.671,83226,9.738,29.342,3128,3133,20935
2000,238,385149,389727,4118843,3988612,49029,12.695,41996,10.874,927757,233618,694139,5.857,23.260,667992,211535,456457,5.303,16.747,259765,6.513,33.495,30961,30986,154928
2000,311,20175,24542,1471059,1465285,1996,8.112,2124,8.632,155682,39796,115886,2.716,10.625,143603,49757,93846,3.396,9.800,12079,0.824,19.601,1488,1508,16745
2000,312,2067,2511,152146,159628,255,10.119,273,10.833,17684,6070,11614,3.803,11.078,31611,21265,10346,13.322,19.803,-13927,-8.725,22.157,157,157,1887
2000,313,3752,4545,345912,357870,287,6.193,465,10.035,27172,7040,20132,1.967,7.593,51211,18073,33138,5.050,14.310,-24039,-6.717,15.185,337,342,6137
2000,314,6870,7267,222372,225656,661,9.019,785,10.711,28782,8667,20115,3.841,12.755,35017,11118,23899,4.927,15.518,-6235,-2.763,25.510,619,622,6761
2000,315,12141,12830,482209,512470,1837,14.053,2320,17.749,69390,27348,42042,5.337,13.540,129391,58483,70908,11.412,25.249,-60001,-11.708,27.081,1790,1821,29508
2000,316,1475,1567,66695,70325,125,7.837,181,11.348,5123,1072,4051,1.524,7.285,12308,4035,8273,5.738,17.502,-7185,-10.217,14.569,126,128,1454
2000,321,14475,16296,599054,597328,1343,8.234,1370,8.400,70651,18908,51743,3.165,11.828,67065,20531,46534,3.437,11.227,3586,0.600,22.455,1026,1035,10162
2000,322,3562,5693,565401,565056,269,4.706,314,5.494,49391,23073,26318,4.083,8.741,49199,22167,27032,3.923,8.707,192,0.034,17.414,171,174,2902
2000,323,35167,36975,811006,818382,2032,5.399,3349,8.899,77697,17686,60011,2.161,9.494,92902,35234,57668,4.305,11.352,-15205,-1.858,18.988,2637,2654,20340
2000,324,1054,2119,123168,123157,129,6.041,162,7.586,9755,1875,7880,1.522,7.921,9746,3046,6700,2.473,7.914,9,0.007,15.827,55,55,751
2000,325,8965,12803,892400,891046,803,6.259,855,6.665,77849,20148,57701,2.261,8.737,75840,20392,55448,2.289,8.511,2009,0.225,17.023,476,491,6486
2000,326,12227,15503,1043187,1035598,885,5.675,1070,6.861,115295,26052,89243,2.516,11.133,100236,31734,68502,3.064,9.679,15059,1.454,19.358,689,696,11506
2000,327,10801,15704,517799,510973,1114,7.118,1007,6.434,62973,15584,47389,3.050,12.324,48986,15089,33897,2.953,9.587,13987,2.737,19.174,651,666,6946
2000,331,4247,5361,593760,584656,404,7.602,311,5.852,63072,29732,33340,5.085,10.788,46913,10804,36109,1.848,8.024,16159,2.764,16.048,201,202,2872
2000,332,54376,58680,1780027,1771534,3574,6.064,4090,6.939,199111,47901,151210,2.704,11.239,183104,54327,128777,3.067,10.336,16007,0.904,20.672,3044,3061,27113
2000,333,25452,28236,1386784,1392037,1499,5.267,1950,6.851,133028,35483,97545,2.549,9.556,144214,42460,101754,3.050,10.360,-11186,-0.804,19.113,1384,1392,17429
2000,334,13583,15680,1533442,1551921,1249,7.919,1432,9.080,194510,50004,144506,3.222,12.533,227507,92999,134508,5.993,14.660,-32997,-2.126,25.067,919,931,15668
2000,335,5438,6545,583612,576507,435,6.630,467,7.118,65299,19614,45685,3.402,11.327,51092,16261,34831,2.821,8.862,14207,2.464,17.725,308,309,3676
2000,336,9987,12065,1830955,1845931,928,7.668,1004,8.295,179562,43873,135689,2.377,9.727,211140,69017,142123,3.739,11.438,-31578,-1.711,19.455,677,679,11398
2000,337,18060,18983,652414,639268,1716,9.043,1704,8.979,84131,20429,63702,3.196,13.161,58031,19288,38743,3.017,9.078,26100,4.083,18.155,1289,1299,12254
2000,339,27719,28940,719777,716275,2628,9.093,2549,8.820,92771,24542,68229,3.426,12.952,85583,28250,57333,3.944,11.948,7188,1.004,23.897,1958,1964,13306
2000,423,179040,234452,3279243,3236696,22813,9.742,22239,9.497,555450,193245,362205,5.970,17.161,471253,186780,284473,5.771,14.560,84197,2.601,29.119,14372,15150,89167
2000,424,101205,127770,2250317,2235743,12144,9.445,13747,10.692,348984,106589,242395,4.767,15.609,320770,143537,177233,6.420,14.347,28214,1.262,28.695,8720,8989,57897
2000,425,33469,35712,291596,291050,2932,8.186,3146,8.783,45883,11249,34634,3.865,15.765,45119,18440,26679,6.336,15.502,764,0.262,31.004,2087,2111,9755
2000,441,88406,116986,1874427,1844394,10286,8.803,9996,8.555,251315,82393,168922,4.467,13.626,190525,81179,109346,4.401,10.330,60790,3.296,20.660,6438,6953,49471
2000,442,44474,60704,557160,544239,5853,9.682,5349,8.848,101250,41046,60204,7.542,18.604,75444,28276,47168,5.196,13.862,25806,4.742,27.725,3417,3846,17730
2000,443,32463,50195,486181,473601,5370,10.727,5103,10.193,92116,34020,58096,7.183,19.450,66551,25493,41058,5.383,14.052,25565,5.398,28.104,3616,3772,16862
2000,444,64755,90203,1280676,1252409,5374,5.928,6272,6.919,187053,57586,129467,4.598,14.935,130516,65698,64818,5.246,10.421,56537,4.514,20.842,4052,4261,23818
2000,445,100402,135805,2969900,2980026,14159,10.414,14472,10.644,383161,164251,218910,5.512,12.858,402501,170889,231612,5.734,13.507,-19340,-0.649,25.715,9290,9589,55939
2000,446,40082,77776,904712,920721,6446,8.273,6720,8.625,132619,51884,80735,5.635,14.404,162745,56722,106023,6.161,17.676,-30126,-3.272,28.808,3232,3511,19137
2000,447,61638,113825,936573,931386,8289,7.244,9494,8.297,160068,56775,103293,6.096,17.186,149205,54244,94961,5.824,16.020,10863,1.166,32.039,5623,6049,33167
2000,448,62076,142120,1371646,1332652,13912,9.774,14351,10.082,277586,103833,173753,7.791,20.830,198375,81645,116730,6.127,14.886,79211,5.944,29.771,6030,6600,24788
2000,451,36816,53385,545044,537308,4979,9.245,5922,10.996,99715,43043,56672,8.011,18.558,84178,32963,51215,6.135,15.667,15537,2.892,31.333,3720,4084,16909
2000,452,9152,37489,2563925,2525208,3911,10.693,2087,5.706,268473,102124,166349,4.044,10.632,187175,55931,131244,2.215,7.412,81298,3.219,14.825,995,1113,13643
2000,453,94284,118880,849072,839331,13245,11.152,13012,10.956,155358,64376,90982,7.670,18.510,135437,51089,84348,6.087,16.136,19921,2.373,32.273,9629,9926,35228
2000,454,34385,41987,563132,545150,5864,14.238,4260,10.344,111597,42102,69495,7.723,20.471,75969,27116,48853,4.974,13.935,35628,6.535,27.871,2957,3017,16125
2000,481,2291,4944,557677,538977,573,12.003,233,4.881,54290,6683,47607,1.240,10.073,16356,1678,14678,0.311,3.035,37934,7.038,6.069,145,147,804
2000,483,1260,1714,70213,69773,212,12.372,211,12.314,11536,2891,8645,4.143,16.534,10868,2313,8555,3.315,15.576,668,0.957,31.153,117,125,1319
2000,484,84418,96975,1490713,1470772,14837,15.357,14113,14.608,282228,92104,190124,6.262,19.189,245946,92032,153914,6.257,16.722,36282,2.467,33.444,10606,10791,49380
2000,485,12890,14891,376360,368285,1839,12.389,1745,11.756,57345,16756,40589,4.550,15.571,41206,18310,22896,4.972,11.189,16139,4.382,22.377,1296,1315,10568
2000,486,187,2840,50060,47770,766,28.917,384,14.496,15020,10163,4857,21.275,31.443,10695,4995,5700,10.456,22.389,4325,9.054,44.778,14,14,171
2000,487,1665,1746,24154,23564,203,11.623,204,11.681,4371,778,3593,3.302,18.549,3236,770,2466,3.268,13.733,1135,4.817,27.466,157,157,618
2000,488,23099,29130,476688,459365,3295,11.337,3164,10.886,98120,29691,68429,6.463,21.360,63890,26711,37179,5.815,13.908,34230,7.452,27.817,2078,2195,13251
2000,492,6711,11149,620305,598493,1808,16.514,1406,12.843,102819,26109,76710,4.362,17.180,57336,28894,28442,4.828,9.580,45483,7.600,19.160,890,942,6136
2000,493,6692,12300,549133,539951,1312,10.686,1268,10.327,104344,42840,61504,7.934,19.325,86192,34378,51814,6.367,15.963,18152,3.362,31.926,354,572,7992
2000,511,22997,29323,1019229,1052870,3519,11.990,3573,12.174,165552,56051,109501,5.324,15.724,231708,65774,165934,6.247,22.007,-66156,-6.283,31.448,2330,2404,23342
2000,512,14513,18827,293466,288933,2529,13.399,2624,13.902,66243,22698,43545,7.856,22.927,56646,26475,30171,9.163,19.605,9597,3.322,39.211,1566,1609,7882
2000,515,5508,8211,280498,278434,938,11.348,1047,12.667,41035,17956,23079,6.449,14.738,36838,17214,19624,6.182,13.230,4197,1.507,26.461,642,758,10944
2000,517,14994,45667,1444049,1386028,10806,24.552,7499,17.038,372221,187632,184589,13.537,26.855,251979,141913,110066,10.239,18.180,120242,8.675,36.360,2105,2548,27755
2000,518,5499,9399,362436,354430,2201,23.990,1752,19.096,86649,38829,47820,10.955,24.447,69994,28167,41827,7.947,19.748,16655,4.699,39.497,435,451,7502
2000,519,3674,4380,82963,73177,795,19.367,245,5.968,26012,13436,12576,18.361,35.547,6092,2603,3489,3.557,8.325,19920,27.222,16.650,128,131,1359
2000,521,14,43,22279,22575,(D),(D),0,0.000,332,(D),326,(D),1.471,918,0,918,0.000,4.067,-586,-2.596,2.941,0,0,0
2000,522,49370,170689,2735860,2754361,21044,12.480,16910,10.028,521859,244498,277361,8.877,18.947,560216,230872,329344,8.382,20.339,-38357,-1.393,37.893,4457,5477,43221
2000,523,36507,65156,850990,808870,13159,21.361,6054,9.827,184743,76877,107866,9.504,22.840,101016,43265,57751,5.349,12.489,83727,10.351,24.977,3172,3260,15453
2000,524,116498,159263,2280661,2305292,16577,10.235,21963,13.561,374572,120707,253865,5.236,16.248,424456,171428,253028,7.436,18.412,-49884,-2.164,32.497,8229,8565,38311
2000,525,2010,2806,36681,36441,957,39.448,197,8.120,10307,7209,3098,19.783,28.284,10021,1350,8671,3.705,27.500,286,0.785,54.999,62,73,408
2000,531,180433,205326,1259255,1241144,24691,12.061,23489,11.473,251759,101243,150516,8.157,20.284,214246,92273,121973,7.435,17.262,37513,3.022,34.524,15354,15793,54347
2000,532,29502,58309,627438,621629,5952,10.160,6495,11.087,114481,43321,71160,6.969,18.416,102163,46694,55469,7.512,16.435,12318,1.982,32.869,3901,4516,23435
2000,533,1684,1822,22531,22236,229,12.638,209,11.534,5131,1869,3262,8.405,23.076,4580,1877,2703,8.441,20.598,551,2.478,41.195,146,149,1252
2000,541,571296,625332,6974856,6771093,82372,13.346,66159,10.719,1454785,506010,948775,7.473,21.485,1045005,393263,651742,5.808,15.433,409780,6.052,30.867,45963,46552,200792
2000,551,28199,52476,3291882,3275404,6504,12.518,5467,10.522,623843,215907,407936,6.592,19.046,596809,186614,410195,5.697,18.221,27034,0.825,36.442,1271,1428,21540
2000,561,246067,294432,8712322,8358764,40534,13.931,33609,11.551,2259725,636127,1623598,7.610,27.034,1561217,590707,970510,7.067,18.678,698508,8.357,37.355,22420,22858,231807
2000,562,12401,15363,297418,293509,1927,12.548,1916,12.476,64464,23623,40841,8.048,21.963,56399,26996,29403,9.198,19.215,8065,2.748,38.431,1350,1383,13903
2000,611,54395,61425,2542910,2484500,6779,11.259,4350,7.225,263161,58855,204306,2.369,10.592,146107,20207,125900,0.813,5.881,117054,4.711,11.761,3131,3195,14547
2000,621,370580,425093,4537498,4472489,36105,8.510,34485,8.128,801410,267085,534325,5.972,17.919,674385,284616,389769,6.364,15.079,127025,2.840,30.157,21676,22796,132289
2000,622,4030,6651,4945066,4930798,373,5.638,303,4.580,296653,101698,194955,2.063,6.016,268096,90705,177391,1.840,5.437,28557,0.579,10.874,92,110,36978
2000,623,29951,60504,2585738,2557911,6455,10.858,4346,7.310,347422,143865,203557,5.624,13.582,291454,111712,179742,4.367,11.394,55968,2.188,22.788,2174,2360,47129
2000,624,89572,121757,1929086,1879328,11673,9.674,9495,7.869,307059,87537,219522,4.658,16.339,208378,61194,147184,3.256,11.088,98681,5.251,22.176,6318,6469,36430
2000,711,25759,26285,352313,340562,4190,16.155,3493,13.468,82245,24378,57867,7.158,24.150,58483,19456,39027,5.713,17.173,23762,6.977,34.345,2337,2341,12228
2000,712,5098,5502,108251,105708,346,6.335,265,4.852,12518,2030,10488,1.920,11.842,7430,1041,6389,0.985,7.029,5088,4.813,14.058,158,159,595
2000,713,47931,53531,1268865,1227237,5377,10.047,5356,10.007,226137,64970,161167,5.294,18.427,142440,50940,91500,4.151,11.607,83697,6.820,23.213,3797,4015,34480
2000,721,42218,52583,1772544,1752543,5268,10.081,4612,8.826,251064,113074,137990,6.452,14.326,210771,81680,129091,4.661,12.027,40293,2.299,24.053,3021,3079,39939
2000,722,317694,433246,8134385,8026008,49023,11.321,48554,11.213,1495256,695922,799334,8.671,18.630,1277190,514107,763083,6.406,15.913,218066,2.717,31.826,32917,34715,303313
2000,811,194861,211797,1347729,1341388,20354,9.542,23369,10.956,233458,83131,150327,6.197,17.404,220540,93798,126742,6.993,16.441,12918,0.963,32.882,16279,16746,60381
2000,812,141894,176897,1286559,1274792,20683,11.760,18626,10.591,228874,95832,133042,7.517,17.954,205669,81673,123996,6.407,16.134,23205,1.820,32.267,13146,13699,53889
2000,813,269480,277230,2642004,2582483,14510,5.319,5629,2.063,326917,54713,272204,2.119,12.659,208667,22018,186649,0.853,8.080,118250,4.579,16.160,3455,3469,11450
2001,211,5721,6974,86413,83035,712,10.271,628,9.059,19068,7688,11380,9.259,22.964,12054,4073,7981,4.905,14.517,7014,8.447,29.034,372,375,1595
2001,212,4295,6803,201969,205942,598,8.776,620,9.099,24047,7631,16416,3.705,11.677,32406,10721,21685,5.206,15.735,-8359,-4.059,23.353,380,386,3777
2001,213,6874,8151,195709,180817,1065,13.334,737,9.227,47000,10143,36857,5.610,25.993,17470,6529,10941,3.611,9.662,29530,16.331,19.323,487,508,3803
2001,221,6526,16748,651664,651405,1533,9.204,1350,8.105,82046,37301,44745,5.726,12.595,82435,23285,59150,3.575,12.655,-389,-0.060,25.190,301,332,3190
2001,236,176404,178088,1569349,1562165,24270,13.689,22691,12.798,323045,94274,228771,6.035,20.679,307883,96385,211498,6.170,19.709,15162,0.971,39.417,15588,15600,67092
2001,237,44086,45559,939946,932216,5150,11.383,4519,9.988,185041,43114,141927,4.625,19.850,170233,39337,130896,4.220,18.261,14808,1.588,36.522,3303,3305,25029
2001,238,378099,382832,4014995,3997506,45999,12.049,43840,11.484,801475,212333,589142,5.312,20.049,766366,244200,522166,6.109,19.171,35109,0.878,38.342,31431,31460,164834
2001,311,20158,24479,1463592,1469299,1999,8.137,2176,8.857,139956,33067,106889,2.251,9.525,151030,50324,100706,3.425,10.279,-11074,-0.754,19.051,1497,1522,20449
2001,312,2289,2804,169129,162456,333,12.138,212,7.727,29356,19285,10071,11.871,18.070,16979,2819,14160,1.735,10.451,12377,7.619,20.903,154,154,1486
2001,313,3617,4374,312977,329033,304,6.799,498,11.138,21576,6485,15091,1.971,6.557,53950,15458,38492,4.698,16.397,-32374,-9.839,13.115,346,352,4679
2001,314,6872,7261,207509,215606,645,8.804,776,10.592,19050,6578,12472,3.051,8.836,34992,11874,23118,5.507,16.230,-15942,-7.394,17.671,609,612,6869
2001,315,11586,12181,422137,452225,1630,13.013,2320,18.521,50324,19667,30657,4.349,11.128,110124,47118,63006,10.419,24.352,-59800,-13.224,22.256,1847,1876,28885
2001,316,1474,1554,57931,61758,147,9.417,161,10.314,5417,1421,3996,2.301,8.771,12907,4264,8643,6.904,20.899,-7490,-12.128,17.543,118,122,2242
2001,321,14469,16330,562336,583378,1293,7.881,1447,8.819,51260,17597,33663,3.016,8.787,93338,26622,66716,4.563,16.000,-42078,-7.213,17.574,1046,1063,14294
2001,322,3527,5606,539690,552437,219,3.871,323,5.709,32587,9592,22995,1.736,5.899,58128,25302,32826,4.580,10.522,-25541,-4.623,11.798,166,180,5125
2001,323,34227,36012,782109,794605,2089,5.725,3043,8.339,67031,16891,50140,2.126,8.436,92143,29122,63021,3.665,11.596,-25112,-3.160,16.872,2422,2431,19382
2001,324,1036,2150,105196,114278,179,8.361,161,7.520,8236,3691,4545,3.230,7.207,26859,16739,10120,14.648,23.503,-18623,-16.296,14.414,55,57,840
2001,325,8982,12784,882572,889461,805,6.267,929,7.232,77711,21526,56185,2.420,8.737,89962,26063,63899,2.930,10.114,-12251,-1.377,17.474,538,544,7407
2001,326,11981,15265,994639,1018901,775,5.033,1041,6.761,81723,23541,58182,2.310,8.021,130085,32784,97301,3.218,12.767,-48362,-4.746,16.041,672,682,13798
2001,327,10950,15996,519398,520430,1180,7.385,1145,7.166,57426,17492,39934,3.361,11.034,59024,16989,42035,3.264,11.341,-1598,-0.307,22.069,682,705,7557
2001,331,4306,5415,562136,579370,372,6.857,392,7.226,35400,10115,25285,1.746,6.110,70194,18452,51742,3.185,12.116,-34794,-6.005,12.220,256,258,4867
2001,332,54890,59255,1760460,1779137,3748,6.319,3873,6.529,178444,46257,132187,2.600,10.030,215916,58465,157451,3.286,12.136,-37472,-2.106,20.060,2856,2875,31815
2001,333,25133,27947,1343224,1366867,1476,5.233,1992,7.063,126393,29544,96849,2.161,9.247,173266,47112,126154,3.447,12.676,-46873,-3.429,18.494,1414,1422,15837
2001,334,13586,15750,1595397,1563381,1388,8.801,1429,9.061,237485,78678,158807,5.033,15.190,174454,59167,115287,3.785,11.159,63031,4.032,22.318,954,960,17465
2001,335,5304,6399,565772,575082,374,5.774,530,8.183,46206,10096,36110,1.756,8.035,64499,18131,46368,3.153,11.216,-18293,-3.181,16.069,365,368,4001
2001,336,9933,12048,1717588,1776107,872,7.200,999,8.248,107917,26686,81231,1.502,6.076,223954,36351,187603,2.047,12.609,-116037,-6.533,12.152,700,709,12270
2001,337,18833,19743,632219,647288,1769,8.967,1737,8.805,55753,13254,42499,2.048,8.613,85305,27613,57692,4.266,13.179,-29552,-4.566,17.227,1267,1276,13586
2001,339,27593,28837,705828,712664,2445,8.456,2600,8.992,75709,17506,58203,2.456,10.623,88837,25888,62949,3.633,12.465,-13128,-1.842,21.247,1971,1977,14220
2001,423,177143,234641,3363986,3336349,23016,9.807,23117,9.850,571672,216065,355607,6.476,17.135,517790,191116,326674,5.728,15.520,53882,1.615,31.039,14393,15137,95475
2001,424,100347,128716,2306399,2290090,13832,10.768,13304,10.357,361292,133276,228016,5.820,15.776,326087,121590,204497,5.309,14.239,35205,1.537,28.478,8761,9026,57451
2001,425,32899,35028,277037,285069,2714,7.682,3318,9.391,42427,15811,26616,5.546,14.883,58483,20642,37841,7.241,20.515,-16056,-5.632,29.766,2192,2218,10254
2001,441,88279,117133,1850338,1862573,9252,7.884,9684,8.252,206795,71050,135745,3.815,11.103,232259,76549,155710,4.110,12.470,-25464,-1.367,22.205,6687,6992,50305
2001,442,44978,61144,572054,566119,5868,9.590,5956,9.734,100112,35476,64636,6.267,17.684,88243,33868,54375,5.982,15.587,11869,2.097,31.175,3516,3965,17468
2001,443,32250,50598,489900,489838,5425,10.717,5466,10.798,83471,33325,50146,6.803,17.041,83589,29592,53997,6.041,17.065,-118,-0.024,34.081,3852,3992,19831
2001,444,65855,91633,1282593,1290489,5968,6.501,6314,6.878,168212,86572,81640,6.708,13.035,186597,48321,138276,3.744,14.459,-18385,-1.425,26.070,4158,4376,25842
2001,445,99769,134704,2909699,2937642,13713,10.139,14805,10.946,355245,146117,209128,4.974,12.093,412720,155803,256917,5.304,14.049,-57475,-1.957,24.186,9924,10199,60275
2001,446,39741,77486,946972,928333,5514,7.096,5959,7.668,141381,36915,104466,3.976,15.230,104843,37541,67302,4.044,11.294,36538,3.936,22.587,3206,3460,17934
2001,447,60320,112745,930259,935123,8510,7.510,9656,8.521,151955,55470,96485,5.932,16.250,161848,53706,108142,5.743,17.308,-9893,-1.058,32.499,5709,6259,32840
2001,448,61185,140352,1387588,1380576,13729,9.713,15722,11.123,252710,105085,147625,7.612,18.305,240487,90581,149906,6.561,17.419,12223,0.885,34.839,5925,8139,35701
2001,451,35982,52561,560273,553179,4615,8.706,5507,10.389,98639,35407,63232,6.401,17.831,84623,28437,56186,5.141,15.298,14016,2.534,30.595,3697,3928,17365
2001,452,8929,38006,2563933,2564620,2949,7.822,2341,6.209,239729,97134,142595,3.787,9.348,243046,76722,166324,2.992,9.477,-3317,-0.129,18.695,1074,1098,4451
2001,453,92793,117591,832696,842569,12320,10.416,13699,11.582,134809,52693,82116,6.254,16.000,154427,57885,96542,6.870,18.328,-19618,-2.328,32.000,9887,10252,37168
2001,454,34743,42407,563325,565643,5597,13.292,5000,11.874,99083,35591,63492,6.292,17.517,104077,38599,65478,6.824,18.400,-4994,-0.883,35.034,3505,3557,20588
2001,481,2309,5073,560296,556599,629,12.916,223,4.579,56243,8922,47321,1.603,10.105,50527,1330,49197,0.239,9.078,5716,1.027,18.156,164,168,1061
2001,483,1227,1696,72281,71920,184,10.814,195,11.460,12306,4044,8262,5.623,17.111,11597,3172,8425,4.410,16.125,709,0.986,32.250,115,124,2094
2001,484,84512,97577,1478758,1486266,14540,14.892,14662,15.017,234704,84779,149925,5.704,15.792,248863,99908,148955,6.722,16.744,-14159,-0.953,31.583,10866,11104,63112
2001,485,13008,15150,387721,383179,1936,12.864,1735,11.529,56674,21541,35133,5.622,14.790,47390,16284,31106,4.250,12.368,9284,2.423,24.735,1289,1310,9760
2001,486,196,2837,48355,49204,285,10.042,287,10.113,6410,2449,3961,4.977,13.027,8213,3218,4995,6.540,16.692,-1803,-3.664,26.055,6,6,16
2001,487,1728,1808,23667,23312,252,14.090,213,11.909,3795,992,2803,4.255,16.280,3097,1144,1953,4.907,13.285,698,2.994,26.571,162,162,768
2001,488,23495,29911,491957,486518,3754,12.676,3160,10.671,92197,32356,59841,6.651,18.950,80946,29912,51034,6.148,16.638,11251,2.313,33.276,2094,2158,12192
2001,492,6877,11453,578242,599092,1813,16.065,1478,13.096,41651,16459,25192,2.747,6.952,83090,14147,68943,2.361,13.869,-41439,-6.917,13.905,916,944,6956
2001,493,6833,12594,570443,561368,1491,11.926,1308,10.462,116932,47515,69417,8.464,20.830,98132,38888,59244,6.927,17.481,18800,3.349,34.962,372,423,5034
2001,511,22565,29705,1073185,1049048,3655,12.367,3356,11.355,187319,70481,116838,6.719,17.856,139266,55015,84251,5.244,13.275,48053,4.581,26.551,2258,2340,26330
2001,512,14755,18650,287685,291653,2504,13.294,2875,15.264,59807,18327,41480,6.284,20.506,66867,24735,42132,8.481,22.927,-7060,-2.421,41.013,1530,1574,7990
2001,515,5140,8965,289524,285282,2151,25.109,1354,15.806,68515,43533,24982,15.260,24.017,57865,37611,20254,13.184,20.283,10650,3.733,40.567,651,701,9273
2001,517,14399,52426,1638837,1547183,14663,29.978,7637,15.613,436457,265542,170915,17.163,28.210,264456,110515,153941,7.143,17.093,172001,11.117,34.185,2920,3243,37418
2001,518,5977,10807,413652,394682,2553,25.196,1204,11.883,100294,41401,58893,10.490,25.411,62550,19458,43092,4.930,15.848,37744,9.563,31.696,459,467,6719
2001,519,3870,4729,89747,84906,800,17.835,313,6.978,22167,9878,12289,11.634,26.108,12565,4122,8443,4.855,14.799,9602,11.309,29.597,221,238,2790
2001,521,15,52,22282,22443,(D),(D),(D),(D),346,(D),321,(D),1.542,656,(D),570,(D),2.923,-310,-1.381,3.083,0,0,0
2001,522,50038,175638,2908887,2821966,23395,13.500,18714,10.799,660721,291038,369683,10.313,23.414,480009,188047,291962,6.664,17.010,180712,6.404,34.019,4221,5154,40159
2001,523,38964,68010,908921,885528,11136,16.631,9034,13.492,208115,93358,114757,10.543,23.502,157617,69669,87948,7.868,17.799,50498,5.703,35.598,3489,3646,21951
2001,524,117629,154079,2327497,2312694,17682,11.264,23485,14.960,400677,165197,235480,7.143,17.325,367324,164453,202871,7.111,15.883,33353,1.442,31.766,8578,8887,35564
2001,525,2746,3565,44992,41115,1106,35.752,163,5.269,13984,8526,5458,20.737,34.012,6559,2220,4339,5.399,15.953,7425,18.059,31.906,69,72,715
2001,531,182402,209976,1295296,1283585,26190,12.589,22302,10.720,248007,109238,138769,8.510,19.321,224043,91325,132718,7.115,17.454,23964,1.867,34.909,15477,15922,57308
2001,532,28529,58840,641766,635691,6602,11.255,6237,10.633,119212,46786,72426,7.360,18.753,107144,40335,66809,6.345,16.855,12068,1.898,33.709,3470,3763,18845
2001,533,1737,1857,22692,22266,228,12.222,245,13.133,4646,1800,2846,8.084,20.866,3829,1728,2101,7.761,17.197,817,3.669,34.393,167,170,906
2001,541,584159,640843,7276186,7121592,86344,13.633,71324,11.262,1499032,520290,978742,7.306,21.049,1190220,428537,761683,6.017,16.713,308812,4.336,33.426,48820,49393,231756
2001,551,28118,52274,3284061,3295647,5658,10.804,5852,11.174,583607,195600,388007,5.935,17.708,607962,186797,421165,5.668,18.447,-24355,-0.739,35.417,1308,1351,24377
2001,561,250593,301324,8621216,8709084,41902,14.137,32059,10.816,1986560,647551,1339009,7.435,22.810,2171949,676144,1495805,7.764,24.939,-185389,-2.129,45.620,21548,21982,256228
2001,562,12974,16170,306750,305270,2052,12.889,1554,9.761,55727,21566,34161,7.065,18.255,52917,19933,32984,6.530,17.334,2810,0.920,34.669,1002,1017,8407
2001,611,54325,61474,2468712,2424080,6912,11.480,4385,7.283,241482,51552,189930,2.127,9.962,151199,24870,126329,1.026,6.237,90283,3.724,12.475,3152,3200,16682
2001,621,376750,433231,4680556,4615959,38905,9.061,31156,7.256,770066,253956,516110,5.502,16.683,641192,234666,406526,5.084,13.891,128874,2.792,27.782,20096,20854,117370
2001,622,3977,6546,5019462,4985058,274,4.156,368,5.582,283397,71198,212199,1.428,5.685,215440,75926,139514,1.523,4.322,67957,1.363,8.643,85,90,22233
2001,623,29744,62315,2637624,2602666,6636,10.833,4515,7.371,350591,140763,209828,5.408,13.470,281291,109452,171839,4.205,10.808,69300,2.663,21.616,2130,2361,50506
2001,624,88245,121680,1969370,1927538,12182,10.105,9922,8.231,309760,85970,223790,4.460,16.070,225412,67716,157696,3.513,11.694,84348,4.376,23.389,6382,6588,39227
2001,711,25937,26487,356927,351570,4247,16.201,3701,14.118,75898,29321,46577,8.340,21.588,65448,21289,44159,6.055,18.616,10450,2.972,37.232,2467,2472,12148
2001,712,4853,5268,107362,105830,327,6.254,249,4.762,10557,1760,8797,1.663,9.975,7611,1745,5866,1.649,7.192,2946,2.784,14.383,154,154,1103
2001,713,47950,53731,1279026,1270657,5464,10.190,5248,9.787,179948,56045,123903,4.411,14.162,163659,53867,109792,4.239,12.880,16289,1.282,25.760,3839,3905,36776
2001,721,42943,53446,1756921,1769960,5384,10.132,4773,8.982,223394,93554,129840,5.286,12.621,251769,104840,146929,5.923,14.225,-28375,-1.603,25.243,2991,3085,43890
2001,722,319625,437782,8229977,8191725,51902,11.898,48775,11.181,1428927,702724,726203,8.578,17.444,1354504,521353,833151,6.364,16.535,74423,0.909,33.070,32714,34429,320401
2001,811,193707,211018,1350320,1350378,21092,9.965,22374,10.571,227119,84021,143098,6.222,16.819,227090,88240,138850,6.534,16.817,29,0.002,33.634,16170,16414,58911
2001,812,140159,175171,1299986,1288898,19241,10.989,19088,10.902,221208,86474,134734,6.709,17.163,200075,83249,116826,6.459,15.523,21133,1.640,31.046,13247,13709,53361
2001,813,261218,269320,2595852,2560476,13806,5.206,5562,2.097,289983,50724,239259,1.981,11.325,218835,22242,196593,0.869,8.547,71148,2.779,17.093,3620,3643,13891
2002,211,5790,7066,84396,84947,692,9.781,710,10.035,18150,6921,11229,8.147,21.366,19388,9653,9735,11.364,22.824,-1238,-1.457,42.733,378,386,3777
2002,212,4279,6860,200396,204448,651,9.405,775,11.196,29871,10138,19733,4.959,14.611,37944,11899,26045,5.820,18.559,-8073,-3.949,29.221,357,360,3976
2002,213,6861,8427,195138,199535,1296,15.697,955,11.567,35951,18070,17881,9.056,18.017,45925,15373,30552,7.704,23.016,-9974,-4.999,36.035,551,557,4685
2002,221,6479,17334,664650,666071,1277,7.441,933,5.436,74263,36474,37789,5.476,11.149,77506,19937,57569,2.993,11.636,-3243,-0.487,22.299,339,350,2839
2002,236,176179,178044,1502385,1519655,26537,14.990,24506,13.843,319169,112515,206654,7.404,21.003,353466,108863,244603,7.164,23.260,-34297,-2.257,42.005,15798,15860,70537
2002,237,43894,45595,991840,1001073,5177,11.338,5307,11.623,200463,56735,143728,5.667,20.025,220569,53056,167513,5.300,22.033,-20106,-2.008,40.050,3486,3508,29419
2002,238,373561,378883,3953910,4011906,48706,12.839,49649,13.088,785252,245883,539369,6.129,19.573,901675,254617,647058,6.347,22.475,-116423,-2.902,39.146,33582,33612,177963
2002,311,20880,25430,1481671,1491538,2230,8.747,2357,9.245,160191,50091,110100,3.358,10.740,180279,60487,119792,4.055,12.087,-20088,-1.347,21.480,1621,1640,28992
2002,312,2244,2747,160996,164674,283,10.295,287,10.440,17720,3708,14012,2.252,10.761,25024,8236,16788,5.001,15.196,-7304,-4.435,21.521,182,186,3793
2002,313,3074,3727,268449,292007,282,7.215,645,16.502,20258,7813,12445,2.676,6.938,66467,27944,38523,9.570,22.762,-46209,-15.825,13.875,417,447,14247
2002,314,7145,7508,192293,201676,671,8.848,822,10.839,19329,8242,11087,4.087,9.584,38068,12202,25866,6.050,18.876,-18739,-9.292,19.168,639,647,7941
2002,315,10237,10686,324363,366626,1543,13.755,2607,23.239,44429,23057,21372,6.289,12.118,129183,62023,67160,16.917,35.236,-84754,-23.117,24.237,2139,2165,37637
2002,316,1343,1407,46326,50992,144,9.894,241,16.558,3656,1321,2335,2.591,7.170,12791,4936,7855,9.680,25.085,-9135,-17.915,14.340,171,172,1950
2002,321,14394,16236,539287,553981,1352,8.231,1732,10.544,57400,18855,38545,3.404,10.361,86729,29260,57469,5.282,15.656,-29329,-5.294,20.723,1238,1262,15376
2002,322,3431,5431,504007,526557,243,4.397,435,7.870,28434,9725,18709,1.847,5.400,74182,24929,49253,4.734,14.088,-45748,-8.688,10.800,241,246,9192
2002,323,33662,35448,720776,759106,2144,5.935,3496,9.678,57209,21056,36153,2.774,7.536,133888,42798,91090,5.638,17.638,-76679,-10.101,15.073,2750,2771,26371
2002,324,1036,2163,96412,100130,162,7.495,159,7.356,8132,2728,5404,2.724,8.121,15635,7906,7729,7.896,15.615,-7503,-7.493,16.243,52,53,2557
2002,325,9109,12930,853687,877095,905,6.941,1123,8.613,76403,21108,55295,2.407,8.711,122150,34373,87777,3.919,13.927,-45747,-5.216,17.422,607,620,11151
2002,326,11754,14979,932923,971285,906,5.972,1292,8.516,82654,30959,51695,3.187,8.510,159709,48788,110921,5.023,16.443,-77055,-7.933,17.020,800,825,21462
2002,327,10677,15814,471663,494754,1184,7.458,1309,8.245,45493,14155,31338,2.861,9.195,92143,24743,67400,5.001,18.624,-46650,-9.429,18.390,754,786,13370
2002,331,3987,5037,494609,529245,323,6.251,584,11.301,26090,10144,15946,1.917,4.930,94755,29207,65548,5.519,17.904,-68665,-12.974,9.859,389,405,10144
2002,332,54726,58929,1577159,1673937,3687,6.186,5036,8.449,141735,50192,91543,2.998,8.467,334722,93809,240913,5.604,19.996,-192987,-11.529,16.934,3486,3533,50216
2002,333,24352,27164,1198006,1282976,1504,5.433,2542,9.183,89519,31952,57567,2.490,6.977,259883,60534,199349,4.718,20.256,-170364,-13.279,13.955,1742,1750,25840
2002,334,13001,15045,1275101,1438226,1122,7.273,1884,12.213,123557,42999,80558,2.990,8.591,451386,127958,323428,8.897,31.385,-327829,-22.794,17.182,1192,1217,42835
2002,335,5228,6236,497445,535158,436,6.877,644,10.158,31073,12795,18278,2.391,5.806,106319,25656,80663,4.794,19.867,-75246,-14.061,11.613,378,383,10549
2002,336,9881,12000,1576090,1658417,897,7.399,1144,9.436,118853,38342,80511,2.312,7.167,281958,57488,224470,3.466,17.002,-163105,-9.835,14.333,773,799,24272
2002,337,19898,20877,599272,622956,1806,8.627,1919,9.167,60578,19798,40780,3.178,9.724,108041,32401,75640,5.201,17.343,-47463,-7.619,19.449,1373,1384,18118
2002,339,28727,29988,713392,735572,2412,7.992,2793,9.255,79367,24314,55053,3.305,10.790,123854,34675,89179,4.714,16.838,-44487,-6.048,21.580,2042,2058,18494
2002,423,177789,238679,3308151,3416531,22495,9.316,28085,11.631,518296,188066,330230,5.505,15.170,730464,276879,453585,8.104,21.380,-212168,-6.210,30.340,15706,16871,139826
2002,424,101172,129202,2242116,2296546,13146,10.079,15604,11.963,346006,127101,218905,5.534,15.066,455271,177676,277595,7.737,19.824,-109265,-4.758,30.133,9216,9622,87804
2002,425,29045,30905,246690,244594,2945,9.408,3739,11.945,53804,17377,36427,7.104,21.997,50204,26167,24037,10.698,20.525,3600,1.472,41.051,2228,2251,14188
2002,441,88449,116838,1871967,1853478,10956,9.369,11166,9.548,292187,113170,179017,6.106,15.764,254617,105660,148957,5.701,13.737,37570,2.027,27.475,7483,7713,71289
2002,442,43690,59466,538283,548089,7068,11.821,7717,12.907,106079,50822,55257,9.273,19.354,124697,61444,63253,11.211,22.751,-18618,-3.397,38.709,4179,5224,44818
2002,443,29562,48341,446801,454638,6059,12.477,6500,13.385,74243,35668,38575,7.845,16.330,89425,38811,50614,8.537,19.670,-15182,-3.339,32.660,4150,4448,23056
2002,444,59930,82308,1184130,1171884,6790,8.182,8151,9.822,199414,100661,98753,8.590,17.017,178374,69008,109366,5.889,15.221,21040,1.795,30.442,4983,5447,47566
2002,445,96912,131804,2814947,2852656,15423,11.712,15191,11.536,338472,159194,179278,5.581,11.865,417276,126105,291171,4.421,14.628,-78804,-2.762,23.730,10357,10600,63846
2002,446,38283,77075,938704,932562,7589,9.900,6756,8.813,182176,83528,98648,8.957,19.535,168340,47007,121333,5.041,18.051,13836,1.484,36.103,3390,3974,21919
2002,447,60509,114015,926392,943050,9967,8.698,11112,9.697,171576,68824,102752,7.298,18.194,206367,65696,140671,6.966,21.883,-34791,-3.689,36.387,5983,6718,37205
2002,448,58855,139200,1383147,1382425,15372,11.065,14820,10.668,293653,138762,154891,10.038,21.242,290550,89157,201393,6.449,21.017,3103,0.224,42.035,6606,7691,39355
2002,451,33999,50246,535249,544038,5171,10.193,6138,12.099,101370,39179,62191,7.202,18.633,118248,39152,79096,7.197,21.735,-16878,-3.102,37.266,3766,4225,24248
2002,452,8169,37969,2582157,2566550,3383,8.988,2725,7.240,227892,84315,143577,3.285,8.879,203082,44177,158905,1.721,7.913,24810,0.967,15.825,1136,1410,7350
2002,453,90738,115885,793632,810017,14460,12.406,15800,13.556,149411,67628,81783,8.349,18.445,181712,73583,108129,9.084,22.433,-32301,-3.988,36.891,10452,11160,45264
2002,454,41047,48923,561739,576406,6386,13.177,5467,11.281,111190,52159,59031,9.049,19.290,140610,62220,78390,10.794,24.394,-29420,-5.104,38.580,3585,3666,33556
2002,481,2343,4967,530695,554518,548,11.126,465,9.441,36456,8224,28232,1.483,6.574,83369,4700,78669,0.848,15.034,-46913,-8.460,13.149,260,283,3114
2002,483,1216,1692,65144,69068,152,8.879,192,11.215,11472,4423,7049,6.404,16.610,19080,7392,11688,10.702,27.625,-7608,-11.015,33.219,106,106,2527
2002,484,83447,96451,1432068,1454092,13911,14.292,15671,16.101,237090,80226,156864,5.517,16.305,280839,97808,183031,6.726,19.314,-43749,-3.009,32.610,11111,11453,66064
2002,485,13220,15508,379862,382664,2052,13.268,1967,12.719,65258,31066,34192,8.118,17.054,71047,29045,42002,7.590,18.566,-5789,-1.513,34.107,1449,1467,17698
2002,486,187,2590,39854,40280,200,7.508,348,13.063,7803,4350,3453,10.800,19.372,8636,6223,2413,15.450,21.440,-833,-2.068,38.744,15,15,186
2002,487,1729,1817,20694,23017,269,14.373,378,20.198,3108,1305,1803,5.670,13.503,7697,2663,5034,11.570,33.441,-4589,-19.938,27.007,230,230,1843
2002,488,24011,30800,465342,472787,3971,12.946,3718,12.121,88278,39157,49121,8.282,18.672,103124,37407,65717,7.912,21.812,-14846,-3.140,37.344,2284,2394,15739
2002,492,6820,11433,555081,567251,1659,14.596,1525,13.417,40876,12982,27894,2.289,7.206,64332,17052,47280,3.006,11.341,-23456,-4.135,14.412,1000,1011,7962
2002,493,6683,11929,543384,547771,1309,10.841,1601,13.259,100637,47399,53238,8.653,18.372,108961,34323,74638,6.266,19.892,-8324,-1.520,36.744,415,468,7821
2002,511,21505,29631,1069830,1114589,3552,11.938,3795,12.755,142308,64007,78301,5.743,12.768,232333,77077,155256,6.915,20.845,-90025,-8.077,25.536,2232,2313,37355
2002,512,14219,18109,286303,294863,2526,13.795,2930,16.001,56528,21010,35518,7.125,19.171,73856,19762,54094,6.702,25.048,-17328,-5.877,38.342,1745,1793,10040
2002,515,4904,8971,282799,290262,874,9.730,897,9.986,35686,15045,20641,5.183,12.294,50148,17969,32179,6.191,17.277,-14462,-4.982,24.589,553,567,8574
2002,517,11872,50123,1533342,1591639,11655,22.882,13278,26.069,425875,274701,151174,17.259,26.757,540537,223626,316911,14.050,33.961,-114662,-7.204,53.514,3418,3607,59842
2002,518,7270,12776,432588,439066,2423,19.650,1533,12.432,99220,49761,49459,11.333,22.598,112058,31459,80599,7.165,25.522,-12838,-2.924,45.196,507,527,6556
2002,519,4430,5404,100608,104777,650,12.311,402,7.614,16594,6794,9800,6.484,15.837,24737,4941,19796,4.716,23.609,-8143,-7.772,31.675,249,255,2684
2002,521,12,47,22869,22950,(D),(D),(D),(D),440,(D),377,(D),1.917,594,(D),569,(D),2.588,-154,-0.671,3.835,(D),(D),(D)
2002,522,52193,186411,3050944,3011707,24014,13.230,14208,7.828,601537,229660,371877,7.626,19.973,522126,182307,339819,6.053,17.337,79411,2.637,34.673,3909,4383,41462
2002,523,39526,70809,968189,945108,12739,18.357,9915,14.287,271308,138111,133197,14.613,28.707,221499,98395,123104,10.411,23.436,49809,5.270,46.873,4296,4409,28652
2002,524,118356,156453,2374780,2364343,17412,11.200,15433,9.927,386006,157890,228116,6.678,16.326,364751,130614,234137,5.524,15.427,21255,0.899,30.854,8347,8578,47262
2002,525,2833,3921,49709,45421,1032,29.579,168,4.815,17859,10411,7448,22.921,39.319,9254,1420,7834,3.126,20.374,8605,18.945,40.748,85,85,797
2002,531,189007,218789,1294136,1296569,28774,13.318,23309,10.788,255192,119765,135427,9.237,19.682,261246,106454,154792,8.210,20.149,-6054,-0.467,39.364,15602,15784,69027
2002,532,27734,59064,617065,626275,6840,11.595,6694,11.347,113367,48646,64721,7.768,18.102,131772,49131,82641,7.845,21.041,-18405,-2.939,36.204,3214,3786,23644
2002,533,1913,2039,26101,26145,277,13.655,256,12.620,6575,2777,3798,10.622,25.149,6528,2990,3538,11.436,24.969,47,0.180,49.938,176,176,2082
2002,541,590196,652952,7040276,7168479,90934,14.014,82786,12.758,1419928,613060,806868,8.552,19.808,1679796,692638,987158,9.662,23.433,-259868,-3.625,39.616,54433,55008,312788
2002,551,26438,46899,2791331,2896405,5297,11.052,7353,15.342,500585,171152,329433,5.909,17.283,708864,275546,433318,9.513,24.474,-208279,-7.191,34.566,1570,1725,57908
2002,561,237622,285793,8036517,8322264,42073,14.803,38931,13.697,1987550,690238,1297312,8.294,23.882,2570251,853243,1717008,10.253,30.884,-582701,-7.002,47.765,23654,24280,387953
2002,562,13483,16952,316793,316412,2060,12.312,1618,9.671,60336,24141,36195,7.630,19.069,60216,18385,41831,5.810,19.031,120,0.038,38.062,1056,1068,9057
2002,611,58509,65995,2717010,2661103,7866,12.192,4910,7.610,316786,80959,235827,3.042,11.904,205079,33105,171974,1.244,7.707,111707,4.198,15.413,3192,3313,20209
2002,621,387192,448636,4837557,4761939,48100,10.881,34916,7.899,956004,377497,578507,7.927,20.076,806428,312930,493498,6.571,16.935,149576,3.141,33.870,20847,21527,158063
2002,622,3827,6398,5083785,5050101,296,4.594,386,5.991,413509,110609,302900,2.190,8.188,347573,135073,212500,2.675,6.882,65936,1.306,13.765,171,213,79061
2002,623,30882,65998,2790221,2754142,7544,11.641,5161,7.964,408878,168895,239983,6.132,14.846,337711,148598,189113,5.395,12.262,71167,2.584,24.524,2151,2379,62022
2002,624,94990,130032,2102485,2076455,15526,12.187,10260,8.053,380856,138526,242330,6.671,18.342,330980,92193,238787,4.440,15.940,49876,2.402,31.879,6346,6500,58135
2002,711,27586,28231,381489,380486,4599,16.372,4318,15.372,89592,30053,59539,7.899,23.547,87242,27392,59850,7.199,22.929,2350,0.618,45.858,2742,2750,19047
2002,712,5543,5980,117717,117324,491,8.339,307,5.214,12045,3007,9038,2.563,10.266,11263,2029,9234,1.729,9.600,782,0.667,19.200,167,167,1548
2002,713,47472,53551,1277010,1266356,6614,12.383,6334,11.859,214778,79674,135104,6.292,16.960,194445,66020,128425,5.213,15.355,20333,1.606,30.709,4228,4332,44796
2002,721,42606,53188,1736931,1779833,5599,10.509,5784,10.856,243822,124208,119614,6.979,13.699,325919,105659,220260,5.936,18.312,-82097,-4.613,27.398,3472,3531,50858
2002,722,325565,447797,8330614,8290324,62983,14.222,53106,11.992,1651523,871767,779756,10.515,19.921,1563812,590240,973572,7.120,18.863,87711,1.058,37.726,34546,35869,336564
2002,811,191816,209184,1285952,1296466,22665,10.835,22663,10.834,235583,102085,133498,7.874,18.171,255947,97191,158756,7.497,19.742,-20364,-1.571,36.342,16246,16456,64795
2002,812,142372,178394,1273167,1289675,23286,13.147,20747,11.713,247297,113867,133430,8.829,19.175,281229,98905,182324,7.669,21.806,-33932,-2.631,38.350,13375,13682,57155
2002,813,273504,282013,2706522,2659792,17194,6.227,5396,1.954,348223,71216,277007,2.678,13.092,254410,28101,226309,1.057,9.565,93813,3.527,19.130,3307,3316,17959
2003,211,5592,6739,82131,83575,631,9.247,800,11.724,16247,5991,10256,7.168,19.440,19327,8305,11022,9.937,23.125,-3080,-3.685,38.880,373,384,2682
2003,212,4012,6481,185885,190358,448,6.812,639,9.716,22044,5963,16081,3.133,11.580,30846,10348,20498,5.436,16.204,-8802,-4.624,23.161,344,353,3178
2003,213,6784,8251,187490,188788,828,9.986,909,10.963,33328,7624,25704,4.038,17.654,35226,9328,25898,4.941,18.659,-1898,-1.005,35.307,530,544,4554
2003,221,6461,17560,661501,661546,1471,8.459,1129,6.493,76964,26561,50403,4.015,11.634,76767,20142,56625,3.045,11.604,197,0.030,23.208,243,254,1900
2003,236,177939,179873,1497323,1489545,27847,15.588,25391,14.213,335460,112947,222513,7.583,22.521,320832,101426,219406,6.809,21.539,14628,0.982,43.078,16947,16949,68661
2003,237,42808,44550,905677,934459,5107,11.431,5363,12.004,155009,32714,122295,3.501,16.588,211081,41307,169774,4.420,22.589,-56072,-6.000,33.176,3704,3738,23256
2003,238,379203,384360,3953984,3938821,53118,13.935,46781,12.272,818060,238538,579522,6.056,20.769,787276,223932,563344,5.685,19.988,30784,0.782,39.975,32303,32319,154612
2003,311,20941,25290,1484484,1481255,2233,8.836,2194,8.682,153267,30594,122673,2.065,10.347,147559,52846,94713,3.568,9.962,5708,0.385,19.924,1527,1546,18248
2003,312,2351,2880,154739,156722,342,12.186,195,6.948,15528,3637,11891,2.321,9.908,19292,4165,15127,2.658,12.310,-3764,-2.402,19.816,128,128,900
2003,313,2940,3563,255036,262393,228,6.263,383,10.521,19317,5292,14025,2.017,7.362,33653,11822,21831,4.505,12.825,-14336,-5.464,14.724,278,280,4373
2003,314,6950,7303,186848,189710,550,7.432,745,10.067,20395,5534,14861,2.917,10.751,25995,8559,17436,4.512,13.703,-5600,-2.952,21.501,573,578,5225
2003,315,10026,10399,294636,309388,1705,16.141,2033,19.246,51270,20520,30750,6.632,16.571,80724,41021,39703,13.259,26.092,-29454,-9.520,33.143,1683,1694,22810
2003,316,1269,1329,42697,43891,116,8.574,164,12.121,4255,916,3339,2.087,9.695,6685,2774,3911,6.320,15.231,-2430,-5.537,19.389,126,126,1205
2003,321,14213,16032,530317,534722,1268,7.857,1480,9.171,60042,16483,43559,3.083,11.229,69245,23145,46100,4.328,12.950,-9203,-1.721,22.457,1070,1076,10023
2003,322,3337,5338,485053,493326,273,5.074,357,6.636,31776,9626,22150,1.951,6.441,48426,19046,29380,3.861,9.816,-16650,-3.375,12.882,191,206,5568
2003,323,32515,34218,698189,708954,2018,5.798,3191,9.168,67724,19214,48510,2.710,9.553,89231,30550,58681,4.309,12.586,-21507,-3.034,19.105,2530,2569,19318
2003,324,1049,2231,96224,96698,122,5.478,114,5.119,5997,1137,4860,1.176,6.202,6958,1883,5075,1.947,7.196,-961,-0.994,12.404,56,56,556
2003,325,8975,12725,846984,850395,788,6.155,945,7.381,71224,15155,56069,1.782,8.375,78426,21021,57405,2.472,9.222,-7202,-0.847,16.751,541,554,6303
2003,326,11381,14549,921343,925802,708,4.808,1060,7.199,91699,20225,71474,2.185,9.905,100632,32110,68522,3.468,10.870,-8933,-0.965,19.810,670,692,11504
2003,327,10503,15736,466848,470763,948,6.002,1064,6.737,51631,10797,40834,2.294,10.968,59319,15983,43336,3.395,12.601,-7688,-1.633,21.935,627,652,6197
2003,331,4067,5078,472213,483659,340,6.646,415,8.113,36606,15421,21185,3.188,7.569,58959,18799,40160,3.887,12.190,-22353,-4.622,15.137,241,250,7706
2003,332,53132,57227,1521116,1549001,3134,5.399,4782,8.238,153363,36870,116493,2.380,9.901,209057,60660,148397,3.916,13.496,-55694,-3.595,19.802,3423,3435,26029
2003,333,23612,26220,1139587,1167994,1314,4.925,2236,8.380,100265,21136,79129,1.810,8.584,157118,48890,108228,4.186,13.452,-56853,-4.868,17.169,1507,1520,17730
2003,334,12523,14465,1122655,1193135,1057,7.180,1569,10.658,107813,29452,78361,2.468,9.036,250234,76212,174022,6.388,20.973,-142421,-11.937,18.072,1036,1042,17482
2003,335,5105,6054,457045,474486,350,5.698,528,8.595,29963,8249,21714,1.739,6.315,64692,16723,47969,3.524,13.634,-34729,-7.319,12.630,337,345,4134
2003,336,9743,11866,1599005,1601126,834,6.998,936,7.854,151124,33949,117175,2.120,9.439,157201,37055,120146,2.314,9.818,-6077,-0.380,18.877,627,632,10146
2003,337,19505,20422,571868,585428,1521,7.367,1968,9.532,56061,12582,43479,2.149,9.576,83019,25317,57702,4.325,14.181,-26958,-4.605,19.152,1441,1445,12712
2003,339,28187,29417,701879,705798,2211,7.465,2617,8.835,79770,17157,62613,2.431,11.302,87813,29743,58070,4.214,12.442,-8043,-1.140,22.604,2030,2033,15018
2003,423,176416,235734,3276534,3284464,21532,9.101,23236,9.821,490749,178371,312378,5.431,14.942,507306,175871,331435,5.355,15.446,-16557,-0.504,29.883,14252,14783,81991
2003,424,100602,126852,2277157,2253763,12271,9.610,13952,10.926,357470,99527,257943,4.416,15.861,309300,118338,190962,5.251,13.724,48170,2.137,27.447,8505,8739,51273
2003,425,30099,31948,258443,254660,3018,9.499,2663,8.382,40401,11656,28745,4.577,15.865,32818,9033,23785,3.547,12.887,7583,2.978,25.774,1802,1811,5142
2003,441,89120,118105,1916021,1894674,10333,8.789,9266,7.881,251249,81326,169923,4.292,13.261,208504,65556,142948,3.460,11.005,42745,2.256,22.009,6326,6592,43022
2003,442,44247,60444,564755,552605,6497,10.834,5546,9.248,109817,44113,65704,7.983,19.873,85974,27211,58763,4.924,15.558,23843,4.315,31.116,3479,3711,15847
2003,443,30210,49795,467904,459617,6434,13.054,5419,10.995,83685,36838,46847,8.015,18.208,67786,24615,43171,5.356,14.748,15899,3.459,29.497,3616,3896,15648
2003,444,60268,83127,1210702,1201009,6019,7.251,5773,6.955,142079,47639,94440,3.967,11.830,121971,34371,87600,2.862,10.156,20108,1.674,20.311,3731,3900,19069
2003,445,99962,134573,2859535,2836827,16834,12.628,14305,10.731,377035,169428,207607,5.972,13.291,332754,121896,210858,4.297,11.730,44281,1.561,23.460,9506,9661,50669
2003,446,39192,78345,954891,948190,6090,7.819,5175,6.644,113607,39411,74196,4.156,11.981,101997,36652,65345,3.865,10.757,11610,1.224,21.514,2714,2917,15358
2003,447,60810,112532,930978,927621,9940,8.777,11372,10.042,171856,61894,109962,6.672,18.527,165410,66956,98454,7.218,17.832,6446,0.695,35.663,5199,5690,30477
2003,448,59499,139349,1454683,1421554,13082,9.392,12957,9.302,272622,78521,194101,5.524,19.178,202841,74143,128698,5.216,14.269,69781,4.909,28.538,5847,6413,24801
2003,451,34202,50251,545627,542134,5032,9.983,5339,10.592,95564,28320,67244,5.224,17.627,89295,32201,57094,5.940,16.471,6269,1.156,32.942,3249,3450,15463
2003,452,8423,39296,2605858,2603283,3923,10.146,2661,6.882,243461,113845,129616,4.373,9.352,238759,72206,166553,2.774,9.171,4702,0.181,18.343,994,1384,25444
2003,453,90435,115632,817437,807499,12647,10.913,13172,11.366,152376,52077,100299,6.449,18.870,131902,49687,82215,6.153,16.335,20474,2.535,32.669,9405,9657,32311
2003,454,40663,48364,574783,571037,5685,11.792,5375,11.149,90557,29750,60807,5.210,15.858,82753,29794,52959,5.218,14.492,7804,1.367,28.983,3810,3883,17195
2003,481,2391,5052,519059,523291,588,12.052,242,4.960,36048,14117,21931,2.698,6.889,43759,1608,42151,0.307,8.362,-7711,-1.474,13.777,181,182,1149
2003,483,1260,1706,66740,66230,212,12.358,231,13.465,14700,8220,6480,12.411,22.195,13328,5025,8303,7.587,20.124,1372,2.072,40.248,110,112,1098
2003,484,83195,95702,1409473,1423688,13857,14.418,14669,15.263,224852,66325,158527,4.659,15.794,252988,115196,137792,8.091,17.770,-28136,-1.976,31.587,10566,10685,50684
2003,485,13207,15517,394444,386315,1919,12.371,1910,12.313,66826,23989,42837,6.210,17.298,50799,20058,30741,5.192,13.150,16027,4.149,26.299,1398,1412,10603
2003,486,203,2665,39175,40783,286,10.870,218,8.286,6397,2897,3500,7.104,15.686,9511,2197,7314,5.387,23.321,-3114,-7.636,31.371,8,8,35
2003,487,1671,1758,21949,21383,244,13.727,283,15.921,4359,1109,3250,5.186,20.385,3220,972,2248,4.546,15.059,1139,5.327,30.117,187,188,622
2003,488,24362,31591,490476,482029,4197,13.470,3332,10.694,102522,41366,61156,8.582,21.269,84901,28180,56721,5.846,17.613,17621,3.656,35.227,2150,2195,14308
2003,492,6987,13133,488670,520204,3408,27.764,1692,13.784,193072,185632,7440,35.684,37.115,256452,23090,233362,4.439,49.298,-63380,-12.184,74.229,933,946,5503
2003,493,6681,12008,543016,542983,1186,9.871,1200,9.988,88409,26681,61728,4.914,16.282,88430,28747,59683,5.294,16.286,-21,-0.004,32.564,382,411,5648
2003,511,21317,29107,1028932,1043469,2906,9.926,3245,11.084,112622,40208,72414,3.853,10.793,142363,44654,97709,4.279,13.643,-29741,-2.850,21.586,1902,1961,16458
2003,512,14217,18090,294514,289882,2578,14.230,2632,14.528,77961,40800,37161,14.075,26.894,66604,20588,46016,7.102,22.976,11357,3.918,45.953,1598,1617,7934
2003,515,4953,10074,297309,297058,1758,18.173,957,9.893,44789,19018,25771,6.402,15.078,44457,13528,30929,4.554,14.966,332,0.112,29.932,384,399,4481
2003,517,12418,50101,1479320,1505986,7377,14.703,7523,14.994,244709,91212,153497,6.057,16.249,303654,175974,127680,11.685,20.163,-58945,-3.914,32.498,2145,2240,23318
2003,518,6929,12604,401279,409433,2387,19.135,2128,17.059,68390,29612,38778,7.232,16.704,84534,35139,49395,8.582,20.647,-16144,-3.943,33.407,775,793,9296
2003,519,4331,5224,92393,93441,581,11.086,615,11.734,13365,4745,8620,5.078,14.303,15558,6147,9411,6.578,16.650,-2193,-2.347,28.606,419,431,3394
2003,521,19,54,22561,22946,(D),(D),0,0.000,473,(D),469,(D),2.061,1217,0,1217,0.000,5.304,-744,-3.242,4.123,0,0,0
2003,522,54679,192596,3090042,3067919,22042,11.638,15646,8.261,556513,212572,343941,6.929,18.140,515062,180553,334509,5.885,16.789,41451,1.351,33.577,3636,4004,24886
2003,523,40603,75625,879799,922732,15863,21.692,10872,14.867,162945,83408,79537,9.039,17.659,255799,98814,156985,10.709,27.722,-92854,-10.063,35.318,4075,4295,18018
2003,524,119988,157236,2361893,2362018,16287,10.395,15176,9.686,358628,118033,240595,4.997,15.183,358625,133171,225454,5.638,15.183,3,0.000,30.366,7499,7643,29831
2003,525,2278,3347,40571,34506,858,28.633,157,5.239,16202,7338,8864,21.266,46.955,4228,826,3402,2.394,12.253,11974,34.702,24.506,64,64,316
2003,531,197253,227643,1388187,1352147,30673,13.722,22437,10.038,289929,118336,171593,8.752,21.442,217278,84997,132281,6.286,16.069,72651,5.373,32.138,15123,15420,54405
2003,532,26968,58323,620891,619468,5533,9.445,6053,10.332,101857,31621,70236,5.105,16.443,100269,38975,61294,6.292,16.186,1588,0.256,32.373,2872,3114,14733
2003,533,1939,2061,27783,27175,277,13.535,248,12.118,5160,2102,3058,7.735,18.988,3879,1690,2189,6.219,14.274,1281,4.714,28.548,165,166,752
2003,541,597800,661396,7141911,7108896,86207,13.113,78263,11.904,1313164,455325,857839,6.405,18.472,1253585,445847,807738,6.272,17.634,59579,0.838,35.268,52377,52907,227921
2003,551,26441,46477,2789551,2811005,4768,10.196,5342,11.423,483404,142284,341120,5.062,17.197,521708,163162,358546,5.804,18.559,-38304,-1.363,34.394,1132,1201,16072
2003,561,240453,285709,7917241,7975426,41275,14.440,41533,14.530,1811759,499273,1312486,6.260,22.717,1917603,662724,1254879,8.310,24.044,-105844,-1.327,45.434,25144,25569,302338
2003,562,13662,17146,330874,325854,1708,9.973,1670,9.751,56098,16853,39245,5.172,17.216,46228,16802,29426,5.156,14.187,9870,3.029,28.373,1087,1099,8588
2003,611,60496,67874,2782966,2736610,7911,11.923,4868,7.337,298141,54200,243941,1.981,10.895,206207,28997,177210,1.060,7.535,91934,3.359,15.070,3367,3453,19199
2003,621,397329,458756,5098036,4968152,41418,9.135,30665,6.764,903585,272925,630660,5.493,18.188,642946,212869,430077,4.285,12.941,260639,5.246,25.883,19261,20381,112242
2003,622,3922,6576,5172704,5130735,296,4.540,185,2.837,297377,57890,239487,1.128,5.796,213549,62315,151234,1.215,4.162,83828,1.634,8.324,56,56,15453
2003,623,31187,66434,2867096,2824290,5178,7.835,4490,6.794,375336,115982,259354,4.107,13.290,288901,109233,179668,3.868,10.229,86435,3.060,20.458,2182,2354,53604
2003,624,97404,132746,2182049,2146024,12686,9.640,10397,7.900,355367,91144,264223,4.247,16.559,283470,73412,210058,3.421,13.209,71897,3.350,26.418,6481,6634,38027
2003,711,28386,29122,398208,391127,4972,17.303,4197,14.606,93998,30487,63511,7.795,24.033,79943,26883,53060,6.873,20.439,14055,3.593,40.878,2767,2771,17853
2003,712,5714,6154,120174,123941,490,8.069,327,5.385,12916,1799,11117,1.452,10.421,20966,1251,19715,1.009,16.916,-8050,-6.495,20.842,187,187,789
2003,713,49226,55342,1314699,1291907,7154,13.135,5401,9.916,223228,68251,154977,5.283,17.279,176563,52727,123836,4.081,13.667,46665,3.612,27.334,3804,3857,33602
2003,721,43037,53608,1795848,1767318,5165,9.664,4841,9.058,252810,90794,162016,5.137,14.305,197340,68018,129322,3.849,11.166,55470,3.139,22.332,3022,3099,35651
2003,722,333995,458163,8637128,8481979,59923,13.227,49642,10.958,1673285,794778,878507,9.370,19.728,1363133,539394,823739,6.359,16.071,310152,3.657,32.142,33302,34227,296250
2003,811,191994,208758,1306875,1298652,21070,10.085,21387,10.237,240873,81577,159296,6.282,18.548,224037,82515,141522,6.354,17.252,16836,1.296,34.503,15298,15542,53942
2003,812,146052,182470,1299788,1285943,23271,12.898,19175,10.628,236376,95545,140831,7.430,18.382,209099,85790,123309,6.671,16.260,27277,2.121,32.521,13001,13525,55056
2003,813,276124,284629,2751062,2711306,16132,5.776,5455,1.953,336810,57744,279066,2.130,12.422,257411,19179,238232,0.707,9.494,79399,2.928,18.988,3626,3652,11758
2004,211,5590,6656,80173,80576,606,9.077,647,9.691,13781,6551,7230,8.130,17.103,14246,6542,7704,8.119,17.680,-465,-0.577,34.206,324,329,2471
2004,212,3998,6448,189178,187282,552,8.533,594,9.182,27107,8599,18508,4.591,14.474,23479,8861,14618,4.731,12.537,3628,1.937,25.073,305,317,2790
2004,213,7088,8567,196716,191817,968,11.471,712,8.437,33066,8087,24979,4.216,17.238,23197,7120,16077,3.712,12.093,9869,5.145,24.187,465,478,4301
2004,221,6339,17243,629492,645353,1239,7.160,1361,7.865,55720,20888,34832,3.237,8.634,87293,23420,63873,3.629,13.526,-31573,-4.892,17.268,283,286,1426
2004,236,186103,188067,1562978,1530081,32595,17.715,24455,13.291,357412,112539,244873,7.355,23.359,291883,100968,190915,6.599,19.076,65529,4.283,38.153,16620,16628,72945
2004,237,41924,43728,914209,911204,4485,10.197,4998,11.363,179207,34061,145146,3.738,19.667,173279,40869,132410,4.485,19.016,5928,0.651,38.033,3592,3596,25552
2004,238,392862,397892,4142537,4042599,60369,15.443,46410,11.872,921344,247412,673932,6.120,22.791,722972,233634,489338,5.779,17.884,198372,4.907,35.768,32655,32720,166059
2004,311,20809,25103,1474182,1481103,1875,7.446,2033,8.073,135773,36217,99556,2.445,9.167,150468,44037,106431,2.973,10.159,-14695,-0.992,18.334,1438,1447,13905
2004,312,2420,2958,153231,154316,324,11.109,241,8.263,12622,2792,9830,1.809,8.179,14849,3340,11509,2.164,9.622,-2227,-1.443,16.359,150,150,1292
2004,313,2802,3380,224016,239522,211,6.085,386,11.132,13937,3744,10193,1.563,5.819,45419,17097,28322,7.138,18.962,-31482,-13.144,11.637,269,277,4415
2004,314,6824,7157,178631,182664,573,7.921,726,10.037,21837,8002,13835,4.381,11.955,30089,12068,18021,6.607,16.472,-8252,-4.518,23.910,557,559,5374
2004,315,9627,9931,271564,280819,1629,16.075,2035,20.081,48782,18450,30332,6.570,17.371,67349,33506,33843,11.932,23.983,-18567,-6.612,34.743,1712,1719,22840
2004,316,1274,1332,41250,41801,137,10.228,152,11.348,4920,2029,2891,4.854,11.770,5944,1358,4586,3.249,14.220,-1024,-2.450,23.540,122,124,1066
2004,321,14144,15950,537269,533486,1280,7.991,1417,8.846,64574,14557,50017,2.729,12.104,56931,22308,34623,4.182,10.672,7643,1.433,21.343,1020,1023,10278
2004,322,3328,5277,465213,474310,232,4.366,305,5.740,28281,6799,21482,1.433,5.963,45967,13788,32179,2.907,9.691,-17686,-3.729,11.925,166,168,3825
2004,323,31625,33290,673570,685610,1901,5.627,2888,8.549,60485,14103,46382,2.057,8.822,84465,26640,57825,3.886,12.320,-23980,-3.498,17.644,2301,2320,16865
2004,324,1042,2324,99521,97909,269,11.780,188,8.233,11463,5145,6318,5.255,11.708,8138,2011,6127,2.054,8.312,3325,3.396,16.624,51,51,537
2004,325,8980,12763,822779,834949,822,6.436,841,6.584,67931,20609,47322,2.468,8.136,92668,22255,70413,2.665,11.099,-24737,-2.963,16.272,502,506,6414
2004,326,11223,14331,898360,908327,679,4.703,891,6.172,77648,14885,62763,1.639,8.548,97797,24897,72900,2.741,10.767,-20149,-2.218,17.097,549,552,8477
2004,327,10530,15823,467315,467123,1006,6.356,1014,6.407,53121,11879,41242,2.543,11.372,52066,15149,36917,3.243,11.146,1055,0.226,22.292,611,622,5841
2004,331,4020,4997,444111,458354,369,7.303,480,9.500,33181,11826,21355,2.580,7.239,61306,26063,35243,5.686,13.375,-28125,-6.136,14.478,322,333,9175
2004,332,52354,56389,1510153,1516747,3180,5.592,4144,7.287,160953,32892,128061,2.169,10.612,174310,52015,122295,3.429,11.492,-13357,-0.881,21.223,2983,3009,25436
2004,333,23275,25796,1101640,1119317,1458,5.602,1922,7.384,94639,22726,71913,2.030,8.455,130639,39769,90870,3.553,11.671,-36000,-3.216,16.910,1334,1349,15187
2004,334,12293,14117,1073032,1092034,1011,7.076,1352,9.463,108783,25234,83549,2.311,9.962,146658,51282,95376,4.696,13.430,-37875,-3.468,19.923,898,914,15774
2004,335,5088,5988,436535,446230,394,6.539,469,7.784,34296,8526,25770,1.911,7.686,53422,16546,36876,3.708,11.972,-19126,-4.286,15.371,288,294,3444
2004,336,9853,11961,1603770,1600444,942,7.883,919,7.691,148929,41356,107573,2.584,9.305,141308,33110,108198,2.069,8.829,7621,0.476,17.659,626,645,11353
2004,337,19180,20064,560620,565433,1558,7.685,1976,9.747,61509,14638,46871,2.589,10.878,70282,22795,47487,4.031,12.430,-8773,-1.552,21.756,1502,1512,11940
2004,339,28331,29545,685317,691809,2335,7.903,2338,7.913,74989,17083,57906,2.469,10.840,88170,24406,63764,3.528,12.745,-13181,-1.905,21.679,1791,1796,12678
2004,423,174338,234981,3315579,3300330,20642,8.792,20268,8.632,475142,161252,313890,4.886,14.397,446621,159164,287457,4.823,13.533,28521,0.864,27.065,12817,13349,76177
2004,424,99244,126086,2314663,2297085,11424,9.062,11378,9.026,340178,112135,228043,4.882,14.809,305692,120173,185519,5.232,13.308,34486,1.501,26.616,7997,8148,48670
2004,425,32146,34068,272319,268466,4067,12.103,3137,9.335,43701,14844,28857,5.529,16.278,35822,11153,24669,4.154,13.343,7879,2.935,26.686,2218,2238,7401
2004,441,89371,118983,1948563,1932509,10026,8.462,9037,7.627,231881,75736,156145,3.919,11.999,200070,66982,133088,3.466,10.353,31811,1.646,20.706,6596,6833,46856
2004,442,44370,60791,576177,569906,5938,9.800,5542,9.146,99428,36608,62820,6.424,17.446,85945,31950,53995,5.606,15.081,13483,2.366,30.161,3785,4077,20384
2004,443,30448,49451,499107,484094,5795,11.664,6255,12.590,96568,29001,67567,5.991,19.948,67230,30589,36641,6.319,13.888,29338,6.060,27.776,3792,4055,16258
2004,444,60145,82988,1251264,1231335,5573,6.713,5630,6.782,140267,43244,97023,3.512,11.391,100804,32198,68606,2.615,8.187,39463,3.205,16.373,3879,4157,21087
2004,445,101900,136113,2939824,2897994,16421,12.165,14171,10.498,414542,155299,259243,5.359,14.304,328061,110947,217114,3.828,11.320,86481,2.984,22.641,10203,10361,53534
2004,446,40027,79754,1032229,994261,6936,8.767,5650,7.142,188813,62341,126472,6.270,18.990,115439,43331,72108,4.358,11.611,73374,7.380,23.221,3002,3088,14904
2004,447,61587,111047,929024,931452,8524,7.614,10338,9.234,154515,50706,103809,5.444,16.589,159490,65755,93735,7.059,17.123,-4975,-0.534,33.177,5293,6289,38862
2004,448,59509,140422,1545878,1501014,13150,9.401,12053,8.617,284424,87349,197075,5.819,18.949,193066,65853,127213,4.387,12.862,91358,6.086,25.725,5996,6749,26643
2004,451,34314,50013,557013,551860,4862,9.694,5150,10.268,82780,34869,47911,6.318,15.000,72423,24716,47707,4.479,13.123,10357,1.877,26.247,3445,3531,13390
2004,452,8808,41026,2736306,2670271,4143,10.302,2519,6.264,309394,77775,231619,2.913,11.587,180960,61054,119906,2.286,6.777,128434,4.810,13.554,1139,1188,6306
2004,453,89879,114485,814002,817950,12278,10.654,13800,11.974,133824,52445,81379,6.412,16.361,142322,54990,87332,6.723,17.400,-8498,-1.039,32.722,9834,10647,36206
2004,454,41003,48376,556279,563734,5119,10.631,4674,9.706,86899,30791,56108,5.462,15.415,101522,38955,62567,6.910,18.009,-14623,-2.594,30.830,3195,3224,17841
2004,481,2475,5242,478430,488134,769,15.440,246,4.939,43318,20537,22781,4.207,8.874,62577,1462,61115,0.300,12.820,-19259,-3.945,17.748,192,197,1244
2004,483,1222,1649,66014,66492,156,9.302,212,12.642,8314,2352,5962,3.537,12.504,9238,1998,7240,3.005,13.893,-924,-1.390,25.008,129,140,951
2004,484,84006,96870,1444132,1426407,14765,15.328,13678,14.200,235607,89602,146005,6.282,16.518,198783,73540,125243,5.156,13.936,36824,2.582,27.872,10134,10274,48618
2004,485,13118,15390,398202,396151,1751,11.331,1877,12.147,56835,17271,39564,4.360,14.347,52842,23048,29794,5.818,13.339,3993,1.008,26.678,1408,1417,12448
2004,486,208,2472,36595,38419,507,19.743,699,27.220,9510,6186,3324,16.101,24.753,13284,8718,4566,22.692,34.577,-3774,-9.823,49.507,9,16,401
2004,487,1711,1803,21995,21941,275,15.406,239,13.389,3641,1456,2185,6.636,16.595,3471,1424,2047,6.490,15.820,170,0.775,31.640,164,165,954
2004,488,25250,32811,522121,508554,4126,12.790,3023,9.371,95428,42476,52952,8.352,18.765,67528,23863,43665,4.692,13.278,27900,5.486,26.557,2089,2153,12879
2004,492,6845,13016,574830,548880,1409,10.752,1586,12.103,103326,21137,82189,3.851,18.825,53682,30408,23274,5.540,9.780,49644,9.045,19.561,931,941,4761
2004,493,6770,12813,574561,560931,1669,13.391,971,7.790,98749,42212,56537,7.525,17.604,71669,20318,51351,3.622,12.777,27080,4.828,25.554,388,399,3523
2004,511,20950,29104,1022801,1024918,3048,10.479,3015,10.365,113985,38013,75972,3.709,11.121,117733,39329,78404,3.837,11.487,-3748,-0.366,22.243,1789,1865,16387
2004,512,14444,18132,305668,304725,2584,14.260,2560,14.128,58132,21657,36475,7.107,19.077,55596,23683,31913,7.772,18.245,2536,0.832,36.489,1470,1492,6267
2004,515,4841,9809,285690,290705,1164,11.734,1385,13.962,42542,16415,26127,5.647,14.634,52321,25754,26567,8.859,17.998,-9779,-3.364,29.268,398,414,4836
2004,517,12108,50193,1366865,1423904,8165,16.300,7960,15.891,250952,69963,180989,4.913,17.624,362089,115222,246867,8.092,25.429,-111137,-7.805,35.248,2228,2403,18815
2004,518,7048,13200,374380,389002,2739,21.323,2029,15.796,76197,40427,35770,10.393,19.588,105485,46316,59169,11.906,27.117,-29288,-7.529,39.176,521,533,4739
2004,519,4586,5480,97102,96001,654,12.207,409,7.634,14543,3097,11446,3.226,15.149,12106,2900,9206,3.021,12.610,2437,2.539,25.221,258,269,1493
2004,521,19,57,21510,22037,5,8.929,3,5.357,653,435,218,1.974,2.963,1758,310,1448,1.407,7.978,-1105,-5.014,5.927,(D),(D),(D)
2004,522,57168,198945,3151347,3126154,22577,11.524,16526,8.435,577745,229321,348424,7.336,18.481,530689,192007,338682,6.142,16.976,47056,1.505,33.952,4040,4347,25558
2004,523,43009,73244,853712,870251,13128,17.615,15696,21.061,207632,83870,123762,9.637,23.859,240971,128625,112346,14.780,27.690,-33339,-3.831,47.718,3893,3944,23733
2004,524,121925,160284,2362003,2362199,16855,10.617,13795,8.690,316582,122964,193618,5.205,13.402,318587,121116,197471,5.127,13.487,-2005,-0.085,26.804,7288,7506,30322
2004,525,2876,4041,57899,53994,1119,31.196,211,5.882,12739,6899,5840,12.777,23.593,4809,1673,3136,3.098,8.907,7930,14.687,17.813,106,108,768
2004,531,204766,236512,1431310,1407064,32714,14.123,22972,9.917,266153,119657,146496,8.504,18.915,217645,93457,124188,6.642,15.468,48508,3.447,30.936,15720,16285,63343
2004,532,26850,59547,614334,617661,6369,10.806,5153,8.743,96204,36120,60084,5.848,15.576,100950,33774,67176,5.468,16.344,-4746,-0.768,31.151,2604,3090,14764
2004,533,2051,2139,30799,28797,326,15.666,210,10.091,7738,3006,4732,10.439,26.871,3668,1474,2194,5.119,12.738,4070,14.134,25.475,145,146,993
2004,541,610742,678168,7232381,7184936,89524,13.360,73390,10.952,1261069,457165,803904,6.363,17.552,1169733,448970,720763,6.249,16.280,91336,1.271,32.561,49626,50202,233277
2004,551,26101,46470,2756159,2790194,4167,8.972,4115,8.860,422681,141561,281120,5.074,15.149,487747,161451,326296,5.786,17.481,-65066,-2.332,30.298,1131,1194,20403
2004,561,247649,293267,8089074,8042036,43887,15.118,37937,13.069,1797992,522081,1275911,6.492,22.357,1720958,624324,1096634,7.763,21.400,77034,0.958,42.799,24289,24834,273180
2004,562,13972,17575,343986,338622,1778,10.207,1468,8.427,53824,16464,37360,4.862,15.895,43520,12802,30718,3.781,12.852,10304,3.043,25.704,1030,1045,7726
2004,611,62758,70265,2882857,2816723,7921,11.524,4858,7.068,293165,63382,229783,2.250,10.408,160615,24539,136076,0.871,5.702,132550,4.706,11.404,3466,3519,17281
2004,621,406408,470045,5327118,5211264,40647,8.757,28859,6.218,813236,247417,565819,4.748,15.605,583262,181969,401293,3.492,11.192,229974,4.413,22.385,20111,20700,108158
2004,622,4046,6784,5216495,5188124,383,5.721,205,3.062,245955,32031,213924,0.617,4.741,189612,55878,133734,1.077,3.655,56343,1.086,7.309,93,94,17578
2004,623,31443,67678,2894100,2879834,5271,7.860,4032,6.013,307683,119876,187807,4.163,10.684,280377,101895,178482,3.538,9.736,27306,0.948,19.472,2161,2336,51818
2004,624,99336,134829,2220770,2203288,12201,9.108,10467,7.813,316217,100266,215951,4.551,14.352,280238,71497,208741,3.245,12.719,35979,1.633,25.438,6886,7081,42667
2004,711,28990,29775,399995,399587,4930,16.741,4276,14.521,79850,25963,53887,6.497,19.983,79809,27170,52639,6.800,19.973,41,0.010,39.946,2790,2795,13213
2004,712,5836,6265,118799,119428,429,6.900,333,5.356,8990,1063,7927,0.890,7.528,10251,1937,8314,1.622,8.583,-1261,-1.056,15.055,205,205,1510
2004,713,51924,58203,1366114,1341709,8011,14.088,5330,9.373,207088,71254,135834,5.311,15.435,158741,47521,111220,3.542,11.831,48347,3.603,23.663,3908,3940,32979
2004,721,43351,53861,1825811,1811516,5055,9.398,4904,9.118,226700,91311,135389,5.041,12.514,198687,75382,123305,4.161,10.968,28013,1.546,21.936,3203,3298,41051
2004,722,343243,467211,8888646,8765579,59263,12.804,50525,10.916,1622388,769437,852951,8.778,18.509,1383913,526229,857684,6.003,15.788,238475,2.721,31.576,35105,36129,317072
2004,811,191236,208039,1312485,1309488,19926,9.566,20438,9.812,218998,75709,143289,5.782,16.724,213162,80194,132968,6.124,16.278,5836,0.446,32.557,15436,15578,55743
2004,812,146990,184521,1337631,1320551,22803,12.471,19443,10.634,249940,108072,141868,8.184,18.927,216518,83798,132720,6.346,16.396,33422,2.531,32.792,14210,14540,54873
2004,813,277085,285531,2752995,2728256,14615,5.194,6287,2.234,296832,54067,242765,1.982,10.880,247038,23516,223522,0.862,9.055,49794,1.825,18.110,4322,4362,15184
2005,211,5551,6610,82921,82362,630,9.582,560,8.517,15474,4361,11113,5.295,18.788,14427,5842,8585,7.093,17.517,1047,1.271,35.033,322,326,1392
2005,212,4010,6538,195226,191454,552,8.486,485,7.456,29207,11016,18191,5.754,15.255,21741,7472,14269,3.903,11.356,7466,3.900,22.711,277,279,3132
2005,213,7423,8846,212433,203913,1071,12.310,780,8.965,42069,9032,33037,4.429,20.631,24559,6523,18036,3.199,12.044,17510,8.587,24.088,456,481,3325
2005,221,6176,16770,632233,629544,1051,6.207,1377,8.132,61521,19342,42179,3.072,9.772,56607,21460,35147,3.409,8.992,4914,0.781,17.983,231,244,1151
2005,236,195007,197278,1597963,1581929,35102,18.173,26865,13.908,366751,132192,234559,8.356,23.184,334705,114442,220263,7.234,21.158,32046,2.026,42.316,18495,18499,76369
2005,237,41946,43966,911958,912933,4826,10.994,4691,10.686,170385,37471,132914,4.104,18.663,173142,43076,130066,4.718,18.965,-2757,-0.302,37.327,3230,3240,21202
2005,238,408816,414321,4272853,4215337,62891,15.450,48393,11.888,927440,291113,636327,6.906,22.002,811197,229720,581477,5.450,19.244,116243,2.758,38.488,34072,34103,166017
2005,311,20078,24300,1459754,1463321,1884,7.696,2244,9.167,126162,31500,94662,2.153,8.622,133060,39338,93722,2.688,9.093,-6898,-0.471,17.243,1664,1683,17296
2005,312,2578,3158,155034,154395,393,12.754,240,7.788,14603,4150,10453,2.688,9.458,13423,3090,10333,2.001,8.694,1180,0.764,17.388,177,179,1613
2005,313,2701,3211,208730,215264,195,5.923,358,10.873,16922,3233,13689,1.502,7.861,30113,13250,16863,6.155,13.989,-13191,-6.128,15.722,249,254,4197
2005,314,6645,6953,168675,172356,520,7.366,733,10.383,17481,3692,13789,2.142,10.142,24629,8935,15694,5.184,14.290,-7148,-4.147,20.285,559,562,5032
2005,315,8672,8937,234336,244087,1261,13.658,1853,20.069,38563,12514,26049,5.127,15.799,57818,26200,31618,10.734,23.688,-19255,-7.889,31.598,1579,1582,18984
2005,316,1228,1280,38330,39460,119,9.196,147,11.360,3237,657,2580,1.665,8.203,5413,1935,3478,4.904,13.718,-2176,-5.514,16.406,116,116,757
2005,321,14011,15875,563361,551862,1315,8.267,1380,8.675,76296,21195,55101,3.841,13.825,53069,17426,35643,3.158,9.616,23227,4.209,19.233,1012,1028,9969
2005,322,3231,5126,453262,460433,204,3.922,356,6.844,27871,6790,21081,1.475,6.053,42339,17151,25188,3.725,9.195,-14468,-3.142,12.106,181,182,2955
2005,323,31090,32675,658891,666999,1997,6.041,2765,8.364,61398,14822,46576,2.222,9.205,77544,28171,49373,4.224,11.626,-16146,-2.421,18.410,2213,2229,15335
2005,324,1026,2241,99735,98714,169,7.580,146,6.549,9321,2060,7261,2.087,9.442,7094,2452,4642,2.484,7.186,2227,2.256,14.373,39,39,349
2005,325,8949,12593,821366,821499,778,6.155,871,6.891,76864,14774,62090,1.798,9.357,76679,19756,56923,2.405,9.334,185,0.023,18.668,479,486,5610
2005,326,11090,14185,899098,899802,667,4.666,884,6.185,86176,16077,70099,1.787,9.577,87488,24392,63096,2.711,9.723,-1312,-0.146,19.154,588,597,10107
2005,327,10539,16041,467154,466082,1185,7.439,962,6.039,56067,14486,41581,3.108,12.029,53884,12834,41050,2.754,11.561,2183,0.468,23.122,610,627,5565
2005,331,3901,4874,447716,449807,296,6.042,346,7.063,37206,8274,28932,1.839,8.272,42349,8488,33861,1.887,9.415,-5143,-1.143,16.543,230,234,3841
2005,332,52046,56069,1524424,1515961,3482,6.190,3854,6.851,182035,39845,142190,2.628,12.008,165101,52476,112625,3.462,10.891,16934,1.117,21.782,2796,2807,27944
2005,333,23053,25555,1119208,1109450,1451,5.651,1696,6.605,117861,26210,91651,2.362,10.623,97568,31963,65605,2.881,8.794,20293,1.829,17.589,1201,1208,12870
2005,334,11974,13758,1037094,1042080,907,6.524,1195,8.596,102049,16896,85153,1.621,9.793,110822,37207,73615,3.570,10.635,-8773,-0.842,19.586,823,834,12810
2005,335,5017,5939,427468,431504,412,6.924,435,7.310,37742,9238,28504,2.141,8.747,45522,14443,31079,3.347,10.550,-7780,-1.803,17.493,306,306,4190
2005,336,9863,11971,1635255,1627677,898,7.496,917,7.654,162877,30173,132704,1.854,10.007,149532,30554,118978,1.877,9.187,13345,0.820,18.374,650,656,11588
2005,337,19178,20018,550956,554575,1698,8.441,1894,9.415,64467,17537,46930,3.162,11.625,71756,24268,47488,4.376,12.939,-7289,-1.314,23.249,1442,1447,11976
2005,339,27794,29050,680275,680784,2306,7.911,2506,8.597,78795,21311,57484,3.130,11.574,79464,23558,55906,3.460,11.672,-669,-0.098,23.148,1913,1922,13564
2005,423,171488,233883,3373312,3358217,19509,8.343,19422,8.306,461324,140597,320727,4.187,13.737,431291,143773,287518,4.281,12.843,30033,0.894,25.686,12737,13261,71493
2005,424,96993,124420,2290082,2301769,10869,8.716,11426,9.163,287658,92662,194996,4.026,12.497,310662,99301,211361,4.314,13.497,-23004,-0.999,24.995,8128,8292,48121
2005,425,37725,39757,296571,292825,5324,13.654,3793,9.728,53722,19084,34638,6.517,18.346,45946,15052,30894,5.140,15.691,7776,2.656,31.381,2749,2784,9534
2005,441,88926,119618,1944029,1946665,10460,8.785,9348,7.851,229371,86477,142894,4.442,11.783,234437,76519,157918,3.931,12.043,-5066,-0.260,23.566,6963,7131,52294
2005,442,44164,61178,570718,573977,6302,10.349,5740,9.426,87561,37701,49860,6.568,15.255,93568,27841,65727,4.851,16.302,-6007,-1.047,30.510,4102,4298,17881
2005,443,30079,50316,508056,503101,6862,13.794,5720,11.499,99822,36630,63192,7.281,19.841,87026,27013,60013,5.369,17.298,12796,2.543,34.596,3706,3925,15534
2005,444,59342,82838,1281243,1261562,5830,7.055,5420,6.559,158496,54971,103525,4.357,12.563,119994,31488,88506,2.496,9.512,38502,3.052,19.023,3817,3982,19090
2005,445,100464,133878,2890736,2904443,15955,11.955,15112,11.324,338505,147503,191002,5.079,11.655,365092,125060,240032,4.306,12.570,-26587,-0.915,23.309,10644,10861,54218
2005,446,40037,80135,1016813,1023588,6365,7.981,5607,7.030,132393,53523,78870,5.229,12.934,148573,29600,118973,2.892,14.515,-16180,-1.581,25.868,3203,3303,16515
2005,447,62999,111981,910098,923854,9369,8.348,9881,8.804,141250,55896,85354,6.050,15.289,167392,56645,110747,6.131,18.119,-26142,-2.830,30.578,5988,6539,35469
2005,448,59341,140709,1535850,1539936,13462,9.592,12748,9.083,243085,86823,156262,5.638,15.785,252519,78220,174299,5.079,16.398,-9434,-0.613,31.571,6003,6573,28603
2005,451,34337,49765,554150,555050,4955,9.924,5285,10.585,77176,30509,46667,5.497,13.904,78838,27733,51105,4.996,14.204,-1662,-0.299,27.809,3536,3758,15526
2005,452,9076,42995,2750920,2743882,3724,8.847,1923,4.568,220457,82871,137586,3.020,8.034,209585,20104,189481,0.733,7.638,10872,0.396,15.277,1231,1272,5056
2005,453,89634,114671,808709,812855,12845,11.181,13272,11.552,134942,54579,80363,6.714,16.601,142917,48409,94508,5.955,17.582,-7975,-0.981,33.202,10029,10440,34165
2005,454,40421,47505,535737,541970,5712,12.048,5523,11.649,85431,34844,50587,6.429,15.763,97610,37840,59770,6.982,18.010,-12179,-2.247,31.526,3909,3981,17087
2005,481,2504,5270,473868,473117,561,10.960,258,5.041,28450,6885,21565,1.455,6.013,26916,2263,24653,0.478,5.689,1534,0.324,11.378,202,206,1674
2005,483,1220,1692,66071,65722,215,12.917,160,9.612,10581,2979,7602,4.533,16.100,10024,3820,6204,5.812,15.252,557,0.848,30.504,112,112,3281
2005,484,86563,99691,1478903,1457776,15898,16.147,13430,13.640,233533,72782,160751,4.993,16.020,189956,65563,124393,4.497,13.031,43577,2.989,26.061,10038,10194,41196
2005,485,13198,15485,399889,399125,1981,12.831,1890,12.241,57704,24956,32748,6.253,14.458,56584,22231,34353,5.570,14.177,1120,0.281,28.354,1430,1434,11787
2005,486,196,2595,36175,36324,164,6.364,128,4.967,4310,2123,2187,5.845,11.865,4698,1074,3624,2.957,12.934,-388,-1.068,23.731,18,19,141
2005,487,1754,1850,22118,21987,289,15.719,266,14.468,3364,1048,2316,4.766,15.300,3152,969,2183,4.407,14.336,212,0.964,28.671,188,188,667
2005,488,26076,33969,547823,539395,4440,13.290,3320,9.937,93232,35900,57332,6.656,17.285,76294,27099,49195,5.024,14.144,16938,3.140,28.289,2078,2136,11874
2005,492,6881,12590,541977,565789,1574,12.292,2005,15.657,65778,35495,30283,6.274,11.626,110678,17102,93576,3.023,19.562,-44900,-7.936,23.252,838,868,4491
2005,493,6709,12989,590951,589094,1091,8.416,1040,8.023,79159,26448,52711,4.490,13.437,76659,23982,52677,4.071,13.013,2500,0.424,26.026,390,399,4267
2005,511,20862,29260,1026079,1020656,2886,9.876,2812,9.623,119924,37075,82849,3.632,11.750,109713,38962,70751,3.817,10.749,10211,1.000,21.499,1709,1777,18079
2005,512,14581,18317,304445,304599,2660,14.614,2430,13.350,46102,21858,24244,7.176,15.135,46313,17760,28553,5.831,15.205,-211,-0.069,30.271,1488,1501,7459
2005,515,4702,9509,280740,281147,790,8.243,940,9.808,31196,14030,17166,4.990,11.096,31665,12452,19213,4.429,11.263,-469,-0.167,22.192,378,409,5613
2005,517,11329,50088,1291470,1328356,6684,13.389,6349,12.718,193538,76574,116964,5.765,14.570,267730,84743,182987,6.380,20.155,-74192,-5.585,29.139,1839,2111,17178
2005,518,7295,13994,384308,384392,2038,14.868,1464,10.681,62971,25777,37194,6.706,16.382,63666,19673,43993,5.118,16.563,-695,-0.181,32.764,678,695,6703
2005,519,4889,5895,104231,101705,792,13.705,560,9.690,18283,6420,11863,6.312,17.977,13029,4215,8814,4.144,12.811,5254,5.166,25.621,370,371,2302
2005,521,19,54,20069,20758,(D),(D),6,10.714,565,(D),557,(D),2.722,2031,182,1849,0.877,9.784,-1466,-7.063,5.444,(D),(D),(D)
2005,522,58787,203851,3170918,3167230,25476,12.650,20546,10.202,517792,209109,308683,6.602,16.348,509323,230123,279200,7.266,16.081,8469,0.267,32.162,4985,5430,33593
2005,523,44470,72143,843056,845908,12256,16.916,12874,17.769,203730,133290,70440,15.757,24.084,207457,115183,92274,13.617,24.525,-3727,-0.441,48.168,4054,4128,18661
2005,524,124437,164332,2325812,2355872,20101,12.377,16250,10.006,297240,124694,172546,5.293,12.617,353995,125467,228528,5.326,15.026,-56755,-2.409,25.234,7649,7859,37168
2005,525,2100,3637,39163,35268,1279,40.584,308,9.773,16100,9555,6545,27.093,45.651,8641,1655,6986,4.693,24.501,7459,21.150,49.003,113,133,555
2005,531,214756,248898,1464925,1447852,39119,16.135,26228,10.818,287959,148066,139893,10.227,19.889,254700,95296,159404,6.582,17.592,33259,2.297,35.183,17820,18424,61701
2005,532,26467,61272,620817,620264,7226,11.961,5505,9.113,102145,46269,55876,7.460,16.468,100127,30669,69458,4.945,16.143,2018,0.325,32.285,2882,3274,13740
2005,533,1920,1989,28566,28280,254,12.845,231,11.681,5211,1879,3332,6.644,18.427,4685,1744,2941,6.167,16.567,526,1.860,33.134,169,172,806
2005,541,627833,696072,7390605,7317672,91690,13.332,75054,10.913,1288773,453027,835746,6.191,17.612,1137724,387924,749800,5.301,15.548,151049,2.064,31.095,50437,51043,210184
2005,551,25778,47475,2807540,2817392,4583,9.762,3529,7.517,415571,138422,277149,4.913,14.750,435852,121321,314531,4.306,15.470,-20281,-0.720,29.500,1062,1103,17215
2005,561,253226,299744,8624959,8373211,44484,14.996,38263,12.899,2009539,621466,1388073,7.422,24.000,1504228,525276,978952,6.273,17.965,505311,6.035,35.930,25008,25393,305162
2005,562,14438,17940,334789,340798,1916,10.725,1764,9.875,51533,16202,35331,4.754,15.121,62452,28143,34309,8.258,18.325,-10919,-3.204,30.243,1004,1007,5863
2005,611,63584,71745,2890720,2866008,8827,12.605,5392,7.700,295729,96872,198857,3.380,10.319,248251,26302,221949,0.918,8.662,47478,1.657,17.324,3789,3828,17764
2005,621,415355,481878,5389132,5367047,42044,8.831,30515,6.409,763254,254758,508496,4.747,14.221,721196,183941,537255,3.427,13.437,42058,0.784,26.875,21422,21918,115886
2005,622,4137,6773,5253987,5228323,298,4.439,177,2.637,223904,40934,182970,0.783,4.283,172685,43503,129182,0.832,3.303,51219,0.980,6.606,80,82,11019
2005,623,32015,69830,2929502,2915111,6313,9.159,4506,6.537,322802,137310,185492,4.710,11.073,294417,114993,179424,3.945,10.100,28385,0.974,20.199,2257,2437,48166
2005,624,101701,137992,2330272,2294898,13434,9.824,10954,8.010,350396,108349,242047,4.721,15.268,279708,75547,204161,3.292,12.188,70688,3.080,24.377,7386,7574,46818
2005,711,30010,30782,417643,411427,5145,16.919,4399,14.466,91807,35846,55961,8.713,22.314,79008,20360,58648,4.949,19.203,12799,3.111,38.407,2838,2850,12722
2005,712,5933,6354,121059,120649,434,6.895,314,4.989,10679,1524,9155,1.263,8.851,9868,1018,8850,0.844,8.179,811,0.672,16.358,183,183,573
2005,713,53478,59911,1401450,1387481,8026,13.605,6186,10.486,208663,79286,129377,5.714,15.039,181686,55540,126146,4.003,13.095,26977,1.944,26.189,4645,4683,38725
2005,721,44104,54508,1839425,1837118,5581,10.264,5312,9.769,239964,102965,136999,5.605,13.062,235105,101180,133925,5.508,12.797,4859,0.264,25.595,3427,3620,53272
2005,722,354243,482941,9190294,9050538,65700,13.805,51680,10.859,1722628,911361,811267,10.070,19.033,1449277,504123,945154,5.570,16.013,273351,3.020,32.026,38724,39668,346846
2005,811,191132,208233,1290347,1302664,21555,10.351,21564,10.355,213913,88674,125239,6.807,16.421,238703,78679,160024,6.040,18.324,-24790,-1.903,32.842,16167,16450,57114
2005,812,149165,186451,1321987,1329312,24108,13.025,21396,11.559,223047,103422,119625,7.780,16.779,237465,86533,150932,6.510,17.864,-14418,-1.085,33.558,15085,15448,57522
2005,813,278475,287062,2736253,2739667,15058,5.329,6074,2.150,282588,51373,231215,1.875,10.315,290108,22816,267292,0.833,10.589,-7520,-0.274,20.629,3966,3990,14774
2006,211,5731,6856,90720,86361,830,12.344,566,8.418,20120,9006,11114,10.428,23.298,11203,5101,6102,5.907,12.972,8917,10.325,25.945,369,372,1844
2006,212,4097,6749,204480,200030,665,9.983,489,7.341,29485,8745,20740,4.372,14.740,20580,6324,14256,3.162,10.288,8905,4.452,20.577,282,289,2507
2006,213,8081,9627,254429,234225,1601,17.303,852,9.208,67283,26332,40951,11.242,28.726,26544,12752,13792,5.444,11.333,40739,17.393,22.665,552,566,5138
2006,221,6071,16700,617881,625350,1140,6.828,1131,6.774,51746,18699,33047,2.990,8.275,66305,13992,52313,2.237,10.603,-14559,-2.328,16.549,279,284,2139
2006,236,203154,205646,1707748,1644781,39910,19.922,29274,14.613,426880,152757,274123,9.287,25.954,301884,110838,191046,6.739,18.354,124996,7.600,36.708,22011,22076,82028
2006,237,43089,45264,990751,951974,5653,12.647,4523,10.119,212870,49484,163386,5.198,22.361,135898,36273,99625,3.810,14.275,76972,8.086,28.551,3302,3313,20360
2006,238,429738,435810,4651505,4466070,71131,16.710,50850,11.946,1105752,332756,772996,7.451,24.759,736638,235310,501328,5.269,16.494,369114,8.265,32.988,38836,38891,181266
2006,311,19821,23987,1446004,1451256,2002,8.297,2289,9.486,125763,29223,96540,2.014,8.666,136880,46289,90591,3.190,9.432,-11117,-0.766,17.332,1737,1754,17854
2006,312,2699,3283,155922,155608,426,13.348,243,7.614,13823,2805,11018,1.803,8.883,13318,3030,10288,1.947,8.559,505,0.325,17.117,180,180,1618
2006,313,2572,3034,190454,198470,199,6.396,354,11.377,16579,5948,10631,2.997,8.353,32996,13117,19879,6.609,16.625,-16417,-8.272,16.707,242,246,3226
2006,314,6430,6712,159252,163393,567,8.285,831,12.142,15389,3623,11766,2.217,9.418,23809,9766,14043,5.977,14.572,-8420,-5.153,18.837,688,690,4496
2006,315,8398,8629,208468,216139,1495,17.069,1754,20.026,34249,17713,16536,8.195,15.846,49349,24043,25306,11.124,22.832,-15100,-6.986,31.692,1544,1548,17363
2006,316,1200,1244,37022,37805,110,8.723,144,11.420,3740,887,2853,2.346,9.893,5247,2367,2880,6.261,13.879,-1507,-3.986,19.786,110,112,957
2006,321,14094,16059,585271,574901,1513,9.462,1377,8.611,78109,23435,54674,4.076,13.587,57018,18123,38895,3.152,9.918,21091,3.669,19.836,1075,1084,10765
2006,322,3182,5033,441723,446970,231,4.545,330,6.493,26410,8377,18033,1.874,5.909,37062,12734,24328,2.849,8.292,-10652,-2.383,11.817,171,172,3124
2006,323,30374,31973,643445,652129,2136,6.584,3070,9.464,62210,19633,42577,3.011,9.540,79609,29221,50388,4.481,12.208,-17399,-2.668,19.079,2554,2559,17737
2006,324,1031,2268,100027,100339,193,8.606,142,6.332,8258,2622,5636,2.613,8.230,8958,3942,5016,3.929,8.928,-700,-0.698,16.460,52,52,922
2006,325,9084,12721,801382,803346,961,7.585,858,6.772,62095,14668,47427,1.826,7.730,66098,16440,49658,2.046,8.228,-4003,-0.498,15.459,514,516,6166
2006,326,10996,14117,896572,897966,774,5.458,904,6.374,80218,20289,59929,2.259,8.933,83177,24187,58990,2.694,9.263,-2959,-0.330,17.867,613,621,9189
2006,327,10650,16644,484154,476352,1623,9.904,1109,6.768,66773,21505,45268,4.515,14.018,50720,13506,37214,2.835,10.648,16053,3.370,21.295,703,720,6403
2006,331,3764,4731,444326,445317,269,5.670,296,6.239,29214,5715,23499,1.283,6.560,31394,9477,21917,2.128,7.050,-2180,-0.490,13.121,206,207,2446
2006,332,52560,56592,1563293,1542930,3988,7.061,3758,6.654,183779,42472,141307,2.753,11.911,142935,43576,99359,2.824,9.264,40844,2.647,18.528,2881,2902,23799
2006,333,22841,25299,1137227,1126542,1495,5.885,1701,6.696,114238,21709,92529,1.927,10.141,91959,31907,60052,2.832,8.163,22279,1.978,16.326,1255,1261,13006
2006,334,11932,13741,1046857,1043661,1058,7.707,1030,7.503,119878,28346,91532,2.716,11.486,112954,31431,81523,3.012,10.823,6924,0.663,21.646,701,706,9983
2006,335,4989,5892,417246,420782,374,6.326,415,7.019,34327,7257,27070,1.725,8.158,41188,14375,26813,3.416,9.788,-6861,-1.631,16.316,271,271,3456
2006,336,9954,12143,1620323,1620936,1077,8.909,969,8.016,167444,34648,132796,2.138,10.330,168695,38532,130163,2.377,10.407,-1251,-0.077,20.660,716,731,15710
2006,337,19356,20160,546904,548526,1873,9.277,1934,9.579,60267,14297,45970,2.606,10.987,62789,21687,41102,3.954,11.447,-2522,-0.460,21.974,1545,1557,11487
2006,339,28014,29310,685739,681754,2724,9.317,2575,8.808,81390,22442,58948,3.292,11.938,73523,22315,51208,3.273,10.784,7867,1.154,21.569,2074,2082,15163
2006,423,172115,237105,3461279,3419216,22238,9.439,19231,8.163,504264,173123,331141,5.063,14.748,419953,151229,268724,4.423,12.282,84311,2.466,24.564,12289,12810,73942
2006,424,95979,124079,2274763,2281254,12020,9.686,12052,9.712,302528,99899,202629,4.379,13.261,315396,96887,218509,4.247,13.826,-12868,-0.564,26.523,8564,8719,51593
2006,425,38851,41030,298891,298270,5950,14.655,5093,12.544,48106,18293,29813,6.133,16.128,47652,21613,26039,7.246,15.976,454,0.152,31.952,4004,4029,15846
2006,441,88358,120290,1940644,1941106,10862,9.071,9771,8.160,228350,94023,134327,4.844,11.764,228717,68143,160574,3.511,11.783,-367,-0.019,23.528,7645,7815,49866
2006,442,43711,61122,573955,572803,6627,10.846,6586,10.779,91383,40590,50793,7.086,15.954,89732,30408,59324,5.309,15.665,1651,0.288,31.331,4712,4956,20136
2006,443,29045,49168,510811,509670,5491,11.073,6332,12.769,89966,29409,60557,5.770,17.652,87107,40686,46421,7.983,17.091,2859,0.561,34.182,4238,4380,20699
2006,444,59003,84204,1385766,1332372,7326,8.795,5513,6.618,227473,119994,107479,9.006,17.073,123226,33169,90057,2.489,9.249,104247,7.824,18.497,4109,4193,19734
2006,445,99360,132805,2879891,2890448,16237,12.243,15866,11.964,338430,140534,197896,4.862,11.709,361013,124555,236458,4.309,12.490,-22583,-0.781,23.417,11968,12124,61744
2006,446,40083,82511,1082652,1051068,8173,10.042,5928,7.284,177903,81272,96631,7.732,16.926,117227,35782,81445,3.404,11.153,60676,5.773,22.306,3538,3733,17370
2006,447,63629,112744,919605,917770,11029,9.786,10950,9.716,161754,70673,91081,7.701,17.625,157918,61104,96814,6.658,17.207,3836,0.418,34.413,7051,7479,39315
2006,448,59556,142536,1618109,1576130,15258,10.794,12893,9.121,295712,114371,181341,7.256,18.762,213188,63219,149969,4.011,13.526,82524,5.236,27.052,6809,7816,27527
2006,451,33712,49715,579002,566459,5557,11.182,5519,11.106,101134,49319,51815,8.707,17.854,74482,26613,47869,4.698,13.149,26652,4.705,26.297,4205,4314,16330
2006,452,8756,44010,2886027,2819655,3623,8.330,2593,5.962,283887,111905,171982,3.969,10.068,152058,21966,130092,0.779,5.393,131829,4.675,10.786,1600,1708,8136
2006,453,87248,112694,806258,807526,13310,11.719,15065,13.265,138665,58219,80446,7.210,17.172,140775,54196,86579,6.711,17.433,-2110,-0.261,34.343,11915,12205,39922
2006,454,40801,47774,547058,542085,5999,12.612,5586,11.743,90559,33997,56562,6.272,16.706,80240,31644,48596,5.837,14.802,10319,1.904,29.604,4265,4317,18578
2006,481,2491,5211,468016,465351,569,11.226,284,5.603,41044,10247,30797,2.202,8.820,36770,1103,35667,0.237,7.902,4274,0.918,15.803,223,223,795
2006,483,1227,1676,71621,68697,189,11.290,185,11.051,12069,2558,9511,3.724,17.568,6213,1617,4596,2.354,9.044,5856,8.524,18.088,101,102,790
2006,484,89482,103029,1527616,1504417,17969,17.733,14570,14.379,249413,91609,157804,6.089,16.579,202752,75213,127539,4.999,13.477,46661,3.102,26.954,11295,11436,47523
2006,485,13170,15558,417922,412093,2149,13.851,2063,13.297,63763,28370,35393,6.884,15.473,51961,20929,31032,5.079,12.609,11802,2.864,25.218,1594,1637,13259
2006,486,201,2529,35734,36397,393,15.277,480,18.659,7110,4345,2765,11.938,19.535,8553,5810,2743,15.963,23.499,-1443,-3.965,39.069,13,13,345
2006,487,1805,1906,22396,22092,335,17.833,280,14.906,4045,1400,2645,6.337,18.310,3399,1093,2306,4.948,15.386,646,2.924,30.772,200,202,751
2006,488,27016,35678,590427,570677,5243,15.047,3576,10.263,118051,51659,66392,9.052,20.686,77748,27943,49805,4.896,13.624,40303,7.062,27.248,2341,2427,14526
2006,492,6849,12543,565360,553926,1590,12.670,1602,12.766,62246,13066,49180,2.359,11.237,39731,17383,22348,3.138,7.173,22515,4.065,14.345,919,940,6369
2006,493,6775,13374,624506,613908,1358,10.234,1149,8.659,112382,50098,62284,8.161,18.306,91966,23649,68317,3.852,14.980,20416,3.326,29.961,406,429,4891
2006,511,20794,29722,1031272,1028526,3282,11.104,2950,9.981,125149,44585,80564,4.335,12.168,120631,46096,74535,4.482,11.729,4518,0.439,23.457,1807,1851,17134
2006,512,15164,18888,335671,327369,3094,16.656,2469,13.292,67405,27101,40304,8.278,20.590,50626,18463,32163,5.640,15.465,16779,5.125,30.929,1556,1575,6544
2006,515,4644,10044,296588,289393,1274,13.019,757,7.736,49407,19866,29541,6.865,17.073,34807,10942,23865,3.781,12.028,14600,5.045,24.055,379,394,3535
2006,517,10647,49529,1238595,1266140,7023,14.133,7346,14.784,190030,84150,105880,6.646,15.009,249643,73164,176479,5.779,19.717,-59613,-4.708,30.017,1725,1935,18959
2006,518,7374,15336,397419,389085,2740,18.712,1354,9.247,72438,26585,45853,6.833,18.618,56479,18042,38437,4.637,14.516,15959,4.102,29.032,725,740,6689
2006,519,5183,6459,118545,111239,1196,19.351,639,10.339,27023,8918,18105,8.017,24.293,12504,5027,7477,4.519,11.241,14519,13.052,22.481,423,428,1921
2006,521,21,55,19862,19962,5,9.346,(D),(D),1158,43,1115,0.215,5.801,1365,(D),1352,(D),6.838,-207,-1.037,11.602,(D),(D),(D)
2006,522,60473,214794,3267123,3217301,31759,15.181,20579,9.837,665506,303102,362404,9.421,20.685,570286,242063,328223,7.524,17.726,95220,2.960,35.451,5709,6016,32857
2006,523,45854,76744,903177,871823,14234,19.172,9237,12.441,187546,95678,91868,10.974,21.512,122724,54304,68420,6.229,14.077,64822,7.435,28.153,4702,4751,18007
2006,524,126565,168332,2373201,2351509,18834,11.326,14757,8.874,326815,136598,190217,5.809,13.898,280211,101239,178972,4.305,11.916,46604,1.982,23.832,8895,9016,30146
2006,525,2193,3402,36563,34790,1113,37.697,214,7.248,9532,6504,3028,18.695,27.399,6243,1534,4709,4.409,17.945,3289,9.454,35.890,124,138,559
2006,531,223562,262334,1532176,1497278,45099,17.643,31673,12.391,320091,162017,158074,10.821,21.378,249822,109318,140504,7.301,16.685,70269,4.693,33.370,23029,23230,74591
2006,532,25879,62269,618780,618708,7010,11.360,5883,9.534,101008,36627,64381,5.920,16.326,100184,35819,64365,5.789,16.192,824,0.133,32.385,3205,3469,15998
2006,533,1914,1995,29283,28609,282,14.344,224,11.394,5316,2439,2877,8.525,18.582,4145,1356,2789,4.740,14.489,1171,4.093,28.977,167,168,872
2006,541,647888,722571,7777098,7590287,107001,15.084,80629,11.366,1483193,526674,956519,6.939,19.541,1110819,417233,693586,5.497,14.635,372374,4.906,29.269,56432,56919,235136
2006,551,26141,48931,2908676,2892104,5492,11.365,4280,8.857,488562,153568,334994,5.310,16.893,457452,110543,346909,3.822,15.817,31110,1.076,31.635,1089,1122,14602
2006,561,261306,313169,9316266,8981785,52643,17.174,39364,12.842,2225897,717998,1507899,7.994,24.782,1562730,525634,1037096,5.852,17.399,663167,7.383,34.798,27542,27850,285932
2006,562,15065,18847,347336,343323,2220,11.970,1619,8.729,55468,20062,35406,5.843,16.156,47171,16554,30617,4.822,13.740,8297,2.417,27.479,1143,1164,8881
2006,611,65731,74876,2979804,2922457,9906,13.590,5940,8.149,316538,88198,228340,3.018,10.831,201543,29367,172176,1.005,6.896,114995,3.935,13.793,4483,4547,20957
2006,621,422886,495326,5643383,5520608,47734,9.766,34635,7.086,899839,339151,560688,6.143,16.300,652153,215294,436859,3.900,11.813,247686,4.487,23.626,24871,25421,128430
2006,622,3767,6528,5336693,5300828,272,4.185,215,3.308,237250,45633,191617,0.861,4.476,164885,52364,112521,0.988,3.111,72365,1.365,6.221,106,106,19622
2006,623,32536,71739,2984851,2960705,6616,9.338,4831,6.819,338480,141552,196928,4.781,11.432,290275,104767,185508,3.539,9.804,48205,1.628,19.609,2411,2549,57050
2006,624,103282,142428,2422075,2377152,16498,11.762,12162,8.671,389131,144886,244245,6.095,16.370,299367,85259,214108,3.587,12.594,89764,3.776,25.187,8598,8793,54832
2006,711,31175,31979,426444,419248,5849,18.647,4624,14.742,80428,26167,54261,6.241,19.184,66011,20296,45715,4.841,15.745,14417,3.439,31.490,3149,3152,14305
2006,712,5989,6467,122958,122131,531,8.287,412,6.430,11911,2387,9524,1.954,9.753,10234,1468,8766,1.202,8.380,1677,1.373,16.759,250,251,780
2006,713,54393,61217,1431344,1416770,8621,14.244,7236,11.955,213964,84824,129140,5.987,15.102,184685,62864,121821,4.437,13.036,29279,2.067,26.071,5765,5812,47817
2006,721,44689,55167,1876854,1864357,6753,12.301,6211,11.314,270817,123166,147651,6.606,14.526,246979,108110,138869,5.799,13.247,23838,1.279,26.495,4456,4527,60659
2006,722,363289,497811,9536706,9369312,71756,14.626,57340,11.688,1800687,954420,846267,10.187,19.219,1465509,552028,913481,5.892,15.642,335178,3.577,31.283,45316,46255,398609
2006,811,190139,207457,1299156,1296319,22893,11.009,23857,11.473,228976,93160,135816,7.187,17.664,223517,90286,133231,6.965,17.242,5459,0.421,34.485,18608,18957,66383
2006,812,149871,187174,1341705,1331151,25420,13.629,24087,12.915,237786,116537,121249,8.755,17.863,216542,98117,118425,7.371,16.267,21244,1.596,32.535,17955,18401,69389
2006,813,275126,284091,2770859,2735604,16781,5.989,9006,3.214,313134,60480,252654,2.211,11.447,242893,27269,215624,0.997,8.879,70241,2.568,17.758,6189,6232,17312
2007,211,5798,6928,141153,114418,856,12.547,645,9.454,66441,11836,54605,10.345,58.069,13029,7669,5360,6.703,11.387,53412,46.681,22.774,352,354,1897
2007,212,4045,6591,215856,207773,607,9.231,577,8.774,42796,11495,31301,5.532,20.597,26647,6769,19878,3.258,12.825,16149,7.772,25.650,282,285,3297
2007,213,8778,10573,346402,299858,1897,18.902,823,8.200,125065,34909,90156,11.642,41.708,31584,14478,17106,4.828,10.533,93481,31.175,21.066,504,516,5515
2007,221,5544,16192,643135,633347,1039,6.412,1063,6.560,69969,17188,52781,2.714,11.047,50686,13777,36909,2.175,8.003,19283,3.045,16.006,233,245,1584
2007,236,201630,204103,1602651,1625329,33803,16.632,32081,15.785,328526,116433,212093,7.164,20.213,375153,121548,253605,7.478,23.082,-46627,-2.869,40.426,24099,24108,82602
2007,237,42448,44573,1033601,1010176,4499,10.076,4652,10.419,204757,37750,167007,3.737,20.269,158222,39368,118854,3.897,15.663,46535,4.607,31.326,3282,3294,22622
2007,238,441032,447457,4651064,4697769,59432,13.371,53467,12.029,884136,240735,643401,5.124,18.820,979341,237547,741794,5.057,20.847,-95205,-2.027,37.641,39982,40016,175289
2007,311,19965,24221,1439554,1446766,1765,7.250,2012,8.265,135510,32183,103327,2.224,9.366,149660,40094,109566,2.771,10.344,-14150,-0.978,18.733,1436,1460,15801
2007,312,2851,3444,155155,154768,393,11.665,243,7.213,15384,4138,11246,2.674,9.940,15041,4463,10578,2.884,9.718,343,0.222,19.437,153,153,1797
2007,313,2381,2787,164111,176978,157,5.438,357,12.366,11588,3488,8100,1.971,6.548,37235,17773,19462,10.042,21.039,-25647,-14.492,13.095,236,238,5256
2007,314,5995,6261,145828,149414,432,6.756,698,10.916,14213,4237,9976,2.836,9.512,21572,6028,15544,4.034,14.438,-7359,-4.925,19.025,554,561,3642
2007,315,7574,7750,175406,183123,1021,12.810,1462,18.343,27015,10726,16289,5.857,14.752,42275,21607,20668,11.799,23.086,-15260,-8.333,29.505,1239,1244,14432
2007,316,1190,1233,34159,35464,108,8.699,125,10.068,2928,773,2155,2.180,8.256,5508,1976,3532,5.572,15.531,-2580,-7.275,16.513,97,97,794
2007,321,14164,16194,537695,563960,1258,7.744,1358,8.360,44851,15502,29349,2.749,7.953,97504,25419,72085,4.507,17.289,-52653,-9.336,15.906,976,1009,13788
2007,322,3123,4864,419254,427278,170,3.445,310,6.283,24545,5508,19037,1.289,5.745,40284,14834,25450,3.472,9.428,-15739,-3.684,11.489,136,139,2984
2007,323,30429,32040,644516,652607,1876,5.779,2719,8.376,59180,17791,41389,2.726,9.068,75357,27967,47390,4.285,11.547,-16177,-2.479,18.136,2150,2162,14484
2007,324,1049,2220,101131,100085,160,7.189,171,7.684,9558,2629,6929,2.627,9.550,7715,1782,5933,1.780,7.708,1843,1.841,15.417,50,58,683
2007,325,9445,13175,801339,808967,892,6.775,875,6.646,74455,19036,55419,2.353,9.204,90252,20620,69632,2.549,11.156,-15797,-1.953,18.407,488,493,7243
2007,326,10845,13862,853483,873876,665,4.751,936,6.687,66801,12460,54341,1.426,7.644,107977,31086,76891,3.557,12.356,-41176,-4.712,15.288,576,585,11682
2007,327,10673,16766,476743,482184,1053,6.267,1124,6.690,49980,12275,37705,2.546,10.365,61040,14709,46331,3.050,12.659,-11060,-2.294,20.731,682,701,6960
2007,331,3658,4629,436461,443476,233,4.990,313,6.704,28762,5223,23539,1.178,6.486,43201,13242,29959,2.986,9.741,-14439,-3.256,12.971,215,217,5846
2007,332,53846,57928,1592691,1590336,3673,6.346,3579,6.183,173217,37896,135321,2.383,10.892,168619,46312,122307,2.912,10.603,4598,0.289,21.205,2617,2623,24222
2007,333,22793,25228,1142257,1139852,1309,5.162,1567,6.180,106938,18220,88718,1.598,9.382,102236,29975,72261,2.630,8.969,4702,0.413,17.938,1097,1104,14016
2007,334,11906,13674,1045338,1045413,940,6.828,1127,8.186,102509,19401,83108,1.856,9.806,103173,38658,64515,3.698,9.869,-664,-0.064,19.611,714,720,10196
2007,335,5072,5970,416444,419998,315,5.240,397,6.605,34361,4507,29854,1.073,8.181,41948,16296,25652,3.880,9.988,-7587,-1.806,16.362,237,237,4920
2007,336,10131,12288,1582580,1602190,930,7.548,995,8.076,140390,32449,107941,2.025,8.762,181269,47776,133493,2.982,11.314,-40879,-2.551,17.525,647,652,12170
2007,337,19286,20091,513691,527566,1625,8.048,1825,9.039,49279,12316,36963,2.334,9.341,76975,21524,55451,4.080,14.591,-27696,-5.250,18.682,1414,1418,11434
2007,339,28007,29309,659366,658080,2792,9.581,2457,8.431,76305,20846,55459,3.168,11.595,73602,25076,48526,3.810,11.184,2703,0.411,22.369,1883,1894,13011
2007,423,170979,237293,3535043,3536452,19832,8.368,19227,8.113,511702,150777,360925,4.264,14.469,513815,172456,341359,4.877,14.529,-2113,-0.060,28.939,11275,11653,68347
2007,424,94804,123759,2294871,2308206,11223,9.042,11954,9.631,316023,98000,218023,4.246,13.691,343377,118899,224478,5.151,14.876,-27354,-1.185,27.383,7457,7659,47383
2007,425,37694,39882,276990,282806,5114,12.725,5729,14.255,50694,22090,28604,7.811,17.925,63621,30719,32902,10.862,22.496,-12927,-4.571,35.851,4237,4267,15458
2007,441,86596,119198,1917584,1922624,9549,7.997,9974,8.353,232132,75898,156234,3.948,12.074,243082,90770,152312,4.721,12.643,-10950,-0.570,24.147,7112,7272,62900
2007,442,42587,60967,583164,575208,6922,11.381,6627,10.896,116193,47699,68494,8.292,20.200,101538,34916,66622,6.070,17.652,14655,2.548,35.305,4223,4724,21734
2007,443,27719,50649,500571,500915,8590,17.344,6345,12.811,97265,50689,46576,10.119,19.417,95801,38965,56836,7.779,19.125,1464,0.292,38.250,3703,3972,20417
2007,444,59604,86208,1362503,1367806,6792,7.934,5587,6.526,151823,69433,82390,5.076,11.100,163502,34472,129030,2.520,11.954,-11679,-0.854,22.199,3687,3831,19526
2007,445,97579,130886,2822820,2835997,15437,11.844,14338,11.001,343441,138229,205212,4.874,12.110,372002,123597,248405,4.358,13.117,-28561,-1.007,24.220,10120,10242,53954
2007,446,40052,84084,1022455,1044054,7972,9.600,5879,7.080,149881,59618,90263,5.710,14.356,190991,40380,150611,3.868,18.293,-41110,-3.938,28.711,3166,3275,14983
2007,447,62226,110596,898353,909926,9714,8.741,10793,9.712,150167,62764,87403,6.898,16.503,174161,62239,111922,6.840,19.140,-23994,-2.637,33.006,6107,6565,33363
2007,448,59175,145947,1641263,1628731,16209,11.240,12721,8.822,328753,127260,201493,7.813,20.185,299146,74235,224911,4.558,18.367,29607,1.818,36.734,6198,6559,24331
2007,451,32815,48647,586414,580153,5189,10.628,5547,11.361,104350,42471,61879,7.321,17.987,91488,28841,62647,4.971,15.770,12862,2.217,31.539,3524,3736,14561
2007,452,7866,44315,2881620,2879916,3642,8.296,2818,6.419,255917,87941,167976,3.054,8.886,254069,43377,210692,1.506,8.822,1848,0.064,17.644,1474,1504,5502
2007,453,85284,110050,789217,792658,12311,11.081,14418,12.977,142565,56677,85888,7.150,17.986,147145,55744,91401,7.033,18.564,-4580,-0.578,35.971,9926,10200,33556
2007,454,45641,53423,600012,594913,6549,12.448,4926,9.363,101696,37041,64655,6.226,17.094,91468,30505,60963,5.128,15.375,10228,1.719,30.750,3549,3585,16430
2007,481,2549,5285,484566,479951,663,12.668,560,10.700,67570,12481,55089,2.600,14.079,58310,20808,37502,4.335,12.149,9260,1.929,24.298,236,239,1454
2007,483,1170,1545,72618,72107,170,10.904,198,12.700,11159,3008,8151,4.172,15.476,9687,4258,5429,5.905,13.434,1472,2.041,26.868,103,104,1377
2007,484,90102,103575,1465592,1466850,16373,15.931,14766,14.368,241814,75090,166724,5.119,16.485,246021,85631,160390,5.838,16.772,-4207,-0.287,32.971,11164,11255,47544
2007,485,13310,16006,435235,427052,2265,14.352,1817,11.513,73140,30206,42934,7.073,17.127,56162,24071,32091,5.637,13.151,16978,3.976,26.302,1316,1326,10433
2007,486,190,2585,37639,36879,273,10.746,184,7.243,6484,1938,4546,5.255,17.582,4987,2005,2982,5.437,13.523,1497,4.059,27.046,13,29,658
2007,487,1757,1853,21689,21433,322,17.658,263,14.423,4213,1505,2708,7.022,19.657,3705,1284,2421,5.991,17.286,508,2.370,34.573,195,195,799
2007,488,29076,39107,629326,614698,5371,14.017,3793,9.899,119764,50127,69637,8.155,19.483,90276,32101,58175,5.222,14.686,29488,4.797,29.372,2170,2191,11319
2007,492,6479,11887,554398,555366,1530,12.816,1633,13.678,53391,22208,31183,3.999,9.614,55967,16957,39010,3.053,10.078,-2576,-0.464,19.227,815,838,4089
2007,493,6669,13434,718465,710607,1144,8.473,1280,9.480,113771,33563,80208,4.723,16.010,97450,30666,66784,4.315,13.714,16321,2.297,27.427,342,360,3653
2007,511,19965,28457,1041405,1045315,2585,8.960,3370,11.681,129517,33178,96339,3.174,12.390,138567,44320,94247,4.240,13.256,-9050,-0.866,24.780,1632,1688,17249
2007,512,15394,19009,343340,342161,2884,15.303,2558,13.573,58614,16807,41807,4.912,17.131,56785,22014,34771,6.434,16.596,1829,0.535,33.192,1637,1656,13847
2007,515,4610,9764,289726,293965,1034,10.403,1384,13.925,41341,15895,25446,5.407,14.063,51192,13675,37517,4.652,17.414,-9851,-3.351,28.126,317,326,3287
2007,517,9488,49569,1241030,1234115,7876,16.014,7105,14.446,237459,114920,122539,9.312,19.241,220478,113790,106688,9.220,17.865,16981,1.376,35.731,1579,1720,10643
2007,518,8068,14557,409970,409779,1864,12.228,3237,21.235,93531,30829,62702,7.523,22.825,93369,39250,54119,9.578,22.785,162,0.040,45.570,635,656,6137
2007,519,5391,6658,121548,118551,1030,15.913,659,10.182,20947,5738,15209,4.840,17.669,14976,4164,10812,3.512,12.633,5971,5.037,25.265,450,452,2257
2007,521,16,51,19537,19762,(D),(D),6,11.321,820,(D),801,(D),4.149,1220,75,1145,0.380,6.174,-400,-2.024,8.299,5,5,43
2007,522,59632,222395,3268556,3283988,29446,13.445,22690,10.360,563261,232791,330470,7.089,17.152,591876,223765,368111,6.814,18.023,-28615,-0.871,34.303,6909,7650,56177
2007,523,48675,79038,917598,917978,12828,16.346,11710,14.921,186814,71939,114875,7.837,20.351,189595,80199,109396,8.736,20.654,-2781,-0.303,40.701,4310,4380,16527
2007,524,127578,169898,2387218,2394957,18137,10.734,16266,9.627,356498,139199,217299,5.812,14.885,371871,138710,233161,5.792,15.527,-15373,-0.642,29.771,7996,8139,30223
2007,525,2163,5297,49803,45572,1706,37.277,265,5.790,15264,10221,5043,22.428,33.495,7519,1761,5758,3.864,16.499,7745,16.995,32.999,138,147,746
2007,531,224456,264081,1513031,1519137,39788,15.160,36546,13.924,302194,141963,160231,9.345,19.892,315086,128724,186362,8.473,20.741,-12892,-0.849,39.785,24862,25104,77094
2007,532,25193,61361,630852,625187,5384,8.706,6347,10.263,110289,28763,81526,4.601,17.641,99178,38844,60334,6.213,15.864,11111,1.777,31.727,2712,2898,13751
2007,533,1940,2036,30305,29694,299,14.850,254,12.615,7493,3865,3628,13.016,25.234,6410,2469,3941,8.315,21.587,1083,3.647,43.174,173,173,776
2007,541,657506,732969,7788152,7742816,95468,13.167,79608,10.980,1371814,450877,920937,5.823,17.717,1286274,449528,836746,5.806,16.612,85540,1.105,33.225,53759,54172,225037
2007,551,26043,49425,2846634,2823432,5784,11.744,5439,11.043,564901,171984,392917,6.091,20.008,512951,192575,320376,6.821,18.168,51950,1.840,36.335,870,904,10848
2007,561,264331,316770,9371191,9350515,45833,14.597,40288,12.831,1888120,562543,1325577,6.016,20.193,1852256,567518,1284738,6.069,19.809,35864,0.384,39.618,25890,26204,299207
2007,562,15827,20024,375380,370348,2483,12.647,1701,8.664,78379,34939,43440,9.434,21.164,68948,23673,45275,6.392,18.617,9431,2.547,37.234,1037,1043,7839
2007,611,68312,77868,3043161,3003465,8958,11.755,5636,7.396,285540,70071,215469,2.333,9.507,207312,31590,175722,1.052,6.902,78228,2.605,13.805,3967,4001,18254
2007,621,429900,507035,5681390,5619704,45822,9.139,34579,6.896,886342,310106,576236,5.518,15.772,763869,236169,527700,4.203,13.593,122473,2.179,27.185,22412,23040,116786
2007,622,3610,6431,5478947,5417034,136,2.110,164,2.545,348368,42270,306098,0.780,6.431,223433,36821,186612,0.680,4.125,124935,2.306,8.249,82,84,16504
2007,623,32461,72987,3054118,3026672,6648,9.178,5548,7.659,368882,153026,215856,5.056,12.188,314778,125764,189014,4.155,10.400,54104,1.788,20.800,2323,2478,66623
2007,624,103245,143289,2517587,2484148,14266,10.044,11771,8.287,380023,107896,272127,4.343,15.298,312805,83331,229474,3.355,12.592,67218,2.706,25.184,7456,7655,45982
2007,711,32054,32886,432989,427670,5399,16.610,4635,14.260,81849,26284,55565,6.146,19.138,71611,20454,51157,4.783,16.744,10238,2.394,33.489,3093,3098,12378
2007,712,6152,6636,128449,126005,441,6.702,329,5.000,13321,1924,11397,1.527,10.572,8495,1508,6987,1.197,6.742,4826,3.830,13.484,187,189,898
2007,713,54519,61887,1471650,1465225,7972,12.977,7060,11.493,213067,71104,141963,4.853,14.542,200696,63342,137354,4.323,13.697,12371,0.844,27.395,5393,5437,41530
2007,721,45207,55636,1933209,1927421,6135,11.075,5658,10.213,275749,119314,156435,6.190,14.307,263636,125936,137700,6.534,13.678,12113,0.628,27.356,3559,3603,53108
2007,722,370234,512832,9672129,9612947,70416,13.933,55523,10.986,1793567,915231,878336,9.521,18.658,1666513,557402,1109111,5.798,17.336,127054,1.322,34.672,39827,40760,357729
2007,811,187674,204611,1272415,1273576,19921,9.712,20938,10.208,220252,84648,135604,6.646,17.294,221339,78591,142748,6.171,17.379,-1087,-0.085,34.588,15152,15390,51951
2007,812,150490,188081,1332439,1330409,24783,13.254,22601,12.087,251467,108130,143337,8.128,18.901,247858,97687,150171,7.343,18.630,3609,0.271,37.260,15259,15543,56567
2007,813,277214,285832,2760391,2738357,16352,5.821,6507,2.316,305320,56716,248604,2.071,11.150,261037,23924,237113,0.874,9.533,44283,1.617,19.065,4235,4249,14597
2008,211,5776,7038,102400,122244,796,11.486,580,8.369,18507,7110,11397,5.816,15.139,57874,10045,47829,8.217,47.343,-39367,-32.204,30.279,367,367,3191
2008,212,3913,6441,201120,209309,409,6.274,565,8.667,26052,5583,20469,2.667,12.447,42222,7240,34982,3.459,20.172,-16170,-7.725,24.893,330,334,2913
2008,213,9000,11045,316305,330024,1573,14.595,1039,9.640,59708,17820,41888,5.400,18.092,87846,15945,71901,4.831,26.618,-28138,-8.526,36.184,705,708,6909
2008,221,5509,16371,632105,634938,1309,8.044,1113,6.840,64045,23316,40729,3.672,10.087,69526,19028,50498,2.997,10.950,-5481,-0.863,20.174,224,227,1415
2008,236,193624,196226,1505976,1554640,28515,14.220,37104,18.504,296632,100231,196401,6.447,19.080,394887,128998,265889,8.298,25.401,-98255,-6.320,38.161,27764,27778,90422
2008,237,40889,43121,1014087,1020050,3536,8.049,5152,11.728,168563,31818,136745,3.119,16.525,181008,36937,144071,3.621,17.745,-12445,-1.220,33.050,3795,3796,19022
2008,238,426057,432673,4465179,4563675,48724,11.062,64265,14.591,807575,200007,607568,4.383,17.696,1003701,248083,755618,5.436,21.993,-196126,-4.298,35.391,47813,47836,185813
2008,311,19387,23528,1442789,1436671,1666,7.056,1833,7.763,131153,26301,104852,1.831,9.129,119114,32032,87082,2.230,8.291,12039,0.838,16.582,1368,1374,17112
2008,312,3026,3627,153666,153731,461,13.054,270,7.645,16056,4526,11530,2.944,10.444,15956,3532,12424,2.298,10.379,100,0.065,20.758,191,196,1651
2008,313,2297,2650,147220,155197,168,6.194,293,10.802,11268,2426,8842,1.563,7.260,27288,12851,14437,8.280,17.583,-16020,-10.322,14.521,201,209,4980
2008,314,5989,6252,140103,143633,505,8.050,547,8.720,15061,4551,10510,3.168,10.486,22376,7819,14557,5.444,15.579,-7315,-5.093,20.972,425,425,3261
2008,315,7147,7292,163712,168698,919,12.210,1388,18.442,27191,9615,17576,5.700,16.118,36869,18891,17978,11.198,21.855,-9678,-5.737,32.236,1150,1152,12668
2008,316,1176,1222,33287,33875,106,8.583,132,10.688,3362,889,2473,2.624,9.925,4470,2213,2257,6.533,13.196,-1108,-3.271,19.850,95,95,420
2008,321,13529,15531,487191,510448,1045,6.623,1538,9.748,43882,15106,28776,2.959,8.597,90738,24103,66635,4.722,17.776,-46856,-9.179,17.194,1148,1163,13206
2008,322,3043,4739,408151,415053,155,3.229,277,5.771,19397,4261,15136,1.027,4.673,33089,10241,22848,2.467,7.972,-13692,-3.299,9.347,154,155,2549
2008,323,29229,30774,617102,628063,1624,5.191,2643,8.449,48780,12577,36203,2.003,7.767,70968,24221,46747,3.856,11.300,-22188,-3.533,15.533,2143,2155,14254
2008,324,1043,2218,103042,101602,163,7.371,150,6.783,9341,1375,7966,1.353,9.194,6416,1716,4700,1.689,6.315,2925,2.879,12.630,60,60,416
2008,325,9282,12832,804563,801133,765,5.942,850,6.602,77536,14657,62879,1.830,9.678,69624,18827,50797,2.350,8.691,7912,0.988,17.381,481,487,5278
2008,326,10437,13378,814990,831792,550,4.063,870,6.426,63189,11788,51401,1.417,7.597,96998,27013,69985,3.248,11.661,-33809,-4.065,15.193,566,578,12073
2008,327,10292,16427,448148,460551,1047,6.341,1218,7.376,41283,11316,29967,2.457,8.964,66258,15427,50831,3.350,14.387,-24975,-5.423,17.928,696,740,6998
2008,331,3936,4892,435514,436991,298,6.090,301,6.151,31051,8450,22601,1.934,7.106,34161,8467,25694,1.938,7.817,-3110,-0.712,14.211,195,197,3184
2008,332,52582,56655,1564353,1571847,3076,5.403,3621,6.361,153236,36324,116912,2.311,9.749,169092,54323,114769,3.456,10.758,-15856,-1.009,19.498,2749,2763,30897
2008,333,22240,24613,1131823,1132760,1232,4.975,1533,6.191,101807,19170,82637,1.692,8.988,103567,26549,77018,2.344,9.143,-1760,-0.155,17.975,1100,1108,12093
2008,334,11464,13096,995674,1005571,887,6.721,1091,8.266,95593,22857,72736,2.273,9.506,114910,39977,74933,3.976,11.427,-19317,-1.921,19.013,721,723,9836
2008,335,4945,5782,404160,408288,334,5.748,392,6.746,35113,8626,26487,2.113,8.600,43774,16097,27677,3.943,10.721,-8661,-2.121,17.200,271,272,3301
2008,336,9853,11887,1505796,1541951,809,6.733,1067,8.880,113588,21694,91894,1.407,7.367,184863,42712,142151,2.770,11.989,-71275,-4.622,14.733,725,732,13150
2008,337,18202,18883,477155,493745,1283,6.659,2052,10.650,42762,10788,31974,2.185,8.661,75953,24870,51083,5.037,15.383,-33191,-6.722,17.321,1624,1634,12736
2008,339,26647,27943,642383,647586,2030,7.175,2733,9.659,62963,14882,48081,2.298,9.723,73409,22346,51063,3.451,11.336,-10446,-1.613,19.445,2186,2191,12638
2008,423,165995,233466,3521277,3536042,19223,8.210,20599,8.797,491839,152101,339738,4.301,13.909,525092,170748,354344,4.829,14.850,-33253,-0.940,27.819,12290,12789,73874
2008,424,92051,120855,2283842,2282470,10172,8.361,11783,9.685,295033,80743,214290,3.538,12.926,292942,100589,192353,4.407,12.834,2091,0.092,25.669,7703,7994,45745
2008,425,41928,44070,302664,300201,5164,11.738,5015,11.399,47602,17873,29729,5.954,15.857,42259,18383,23876,6.124,14.077,5343,1.780,28.154,3722,3734,12913
2008,441,84218,117188,1883991,1900124,8024,6.801,9626,8.158,205542,71822,133720,3.780,10.817,236776,75274,161502,3.962,12.461,-31234,-1.644,21.635,7165,7321,54698
2008,442,40757,58532,531634,558548,4607,7.698,7232,12.085,70651,24560,46091,4.397,12.649,122001,40588,81413,7.267,21.843,-51350,-9.193,25.298,4652,5278,25785
2008,443,27035,49532,489486,493862,4528,9.074,5264,10.549,68518,23419,45099,4.742,13.874,78052,26743,51309,5.415,15.804,-9534,-1.930,27.748,3486,3635,14057
2008,444,57928,84704,1329684,1344974,4798,5.625,5977,7.008,131517,39401,92116,2.930,9.778,162204,33193,129011,2.468,12.060,-30687,-2.282,19.557,3949,4143,18899
2008,445,97916,131347,2857437,2839488,14139,10.798,13322,10.174,310791,102139,208652,3.597,10.945,274659,93368,181291,3.288,9.673,36132,1.272,19.346,9770,9917,48414
2008,446,39592,84809,1020600,1023490,6711,7.961,5693,6.753,138217,56922,81295,5.562,13.504,145864,40638,105226,3.971,14.252,-7647,-0.747,27.009,3144,3299,15867
2008,447,61253,108221,891804,895209,7976,7.290,10353,9.463,144383,47832,96551,5.343,16.128,150980,55214,95766,6.168,16.865,-6597,-0.737,32.257,6111,6578,31716
2008,448,58182,146596,1645888,1641183,13008,8.898,12190,8.339,287690,91862,195828,5.597,17.529,279904,66977,212927,4.081,17.055,7786,0.474,34.110,6411,6722,23241
2008,451,31934,47747,573437,578885,4574,9.488,5497,11.403,91413,41137,50276,7.106,15.791,101992,30317,71675,5.237,17.619,-10579,-1.827,31.582,3595,3912,15526
2008,452,7486,44056,2972419,2926866,2048,4.633,2341,5.296,243937,93714,150223,3.202,8.334,157081,24951,132130,0.852,5.367,86856,2.968,10.734,1328,1384,5365
2008,453,82179,106943,776856,782993,10226,9.437,13067,12.058,121699,45964,75735,5.870,15.543,133821,47610,86211,6.081,17.091,-12122,-1.548,31.086,9763,9985,32575
2008,454,44848,52400,586397,592134,5764,10.964,6108,11.618,91248,26630,64618,4.497,15.410,103926,40899,63027,6.907,17.551,-12678,-2.141,30.820,4291,4327,17185
2008,481,2499,5151,488595,485263,454,8.702,586,11.233,34764,3981,30783,0.820,7.164,28027,6404,21623,1.320,5.776,6737,1.388,11.551,282,310,3933
2008,483,1181,1547,67612,68846,162,10.428,175,11.265,7210,1758,5452,2.554,10.473,9762,2572,7190,3.736,14.179,-2552,-3.707,20.945,102,102,1297
2008,484,87276,100560,1413001,1432008,13850,13.589,16573,16.261,192237,57919,134318,4.045,13.424,229566,75899,153667,5.300,16.031,-37329,-2.607,26.849,12362,12397,50260
2008,485,13584,16176,448006,441035,2141,13.285,2020,12.535,70372,20441,49931,4.635,15.956,56696,26437,30259,5.994,12.855,13676,3.101,25.710,1346,1350,9210
2008,486,209,2867,42648,40569,521,18.952,285,10.367,10033,5147,4886,12.687,24.731,5603,2437,3166,6.007,13.811,4430,10.920,27.622,11,11,200
2008,487,1782,1884,22606,22182,285,15.200,267,14.240,4215,1281,2934,5.775,19.002,3415,785,2630,3.539,15.396,800,3.607,30.791,174,174,460
2008,488,29228,39135,649281,647722,4356,11.176,4041,10.368,97435,29934,67501,4.621,15.043,93374,31191,62183,4.815,14.416,4061,0.627,28.832,2413,2434,12999
2008,492,6839,12712,588945,574906,2178,17.661,1418,11.499,67481,19308,48173,3.358,11.738,37480,13321,24159,2.317,6.519,30001,5.218,13.039,832,853,5027
2008,493,6853,13962,704575,716696,1259,9.012,1274,9.120,95422,28876,66546,4.029,13.314,120298,34590,85708,4.826,16.785,-24876,-3.471,26.628,376,404,4437
2008,511,19578,27983,1023718,1026192,2718,9.643,3122,11.077,125540,42198,83342,4.112,12.234,131511,47599,83912,4.638,12.815,-5971,-0.582,24.467,1671,1719,15056
2008,512,15669,19287,346771,344855,2883,15.029,2675,13.945,60352,20629,39723,5.982,17.501,57360,28231,29129,8.186,16.633,2992,0.868,33.266,1696,1705,17685
2008,515,4602,9464,284766,286811,1037,10.785,1340,13.936,34122,15604,18518,5.441,11.897,37908,15316,22592,5.340,13.217,-3786,-1.320,23.794,309,320,2339
2008,517,9328,50004,1186287,1192906,7107,14.221,7050,14.107,202919,87496,115423,7.335,17.010,220551,58218,162333,4.880,18.489,-17632,-1.478,34.021,1303,1321,9233
2008,518,8099,14548,405269,407406,1283,8.820,1279,8.793,75439,19091,56348,4.686,18.517,78612,26560,52052,6.519,19.296,-3173,-0.779,37.034,702,712,7812
2008,519,5503,6890,138681,131201,955,14.035,784,11.522,28611,11650,16961,8.880,21.807,13159,5526,7633,4.212,10.030,15452,11.777,20.059,520,522,2199
2008,521,13,48,19006,19261,0,0.000,0,0.000,319,0,319,0.000,1.656,839,0,839,0.000,4.356,-520,-2.700,3.312,0,0,0
2008,522,52398,215460,3059052,3157579,19127,8.753,25230,11.546,421842,142100,279742,4.500,13.360,617567,230543,387024,7.301,19.558,-195725,-6.199,26.719,10579,11878,78818
2008,523,49127,82664,945497,930296,12137,14.958,9085,11.197,163100,72635,90465,7.808,17.532,132708,56037,76671,6.024,14.265,30392,3.267,28.530,4726,4766,19438
2008,524,126648,168900,2390834,2378838,17303,10.223,18005,10.638,378414,168452,209962,7.081,15.908,352263,138459,213804,5.820,14.808,26151,1.099,29.616,8693,8840,30495
2008,525,1865,4293,47618,45114,657,14.983,841,19.179,12100,6301,5799,13.967,26.821,6895,3369,3526,7.468,15.284,5205,11.538,30.567,115,118,964
2008,531,213422,255154,1481153,1494196,32634,12.572,41460,15.973,277027,117246,159781,7.847,18.540,303010,132455,170555,8.865,20.279,-25983,-1.739,37.080,28491,28745,84733
2008,532,24239,60505,620592,624066,5821,9.551,6703,10.998,98523,34877,63646,5.589,15.787,105614,43035,62579,6.896,16.924,-7091,-1.136,31.575,2844,2979,13391
2008,533,1953,2054,31491,31135,273,13.346,256,12.515,6208,1679,4529,5.393,19.939,5568,1515,4053,4.866,17.884,640,2.056,35.767,189,192,1274
2008,541,660549,736037,7900187,7840634,88470,12.037,86390,11.754,1338369,445390,892979,5.681,17.070,1213963,456107,757856,5.817,15.483,124406,1.587,30.966,58263,58726,225341
2008,551,26358,49885,2894220,2947688,4455,8.904,4751,9.496,463294,132405,330889,4.492,15.717,572397,141844,430553,4.812,19.419,-109103,-3.701,31.434,981,1026,16283
2008,561,263122,317607,9268548,9283282,44278,13.987,42188,13.327,1847462,599795,1247667,6.461,19.901,1890920,598207,1292713,6.444,20.369,-43458,-0.468,39.802,27508,27885,291810
2008,562,15964,20247,366479,366365,1952,9.685,1766,8.763,50957,15253,35704,4.163,13.909,50877,16587,34290,4.527,13.887,80,0.022,27.774,1180,1194,7766
2008,611,69508,79328,3123887,3071990,8547,10.948,6029,7.723,284679,57244,227435,1.863,9.267,181025,31794,149231,1.035,5.893,103654,3.374,11.786,4394,4473,22509
2008,621,433271,513271,5863815,5778565,41668,8.170,35090,6.881,882950,267597,615353,4.631,15.280,713639,222993,490646,3.859,12.350,169311,2.930,24.700,23022,23481,119540
2008,622,3680,6677,5564782,5520970,322,4.891,136,2.066,293050,37007,256043,0.670,5.308,210307,59407,150900,1.076,3.809,82743,1.499,7.618,35,35,15728
2008,623,32611,73814,3108103,3081687,6011,8.184,5276,7.183,360291,112998,247293,3.667,11.691,308144,127841,180303,4.148,9.999,52147,1.692,19.998,2253,2398,63888
2008,624,105753,145060,2583625,2542420,14086,9.775,12178,8.451,399071,113120,285951,4.449,15.697,316662,96305,220357,3.788,12.455,82409,3.241,24.910,7356,7538,47048
2008,711,32122,32930,447916,440506,5001,15.173,5060,15.352,82243,21586,60657,4.900,18.670,67566,20519,47047,4.658,15.338,14677,3.332,30.677,3371,3373,13152
2008,712,6274,6757,132922,130775,401,5.967,328,4.881,12741,1669,11072,1.276,9.743,8544,1085,7459,0.830,6.533,4197,3.209,13.067,186,186,582
2008,713,53904,61304,1480964,1471131,7171,11.658,7586,12.333,202482,67548,134934,4.592,13.764,181676,66559,115117,4.524,12.349,20806,1.414,24.699,5760,5819,42626
2008,721,45289,55782,1956618,1947801,5764,10.348,5602,10.057,252087,121978,130109,6.262,12.942,235453,99450,136003,5.106,12.088,16634,0.854,24.176,3613,3681,57222
2008,722,373598,520080,9912727,9798723,64286,12.442,57468,11.123,1799230,822911,976319,8.398,18.362,1580141,572146,1007995,5.839,16.126,219089,2.236,32.252,41882,42771,373101
2008,811,185230,201784,1271044,1275790,17538,8.613,21193,10.409,199659,66275,133384,5.195,15.650,209430,77183,132247,6.050,16.416,-9771,-0.766,31.300,15530,15835,53256
2008,812,151638,190034,1361634,1347637,23909,12.647,21942,11.606,279269,113516,165753,8.423,20.723,249763,98801,150962,7.331,18.533,29506,2.189,37.067,14951,15406,59750
2008,813,278065,286724,2803445,2768766,14969,5.306,5755,2.040,304618,48370,256248,1.747,11.002,235144,22127,213017,0.799,8.493,69474,2.509,16.985,3734,3770,14436
2009,211,5792,7119,107448,105428,748,10.598,626,8.869,17899,6345,11554,6.018,16.977,13931,5280,8651,5.008,13.214,3968,3.764,26.428,364,369,2384
2009,212,3789,6276,198704,200285,479,7.528,652,10.248,27628,8749,18879,4.368,13.794,30478,7225,23253,3.607,15.217,-2850,-1.423,27.589,329,334,3183
2009,213,9253,11352,295550,307286,1364,12.129,1151,10.235,43383,13282,30101,4.322,14.118,67148,15345,51803,4.994,21.852,-23765,-7.734,28.236,734,752,7843
2009,221,5346,16803,642160,637895,1288,7.762,869,5.237,65785,23016,42769,3.608,10.313,57805,16745,41060,2.625,9.062,7980,1.251,18.124,234,321,5198
2009,236,173199,175946,1275816,1409194,22766,12.161,45273,24.184,202495,71063,131432,5.043,14.370,469652,141955,327697,10.073,33.328,-267157,-18.958,28.739,31440,31459,98981
2009,237,37723,39997,897380,946737,2816,6.771,5999,14.425,122100,32588,89512,3.442,12.897,219730,40865,178865,4.316,23.209,-97630,-10.312,25.794,4357,4372,26975
2009,238,387971,394533,3769713,4123969,37829,9.147,75881,18.348,533518,159592,373926,3.870,12.937,1241964,295721,946243,7.171,30.116,-708446,-17.179,25.874,51817,51847,207016
2009,311,19067,23172,1428309,1437493,1673,7.173,1978,8.480,109300,24339,84961,1.693,7.604,128016,31007,97009,2.157,8.906,-18716,-1.302,15.207,1461,1478,14626
2009,312,3148,3744,143495,148402,411,11.191,268,7.297,11812,3758,8054,2.532,7.959,21658,3820,17838,2.574,14.594,-9846,-6.635,15.919,176,177,1229
2009,313,2187,2503,120864,133413,148,5.761,280,10.899,7820,3309,4511,2.480,5.861,32364,8829,23535,6.618,24.259,-24544,-18.397,11.723,196,198,2917
2009,314,5895,6134,118496,129736,482,7.689,751,11.981,7579,3000,4579,2.312,5.842,30207,6145,24062,4.737,23.283,-22628,-17.442,11.684,546,550,3397
2009,315,6276,6399,130217,143843,770,11.458,1412,21.012,16988,7568,9420,5.261,11.810,44309,16214,28095,11.272,30.804,-27321,-18.994,23.620,1163,1165,11822
2009,316,1103,1144,29405,30843,95,8.120,147,12.564,2767,1109,1658,3.596,8.971,5671,1584,4087,5.136,18.387,-2904,-9.415,17.942,115,115,976
2009,321,12672,14575,387031,438689,792,5.250,1814,12.024,24896,9332,15564,2.127,5.675,128257,26029,102228,5.933,29.236,-103361,-23.561,11.350,1248,1265,12608
2009,322,2934,4574,379339,394928,135,2.898,305,6.546,18285,6119,12166,1.549,4.630,49424,13753,35671,3.482,12.515,-31139,-7.885,9.260,171,181,4633
2009,323,27676,29086,546709,581699,1368,4.567,3101,10.353,34624,10830,23794,1.862,5.952,104794,29091,75703,5.001,18.015,-70170,-12.063,11.904,2480,2492,16836
2009,324,994,2140,99649,101334,147,6.776,206,9.495,5714,1156,4558,1.141,5.639,9037,2974,6063,2.935,8.918,-3323,-3.279,11.278,74,74,622
2009,325,9114,12621,750596,774402,787,6.184,997,7.834,57275,17397,39878,2.247,7.396,104728,26609,78119,3.436,13.524,-47453,-6.128,14.792,587,595,6700
2009,326,10026,12874,685877,746935,465,3.540,986,7.507,32874,9680,23194,1.296,4.401,155528,33056,122472,4.426,20.822,-122654,-16.421,8.802,621,643,13941
2009,327,9773,15590,377001,412048,825,5.160,1619,10.127,30017,10921,19096,2.650,7.285,100190,20160,80030,4.893,24.315,-70173,-17.030,14.570,820,831,7340
2009,331,3600,4527,376963,403254,245,5.358,336,7.348,17302,5924,11378,1.469,4.291,70090,9356,60734,2.320,17.381,-52788,-13.091,8.581,225,228,4172
2009,332,51424,55505,1397402,1485752,2547,4.524,4140,7.353,97230,30649,66581,2.063,6.544,274184,47029,227155,3.165,18.454,-176954,-11.910,13.088,2921,2935,25117
2009,333,21614,23983,1036293,1087568,1102,4.528,1812,7.445,72833,21044,51789,1.935,6.697,175931,33580,142351,3.088,16.177,-103098,-9.480,13.394,1249,1263,14792
2009,334,11081,12728,951641,976724,747,5.776,1157,8.946,82717,18465,64252,1.891,8.469,134959,32170,102789,3.294,13.818,-52242,-5.349,16.938,761,765,11319
2009,335,4828,5655,360265,381309,282,4.936,398,6.967,20587,5207,15380,1.366,5.399,62259,12509,49750,3.281,16.328,-41672,-10.929,10.798,249,250,3760
2009,336,9473,11482,1261547,1383509,749,6.403,1181,10.096,80061,20603,59458,1.489,5.787,323965,51551,272414,3.726,23.416,-243904,-17.629,11.574,794,803,14133
2009,337,16696,17321,384965,430273,938,5.177,2533,13.980,23439,8266,15173,1.921,5.447,113929,27426,86503,6.374,26.478,-90490,-21.031,10.895,1928,1934,13422
2009,339,25744,27027,593243,616886,1791,6.510,2764,10.046,47815,12776,35039,2.071,7.751,95984,22076,73908,3.579,15.559,-48169,-7.808,15.502,2106,2110,12145
2009,423,162231,230230,3325585,3443145,15831,6.793,21494,9.222,352749,111465,241284,3.237,10.245,588541,166842,421699,4.846,17.093,-235792,-6.848,20.490,13032,13510,76799
2009,424,90005,119773,2194978,2244394,9638,7.980,11636,9.635,240641,71904,168737,3.204,10.722,338233,96690,241543,4.308,15.070,-97592,-4.348,21.444,7801,7998,49826
2009,425,39935,42039,288735,292618,4557,10.637,6162,14.383,41617,17051,24566,5.827,14.222,49329,20176,29153,6.895,16.858,-7712,-2.636,28.445,4544,4564,14045
2009,441,80097,113463,1643590,1766112,6982,6.051,10810,9.369,117337,49231,68106,2.788,6.644,362262,96836,265426,5.483,20.512,-244925,-13.868,13.288,7991,8128,69433
2009,442,37685,54309,445984,489627,3459,6.120,7874,13.932,45274,20088,25186,4.103,9.247,133849,51565,82284,10.531,27.337,-88575,-18.090,18.493,4900,5894,39258
2009,443,25898,48041,466024,478120,4357,8.941,5739,11.777,56978,25621,31357,5.359,11.917,81705,35876,45829,7.504,17.089,-24727,-5.172,23.834,3508,4161,18179
2009,444,55372,81992,1217965,1273411,3844,4.610,6631,7.952,85998,35420,50578,2.782,6.753,197611,39297,158314,3.086,15.518,-111613,-8.765,13.507,4472,4631,23502
2009,445,98341,132152,2847207,2852287,13582,10.310,12742,9.673,303209,140096,163113,4.912,10.630,314526,103723,210803,3.636,11.027,-11317,-0.397,21.261,9289,9383,46007
2009,446,39083,85746,984906,1003049,6321,7.409,5457,6.396,95117,37939,57178,3.782,9.483,131519,28641,102878,2.855,13.112,-36402,-3.629,18.966,3159,3288,14038
2009,447,61099,107805,854993,874791,7667,7.077,8741,8.068,108714,41382,67332,4.731,12.427,148079,47319,100760,5.409,16.927,-39365,-4.500,24.855,5674,5920,28556
2009,448,56072,142197,1533154,1592513,11384,7.875,16102,11.139,198155,97967,100188,6.152,12.443,312319,96257,216062,6.044,19.612,-114164,-7.169,24.886,6862,7877,28674
2009,451,30784,46111,535795,555520,3637,7.740,5398,11.487,57189,25494,31695,4.589,10.295,97484,27338,70146,4.921,17.548,-40295,-7.254,20.589,3539,3636,14082
2009,452,7127,43646,2910377,2941173,2053,4.681,2480,5.654,186381,50436,135945,1.715,6.337,251238,60547,190691,2.059,8.542,-64857,-2.205,12.674,1211,1432,33988
2009,453,78022,103339,730915,754006,8832,8.390,12691,12.056,89778,36637,53141,4.859,11.907,135726,43332,92394,5.747,18.001,-45948,-6.094,23.814,9817,9970,31274
2009,454,43929,51497,559983,576048,5190,9.962,6389,12.264,79343,31306,48037,5.435,13.774,111674,36507,75167,6.337,19.386,-32331,-5.613,27.547,4814,4875,21024
2009,481,2408,4963,438105,460610,467,9.279,607,12.060,16612,4028,12584,0.874,3.607,61059,9159,51900,1.988,13.256,-44447,-9.650,7.213,286,302,5024
2009,483,1154,1539,67285,68024,173,11.296,158,10.317,6809,2154,4655,3.167,10.010,8334,1966,6368,2.890,12.252,-1525,-2.242,20.019,112,112,1131
2009,484,82682,96331,1322243,1377279,12406,12.566,17197,17.419,165427,68352,97075,4.963,12.011,276765,91892,184873,6.672,20.095,-111338,-8.084,24.022,12281,12423,56357
2009,485,13588,16254,436897,443548,2084,12.836,2046,12.602,54853,20959,33894,4.725,12.367,69240,21434,47806,4.832,15.610,-14387,-3.244,24.734,1442,1445,11498
2009,486,193,2771,40765,40493,173,6.225,189,6.801,4578,1638,2940,4.045,11.306,4091,1282,2809,3.166,10.103,487,1.203,20.206,20,20,90
2009,487,1758,1858,21297,22238,232,12.211,316,16.632,3171,1250,1921,5.621,14.259,5006,1275,3731,5.733,22.511,-1835,-8.252,28.519,222,224,970
2009,488,28737,38523,600749,622520,3840,9.901,4363,11.249,82589,29010,53579,4.660,13.267,125774,37599,88175,6.040,20.204,-43185,-6.937,26.534,2625,2779,22156
2009,492,6993,12718,548221,571938,1466,11.484,1562,12.236,30310,12553,17757,2.195,5.300,80071,9913,70158,1.733,14.000,-49761,-8.700,10.599,898,907,4809
2009,493,6844,14060,681265,696576,1301,9.251,1309,9.307,84508,35863,48645,5.148,12.132,115399,37834,77565,5.431,16.567,-30891,-4.435,24.264,419,464,7954
2009,511,19025,27587,964110,1010876,2402,8.582,3205,11.451,90652,32832,57820,3.248,8.968,184294,50837,133457,5.029,18.231,-93642,-9.263,17.935,1731,1804,22915
2009,512,15366,18995,336990,342465,2507,13.056,2922,15.217,44564,18746,25818,5.474,13.013,55064,13489,41575,3.939,16.079,-10500,-3.066,26.025,1889,1937,7851
2009,515,4532,9375,269611,279396,959,10.152,1101,11.656,22525,10184,12341,3.645,8.062,42227,12604,29623,4.511,15.114,-19702,-7.052,16.124,300,314,2594
2009,517,8900,49963,1180568,1188283,7722,15.404,8058,16.074,175931,79948,95983,6.728,14.805,192991,72108,120883,6.068,16.241,-17060,-1.436,29.611,1303,1399,12493
2009,518,7954,11831,394691,396972,1852,14.031,4589,34.766,67578,33705,33873,8.491,17.023,71678,30482,41196,7.679,18.056,-4100,-1.033,34.047,810,823,8138
2009,519,5981,7387,139069,139291,1183,16.374,859,11.889,25335,11181,14154,8.027,18.189,25544,7011,18533,5.033,18.339,-209,-0.150,36.377,534,542,3368
2009,521,13,48,18775,18894,(D),(D),(D),(D),994,(D),972,(D),5.261,1164,(D),1034,(D),6.161,-170,-0.900,10.522,0,0,0
2009,522,44913,202303,2852185,2939832,13569,6.502,26352,12.627,347613,129613,218000,4.409,11.824,522043,176453,345590,6.002,17.758,-174430,-5.933,23.648,9583,10946,52888
2009,523,48629,84811,918382,942663,12725,15.149,11098,13.212,151830,75191,76639,7.976,16.107,199939,46458,153481,4.928,21.210,-48109,-5.104,32.213,4940,4997,18885
2009,524,124807,166839,2350943,2365282,14390,8.561,16886,10.046,271475,105867,165608,4.476,11.477,300657,105425,195232,4.457,12.711,-29182,-1.234,22.955,9064,9214,33393
2009,525,1083,1103,21236,16442,445,46.114,169,17.513,13801,9463,4338,57.554,83.937,3770,1009,2761,6.137,22.929,10031,61.008,45.858,97,97,509
2009,531,201891,246934,1425947,1471459,28135,11.131,39798,15.745,231415,103068,128347,7.004,15.727,322232,135428,186804,9.204,21.899,-90817,-6.172,31.454,25851,26116,77792
2009,532,22940,56013,541825,577073,3487,5.993,7825,13.449,53830,19524,34306,3.383,9.328,125822,45895,79927,7.953,21.803,-71992,-12.475,18.656,2675,2837,14176
2009,533,1975,2067,31077,31710,259,12.443,288,13.836,5231,2303,2928,7.263,16.497,6424,3869,2555,12.201,20.259,-1193,-3.762,32.993,198,198,996
2009,541,648313,729216,7771643,7862371,83850,11.439,91513,12.484,1195994,466677,729317,5.936,15.212,1376422,464092,912330,5.903,17.506,-180428,-2.295,30.423,61658,62167,250598
2009,551,26668,49946,2803042,2842381,4278,8.523,4779,9.521,403513,136340,267173,4.797,14.196,482335,129109,353226,4.542,16.969,-78822,-2.773,28.393,986,1116,18080
2009,561,258360,312536,8244742,8776326,39114,12.377,46077,14.581,1315429,462342,853087,5.268,14.988,2384801,588094,1796707,6.701,27.173,-1069372,-12.185,29.977,28044,28406,307565
2009,562,15775,20222,349197,357984,1646,8.097,1858,9.140,42843,15712,27131,4.389,11.968,60187,16144,44043,4.510,16.813,-17344,-4.845,23.936,1241,1260,8555
2009,611,70374,80397,3188018,3143366,8230,10.354,6403,8.056,280569,55308,225261,1.760,8.926,192075,37724,154351,1.200,6.110,88494,2.815,12.221,4592,4637,26829
2009,621,437840,522006,6022385,5942531,41578,8.023,34003,6.562,871819,286909,584910,4.828,14.671,712171,232333,479838,3.910,11.984,159648,2.687,23.969,22892,23506,136604
2009,622,3826,6841,5626944,5597390,338,4.995,190,2.808,254951,43741,211210,0.781,4.555,194399,56287,138112,1.006,3.473,60552,1.082,6.946,74,78,29164
2009,623,33289,74693,3172476,3145669,4703,6.313,4312,5.788,310852,90773,220079,2.886,9.882,255027,92719,162308,2.948,8.107,55825,1.775,16.214,1971,2105,57459
2009,624,108178,148338,2648484,2634756,13413,9.113,11103,7.544,347535,96458,251077,3.661,13.190,319072,91909,227163,3.488,12.110,28463,1.080,24.220,7535,7685,63050
2009,711,31576,32389,427257,437575,4715,14.439,5247,16.068,63716,19133,44583,4.373,14.561,84615,23989,60626,5.482,19.337,-20899,-4.776,29.122,3457,3469,15145
2009,712,6311,6800,128680,131136,342,5.031,338,4.972,8696,1771,6925,1.351,6.631,13381,1309,12072,0.998,10.204,-4685,-3.573,13.263,223,224,949
2009,713,53204,60936,1451666,1470326,6292,10.253,7151,11.653,172874,60738,112136,4.131,11.758,211156,57928,153228,3.940,14.361,-38282,-2.604,23.515,5521,5565,44047
2009,721,45349,56525,1842006,1906316,5369,9.546,4806,8.545,180283,96636,83647,5.069,9.457,309516,66534,242982,3.490,16.236,-129233,-6.779,18.914,3232,3283,41213
2009,722,374394,523229,9591395,9763412,59083,11.308,57640,11.031,1422206,736486,685720,7.543,14.567,1764786,588740,1176046,6.030,18.076,-342580,-3.509,29.133,42601,43773,394099
2009,811,180251,196602,1187402,1230302,15945,7.991,21793,10.922,153015,58313,94702,4.740,12.437,239290,74444,164846,6.051,19.450,-86275,-7.013,24.874,15339,15578,49514
2009,812,151584,188547,1313713,1338261,19985,10.548,21810,11.512,196855,82080,114775,6.133,14.710,244473,96110,148363,7.182,18.268,-47618,-3.558,29.420,15091,15778,63248
2009,813,280211,289078,2751408,2764361,14608,5.134,5558,1.953,262604,48297,214307,1.747,9.500,290417,21890,268527,0.792,10.506,-27813,-1.006,18.999,3728,3743,15585
2010,211,5751,7043,108741,108311,591,8.373,622,8.812,14044,5006,9038,4.622,12.966,13313,4751,8562,4.386,12.292,731,0.675,24.583,394,398,2037
2010,212,3659,6191,192102,195411,440,7.047,545,8.729,23448,6677,16771,3.417,11.999,30200,5812,24388,2.974,15.455,-6752,-3.455,23.999,297,302,2677
2010,213,9125,11372,285548,292336,1288,11.272,1398,12.234,49659,20251,29408,6.927,16.987,63136,15189,47947,5.196,21.597,-13477,-4.610,33.974,873,875,7387
2010,221,5411,17144,639164,639236,1085,6.409,655,3.869,41276,15035,26241,2.352,6.457,41220,9244,31976,1.446,6.448,56,0.009,12.897,178,180,1274
2010,236,160755,163652,1145750,1211324,25225,14.860,37417,22.043,222923,93747,129176,7.739,18.403,354961,112327,242634,9.273,29.304,-132038,-10.900,36.807,24140,24175,74597
2010,237,35526,37903,841359,870612,3057,7.838,5257,13.478,127073,32173,94900,3.695,14.596,186656,32727,153929,3.759,21.440,-59583,-6.844,29.192,3553,3570,20883
2010,238,363314,369961,3361688,3558768,41120,10.782,63985,16.777,550767,160939,389828,4.522,15.476,945398,235316,710082,6.612,26.565,-394631,-11.089,30.953,41004,41063,158061
2010,311,19127,23228,1424446,1426162,1723,7.441,1578,6.815,100932,21368,79564,1.498,7.077,103727,30081,73646,2.109,7.273,-2795,-0.196,14.154,1117,1121,9819
2010,312,3303,3894,139156,141285,427,11.219,251,6.595,10537,2695,7842,1.907,7.458,14779,4107,10672,2.907,10.460,-4242,-3.002,14.916,173,173,1040
2010,313,2092,2365,109610,114744,152,6.280,263,10.866,8564,2236,6328,1.949,7.464,18537,6907,11630,6.020,16.155,-9973,-8.692,14.927,179,182,1914
2010,314,5592,5821,111923,114958,452,7.565,759,12.704,11412,3017,8395,2.624,9.927,17328,4436,12892,3.859,15.073,-5916,-5.146,19.854,564,564,2321
2010,315,5855,5954,118008,121998,789,12.878,1134,18.510,20154,6434,13720,5.274,16.520,28047,11308,16739,9.269,22.990,-7893,-6.470,33.040,922,927,8227
2010,316,1037,1076,26827,28019,81,7.384,123,11.212,1753,243,1510,0.867,6.256,4063,787,3276,2.809,14.501,-2310,-8.244,12.513,89,89,410
2010,321,11914,13697,351834,368653,808,5.719,1672,11.834,34846,9571,25275,2.596,9.452,68227,21311,46916,5.781,18.507,-33381,-9.055,18.904,1088,1097,9631
2010,322,2877,4487,365601,372195,163,3.597,252,5.561,18065,3647,14418,0.980,4.854,31407,8373,23034,2.250,8.438,-13342,-3.585,9.707,151,151,1749
2010,323,26331,27680,499728,524406,1374,4.836,2834,9.975,33612,11095,22517,2.116,6.410,83287,26010,57277,4.960,15.882,-49675,-9.473,12.819,2264,2270,15366
2010,324,993,2133,98775,100388,141,6.610,141,6.610,6033,2509,3524,2.499,6.010,9531,2835,6696,2.824,9.494,-3498,-3.484,12.019,53,54,333
2010,325,9031,12444,722321,732489,707,5.650,846,6.761,52974,15080,37894,2.059,7.232,73059,14602,58457,1.993,9.974,-20085,-2.742,14.464,515,521,5829
2010,326,9753,12503,665725,676988,509,4.006,912,7.179,56746,12580,44166,1.858,8.382,79734,26618,53116,3.932,11.778,-22988,-3.396,16.764,553,561,8469
2010,327,9468,15152,343670,361308,758,4.917,1284,8.330,27739,7127,20612,1.973,7.677,63343,13272,50071,3.673,17.532,-35604,-9.854,15.355,697,704,4912
2010,331,3497,4381,348450,362009,208,4.669,356,7.991,20870,3781,17089,1.044,5.765,47951,9546,38405,2.637,13.246,-27081,-7.481,11.530,226,227,3916
2010,332,49253,53187,1277733,1337134,2235,4.109,4653,8.554,98394,21855,76539,1.634,7.359,217327,46388,170939,3.469,16.253,-118933,-8.895,14.717,3108,3120,23059
2010,333,20827,23125,928578,980107,1063,4.518,1866,7.931,59741,16715,43026,1.705,6.095,162004,29726,132278,3.033,16.529,-102263,-10.434,12.191,1244,1250,11292
2010,334,10907,12459,871821,908487,824,6.547,1078,8.565,64584,14397,50187,1.585,7.109,136825,29464,107361,3.243,15.061,-72241,-7.952,14.218,694,698,7217
2010,335,4763,5547,325104,340796,304,5.418,432,7.699,18502,4227,14275,1.240,5.429,49872,12926,36946,3.793,14.634,-31370,-9.205,10.858,260,266,2361
2010,336,9167,11143,1200349,1232742,782,6.916,1111,9.825,109375,22967,86408,1.863,8.872,175161,42839,132322,3.475,14.209,-65786,-5.337,17.745,711,726,12909
2010,337,15506,16077,343858,363932,1014,6.060,2327,13.906,28670,7336,21334,2.016,7.878,68792,20706,48086,5.690,18.902,-40122,-11.025,15.756,1678,1682,10961
2010,339,25049,26347,556280,572603,1812,6.789,2497,9.356,43942,10075,33867,1.760,7.674,76622,22479,54143,3.926,13.381,-32680,-5.707,15.348,1853,1858,10314
2010,423,157528,225846,3134914,3223954,16345,7.181,19901,8.743,323917,112341,211576,3.485,10.047,502071,137702,364369,4.271,15.573,-178154,-5.526,20.094,11999,12557,66723
2010,424,88911,119075,2159914,2180971,9670,8.096,10413,8.718,226202,64007,162195,2.935,10.372,267833,75527,192306,3.463,12.280,-41631,-1.909,20.743,6966,7132,40070
2010,425,39130,41322,297316,293937,4767,11.411,5673,13.580,66133,32174,33959,10.946,22.499,57771,21564,36207,7.336,19.654,8362,2.845,39.308,4113,4144,15316
2010,441,77339,110921,1627680,1635844,7009,6.253,9364,8.353,174393,53238,121155,3.254,10.661,191751,73901,117850,4.518,11.722,-17358,-1.061,21.321,6636,6852,53572
2010,442,35255,51587,426461,436629,3298,6.229,6024,11.377,50630,17233,33397,3.947,11.596,70956,24808,46148,5.682,16.251,-20326,-4.655,23.191,4049,4405,16865
2010,443,25362,46237,424931,445501,5284,11.225,6961,14.787,65485,27793,37692,6.239,14.699,102728,69512,33216,15.603,23.059,-37243,-8.360,29.398,2991,4382,57905
2010,444,53336,79573,1206016,1212277,3463,4.286,5900,7.303,100886,21898,78988,1.806,8.322,115498,29758,85740,2.455,9.527,-14612,-1.205,16.644,3679,3825,15301
2010,445,99766,133630,2814916,2829806,13153,9.920,11079,8.356,248067,99820,148247,3.527,8.766,278111,70333,207778,2.485,9.828,-30044,-1.062,17.532,8021,8166,36265
2010,446,39062,85935,990792,986451,5475,6.381,5221,6.085,96407,28818,67589,2.921,9.773,87265,25496,61769,2.585,8.846,9142,0.927,17.693,2791,2951,13073
2010,447,61811,107773,853246,853961,7292,6.760,7499,6.951,115304,40664,74640,4.762,13.502,116821,41100,75721,4.813,13.680,-1517,-0.178,27.005,4496,4805,22020
2010,448,54616,139463,1528960,1531299,9886,7.026,12365,8.788,215117,79911,135206,5.219,14.048,218094,76895,141199,5.022,14.242,-2977,-0.194,28.096,6128,7308,32465
2010,451,30030,44897,523527,529338,3334,7.328,4537,9.972,66286,17540,48746,3.314,12.522,77547,20946,56601,3.957,14.650,-11261,-2.127,25.045,2983,3293,12317
2010,452,7096,44400,2789628,2849837,2327,5.288,1532,3.482,117633,41417,76216,1.453,4.128,235706,15111,220595,0.530,8.271,-118073,-4.143,8.255,880,917,2997
2010,453,75311,100558,717708,724698,8597,8.433,11375,11.158,94511,36793,57718,5.077,13.041,108961,36345,72616,5.015,15.035,-14450,-1.994,26.083,8268,8647,25740
2010,454,43682,51140,542228,547465,5463,10.663,5648,11.024,72196,26433,45763,4.828,13.187,82949,27312,55637,4.989,15.151,-10753,-1.964,26.375,4177,4251,17249
2010,481,2338,4729,416974,428038,485,10.057,672,13.935,44541,7330,37211,1.712,10.406,66893,33940,32953,7.929,15.628,-22352,-5.222,20.812,253,261,1235
2010,483,1086,1524,63368,65300,150,9.810,160,10.464,5291,1850,3441,2.833,8.103,9282,1754,7528,2.686,14.215,-3991,-6.112,16.205,108,109,1075
2010,484,79809,93218,1262490,1291737,11513,12.159,14449,15.260,165005,54239,110766,4.199,12.774,221532,68918,152614,5.335,17.150,-56527,-4.376,25.548,9920,10011,39682
2010,485,13645,16387,439300,437925,2044,12.526,1906,11.680,54709,21940,32769,5.010,12.493,52315,17668,34647,4.034,11.946,2394,0.547,23.892,1328,1332,8763
2010,486,196,2957,44703,44339,219,7.501,144,4.932,8358,1152,7206,2.598,18.850,7669,1031,6638,2.325,17.296,689,1.554,34.593,13,13,101
2010,487,1718,1816,20621,21056,251,13.675,290,15.800,3110,947,2163,4.498,14.770,4050,1633,2417,7.756,19.234,-940,-4.464,29.540,183,183,1101
2010,488,28441,38476,581721,592976,4069,10.563,4158,10.794,79339,32266,47073,5.441,13.380,102029,30734,71295,5.183,17.206,-22690,-3.826,26.760,2481,2576,14090
2010,492,6805,12136,516707,531621,1186,9.543,1770,14.242,27871,8142,19729,1.532,5.243,57371,18845,38526,3.545,10.792,-29500,-5.549,10.485,905,939,5047
2010,493,6817,14066,666792,674397,1102,7.811,1187,8.413,75566,26061,49505,3.864,11.205,89894,23669,66225,3.510,13.330,-14328,-2.125,22.410,416,450,5603
2010,511,18431,26649,900279,930286,1910,7.041,2865,10.562,81670,34109,47561,3.667,8.779,142119,43911,98208,4.720,15.277,-60449,-6.498,17.558,1545,1594,12216
2010,512,15132,18822,316670,321540,2530,13.375,2718,14.369,40273,16047,24226,4.991,12.525,50306,13136,37170,4.085,15.645,-10033,-3.120,25.050,1704,1734,7348
2010,515,4482,9635,260245,264956,769,8.089,512,5.386,22387,9077,13310,3.426,8.449,30866,8822,22044,3.330,11.649,-8479,-3.200,16.899,277,280,3510
2010,517,8448,48773,1114936,1146868,5193,10.541,6172,12.529,115577,49716,65861,4.335,10.078,176997,71164,105833,6.205,15.433,-61420,-5.355,20.155,1088,1116,6198
2010,518,7911,11893,391337,394600,1469,12.350,1473,12.383,77091,26585,50506,6.737,19.536,83322,26133,57189,6.623,21.116,-6231,-1.579,39.073,685,704,6708
2010,519,6238,7792,137068,139134,1313,17.251,951,12.495,28919,15187,13732,10.915,20.785,32883,6898,25985,4.958,23.634,-3964,-2.849,41.570,638,639,2813
2010,521,12,46,17380,18078,(D),(D),3,6.383,344,(D),339,(D),1.903,1811,871,940,4.818,10.018,-1467,-8.115,3.806,(D),(D),(D)
2010,522,41303,194133,2753500,2805065,12166,6.139,20257,10.222,350088,112789,237299,4.021,12.481,450465,146272,304193,5.215,16.059,-100377,-3.578,24.961,5736,6680,38016
2010,523,48931,84280,865091,893003,11884,14.070,12255,14.509,158866,69117,89749,7.740,17.790,214165,71430,142735,7.999,23.983,-55299,-6.192,35.580,4478,4575,16671
2010,524,123969,164278,2258621,2304566,14585,8.816,16906,10.219,252098,102364,149734,4.442,10.939,344705,115643,229062,5.018,14.957,-92607,-4.018,21.878,7883,8026,24832
2010,525,1316,1344,18032,13520,522,47.802,18,1.648,10282,6704,3578,49.588,76.053,1028,100,928,0.740,7.604,9254,68.449,15.208,9,9,11
2010,531,200115,248018,1394209,1406180,30452,12.313,29066,11.752,227358,112032,115326,7.967,16.168,250104,99469,150635,7.074,17.786,-22746,-1.618,32.337,18956,19269,56224
2010,532,21879,52974,505451,522945,3612,6.637,6516,11.972,59045,21850,37195,4.178,11.291,94363,42061,52302,8.043,18.045,-35318,-6.754,22.582,2437,2563,11026
2010,533,1983,2066,28663,29367,237,11.480,234,11.334,4117,1587,2530,5.404,14.019,5451,2129,3322,7.250,18.562,-1334,-4.543,28.039,171,171,1548
2010,541,644247,728370,7703682,7749135,86625,11.887,87369,11.989,1153854,432607,721247,5.583,14.890,1246574,391280,855294,5.049,16.087,-92720,-1.197,29.780,56423,57012,210631
2010,551,26631,49750,2823941,2828514,4056,8.112,4562,9.123,390771,122493,268278,4.331,13.815,398040,103400,294640,3.656,14.072,-7269,-0.257,27.631,907,976,15777
2010,561,254995,308118,8265663,8260228,38312,12.351,42483,13.695,1580284,438940,1141344,5.314,19.131,1571038,493284,1077754,5.972,19.019,9246,0.112,38.039,25485,26017,241148
2010,562,15868,20575,355048,358243,1895,9.243,1751,8.540,46062,17744,28318,4.953,12.858,52917,16806,36111,4.691,14.771,-6855,-1.914,25.716,1108,1133,8684
2010,611,70954,81621,3265118,3217936,8770,10.904,6381,7.934,293356,72271,221085,2.246,9.116,198973,31571,167402,0.981,6.183,94383,2.933,12.366,4389,4428,20497
2010,621,443024,533341,6145941,6087691,42002,7.957,31056,5.883,816107,287697,528410,4.726,13.406,699238,197401,501837,3.243,11.486,116869,1.920,22.972,21036,21522,113683
2010,622,3595,6583,5627365,5619257,180,2.748,113,1.725,185261,35991,149270,0.640,3.297,170718,26112,144606,0.465,3.038,14543,0.259,6.076,64,64,14130
2010,623,33830,77072,3230204,3204649,6211,8.182,3892,5.127,313737,132133,181604,4.123,9.790,261607,72797,188810,2.272,8.163,52130,1.627,16.327,1710,1814,33182
2010,624,108778,150398,2721015,2689091,14270,9.556,12146,8.133,383970,122489,261481,4.555,14.279,318196,81868,236328,3.044,11.833,65774,2.446,23.666,8135,8409,48459
2010,711,31262,32076,425431,427307,4572,14.195,4838,15.021,63465,20757,42708,4.858,14.852,67295,18407,48888,4.308,15.749,-3830,-0.896,29.705,3145,3158,12879
2010,712,6320,6800,126086,127322,327,4.817,304,4.478,9895,2859,7036,2.245,7.772,12513,2512,10001,1.973,9.828,-2618,-2.056,15.543,186,186,1696
2010,713,52481,60563,1443569,1448059,6217,10.247,6432,10.602,169308,66936,102372,4.622,11.692,178963,48796,130167,3.370,12.359,-9655,-0.667,23.384,4867,4934,37100
2010,721,45576,56984,1818085,1831814,4579,8.073,4048,7.137,186238,84169,102069,4.595,10.167,213034,53849,159185,2.940,11.630,-26796,-1.463,20.334,2548,2587,29013
2010,722,379689,530351,9476957,9535012,57821,10.979,50430,9.576,1306554,669852,636702,7.025,13.703,1414309,464292,950017,4.869,14.833,-107755,-1.130,27.405,36857,37888,311259
2010,811,178146,194751,1154815,1169910,16240,8.296,18248,9.322,158695,61789,96906,5.282,13.565,188801,62283,126518,5.324,16.138,-30106,-2.573,27.129,12650,12805,38484
2010,812,151942,189516,1305822,1308157,20323,10.759,19094,10.108,200227,87088,113139,6.657,15.306,204675,80866,123809,6.182,15.646,-4448,-0.340,30.612,13504,13705,51149
2010,813,282354,291268,2731905,2729337,15320,5.349,5610,1.959,263598,55055,208543,2.017,9.658,259370,20694,238676,0.758,9.503,4228,0.155,19.006,3746,3802,13626
2011,211,5787,7162,114588,111429,706,9.951,571,8.048,19535,6815,12720,6.116,17.531,13196,3911,9285,3.510,11.843,6339,5.689,23.685,374,381,1534
2011,212,3625,6192,199045,196286,454,7.330,458,7.394,23873,5257,18616,2.678,12.162,18191,4288,13903,2.185,9.268,5682,2.895,18.535,279,286,2390
2011,213,9505,11883,334867,310225,1641,14.115,1127,9.694,90407,21726,68681,7.003,29.142,40799,12277,28522,3.957,13.151,49608,15.991,26.303,738,741,6196
2011,221,5436,17128,641505,641806,985,5.743,1030,6.006,47687,17182,30505,2.677,7.430,48475,16218,32257,2.527,7.553,-788,-0.123,14.860,191,199,974
2011,236,154643,157391,1085738,1115913,26473,16.515,32280,20.138,223497,80801,142696,7.241,20.028,283312,99810,183502,8.944,25.388,-59815,-5.360,40.056,20539,20599,62892
2011,237,34325,36924,832599,839284,3386,9.029,4541,12.109,144921,27371,117550,3.261,17.267,157270,31521,125749,3.756,18.739,-12349,-1.471,34.534,3017,3031,17495
2011,238,352864,359553,3248549,3306005,44030,12.066,54769,15.008,599167,147404,451763,4.459,18.124,713692,198216,515476,5.996,21.588,-114525,-3.464,36.247,35150,35220,136319
2011,311,19523,23632,1421401,1422890,1897,8.084,1564,6.665,104033,20581,83452,1.446,7.311,106819,24257,82562,1.705,7.507,-2786,-0.196,14.623,1139,1140,12227
2011,312,3579,4188,143984,141588,562,13.894,276,6.823,18053,4529,13524,3.199,12.750,13159,3611,9548,2.550,9.294,4894,3.457,18.588,193,195,1135
2011,313,2052,2314,109740,109665,147,6.298,187,8.012,10468,1996,8472,1.820,9.545,10282,3073,7209,2.802,9.376,186,0.170,18.752,138,139,1205
2011,314,5446,5688,112335,112426,463,8.036,610,10.588,12208,2644,9564,2.352,10.859,12487,3712,8775,3.302,11.107,-279,-0.248,21.717,456,456,2368
2011,315,5724,5813,110181,113225,833,14.175,960,16.336,16510,6344,10166,5.603,14.582,22570,9466,13104,8.360,19.934,-6060,-5.352,29.163,801,802,7414
2011,316,1009,1049,28426,27604,93,8.749,121,11.383,4082,591,3491,2.141,14.788,2380,812,1568,2.942,8.622,1702,6.166,17.244,95,95,371
2011,321,11534,13270,345760,348674,842,6.248,1255,9.313,36662,7843,28819,2.249,10.515,42256,14589,27667,4.184,12.119,-5594,-1.604,21.029,879,892,7702
2011,322,2801,4387,361301,363142,148,3.333,256,5.764,21840,4887,16953,1.346,6.014,25573,11350,14223,3.125,7.042,-3733,-1.028,12.028,149,151,2535
2011,323,25337,26646,481199,490773,1465,5.391,2527,9.298,36625,8182,28443,1.667,7.463,55592,20929,34663,4.265,11.327,-18967,-3.865,14.925,1998,2011,12430
2011,324,971,2107,98038,98118,110,5.202,125,5.912,5687,1450,4237,1.478,5.796,5925,927,4998,0.945,6.039,-238,-0.243,11.592,65,65,403
2011,325,9005,12477,724832,725130,796,6.378,804,6.442,56691,12867,43824,1.774,7.818,57428,11935,45493,1.646,7.920,-737,-0.102,15.636,531,550,5244
2011,326,9672,12374,684691,674743,532,4.275,674,5.416,69015,10032,58983,1.487,10.228,49080,15655,33425,2.320,7.274,19935,2.954,14.548,433,439,6527
2011,327,9211,14768,338759,341568,734,4.904,1134,7.576,31165,5123,26042,1.500,9.124,36753,8860,27893,2.594,10.760,-5588,-1.636,18.248,607,638,4255
2011,331,3484,4381,371607,360722,247,5.644,238,5.438,38732,4412,34320,1.223,10.737,17067,3783,13284,1.049,4.731,21665,6.006,9.463,167,169,2124
2011,332,49083,52977,1329726,1302880,2884,5.425,3247,6.108,165893,26967,138926,2.070,12.733,111923,28688,83235,2.202,8.590,53970,4.142,17.181,2285,2296,16980
2011,333,20708,23004,970142,948817,1258,5.460,1329,5.768,110886,14837,96049,1.564,11.687,67683,22712,44971,2.394,7.133,43203,4.553,14.267,928,939,8879
2011,334,10838,12351,868730,865276,843,6.806,914,7.379,77186,13531,63655,1.564,8.920,70721,20548,50173,2.375,8.173,6465,0.747,16.346,630,631,7177
2011,335,4727,5486,330960,327883,344,6.241,396,7.184,30583,6800,23783,2.074,9.327,24333,8908,15425,2.717,7.421,6250,1.906,14.843,256,256,2485
2011,336,9051,10962,1203843,1187486,718,6.495,902,8.160,129637,22225,107412,1.872,10.917,97918,26819,71099,2.258,8.246,31719,2.671,16.492,586,602,6902
2011,337,14791,15334,333554,338779,1058,6.720,1877,11.922,31997,6014,25983,1.775,9.445,42491,13818,28673,4.079,12.542,-10494,-3.098,18.890,1364,1372,8456
2011,339,24782,26057,557119,555786,1976,7.535,2310,8.809,56100,12661,43439,2.278,10.094,53441,16567,36874,2.981,9.615,2659,0.478,19.231,1729,1733,8831
2011,423,156561,226706,3171090,3157639,17499,7.722,17309,7.638,395845,117467,278378,3.720,12.536,368036,133286,234750,4.221,11.655,27809,0.881,23.311,10738,11182,56992
2011,424,88146,118982,2162214,2158448,10039,8.435,10119,8.502,244393,76324,168069,3.536,11.323,237931,72518,165413,3.360,11.023,6462,0.299,22.046,6699,6847,36259
2011,425,38389,40688,298958,297145,4672,11.414,5159,12.604,48427,14397,34030,4.845,16.297,44060,16419,27641,5.526,14.828,4367,1.470,29.656,3907,3939,12686
2011,441,75882,109925,1657363,1642039,6999,6.343,7816,7.084,184458,53841,130617,3.279,11.233,153982,51869,102113,3.159,9.377,30476,1.856,18.755,5711,5898,38697
2011,442,33422,49747,423134,424047,3550,7.022,5171,10.228,55543,17191,38352,4.054,13.098,57400,19558,37842,4.612,13.536,-1857,-0.438,26.197,3472,3733,12029
2011,443,24677,47487,437293,430994,6133,13.114,4692,10.033,71029,34285,36744,7.955,16.480,57474,20475,36999,4.751,13.335,13555,3.145,26.670,2963,3279,12040
2011,444,51537,77758,1193659,1198824,3607,4.593,5161,6.572,86731,19688,67043,1.642,7.235,97014,22200,74814,1.852,8.092,-10283,-0.858,14.469,3455,3640,14820
2011,445,100664,134645,2833167,2823906,13262,9.895,12016,8.966,251324,103080,148244,3.650,8.900,232272,71302,160970,2.525,8.225,19052,0.675,16.450,8619,8771,36814
2011,446,39386,88068,964833,977242,7801,8.969,5623,6.465,115619,45600,70019,4.666,11.831,142408,40650,101758,4.160,14.572,-26789,-2.741,23.662,2828,2895,12689
2011,447,62060,107913,852641,853419,7530,6.979,7491,6.943,114032,41836,72196,4.902,13.362,114834,37464,77370,4.390,13.456,-802,-0.094,26.724,4796,5124,23892
2011,448,53817,139960,1655865,1593451,11222,8.027,10904,7.800,314513,86577,227936,5.433,19.738,190294,67835,122459,4.257,11.942,124219,7.796,23.885,5645,6183,21405
2011,451,29272,44298,518862,521107,3531,7.922,4074,9.141,56774,18568,38206,3.563,10.895,61085,17733,43352,3.403,11.722,-4311,-0.827,21.790,2830,2936,9801
2011,452,7210,45519,2835296,2812477,2604,5.790,1515,3.369,179949,40516,139433,1.441,6.398,134087,11459,122628,0.407,4.768,45862,1.631,9.535,886,941,3311
2011,453,73433,98813,714606,715748,9429,9.464,11070,11.111,101173,39292,61881,5.490,14.135,103243,39678,63565,5.544,14.425,-2070,-0.289,28.271,7764,8011,24120
2011,454,44395,51785,550787,546691,6116,11.881,5499,10.683,83342,27248,56094,4.984,15.245,74822,27349,47473,5.003,13.686,8520,1.558,27.373,4094,4152,15561
2011,481,2321,4737,423623,418337,370,7.793,392,8.256,30616,4790,25826,1.145,7.319,19701,3434,16267,0.821,4.709,10915,2.609,9.419,213,217,1375
2011,483,1058,1468,63393,62660,140,9.466,162,10.953,7434,2499,4935,3.988,11.864,5844,1958,3886,3.125,9.327,1590,2.538,18.653,99,99,1375
2011,484,81168,94406,1313450,1288680,14487,15.468,12996,13.876,213459,67338,146121,5.225,16.564,163913,60146,103767,4.667,12.719,49546,3.845,25.439,9088,9166,35525
2011,485,13765,16559,448432,443290,2084,12.655,1902,11.550,53311,18491,34820,4.171,12.026,43042,17017,26025,3.839,9.710,10269,2.317,19.419,1372,1380,8464
2011,486,173,3237,45251,44064,498,16.169,184,5.974,9487,3913,5574,8.880,21.530,6910,1882,5028,4.271,15.682,2577,5.848,31.363,11,11,54
2011,487,1749,1862,22444,21918,272,14.679,254,13.708,3815,1166,2649,5.320,17.406,2714,756,1958,3.449,12.383,1101,5.023,24.766,162,165,533
2011,488,28725,38632,593567,587321,4009,10.410,3765,9.777,89016,28751,60265,4.895,15.156,76672,29310,47362,4.990,13.055,12344,2.102,26.109,2254,2317,10184
2011,492,7901,12786,522278,518918,2508,20.212,1753,14.127,36056,10284,25772,1.982,6.948,28048,10349,17699,1.994,5.405,8008,1.543,10.810,999,1017,3945
2011,493,6830,14151,681508,675690,1026,7.259,994,7.032,87831,26100,61731,3.863,12.999,73925,17009,56916,2.517,10.941,13906,2.058,21.881,326,335,2967
2011,511,17889,26194,874150,880474,2302,8.734,2629,9.974,94320,26631,67689,3.025,10.712,107661,36874,70787,4.188,12.228,-13341,-1.515,21.425,1386,1415,12369
2011,512,15363,19058,310851,311299,2823,14.940,2498,13.220,45215,17758,27457,5.704,14.525,46537,13394,33143,4.303,14.949,-1322,-0.425,29.049,1574,1589,5706
2011,515,4435,9499,260677,261254,1159,12.098,1321,13.789,34804,18899,15905,7.234,13.322,35793,13150,22643,5.033,13.700,-989,-0.379,26.644,249,254,2228
2011,517,8062,49141,1104453,1110309,6968,14.255,6450,13.195,159118,82117,77001,7.396,14.331,171098,65987,105111,5.943,15.410,-11980,-1.079,28.662,1000,1051,7341
2011,518,7919,12553,419806,405460,1924,15.760,1235,10.116,99356,39134,60222,9.652,24.505,71226,18875,52351,4.655,17.567,28130,6.938,35.133,718,732,6925
2011,519,6665,8670,176600,168609,1538,18.300,1007,11.982,35459,12797,22662,7.590,21.030,19047,6643,12404,3.940,11.297,16412,9.734,22.593,707,716,3163
2011,521,12,47,18039,18043,0,0.000,(D),(D),469,0,469,0.000,2.599,478,(D),449,(D),2.649,-9,-0.050,5.199,0,0,0
2011,522,38984,190834,2757253,2752774,12887,6.695,16175,8.404,366890,103839,263051,3.772,13.328,359983,111180,248803,4.039,13.077,6907,0.251,26.154,4402,5057,24708
2011,523,49536,84856,869776,870054,10674,12.601,10372,12.245,127113,45893,81220,5.275,14.610,127802,53848,73954,6.189,14.689,-689,-0.079,29.220,4335,4407,16636
2011,524,122515,161808,2226678,2241319,13809,8.471,16220,9.950,244647,94454,150193,4.214,10.915,274684,85437,189247,3.812,12.255,-30037,-1.340,21.831,8316,8486,26508
2011,525,1427,1461,21063,16367,462,37.108,30,2.410,11118,7321,3797,44.732,67.931,1562,67,1495,0.409,9.544,9556,58.388,19.088,11,11,33
2011,531,197785,247490,1386752,1391610,28787,11.625,29051,11.732,209184,93122,116062,6.692,15.032,218660,91903,126757,6.604,15.713,-9476,-0.681,30.064,18530,18826,52568
2011,532,21136,49473,488649,495641,5619,11.010,8745,17.135,75625,30483,45142,6.150,15.258,91093,53978,37115,10.891,18.379,-15468,-3.121,30.516,2268,5337,28169
2011,533,1936,2047,29099,28925,268,13.083,271,13.229,4981,1960,3021,6.776,17.220,4663,2274,2389,7.862,16.121,318,1.099,32.242,203,203,838
2011,541,645696,732521,7817154,7769225,89214,12.216,84734,11.603,1262390,403930,858460,5.199,16.249,1170669,423238,747431,5.448,15.068,91721,1.181,30.136,56034,56608,203023
2011,551,26502,50403,2944738,2894385,4255,8.501,3551,7.095,469248,144554,324694,4.994,16.212,366957,85437,281520,2.952,12.678,102291,3.534,25.356,821,850,12484
2011,561,254505,307188,8692222,8478663,38872,12.642,39462,12.834,1803980,375290,1428690,4.426,21.277,1364773,458695,906078,5.410,16.097,439207,5.180,32.193,24245,24721,214023
2011,562,15950,21701,359167,356902,2897,13.678,1854,8.754,62951,27922,35029,7.823,17.638,58813,17932,40881,5.024,16.479,4138,1.159,32.958,1133,1142,7464
2011,611,72369,83224,3384123,3315314,9001,10.997,6249,7.635,341301,81225,260076,2.450,10.295,203611,29461,174150,0.889,6.142,137690,4.153,12.283,4366,4415,18487
2011,621,445723,540213,6317158,6235345,40920,7.624,33950,6.325,837371,273035,564336,4.379,13.429,672683,212040,460643,3.401,10.788,164688,2.641,21.576,23202,23839,129808
2011,622,3505,6559,5646141,5625839,122,1.862,105,1.603,218972,26628,192344,0.473,3.892,176503,24537,151966,0.436,3.137,42469,0.755,6.275,50,50,9281
2011,623,34042,77873,3250125,3237316,4942,6.384,4028,5.203,277621,91930,185691,2.840,8.576,253524,83137,170387,2.568,7.831,24097,0.744,15.663,1874,2144,44478
2011,624,109256,151681,2783450,2752910,13056,8.654,11425,7.573,352519,92132,260387,3.347,12.805,291727,79873,211854,2.901,10.597,60792,2.208,21.194,7754,7896,48858
2011,711,31544,32373,425505,425948,4842,15.014,4596,14.251,69818,19516,50302,4.582,16.391,71470,19629,51841,4.608,16.779,-1652,-0.388,32.782,3023,3029,11360
2011,712,6330,6790,128834,127455,317,4.661,339,4.985,10320,1122,9198,0.880,8.097,7569,1209,6360,0.949,5.939,2751,2.158,11.877,201,201,879
2011,713,52043,60283,1440026,1442067,6355,10.538,6397,10.608,170128,61206,108922,4.244,11.798,174325,51761,122564,3.589,12.089,-4197,-0.291,23.595,4791,4856,35768
2011,721,45606,57312,1859724,1842451,4229,7.394,3993,6.982,188582,71773,116809,3.896,10.235,155272,54427,100845,2.954,8.427,33310,1.808,16.855,2573,2625,33913
2011,722,384812,537363,9689073,9590679,57347,10.743,50240,9.412,1412671,674361,738310,7.031,14.730,1211611,432253,779358,4.507,12.633,201060,2.096,25.266,37922,38966,307366
2011,811,177499,193838,1163019,1159537,16973,8.737,17815,9.171,170162,61019,109143,5.262,14.675,163420,58000,105420,5.002,14.094,6742,0.581,28.187,12392,12624,37489
2011,812,153100,190916,1308076,1306887,20681,10.875,19188,10.090,197223,81146,116077,6.209,15.091,196056,72981,123075,5.584,15.002,1167,0.089,30.004,13689,13989,50131
2011,813,281387,290424,2708648,2706184,14819,5.182,5941,2.077,265865,49385,216480,1.825,9.824,261788,20791,240997,0.768,9.674,4077,0.151,19.347,4016,4031,13426
2012,211,5896,7320,127441,121280,667,9.185,550,7.574,22629,5761,16868,4.750,18.658,10493,4353,6140,3.589,8.652,12136,10.007,17.304,352,357,1661
2012,212,3599,6160,204237,202294,456,7.384,487,7.886,31195,7154,24041,3.536,15.421,27607,9368,18239,4.631,13.647,3588,1.774,27.294,227,232,2203
2012,213,10242,12781,393122,364061,1871,15.087,1111,8.959,101011,26829,74182,7.369,27.746,43410,15141,28269,4.159,11.924,57601,15.822,23.848,695,710,7989
2012,221,5485,17311,641305,641762,936,5.434,763,4.430,45651,14783,30868,2.304,7.113,46876,9986,36890,1.556,7.304,-1225,-0.191,14.227,193,200,1743
2012,236,155502,157990,1080296,1071888,27428,17.477,25324,16.136,234834,80342,154492,7.495,21.908,217554,81632,135922,7.616,20.296,17280,1.612,40.593,15771,15800,50168
2012,237,33037,35523,856960,835917,3281,9.172,3776,10.556,160714,26054,134660,3.117,19.226,119677,28088,91589,3.360,14.317,41037,4.909,28.634,2412,2426,14967
2012,238,357417,363899,3361040,3319175,45801,12.634,43037,11.872,664674,154066,510608,4.642,20.025,579956,180175,399781,5.428,17.473,84718,2.552,34.946,27923,28053,122840
2012,311,19976,24114,1416244,1417991,2001,8.361,1640,6.852,111125,22377,88748,1.578,7.837,114064,29315,84749,2.067,8.044,-2939,-0.207,15.674,1188,1198,15024
2012,312,3879,4498,149184,147623,569,13.049,294,6.742,15112,3053,12059,2.068,10.237,12041,2729,9312,1.849,8.157,3071,2.080,16.313,205,208,1193
2012,313,1980,2225,105684,107095,104,4.604,172,7.614,7452,1173,6279,1.095,6.958,10371,4224,6147,3.944,9.684,-2919,-2.726,13.917,124,125,1863
2012,314,5582,5818,112868,113070,431,7.352,519,8.854,12761,3532,9229,3.124,11.286,13092,3978,9114,3.518,11.579,-331,-0.293,22.572,378,386,2020
2012,315,5492,5571,108838,107556,833,14.915,861,15.416,18308,6100,12208,5.671,17.022,15626,7844,7782,7.293,14.528,2682,2.494,29.057,715,718,6189
2012,316,994,1028,26726,26420,89,8.628,96,9.307,3198,1505,1693,5.697,12.105,2676,928,1748,3.513,10.129,522,1.976,20.258,70,71,374
2012,321,11262,12931,341365,342735,764,5.837,1080,8.251,36288,6949,29339,2.028,10.588,39114,13092,26022,3.820,11.412,-2826,-0.825,21.176,725,745,7415
2012,322,2767,4316,353930,358773,138,3.160,240,5.496,18270,3769,14501,1.051,5.092,27572,9460,18112,2.637,7.685,-9302,-2.593,10.185,129,133,3369
2012,323,24927,26189,473538,479260,1395,5.252,2139,8.053,38479,10034,28445,2.094,8.029,50073,19059,31014,3.977,10.448,-11594,-2.419,16.058,1672,1679,10884
2012,324,948,2126,98390,98840,121,5.689,123,5.783,5922,734,5188,0.743,5.992,6955,2149,4806,2.174,7.037,-1033,-1.045,11.983,52,52,379
2012,325,9285,12788,740807,736232,722,5.654,684,5.357,58112,9990,48122,1.357,7.893,48857,11918,36939,1.619,6.636,9255,1.257,13.272,436,442,6834
2012,326,9633,12344,700444,696262,475,3.821,651,5.236,62014,10694,51320,1.536,8.907,53535,13802,39733,1.982,7.689,8479,1.218,15.378,418,419,5331
2012,327,9172,14638,346083,344952,814,5.510,1082,7.325,37866,7537,30329,2.185,10.977,35199,8749,26450,2.536,10.204,2667,0.773,20.408,546,571,3467
2012,331,3463,4380,396207,385355,202,4.601,223,5.079,37897,4124,33773,1.070,9.834,16247,3639,12608,0.944,4.216,21650,5.618,8.432,140,142,1850
2012,332,49182,53042,1381804,1351074,2808,5.292,2840,5.353,159369,26626,132743,1.971,11.796,97957,31118,66839,2.303,7.250,61412,4.545,14.501,2003,2015,18720
2012,333,20853,23205,1044258,1016398,1042,4.475,1200,5.154,121001,15758,105243,1.550,11.905,65567,19012,46555,1.871,6.451,55434,5.454,12.902,833,838,9288
2012,334,11024,12523,853258,866182,811,6.452,905,7.200,65058,13633,51425,1.574,7.511,91546,22487,69059,2.596,10.569,-26488,-3.058,15.022,613,617,11193
2012,335,4721,5457,332892,329621,318,5.841,293,5.382,29181,4111,25070,1.247,8.853,22731,6098,16633,1.850,6.896,6450,1.957,13.792,192,192,1854
2012,336,9383,11311,1290752,1256355,714,6.313,713,6.304,154235,12397,141838,0.987,12.276,84510,22357,62153,1.780,6.727,69725,5.550,13.453,445,448,5407
2012,337,14621,15201,339497,340082,1086,7.034,1562,10.117,34804,6251,28553,1.838,10.234,36061,12489,23572,3.672,10.604,-1257,-0.370,20.468,1077,1082,7474
2012,339,25165,26422,546466,542011,2731,10.484,1986,7.624,60082,17825,42257,3.289,11.085,51110,15795,35315,2.914,9.430,8972,1.655,18.859,1493,1495,8719
2012,423,160195,229923,3283065,3239123,17121,7.439,17573,7.635,457704,113890,343814,3.516,14.130,369139,121396,247743,3.748,11.396,88565,2.734,22.793,9312,9727,52727
2012,424,90223,120697,2198044,2190953,9651,7.966,10560,8.716,274525,71486,203039,3.263,12.530,259590,81385,178205,3.715,11.848,14935,0.682,23.697,6261,6447,36886
2012,425,34592,36870,271603,276952,4415,11.892,4926,13.269,53399,14940,38459,5.394,19.281,63040,20010,43030,7.225,22.762,-9641,-3.481,38.562,3586,3625,11546
2012,441,76024,110324,1715148,1683408,7369,6.693,6910,6.276,202830,53527,149303,3.180,12.049,139800,44872,94928,2.666,8.305,63030,3.744,16.609,4576,4704,28210
2012,442,32267,48616,423144,421812,4149,8.454,5072,10.335,61404,25327,36077,6.004,14.557,58540,24724,33816,5.861,13.878,2864,0.679,27.756,2827,3110,12446
2012,443,23563,45307,416404,418939,4534,9.920,5328,11.658,64658,22257,42401,5.313,15.434,69788,22923,46865,5.472,16.658,-5130,-1.225,30.868,2819,3098,12918
2012,444,49480,74501,1166474,1167149,3554,4.721,5111,6.789,92802,18656,74146,1.598,7.951,93612,26312,67300,2.254,8.021,-810,-0.069,15.902,3123,3284,13476
2012,445,100780,134863,2879743,2850742,13648,10.207,11350,8.488,300150,106347,193803,3.731,10.529,245517,73827,171690,2.590,8.612,54633,1.916,17.225,8023,8130,35532
2012,446,39483,86599,997039,972351,5522,6.364,5871,6.766,160494,33706,126788,3.466,16.506,107781,36167,71614,3.720,11.085,52713,5.421,22.169,2759,2882,12623
2012,447,62056,107999,855978,853568,7585,7.024,7549,6.991,125220,44138,81082,5.171,14.670,119948,38085,81863,4.462,14.053,5272,0.618,28.105,4581,4789,22177
2012,448,53475,139000,1629060,1635093,10473,7.521,10958,7.870,255457,83698,171759,5.119,15.623,269268,79669,189599,4.872,16.468,-13811,-0.845,31.247,5042,5482,20515
2012,451,28630,43066,513613,515407,3672,8.455,4402,10.136,66835,22290,44545,4.325,12.967,68956,33673,35283,6.533,13.379,-2121,-0.412,25.935,2475,3205,25968
2012,452,7129,46890,2866359,2852899,2900,6.277,1515,3.279,162679,44490,118189,1.559,5.702,134671,13499,121172,0.473,4.720,28008,0.982,9.441,859,940,3076
2012,453,72387,97641,709900,706802,9837,10.072,9885,10.121,106969,41080,65889,5.812,15.134,100988,37627,63361,5.324,14.288,5981,0.846,28.576,6738,6942,21542
2012,454,48167,55171,581060,567869,7663,14.150,5635,10.405,108628,36328,72300,6.397,19.129,82366,28284,54082,4.981,14.504,26262,4.625,29.009,3966,4061,15973
2012,481,2289,4643,434266,425155,344,7.376,385,8.256,33199,4923,28276,1.158,7.809,15189,2570,12619,0.604,3.573,18010,4.236,7.145,193,196,765
2012,483,951,1342,64692,64225,143,10.668,140,10.444,6971,1795,5176,2.795,10.854,6044,2043,4001,3.181,9.411,927,1.443,18.821,82,82,294
2012,484,83902,96919,1333526,1315924,15016,15.737,12010,12.587,205142,65895,139247,5.008,15.589,169079,60043,109036,4.563,12.849,36063,2.741,25.697,8520,8616,38206
2012,485,14079,16858,462661,457905,2138,12.777,1888,11.283,55406,17638,37768,3.852,12.100,46703,17115,29588,3.738,10.199,8703,1.901,20.399,1383,1389,10172
2012,486,167,3422,46401,45293,451,13.638,221,6.683,9033,4246,4787,9.375,19.943,6601,2410,4191,5.321,14.574,2432,5.369,29.148,4,4,21
2012,487,1751,1867,23905,22905,268,14.420,251,13.506,4248,1143,3105,4.990,18.547,2278,994,1284,4.340,9.946,1970,8.601,19.891,184,184,783
2012,488,29219,39262,614946,607650,3841,9.811,3615,9.234,94917,26475,68442,4.357,15.620,80608,27105,53503,4.461,13.266,14309,2.355,26.531,2103,2161,10702
2012,492,7871,12822,530359,528310,1324,10.383,1182,9.270,28400,8060,20340,1.526,5.376,23749,5735,18014,1.086,4.495,4651,0.880,8.991,887,893,3188
2012,493,6703,13940,712217,707663,936,6.658,1172,8.337,88854,24149,64705,3.413,12.556,79124,20383,58741,2.880,11.181,9730,1.375,22.362,322,338,3756
2012,511,17633,26125,867552,875102,2089,7.956,2356,8.972,101616,36202,65414,4.137,11.612,116794,43477,73317,4.968,13.346,-15178,-1.734,23.224,1278,1337,11635
2012,512,15914,19517,340987,326297,2913,15.087,2495,12.922,70032,17475,52557,5.356,21.463,43452,12961,30491,3.972,13.317,26580,8.146,26.633,1489,1514,6067
2012,515,4396,9214,270336,264749,551,5.916,752,8.073,35574,8579,26995,3.240,13.437,24108,8418,15690,3.180,9.106,11466,4.331,18.212,247,260,1737
2012,517,7636,48068,1057675,1080589,5528,11.313,7116,14.563,139504,53634,85870,4.963,12.910,187560,73647,113913,6.815,17.357,-48056,-4.447,25.820,873,970,6294
2012,518,8781,13362,489237,477175,1963,14.639,2058,15.347,106948,27989,78959,5.866,22.413,82435,39148,43287,8.204,17.276,24513,5.137,34.551,670,698,6582
2012,519,7362,9252,210807,198901,1576,17.453,1132,12.536,48106,18547,29559,9.325,24.186,23746,8422,15324,4.234,11.939,24360,12.247,23.877,670,677,3276
2012,521,13,57,17939,17989,(D),(D),(D),(D),799,(D),698,(D),4.442,855,(D),851,(D),4.753,-56,-0.311,8.883,0,0,0
2012,522,37745,190243,2782985,2778555,14553,7.648,14643,7.695,411618,114338,297280,4.115,14.814,403523,164194,239329,5.909,14.523,8095,0.291,29.046,3091,3537,20087
2012,523,50279,89085,896872,881230,12478,14.337,8376,9.624,141916,51486,90430,5.843,16.104,112191,40034,72157,4.543,12.731,29725,3.373,25.462,3935,3990,13797
2012,524,122727,162777,2272727,2256924,15198,9.359,14419,8.879,283265,111700,171565,4.949,12.551,251277,78307,172970,3.470,11.134,31988,1.417,22.267,7459,7679,22914
2012,525,1181,1188,14225,9479,542,58.155,30,3.219,11460,10219,1241,107.807,120.899,2095,1684,411,17.766,22.101,9365,98.797,44.203,14,14,28
2012,531,201717,250329,1395894,1385926,28439,11.400,26717,10.710,228919,94819,134100,6.842,16.517,208944,84785,124159,6.118,15.076,19975,1.441,30.152,15976,16333,48215
2012,532,20382,49892,469658,477452,7521,15.185,6797,13.723,111326,56265,55061,11.784,23.317,125134,43393,81741,9.088,26.209,-13808,-2.892,46.633,1910,2354,10598
2012,533,1983,2137,33244,32048,294,14.033,210,10.024,5770,1937,3833,6.044,18.005,3254,886,2368,2.765,10.154,2516,7.851,20.307,150,150,626
2012,541,652855,737308,7899734,7852495,88110,12.010,80819,11.016,1290407,413502,876905,5.266,16.433,1193804,438574,755230,5.585,15.203,96603,1.230,30.406,51677,52284,209844
2012,551,25903,51099,3030877,3013210,4697,9.210,4500,8.823,471031,107710,363321,3.575,15.632,434359,130014,304345,4.315,14.415,36672,1.217,28.830,817,862,11196
2012,561,259824,311751,9080276,8864704,39633,12.823,34301,11.098,1697844,383520,1314324,4.326,19.153,1265582,419763,845819,4.735,14.277,432262,4.876,28.553,21593,21937,230530
2012,562,16218,21788,358611,358956,1857,8.522,1861,8.541,61153,16023,45130,4.464,17.036,61613,20227,41386,5.635,17.164,-460,-0.128,34.073,1062,1081,6927
2012,611,74688,85831,3458828,3407790,9224,10.966,5786,6.879,312690,64129,248561,1.882,9.176,209372,31095,178277,0.912,6.144,103318,3.032,12.288,3980,4021,18338
2012,621,447125,543679,6374367,6293641,41304,7.624,37429,6.909,903343,275565,627778,4.378,14.353,742290,245686,496604,3.904,11.794,161053,2.559,23.589,23587,25748,150512
2012,622,3384,6489,5743758,5697726,124,1.912,117,1.804,315584,60806,254778,1.067,5.539,225967,32848,193119,0.577,3.966,89617,1.573,7.932,57,60,14188
2012,623,34432,78200,3318689,3295825,4659,5.975,4220,5.412,325559,111140,214419,3.372,9.878,279609,84116,195493,2.552,8.484,45950,1.394,16.967,1817,1945,48378
2012,624,111132,152608,2827095,2817556,13519,8.889,12470,8.199,375154,101190,273964,3.591,13.315,356374,101241,255133,3.593,12.648,18780,0.667,25.297,7465,7683,52053
2012,711,32210,33010,435481,429845,4977,15.234,4299,13.158,69393,20755,48638,4.828,16.144,58230,17480,40750,4.067,13.547,11163,2.597,27.094,2765,2774,11064
2012,712,6399,6842,136743,132979,365,5.369,277,4.075,14387,2123,12264,1.596,10.819,6952,1215,5737,0.914,5.228,7435,5.591,10.456,163,163,750
2012,713,52467,60914,1490977,1458847,6819,11.278,5919,9.789,212224,68967,143257,4.728,14.547,147606,47123,100483,3.230,10.118,64618,4.429,20.236,4281,4342,31425
2012,721,45832,57766,1938326,1921507,4567,7.936,4125,7.168,207330,89468,117862,4.656,10.790,174271,71776,102495,3.735,9.069,33059,1.720,18.139,2491,2540,37587
2012,722,392958,544274,10035225,9865706,59564,11.015,52521,9.713,1629201,703975,925226,7.136,16.514,1286082,487614,798468,4.943,13.036,343119,3.478,26.072,36585,37756,316420
2012,811,178039,194185,1165010,1154355,17309,8.954,15572,8.055,178742,59855,118887,5.185,15.484,156304,56673,99631,4.909,13.540,22438,1.944,27.081,10902,11106,35894
2012,812,155764,192902,1320126,1313818,21635,11.296,18895,9.865,222703,89339,133364,6.800,16.951,209506,80277,129229,6.110,15.946,13197,1.004,31.893,12300,12714,47755
2012,813,283659,292509,2736809,2707227,15432,5.367,5508,1.916,277486,55519,221967,2.051,10.250,219438,21797,197641,0.805,8.106,58048,2.144,16.211,3535,3551,12584
2013,211,5818,7249,129355,127617,637,8.793,627,8.655,20201,6444,13757,5.049,15.829,16791,5444,11347,4.266,13.157,3410,2.672,26.315,386,389,1537
2013,212,3466,6046,203316,202524,414,6.799,501,8.227,22670,8300,14370,4.098,11.194,21012,4443,16569,2.194,10.375,1658,0.819,20.750,273,274,2159
2013,213,10251,12739,391377,390540,1661,13.164,1419,11.246,73069,19631,53438,5.027,18.710,71594,29564,42030,7.570,18.332,1475,0.378,36.664,883,913,9146
2013,221,5521,17405,634510,637066,991,5.711,888,5.117,45220,16753,28467,2.630,7.098,50300,11208,39092,1.759,7.896,-5080,-0.797,14.196,207,216,1927
2013,236,159180,161737,1142376,1120297,26726,16.634,24593,15.306,251135,82090,169045,7.328,22.417,206587,74931,131656,6.688,18.440,44548,3.976,36.881,15564,15588,49909
2013,237,32029,34550,864705,858858,2804,8.015,3676,10.507,155421,27129,128292,3.159,18.096,144339,33053,111286,3.848,16.806,11082,1.290,33.612,2357,2399,21455
2013,238,354359,360822,3444820,3394854,41131,11.386,41978,11.620,642396,142478,499918,4.197,18.923,542444,162116,380328,4.775,15.978,99952,2.944,31.957,27074,27121,113033
2013,311,19855,23892,1413727,1412327,1927,8.096,1744,7.328,114559,22370,92189,1.584,8.111,111823,38712,73111,2.741,7.918,2736,0.194,15.835,1266,1282,14514
2013,312,4530,5163,159353,154384,903,18.647,262,5.410,19344,5664,13680,3.669,12.530,9425,2217,7208,1.436,6.105,9919,6.425,12.210,169,174,989
2013,313,2016,2256,104458,104673,191,8.542,151,6.753,8277,1488,6789,1.422,7.907,8753,2550,6203,2.436,8.362,-476,-0.455,15.815,100,103,775
2013,314,5592,5825,113367,113328,507,8.694,520,8.917,11875,2588,9287,2.284,10.478,11631,3621,8010,3.195,10.263,244,0.215,20.526,380,380,1954
2013,315,5516,5588,110903,110173,787,14.050,814,14.532,18687,7979,10708,7.242,16.962,17302,7206,10096,6.541,15.704,1385,1.257,31.409,672,672,5892
2013,316,1002,1036,27021,27233,87,8.349,99,9.501,2483,380,2103,1.395,9.118,2918,842,2076,3.092,10.715,-435,-1.597,18.236,70,70,608
2013,321,10975,12617,352841,346144,777,6.095,1040,8.158,43628,7583,36045,2.191,12.604,30188,12221,17967,3.531,8.721,13440,3.883,17.442,729,735,7120
2013,322,2688,4231,348813,349724,143,3.362,187,4.397,18837,3793,15044,1.085,5.386,20812,6400,14412,1.830,5.951,-1975,-0.565,10.773,110,112,1944
2013,323,24065,25295,463345,468758,1316,5.123,2105,8.194,35800,8821,26979,1.882,7.637,46751,16383,30368,3.495,9.973,-10951,-2.336,15.274,1685,1689,10909
2013,324,918,2074,96785,97556,107,5.117,141,6.743,6038,1108,4930,1.136,6.189,7565,2147,5418,2.201,7.755,-1527,-1.565,12.379,43,46,295
2013,325,9009,12463,738466,735959,657,5.254,739,5.910,65385,18551,46834,2.521,8.884,61408,13845,47563,1.881,8.344,3977,0.540,16.688,492,495,6258
2013,326,9378,12077,707864,704324,477,3.924,638,5.248,58531,9198,49333,1.306,8.310,51615,15501,36114,2.201,7.328,6916,0.982,14.657,411,423,8117
2013,327,8899,14261,349996,347965,654,4.535,973,6.747,37840,7827,30013,2.249,10.875,34210,10331,23879,2.969,9.831,3630,1.043,19.663,519,526,4593
2013,331,3438,4333,391193,391820,201,4.641,196,4.526,23779,4475,19304,1.142,6.069,25103,5528,19575,1.411,6.407,-1324,-0.338,12.138,138,139,1841
2013,332,48342,52226,1396265,1386285,2512,4.792,2898,5.529,134128,23243,110885,1.677,9.675,113687,31938,81749,2.304,8.201,20441,1.475,16.402,2119,2137,18317
2013,333,20967,23371,1066017,1059323,1039,4.434,1159,4.946,91784,14725,77059,1.390,8.664,78968,21579,57389,2.037,7.455,12816,1.210,14.909,803,805,9103
2013,334,10712,12155,829751,837874,666,5.429,889,7.247,59813,10455,49358,1.248,7.139,76163,23119,53044,2.759,9.090,-16350,-1.951,14.277,626,629,7945
2013,335,4722,5461,334210,335227,282,5.160,290,5.306,23197,3282,19915,0.979,6.920,25150,7903,17247,2.358,7.502,-1953,-0.583,13.840,192,192,2350
2013,336,9044,10920,1314644,1293619,686,6.260,762,6.954,133351,16364,116987,1.265,10.308,91291,23209,68082,1.794,7.057,42060,3.251,14.114,506,513,6255
2013,337,14164,14683,342213,340363,1038,7.009,1292,8.724,33877,6400,27477,1.880,9.953,30131,10355,19776,3.042,8.853,3746,1.101,17.705,912,917,6287
2013,339,23987,25263,553706,554388,1909,7.506,2251,8.850,49810,9854,39956,1.777,8.985,50946,15536,35410,2.802,9.190,-1136,-0.205,17.969,1718,1726,9591
2013,423,157043,227661,3335545,3312873,16302,7.147,17176,7.530,443787,139462,304325,4.210,13.396,399847,137406,262441,4.148,12.069,43940,1.326,24.139,10286,10622,58626
2013,424,89221,120356,2247064,2219420,10258,8.529,10086,8.386,302001,81150,220851,3.656,13.607,244864,82153,162711,3.702,11.033,57137,2.574,22.066,6468,6607,37522
2013,425,37350,39730,292946,288283,4963,12.599,4289,10.888,49653,23226,26427,8.057,17.224,40156,17138,23018,5.945,13.929,9497,3.294,27.859,3129,3139,9730
2013,441,75708,110571,1758681,1737637,7197,6.520,6824,6.182,189772,52943,136829,3.047,10.921,148271,42554,105717,2.449,8.533,41501,2.388,17.066,4689,4838,29176
2013,442,31707,48400,425551,424931,3593,7.396,3954,8.139,56937,18121,38816,4.264,13.399,55230,19581,35649,4.608,12.997,1707,0.402,25.995,2517,2693,10181
2013,443,22927,44909,407114,414919,3528,7.754,4712,10.356,47401,17402,29999,4.194,11.424,63654,22700,40954,5.471,15.341,-16253,-3.917,22.848,2757,2959,11502
2013,444,48284,73668,1232869,1198457,3716,5.027,4222,5.712,134085,21103,112982,1.761,11.188,66176,18899,47277,1.577,5.522,67909,5.666,11.044,2829,2896,11523
2013,445,102753,136650,2905381,2893302,13472,9.932,11450,8.442,270309,106075,164234,3.666,9.343,244021,79560,164461,2.750,8.434,26288,0.909,16.868,8030,8178,36526
2013,446,39936,88806,1015958,1011120,6322,7.173,4990,5.661,112202,32658,79544,3.230,11.097,104525,37549,66976,3.714,10.338,7677,0.759,20.675,2938,3113,15416
2013,447,61536,106956,878528,866676,7301,6.795,8289,7.714,136460,44143,92317,5.093,15.745,113327,43084,70243,4.971,13.076,23133,2.669,26.152,4941,5190,23828
2013,448,53152,138154,1711584,1670480,10016,7.233,10656,7.695,267620,73370,194250,4.392,16.021,184753,65470,119283,3.919,11.060,82867,4.961,22.120,4935,5614,24076
2013,451,28514,43287,538702,527393,3500,8.092,3433,7.937,72612,24414,48198,4.629,13.768,50205,14735,35470,2.794,9.519,22407,4.249,19.039,2341,2382,7906
2013,452,7199,48438,2797079,2832643,2942,6.169,1452,3.044,125972,42720,83252,1.508,4.447,194328,18188,176140,0.642,6.860,-68356,-2.413,8.894,846,854,2792
2013,453,72453,98038,728997,718482,9370,9.578,8950,9.149,112723,40128,72595,5.585,15.689,91769,33128,58641,4.611,12.773,20954,2.916,25.545,6615,6725,22065
2013,454,48451,55377,590235,583232,7246,13.198,6295,11.466,98404,37162,61242,6.372,16.872,83994,32668,51326,5.601,14.401,14410,2.471,28.803,4518,4557,16028
2013,481,2412,4655,420282,428430,518,10.978,645,13.670,64833,8041,56792,1.877,15.133,81782,53494,28288,12.486,19.089,-16949,-3.956,30.265,212,213,944
2013,483,1275,1687,72847,72706,194,11.648,151,9.066,8246,1914,6332,2.633,11.342,7956,2462,5494,3.386,10.943,290,0.399,21.886,78,78,317
2013,484,84923,98186,1366643,1353332,13714,14.047,12606,12.912,198570,61610,136960,4.552,14.673,171592,63891,107701,4.721,12.679,26978,1.993,25.358,8761,8827,36384
2013,485,14387,17178,472750,467867,2107,12.347,1880,11.017,55744,18242,37502,3.899,11.915,46330,22252,24078,4.756,9.902,9414,2.012,19.805,1345,1356,12022
2013,486,204,3668,51365,49636,310,8.673,123,3.441,9090,2304,6786,4.642,18.313,5743,2141,3602,4.313,11.570,3347,6.743,23.140,10,10,40
2013,487,1705,1822,23992,23779,216,11.924,195,10.765,3172,834,2338,3.507,13.340,2746,724,2022,3.045,11.548,426,1.792,23.096,141,141,431
2013,488,28897,38513,621237,608890,3696,9.598,3688,9.577,94711,26780,67931,4.398,15.555,70595,25200,45395,4.139,11.594,24116,3.961,23.188,2201,2253,12957
2013,492,7842,12633,521176,525875,1073,8.402,1348,10.556,28345,7362,20983,1.400,5.390,38460,8658,29802,1.646,7.314,-10115,-1.923,10.780,810,823,3138
2013,493,6847,13881,725466,717783,1224,8.774,1364,9.777,97188,29291,67897,4.081,13.540,80722,27567,53155,3.841,11.246,16466,2.294,22.492,309,325,3000
2013,511,17192,25152,860980,862531,1694,6.622,2556,9.991,113290,34399,78891,3.988,13.135,116409,44364,72045,5.143,13.496,-3119,-0.362,26.269,1336,1366,13371
2013,512,15953,19437,334064,329668,2756,14.249,2565,13.262,44836,17563,27273,5.327,13.600,36272,14405,21867,4.370,11.003,8564,2.598,22.005,1671,1690,8279
2013,515,4415,9450,280273,278288,634,6.741,544,5.784,31556,8884,22672,3.192,11.339,27441,6676,20765,2.399,9.861,4115,1.479,19.721,271,328,3418
2013,517,7752,46513,1060936,1057554,5772,12.305,6565,13.995,193244,87103,106141,8.236,18.273,187401,88757,98644,8.393,17.720,5843,0.553,35.440,858,934,5998
2013,518,8435,13238,493267,482239,1778,13.569,1509,11.516,84647,23305,61342,4.833,17.553,62857,25596,37261,5.308,13.034,21790,4.519,26.069,769,786,8512
2013,519,7786,9760,218968,213817,1689,17.792,1155,12.167,40817,16690,24127,7.806,19.090,30579,9412,21167,4.402,14.301,10238,4.788,28.603,814,816,4806
2013,521,14,58,18503,18221,(D),(D),0,0.000,779,(D),778,(D),4.275,227,0,227,0.000,1.246,552,3.029,2.492,0,0,0
2013,522,37823,187421,2817855,2798090,10494,5.555,13448,7.119,365631,90953,274678,3.251,13.067,328236,96404,231832,3.445,11.731,37395,1.336,23.461,2536,2822,17239
2013,523,50794,86177,866074,877716,9905,11.339,12258,14.033,110278,41337,68941,4.710,12.564,131585,51801,79784,5.902,14.992,-21307,-2.428,25.128,3944,3989,23104
2013,524,122224,161707,2296761,2282395,14610,9.017,15256,9.416,283204,80497,202707,3.527,12.408,255796,107075,148721,4.691,11.207,27408,1.201,22.415,7460,7638,29686
2013,525,1835,1905,26526,20795,659,41.617,16,1.010,14697,13419,1278,64.530,70.676,3127,107,3020,0.515,15.037,11570,55.638,30.075,(D),(D),(D)
2013,531,206899,257252,1432670,1414970,33223,13.111,25499,10.063,241930,113864,128066,8.047,17.098,206435,85256,121179,6.025,14.589,35495,2.509,29.179,15475,15779,49883
2013,532,20459,48527,472848,472161,4211,8.550,5657,11.486,87332,27106,60226,5.741,18.496,86346,40883,45463,8.659,18.287,986,0.209,36.575,1775,1870,7760
2013,533,2052,2192,35038,34242,253,11.632,219,10.069,5845,1863,3982,5.441,17.070,4251,1345,2906,3.928,12.415,1594,4.655,24.830,152,152,796
2013,541,660467,747116,8112366,7970849,91331,12.304,81702,11.007,1388924,530123,858801,6.651,17.425,1106963,414172,692791,5.196,13.888,281961,3.537,27.775,52685,53004,211374
2013,551,25902,51178,3091965,3075173,3674,7.182,3629,7.094,450809,112534,338275,3.659,14.660,420743,115974,304769,3.771,13.682,30066,0.978,27.364,636,655,7811
2013,561,259085,316102,9558673,9395923,42214,13.464,37058,11.820,1723884,430613,1293271,4.583,18.347,1398502,445723,952779,4.744,14.884,325382,3.463,29.768,22603,22826,211184
2013,562,16391,22330,374522,368305,2136,9.638,1799,8.118,60637,16927,43710,4.596,16.464,48482,13215,35267,3.588,13.164,12155,3.300,26.327,1102,1125,6762
2013,611,76893,88332,3506685,3478622,9289,10.704,6194,7.137,288174,64528,223646,1.855,8.284,231234,38293,192941,1.101,6.647,56940,1.637,13.295,4267,4355,25327
2013,621,446522,547502,6591803,6509115,41210,7.559,36513,6.698,923684,280984,642700,4.317,14.191,758836,240896,517940,3.701,11.658,164848,2.533,23.316,25065,25538,145992
2013,622,3418,6657,5646326,5656724,255,3.876,98,1.490,226072,25263,200809,0.447,3.997,248355,39745,208610,0.703,4.390,-22283,-0.394,7.993,44,46,18000
2013,623,34907,79001,3355803,3333749,5195,6.620,4151,5.289,330787,115801,214986,3.474,9.922,285832,92472,193360,2.774,8.574,44955,1.348,17.148,1852,2010,50527
2013,624,114442,155676,2843048,2829963,15276,9.898,12597,8.162,381215,101135,280080,3.574,13.471,354414,107294,247120,3.791,12.524,26801,0.947,25.047,7904,8045,61360
2013,711,32989,33826,455548,448318,4970,14.829,4351,12.982,72809,21097,51712,4.706,16.240,57957,18114,39843,4.040,12.928,14852,3.313,25.855,2803,2804,10113
2013,712,6524,6984,139815,138333,389,5.615,277,3.998,10849,2123,8726,1.535,7.843,7825,972,6853,0.703,5.657,3024,2.186,11.313,173,173,634
2013,713,52922,61343,1514220,1499257,6674,10.945,5946,9.751,194919,73513,121406,4.903,13.001,164739,49011,115728,3.269,10.988,30180,2.013,21.976,4359,4384,33860
2013,721,46367,57966,1947933,1942149,4449,7.683,4325,7.469,204908,77545,127363,3.993,10.551,192835,82463,110372,4.246,9.929,12073,0.622,19.858,2516,2583,34582
2013,722,399350,554968,10421983,10230159,63434,11.547,52200,9.502,1722627,793618,929009,7.758,16.839,1333849,521088,812761,5.094,13.038,388778,3.800,26.077,38709,39670,334773
2013,811,178604,194986,1186929,1179097,17297,8.886,16653,8.555,176931,66993,109938,5.682,15.006,160612,59845,100767,5.075,13.622,16319,1.384,27.243,11852,11977,39048
2013,812,158686,195160,1343030,1333748,21844,11.263,19403,10.005,222254,89751,132503,6.729,16.664,202266,82892,119374,6.215,15.165,19988,1.499,30.330,12635,12889,48979
2013,813,283903,292807,2738609,2726112,13874,4.809,5287,1.832,249961,46816,203145,1.717,9.169,225099,20123,204976,0.738,8.257,24862,0.912,16.514,3526,3534,12254
2014,211,5854,7413,135923,133372,685,9.293,602,8.167,23869,8300,15569,6.223,17.897,18668,5698,12970,4.272,13.997,5201,3.900,27.994,379,392,2725
2014,212,3446,5997,195496,199587,389,6.437,482,7.976,22494,6778,15716,3.396,11.270,30265,12233,18032,6.129,15.164,-7771,-3.894,22.541,242,242,2804
2014,213,10843,13481,422504,407330,1804,13.665,1246,9.438,81698,25552,56146,6.273,20.057,51887,14287,37600,3.507,12.738,29811,7.319,25.477,867,885,8698
2014,221,5563,17491,633823,634296,884,5.068,790,4.529,44183,9769,34414,1.540,6.966,44842,10164,34678,1.602,7.070,-659,-0.104,13.931,194,205,1301
2014,236,161085,163767,1175282,1146026,27169,16.804,22997,14.224,255586,84417,171169,7.366,22.302,196590,70254,126336,6.130,17.154,58996,5.148,34.308,15190,15196,46964
2014,237,31880,34478,897128,884819,3018,8.737,3144,9.102,160784,40918,119866,4.624,18.171,135898,28470,107428,3.218,15.359,24886,2.813,30.718,2046,2079,14405
2014,238,360138,366938,3619530,3536375,42663,11.702,37974,10.415,684127,164020,520107,4.638,19.345,517662,148690,368972,4.205,14.638,166465,4.707,29.276,24912,24944,97953
2014,311,20856,25003,1436587,1429773,2191,8.860,1646,6.656,123047,31609,91438,2.211,8.606,108754,25884,82870,1.810,7.606,14293,1.000,15.213,1244,1248,10938
2014,312,5101,5740,169573,165453,988,18.259,330,6.099,20248,5919,14329,3.577,12.238,11855,2416,9439,1.460,7.165,8393,5.073,14.330,251,251,1296
2014,313,1917,2150,103879,104412,105,4.832,151,6.949,7158,1065,6093,1.020,6.856,8088,2137,5951,2.047,7.746,-930,-0.891,13.711,104,104,886
2014,314,5508,5726,113116,113023,425,7.385,483,8.393,10884,2401,8483,2.124,9.630,10686,3572,7114,3.160,9.455,198,0.175,18.909,378,379,2273
2014,315,5679,5745,106931,109143,941,16.590,795,14.016,16310,6960,9350,6.377,14.944,20696,6713,13983,6.151,18.962,-4386,-4.019,29.887,657,661,5260
2014,316,1030,1064,25341,25546,118,11.281,82,7.839,2311,715,1596,2.799,9.047,2632,556,2076,2.177,10.303,-321,-1.257,18.093,66,66,389
2014,321,11056,12820,365064,359086,974,7.617,908,7.101,44378,11491,32887,3.200,12.359,32224,9142,23082,2.546,8.974,12154,3.385,17.948,672,676,5331
2014,322,2638,4169,350521,350974,147,3.494,223,5.301,21480,4572,16908,1.303,6.120,22551,7706,14845,2.196,6.425,-1071,-0.305,12.240,120,124,2105
2014,323,23727,24952,457811,460515,1364,5.412,1871,7.423,38067,9882,28185,2.146,8.266,43414,16749,26665,3.637,9.427,-5347,-1.161,16.532,1518,1529,10303
2014,324,924,2069,101815,99373,113,5.447,124,5.977,9352,2071,7281,2.084,9.411,4490,579,3911,0.583,4.518,4862,4.893,9.037,39,41,125
2014,325,9049,12520,745322,741308,703,5.615,704,5.623,65294,14003,51291,1.889,8.808,57321,17338,39983,2.339,7.732,7973,1.076,15.465,448,453,6037
2014,326,9341,12061,723376,715640,467,3.854,579,4.778,62619,10996,51623,1.537,8.750,46955,13919,33036,1.945,6.561,15664,2.189,13.123,361,365,5469
2014,327,8780,14099,358978,354712,750,5.282,950,6.691,40590,9004,31586,2.538,11.443,32220,9233,22987,2.603,9.083,8370,2.360,18.167,471,485,4259
2014,331,3413,4337,390655,390953,181,4.157,216,4.960,23745,4210,19535,1.077,6.074,24666,4292,20374,1.098,6.309,-921,-0.236,12.147,151,152,1941
2014,332,48643,52604,1421002,1412560,2583,4.901,2785,5.284,132829,25743,107086,1.822,9.403,115773,30074,85699,2.129,8.196,17056,1.207,16.392,2082,2089,18615
2014,333,20534,22971,1058371,1053568,1014,4.405,1111,4.826,89259,17833,71426,1.693,8.472,80464,21653,58811,2.055,7.637,8795,0.835,15.275,820,828,8268
2014,334,10634,12118,811788,822200,733,6.023,836,6.870,70060,17218,52842,2.094,8.521,90395,21794,68601,2.651,10.994,-20335,-2.473,17.042,597,599,7487
2014,335,4678,5407,336620,334934,292,5.382,328,6.046,27926,5664,22262,1.691,8.338,24664,7318,17346,2.185,7.364,3262,0.974,14.728,229,230,2161
2014,336,9174,11132,1376494,1352232,653,5.874,624,5.613,137866,20492,117374,1.515,10.195,87706,21589,66117,1.597,6.486,50160,3.709,12.972,450,451,6386
2014,337,14057,14628,354223,348318,988,6.705,1201,8.151,44667,7674,36993,2.203,12.824,32615,13457,19158,3.863,9.364,12052,3.460,18.727,904,906,9403
2014,339,23354,24674,539685,539662,1821,7.337,2113,8.513,50761,12242,38519,2.268,9.406,50352,15323,35029,2.839,9.330,409,0.076,18.661,1680,1683,9042
2014,423,156598,227936,3376619,3353369,15792,6.921,16291,7.139,398155,99644,298511,2.971,11.873,351634,128555,223079,3.834,10.486,46521,1.387,20.972,9641,9984,52622
2014,424,89676,121130,2275221,2260123,9436,7.800,9134,7.550,259848,63521,196327,2.811,11.497,228330,81875,146455,3.623,10.103,31518,1.395,20.205,6051,6182,36462
2014,425,35878,38245,291661,288665,4639,12.096,4855,12.659,50670,17840,32830,6.180,17.553,44770,17630,27140,6.107,15.509,5900,2.044,31.019,3767,3792,11870
2014,441,75605,111567,1832627,1796618,7516,6.765,6577,5.920,197079,61444,135635,3.420,10.969,125146,42911,82235,2.388,6.966,71933,4.004,13.931,4770,4856,29918
2014,442,31201,48128,428896,426127,3532,7.334,3591,7.457,49659,16780,32879,3.938,11.654,44024,15352,28672,3.603,10.331,5635,1.322,20.662,2313,2401,8068
2014,443,22538,42384,400529,402959,3444,7.909,5767,13.244,48017,15550,32467,3.859,11.916,54402,25377,29025,6.298,13.501,-6385,-1.585,23.832,2635,2978,11104
2014,444,47582,73627,1262990,1248259,3549,4.815,3715,5.040,107562,24940,82622,1.998,8.617,78277,16842,61435,1.349,6.271,29285,2.346,12.542,2617,2672,10376
2014,445,103486,137481,3011267,2957010,12739,9.312,11371,8.312,306926,116796,190130,3.950,10.380,201741,70766,130975,2.393,6.822,105185,3.557,13.645,8377,8511,38335
2014,446,39833,88433,1016853,1012037,5562,6.316,4819,5.472,99692,32460,67232,3.207,9.851,90830,25055,65775,2.476,8.975,8862,0.876,17.950,3023,3315,15259
2014,447,61424,107120,901570,891000,6987,6.519,7112,6.635,119722,42214,77508,4.738,13.437,98001,33848,64153,3.799,10.999,21721,2.438,21.998,4537,4779,20289
2014,448,52958,139333,1734956,1724034,10798,7.777,9833,7.082,233322,87795,145527,5.092,13.533,215542,52645,162897,3.054,12.502,17780,1.031,25.004,5173,5683,19288
2014,451,28138,42866,559610,548765,3348,7.776,3722,8.645,75962,24473,51489,4.460,13.842,54954,15702,39252,2.861,10.014,21008,3.828,20.028,2498,2557,8966
2014,452,7145,49945,2839271,2817700,2982,6.062,1481,3.010,144087,26883,117204,0.954,5.114,96677,15082,81595,0.535,3.431,47410,1.683,6.862,940,974,2869
2014,453,72572,98664,746563,737863,9876,10.042,9250,9.405,108354,41332,67022,5.602,14.685,90852,29771,61081,4.035,12.313,17502,2.372,24.626,6748,6864,20586
2014,454,49388,56219,607620,599444,7361,13.217,6311,11.332,94327,27279,67048,4.551,15.736,77313,30791,46522,5.137,12.897,17014,2.838,25.795,4480,4551,17564
2014,481,2293,4547,428403,423861,380,8.367,369,8.125,30731,5036,25695,1.188,7.250,21379,4537,16842,1.070,5.044,9352,2.206,10.088,212,215,2696
2014,483,1058,1473,69437,68358,211,14.683,139,9.673,8798,2461,6337,3.600,12.871,6632,1181,5451,1.728,9.702,2166,3.169,19.404,84,84,440
2014,484,86425,99597,1395361,1377970,14004,14.179,12336,12.491,188820,57422,131398,4.167,13.703,154148,59612,94536,4.326,11.187,34672,2.516,22.373,8870,8932,36021
2014,485,14680,17506,480574,476165,2227,12.855,1863,10.754,76639,27186,49453,5.709,16.095,68059,21324,46735,4.478,14.293,8580,1.802,28.586,1413,1424,9886
2014,486,206,3982,53878,51866,659,17.319,305,8.016,11192,6915,4277,13.332,21.579,7123,2116,5007,4.080,13.733,4069,7.845,27.467,15,16,59
2014,487,1832,1950,25230,24706,270,14.063,210,10.938,3441,696,2745,2.817,13.928,2413,722,1691,2.922,9.767,1028,4.161,19.534,142,143,521
2014,488,29432,39553,655213,646426,3785,9.612,3436,8.726,90168,26823,63345,4.149,13.949,72622,21715,50907,3.359,11.234,17546,2.714,22.469,2211,2283,10752
2014,492,7700,12816,540174,530596,1391,10.930,1212,9.523,50647,15564,35083,2.933,9.545,31800,10782,21018,2.032,5.993,18847,3.552,11.987,852,854,4627
2014,493,6954,14050,757101,741111,1112,7.964,937,6.711,98486,24519,73967,3.308,13.289,65284,20392,44892,2.752,8.809,33202,4.480,17.618,316,349,3196
2014,511,17453,25291,869228,865980,2020,7.990,1999,7.907,99780,33229,66551,3.837,11.522,93599,26250,67349,3.031,10.808,6181,0.714,21.617,1155,1175,9620
2014,512,16301,19733,368111,351315,2722,13.893,2440,12.454,73390,15225,58165,4.334,20.890,40646,11695,28951,3.329,11.570,32744,9.320,23.139,1552,1579,7667
2014,515,4384,9350,265084,271110,491,5.231,564,6.009,27850,8963,18887,3.306,10.273,40417,10770,29647,3.973,14.908,-12567,-4.635,20.545,238,266,2526
2014,517,7869,50367,1048686,1054064,9501,19.620,5619,11.603,145709,75231,70478,7.137,13.824,156730,50438,106292,4.785,14.869,-11021,-1.046,27.647,811,838,5111
2014,518,8585,12798,531210,518341,1530,11.705,2076,15.882,120135,36769,83366,7.094,23.177,91913,33703,58210,6.502,17.732,28222,5.445,35.464,730,743,6055
2014,519,8176,10291,247897,234154,1690,16.768,1266,12.561,58511,14489,44022,6.188,24.988,30043,7064,22979,3.017,12.830,28468,12.158,25.661,945,952,4072
2014,521,13,59,18787,18645,(D),(D),0,0.000,524,(D),454,(D),2.810,211,0,211,0.000,1.132,313,1.679,2.263,0,0,0
2014,522,36815,187047,2783072,2799555,11575,6.186,11684,6.245,293507,85643,207864,3.059,10.484,327633,80280,247353,2.868,11.703,-34126,-1.219,20.968,2747,3067,17109
2014,523,52339,88762,882435,877042,10810,12.341,8475,9.675,129194,62943,66251,7.177,14.731,118486,38251,80235,4.361,13.510,10708,1.221,27.019,3946,3999,13802
2014,524,122619,163830,2365114,2349061,14914,9.161,12842,7.888,319777,118574,201203,5.048,13.613,288292,81642,206650,3.476,12.273,31485,1.340,24.545,7245,7332,22780
2014,525,1245,1296,42598,28700,500,47.148,29,2.735,30639,11929,18710,41.564,106.756,3228,165,3063,0.575,11.247,27411,95.509,22.495,22,22,96
2014,531,212245,265425,1482228,1457457,32940,12.599,24980,9.555,242974,107780,135194,7.395,16.671,193471,83066,110405,5.699,13.275,49503,3.397,26.549,15914,16196,49948
2014,532,20044,49251,491343,479615,5012,10.277,4052,8.308,96642,35326,61316,7.365,20.150,70966,26080,44886,5.438,14.796,25676,5.353,29.593,1850,1966,8746
2014,533,2026,2169,32869,34009,219,10.048,240,11.012,4255,891,3364,2.620,12.512,6606,2964,3642,8.715,19.425,-2351,-6.913,25.023,170,170,990
2014,541,667692,759347,8412878,8293177,93272,12.380,81449,10.810,1348106,457745,890361,5.520,16.256,1110026,362944,747082,4.376,13.385,238080,2.871,26.770,54023,54634,196831
2014,551,26183,52287,3227848,3214127,4264,8.209,3572,6.877,435875,132602,303273,4.126,13.561,403970,86509,317461,2.692,12.569,31905,0.993,25.137,699,726,11861
2014,561,260451,319646,9772738,9586941,40784,12.857,35897,11.317,1906617,492434,1414183,5.137,19.888,1545285,553146,992139,5.770,16.119,361332,3.769,32.237,22090,22383,210729
2014,562,16379,22455,377621,375752,1826,8.166,1638,7.325,45467,11782,33685,3.136,12.100,41614,11769,29845,3.132,11.075,3853,1.025,22.150,1068,1078,6218
2014,611,78105,89688,3560342,3518828,8931,10.111,6211,7.032,315165,85198,229967,2.421,8.957,229964,32988,196976,0.937,6.535,85201,2.421,13.070,4423,4478,21236
2014,621,444991,551792,6701447,6607212,41762,7.599,37311,6.789,909307,302815,606492,4.583,13.762,717249,230122,487127,3.483,10.856,192058,2.907,21.711,26125,26842,143543
2014,622,3375,6744,5629830,5639915,287,4.301,146,2.188,187737,43605,144132,0.773,3.329,207178,31834,175344,0.564,3.673,-19441,-0.345,6.657,70,72,12028
2014,623,35371,82667,3420015,3389539,7523,9.291,4124,5.093,352722,133418,219304,3.936,10.406,291795,96518,195277,2.848,8.609,60927,1.798,17.217,1974,2139,52204
2014,624,118944,160669,2926197,2889842,16952,10.706,12294,7.764,371475,112169,259306,3.881,12.855,298396,84388,214008,2.920,10.326,73079,2.529,20.651,8194,8501,50950
2014,711,33610,34502,472836,462418,5289,15.515,4463,13.092,77080,23481,53599,5.078,16.669,56323,18658,37665,4.035,12.180,20757,4.489,24.360,3014,3020,11866
2014,712,6542,7007,142881,141247,316,4.521,282,4.034,11193,1285,9908,0.910,7.924,7973,1251,6722,0.886,5.645,3220,2.280,11.289,184,184,732
2014,713,53738,62780,1552040,1528693,7025,11.300,5797,9.325,203494,77693,125801,5.082,13.312,155427,50820,104607,3.324,10.167,48067,3.144,20.335,4383,4460,37197
2014,721,46821,58380,1992275,1980429,4634,7.964,4243,7.292,210819,82461,128358,4.164,10.645,184966,73092,111874,3.691,9.340,25853,1.305,18.679,2718,2808,39122
2014,722,404133,561832,10783788,10603173,60337,10.809,53049,9.504,1677203,778414,898789,7.341,15.818,1315485,493520,821965,4.654,12.407,361718,3.411,24.813,40667,41682,354438
2014,811,178481,195691,1222301,1207969,16780,8.591,16034,8.209,179278,66118,113160,5.473,14.841,151019,54812,96207,4.538,12.502,28259,2.339,25.004,11812,11932,39095
2014,812,161540,198948,1363293,1352687,22841,11.594,18966,9.627,222561,109819,112742,8.119,16.453,200425,78490,121935,5.803,14.817,22136,1.636,29.634,13309,13544,48786
2014,813,284080,293096,2739831,2723227,13786,4.773,5246,1.816,244816,44587,200229,1.637,8.990,211585,18573,193012,0.682,7.770,33231,1.220,15.539,3694,3714,12504
2015,211,5705,7173,134294,134347,549,7.536,774,10.624,21652,7891,13761,5.874,16.117,22068,9515,12553,7.082,16.426,-416,-0.310,32.233,464,467,3948
2015,212,3365,6000,191362,194590,460,7.661,469,7.811,23615,8211,15404,4.220,12.136,30297,9333,20964,4.796,15.570,-6682,-3.434,24.272,263,263,3163
2015,213,10947,13753,415169,420436,1815,13.322,1557,11.428,63433,24491,38942,5.825,15.087,74109,17874,56235,4.251,17.627,-10676,-2.539,30.175,1103,1116,7839
2015,221,5557,17506,640135,637693,921,5.262,916,5.233,48278,11619,36659,1.822,7.571,43559,9357,34202,1.467,6.831,4719,0.740,13.661,227,229,1018
2015,236,166277,169145,1256657,1216655,27477,16.523,21772,13.093,274802,94219,180583,7.744,22.587,194175,68392,125783,5.621,15.960,80627,6.627,31.919,14800,14814,48249
2015,237,31867,34575,918757,908451,2959,8.568,2883,8.348,159437,30839,128598,3.395,17.550,140197,25348,114849,2.790,15.433,19240,2.118,30.865,1971,1974,12722
2015,238,368588,375807,3827349,3724317,44628,12.014,35974,9.684,714801,173672,541129,4.663,19.193,509029,143455,365574,3.852,13.668,205772,5.525,27.335,24570,24605,99283
2015,311,20975,25184,1479515,1456450,2106,8.419,1767,7.064,141962,31427,110535,2.158,9.747,95129,25219,69910,1.732,6.532,46833,3.216,13.063,1358,1368,11889
2015,312,6021,6669,182209,175860,1213,19.442,353,5.658,24201,6497,17704,3.694,13.762,11341,3459,7882,1.967,6.449,12860,7.313,12.898,263,267,2607
2015,313,1849,2084,103305,104042,101,4.775,163,7.707,7023,1464,5559,1.407,6.750,8535,1968,6567,1.892,8.203,-1512,-1.453,13.500,131,131,799
2015,314,5464,5701,114065,113747,431,7.555,439,7.695,11284,4166,7118,3.663,9.920,10541,2594,7947,2.281,9.267,743,0.653,18.534,340,340,1521
2015,315,5757,5821,104082,104826,994,17.279,857,14.898,15948,7573,8375,7.224,15.214,17391,8071,9320,7.699,16.590,-1443,-1.377,30.428,723,724,6891
2015,316,1050,1085,26186,25586,127,11.864,98,9.155,3482,1226,2256,4.792,13.609,2298,897,1401,3.506,8.981,1184,4.628,17.963,88,89,879
2015,321,11278,13101,379861,372374,1046,8.053,822,6.328,43811,10157,33654,2.728,11.765,28808,9202,19606,2.471,7.736,15003,4.029,15.473,607,613,5659
2015,322,2584,4126,349751,350185,137,3.301,186,4.481,22506,5300,17206,1.513,6.427,23495,6424,17071,1.834,6.709,-989,-0.282,12.854,114,117,3268
2015,323,23156,24400,447818,453305,1300,5.262,1907,7.720,37647,8491,29156,1.873,8.305,48246,18174,30072,4.009,10.643,-10599,-2.338,16.610,1531,1535,9551
2015,324,912,2056,101880,101742,106,5.146,114,5.534,5926,1456,4470,1.431,5.825,5666,1500,4166,1.474,5.569,260,0.256,11.138,39,40,355
2015,325,9067,12634,750614,748122,781,6.205,685,5.443,68794,20082,48712,2.684,9.196,63963,16243,47720,2.171,8.550,4831,0.646,17.100,433,443,5387
2015,326,9219,11987,739716,728825,469,3.902,531,4.418,65303,10305,54998,1.414,8.960,43364,10599,32765,1.454,5.950,21939,3.010,11.900,382,385,5936
2015,327,8737,14175,370110,364164,879,6.211,833,5.886,41957,8792,33165,2.414,11.521,30211,8861,21350,2.433,8.296,11746,3.225,16.592,477,481,4368
2015,331,3382,4316,397049,394156,214,4.954,222,5.139,28823,4042,24781,1.025,7.313,23316,6257,17059,1.587,5.915,5507,1.397,11.831,155,155,3074
2015,332,48338,52398,1445156,1432732,2554,4.860,2851,5.426,136917,27681,109236,1.932,9.556,111885,30134,81751,2.103,7.809,25032,1.747,15.618,2178,2182,18444
2015,333,20451,22942,1077520,1070621,992,4.311,1130,4.911,91472,14927,76545,1.394,8.544,77604,15231,62373,1.423,7.249,13868,1.295,14.497,869,869,8657
2015,334,10458,11927,795227,796656,698,5.815,850,7.082,65667,14675,50992,1.842,8.243,68593,20366,48227,2.556,8.610,-2926,-0.367,16.486,613,619,8523
2015,335,4699,5413,345381,341684,332,6.127,344,6.348,30346,4864,25482,1.424,8.881,22893,6247,16646,1.828,6.700,7453,2.181,13.400,249,250,2672
2015,336,9170,11229,1433250,1411121,724,6.472,640,5.721,140909,20491,120418,1.452,9.986,95718,18240,77478,1.293,6.783,45191,3.202,13.566,465,467,5897
2015,337,13794,14345,359276,357475,920,6.357,1176,8.125,35710,6942,28768,1.942,9.990,32385,10389,21996,2.906,9.059,3325,0.930,18.119,872,884,6880
2015,339,23260,24603,537496,535390,1962,7.968,2005,8.142,55447,16618,38829,3.104,10.356,51562,13568,37994,2.534,9.631,3885,0.726,19.261,1574,1587,8275
2015,423,154505,225377,3434559,3405320,14589,6.438,17079,7.536,403649,101813,301836,2.990,11.853,342041,120789,221252,3.547,10.044,61608,1.809,20.089,10222,10538,57130
2015,424,89236,121777,2317884,2295977,9788,8.051,9381,7.716,258198,74726,183472,3.255,11.246,215800,65663,150137,2.860,9.399,42398,1.847,18.798,6655,6802,38541
2015,425,36152,38586,299481,293867,4612,12.020,4181,10.896,47368,19408,27960,6.604,16.119,35895,13836,22059,4.708,12.215,11473,3.904,24.429,3209,3234,8402
2015,441,75349,112093,1906361,1869380,7447,6.662,6841,6.120,208408,67639,140769,3.618,11.149,134297,46264,88033,2.475,7.184,74111,3.964,14.368,4777,4868,31676
2015,442,30703,47980,447796,437853,3393,7.062,3518,7.323,63163,20080,43083,4.586,14.426,42908,15125,27783,3.454,9.800,20255,4.626,19.599,2269,2549,9211
2015,443,22019,41610,394257,396853,3484,8.315,4069,9.711,42098,14833,27265,3.738,10.608,48146,18352,29794,4.624,12.132,-6048,-1.524,21.216,2531,2831,11585
2015,444,46871,73393,1278193,1270180,3271,4.451,3469,4.720,92449,18750,73699,1.476,7.278,75484,15021,60463,1.183,5.943,16965,1.336,11.886,2493,2559,10438
2015,445,103966,138952,3134003,3063122,13534,9.808,11612,8.415,365621,147974,217647,4.831,11.936,224365,79134,145231,2.583,7.325,141256,4.612,14.649,8480,8672,39006
2015,446,39815,88861,1038240,1028165,5386,6.081,4794,5.413,98193,29159,69034,2.836,9.550,77543,27884,49659,2.712,7.542,20650,2.008,15.084,3079,3190,14739
2015,447,61170,107137,921410,911166,6796,6.338,6988,6.517,120947,44739,76208,4.910,13.274,100570,35135,65435,3.856,11.038,20377,2.236,22.075,4682,4916,22914
2015,448,52078,139163,1709418,1717655,10853,7.796,10951,7.866,243520,97951,145569,5.703,14.177,263045,71757,191288,4.178,15.314,-19525,-1.137,28.355,5361,6624,31568
2015,451,28093,43092,580655,570138,3415,7.944,3213,7.474,75890,24571,51319,4.310,13.311,54020,13863,40157,2.432,9.475,21870,3.836,18.950,2312,2387,8479
2015,452,7251,51475,2897657,2869067,3083,6.075,1632,3.216,164612,83516,81096,2.911,5.737,106174,11025,95149,0.384,3.701,58438,2.037,7.401,847,876,2707
2015,453,73004,99396,754865,750892,10031,10.127,9335,9.425,108724,42846,65878,5.706,14.479,100288,32945,67343,4.387,13.356,8436,1.123,26.712,6798,6975,21501
2015,454,50101,56920,639936,622327,7646,13.556,6609,11.718,122666,55488,67178,8.916,19.711,86523,35580,50943,5.717,13.903,36143,5.808,27.806,5025,5066,19705
2015,481,2322,4327,453342,440646,407,9.166,634,14.278,66081,5377,60704,1.220,14.996,40074,18461,21613,4.190,9.094,26007,5.902,18.189,194,233,920
2015,483,1080,1505,67971,68298,171,11.473,142,9.527,5374,1282,4092,1.877,7.868,6153,1063,5090,1.556,9.009,-779,-1.141,15.737,93,95,538
2015,484,90333,104308,1444417,1419816,16359,16.052,11562,11.345,217475,73007,144468,5.142,15.317,167504,55720,111784,3.924,11.798,49971,3.520,23.595,8586,8640,34749
2015,485,14856,17852,493915,487399,2443,13.824,2084,11.792,69150,26216,42934,5.379,14.188,56503,23942,32561,4.912,11.593,12647,2.595,23.186,1573,1589,11106
2015,486,216,3594,51752,52978,189,4.984,585,15.427,6709,2549,4160,4.811,12.664,9365,6515,2850,12.298,17.677,-2656,-5.013,25.328,14,14,57
2015,487,1873,1995,26466,25963,279,14.094,248,12.528,3759,1003,2756,3.863,14.479,2775,893,1882,3.440,10.688,984,3.790,21.377,176,177,697
2015,488,29612,39993,670954,663187,4214,10.597,3760,9.455,101294,32873,68421,4.957,15.274,85960,39022,46938,5.884,12.962,15334,2.312,25.923,2229,2258,11052
2015,492,7605,13715,591536,566250,2150,16.186,1286,9.682,75526,25624,49902,4.525,13.338,24833,8175,16658,1.444,4.386,50693,8.952,8.771,851,869,3717
2015,493,7128,14572,795099,777147,1369,9.538,931,6.486,106194,37964,68230,4.885,13.665,69816,18994,50822,2.444,8.984,36378,4.681,17.967,338,355,3888
2015,511,17487,25037,882175,885171,2060,8.171,2411,9.563,101732,23928,77804,2.703,11.493,108491,32970,75521,3.725,12.257,-6759,-0.764,22.986,1339,1404,11717
2015,512,16422,19883,386976,377614,2721,13.746,2546,12.862,54147,18990,35157,5.029,14.339,36325,12257,24068,3.246,9.620,17822,4.720,19.239,1736,1754,6996
2015,515,4347,8138,262260,264341,526,6.015,1740,19.897,33288,11559,21729,4.373,12.593,38066,14079,23987,5.326,14.400,-4778,-1.808,25.186,245,294,3151
2015,517,8205,51893,1039137,1045396,5229,10.196,4014,7.827,124138,44555,79583,4.262,11.875,135028,34000,101028,3.252,12.916,-10890,-1.042,23.749,787,803,5639
2015,518,8549,12798,535086,523928,1541,12.087,1443,11.319,94305,18738,75567,3.576,18.000,71327,26358,44969,5.031,13.614,22978,4.386,27.228,810,938,15353
2015,519,8444,10578,259985,253202,1637,15.688,1351,12.947,51786,13234,38552,5.227,20.452,36987,17485,19502,6.906,14.608,14799,5.845,29.215,938,947,4836
2015,521,13,59,19189,18988,0,0.000,0,0.000,653,0,653,0.000,3.439,270,0,270,0.000,1.422,383,2.017,2.844,0,0,0
2015,522,36304,187206,2760018,2772344,12209,6.526,11979,6.403,336373,86378,249995,3.116,12.133,358081,85609,272472,3.088,12.916,-21708,-0.783,24.266,2594,3076,17129
2015,523,53583,88366,892996,888248,9642,10.881,10135,11.437,133734,40457,93277,4.555,15.056,124221,45141,79080,5.082,13.985,9513,1.071,27.970,4076,4111,14911
2015,524,123001,165175,2413787,2378277,16664,10.134,15176,9.229,328295,114911,213384,4.832,13.804,257140,89310,167830,3.755,10.812,71155,2.992,21.624,7441,7559,25463
2015,525,1258,1290,19930,15830,571,56.479,13,1.286,12993,11910,1083,75.237,82.078,4868,519,4349,3.279,30.752,8125,51.327,61.503,7,7,15
2015,531,217709,273088,1517448,1500984,33833,12.570,25978,9.651,241848,106799,135049,7.115,16.113,208680,94437,114243,6.292,13.903,33168,2.210,27.806,16863,17226,53987
2015,532,20030,49640,509406,500208,4255,8.605,3872,7.830,80626,26409,54217,5.280,16.119,62856,22708,40148,4.540,12.566,17770,3.553,25.132,1694,1815,9765
2015,533,2026,2158,33902,33290,230,10.670,225,10.438,4273,977,3296,2.935,12.836,2996,930,2066,2.794,9.000,1277,3.836,18.000,174,174,615
2015,541,673797,770641,8638445,8513822,93470,12.223,81641,10.676,1438178,520594,917584,6.115,16.892,1184877,405471,779406,4.763,13.917,253301,2.975,27.834,56186,56692,214847
2015,551,26491,52607,3323833,3289475,4265,8.135,3908,7.454,488309,145530,342779,4.424,14.845,420383,92113,328270,2.800,12.780,67926,2.065,25.559,697,732,10977
2015,561,263092,323741,10255419,10044564,41702,12.972,37184,11.566,1746801,440798,1306003,4.388,17.391,1321187,416849,904338,4.150,13.153,425614,4.237,26.307,22229,22469,222320
2015,562,16381,22620,381799,378130,1652,7.329,1491,6.615,48740,12379,36361,3.274,12.890,41059,10687,30372,2.826,10.858,7681,2.031,21.717,1021,1040,6486
2015,611,79985,91936,3637574,3584398,9794,10.861,6273,6.956,303480,62575,240905,1.746,8.467,198217,28701,169516,0.801,5.530,105263,2.937,11.060,4635,4806,20910
2015,621,442972,564363,7011249,6863211,51325,9.198,38627,6.922,1125518,452386,673132,6.591,16.399,826568,275308,551260,4.011,12.043,298950,4.356,24.087,27086,27776,148507
2015,622,3135,6719,5600056,5619043,244,3.660,140,2.100,223580,46473,177107,0.827,3.979,262736,33349,229387,0.593,4.676,-39156,-0.697,7.958,74,75,8099
2015,623,36013,84061,3466766,3444387,6176,7.405,4850,5.815,387876,136390,251486,3.960,11.261,341564,111692,229872,3.243,9.917,46312,1.345,19.833,2066,2221,58655
2015,624,122365,164740,3027851,2977790,16695,10.252,12922,7.935,403944,109838,294106,3.689,13.565,305501,87555,217946,2.940,10.259,98443,3.306,20.519,8915,9083,56149
2015,711,34578,35505,479845,475831,5418,15.474,4435,12.667,71957,22054,49903,4.635,15.122,63957,19042,44915,4.002,13.441,8000,1.681,26.882,2949,2955,12169
2015,712,6612,7090,146070,144618,348,4.938,262,3.718,10774,1858,8916,1.285,7.450,7801,1049,6752,0.725,5.394,2973,2.056,10.788,165,165,784
2015,713,54864,64190,1604317,1574660,7463,11.757,6038,9.512,205980,72182,133798,4.584,13.081,146174,54350,91824,3.452,9.283,59806,3.798,18.566,4524,4583,38497
2015,721,47248,59110,2020385,2005523,5073,8.632,4397,7.481,223337,96765,126572,4.825,11.136,194337,78153,116184,3.897,9.690,29000,1.446,19.380,3006,3046,47635
2015,722,409050,567497,11169478,10975209,58570,10.374,52696,9.334,1814590,830086,984504,7.563,16.534,1426879,561962,864917,5.120,13.001,387711,3.533,26.002,36472,37707,357433
2015,811,179128,196793,1245576,1235232,17229,8.779,16131,8.220,180328,63375,116953,5.131,14.599,159561,62061,97500,5.024,12.917,20767,1.681,25.835,11833,11955,40037
2015,812,164927,202950,1398900,1380653,23427,11.663,19275,9.596,227554,97335,130219,7.050,16.482,192262,82874,109388,6.003,13.925,35292,2.556,27.851,13347,13707,49468
2015,813,284157,293194,2764710,2744348,13858,4.795,5501,1.903,245193,51049,194144,1.860,8.934,204394,20794,183600,0.758,7.448,40799,1.487,14.896,3842,3877,12931
2016,211,5113,6639,119357,126500,471,6.877,890,12.996,14381,8445,5936,6.676,11.368,28491,8572,19919,6.776,22.523,-14110,-11.154,22.737,614,614,2462
2016,212,3322,5923,173235,182528,349,5.852,430,7.211,15009,5002,10007,2.740,8.223,33134,9035,24099,4.950,18.153,-18125,-9.930,16.446,227,245,4859
2016,213,9882,12517,290505,352940,1133,8.596,2460,18.664,24329,12839,11490,3.638,6.893,149152,24258,124894,6.873,42.260,-124823,-35.367,13.786,1634,1644,11641
2016,221,5567,17723,638798,638796,1068,6.073,796,4.526,43153,12804,30349,2.004,6.755,42951,11367,31584,1.779,6.724,202,0.032,13.447,255,261,1445
2016,236,170315,173226,1315756,1278791,28106,16.553,21252,12.516,268849,88774,180075,6.942,21.024,195134,66279,128855,5.183,15.259,73715,5.764,30.519,15173,15179,47152
2016,237,31911,34683,936328,927518,2892,8.344,2844,8.206,152357,28555,123802,3.079,16.426,134418,29204,105214,3.149,14.492,17939,1.934,28.984,2054,2061,16847
2016,238,381967,389507,4055251,3946170,47008,12.258,34962,9.117,741060,177151,563909,4.489,18.779,522718,146200,376518,3.705,13.246,218342,5.533,26.492,25008,25058,104925
2016,311,21176,25422,1499244,1486616,2114,8.370,1782,7.056,129851,25066,104785,1.686,8.735,103774,24792,78982,1.668,6.981,26077,1.754,13.961,1427,1431,11960
2016,312,6695,7370,196358,189079,1233,17.721,409,5.878,26122,7773,18349,4.111,13.815,11472,2513,8959,1.329,6.067,14650,7.748,12.135,328,328,1472
2016,313,1768,2003,101210,100862,98,4.830,150,7.393,7468,898,6570,0.890,7.404,6607,1664,4943,1.650,6.551,861,0.854,13.101,122,122,1141
2016,314,5377,5599,111912,112565,418,7.434,465,8.270,9412,1919,7493,1.705,8.361,10674,4179,6495,3.713,9.483,-1262,-1.121,16.723,368,368,2017
2016,315,5330,5396,96877,99617,700,12.740,897,16.325,15264,5395,9869,5.416,15.323,20856,7203,13653,7.231,20.936,-5592,-5.613,30.645,779,779,6206
2016,316,1063,1098,25752,25936,111,10.151,102,9.328,1811,477,1334,1.839,6.983,2151,568,1583,2.190,8.294,-340,-1.311,13.965,83,83,327
2016,321,11351,13254,392504,386954,1036,7.865,873,6.627,41982,10032,31950,2.593,10.849,30783,8649,22134,2.235,7.955,11199,2.894,15.910,691,693,6203
2016,322,2506,4037,348785,349368,123,3.021,192,4.716,20144,3370,16774,0.965,5.766,21013,6117,14896,1.751,6.015,-869,-0.249,11.532,123,126,2196
2016,323,22811,24208,445861,446232,1549,6.362,1832,7.524,44099,13605,30494,3.049,9.883,44827,17811,27016,3.991,10.046,-728,-0.163,19.765,1506,1513,10062
2016,324,916,2091,103232,102736,141,6.774,122,5.861,8436,2230,6206,2.171,8.211,7658,2985,4673,2.906,7.454,778,0.757,14.908,45,45,674
2016,325,9190,12883,760639,760304,879,6.870,702,5.487,64024,15250,48774,2.006,8.421,63559,15585,47974,2.050,8.360,465,0.061,16.719,477,481,6474
2016,326,9078,11849,749120,742715,415,3.485,535,4.492,61015,7801,53214,1.050,8.215,47899,10686,37213,1.439,6.449,13116,1.766,12.898,382,389,6005
2016,327,8839,14478,383407,376815,892,6.206,682,4.745,44340,9115,35225,2.419,11.767,31043,7724,23319,2.050,8.238,13297,3.529,16.477,418,427,3569
2016,331,3348,4278,375889,386522,165,3.835,213,4.951,18816,3120,15696,0.807,4.868,39498,5078,34420,1.314,10.219,-20682,-5.351,9.736,157,161,2164
2016,332,48265,52342,1403870,1423060,2740,5.220,3045,5.801,113982,26029,87953,1.829,8.010,152489,31815,120674,2.236,10.716,-38507,-2.706,16.019,2343,2360,19081
2016,333,20255,22780,1029883,1053912,1054,4.605,1268,5.540,66478,13944,52534,1.323,6.308,114567,23991,90576,2.276,10.871,-48089,-4.563,12.615,930,932,9676
2016,334,10322,11780,788353,791632,672,5.674,801,6.763,57521,8341,49180,1.054,7.266,63876,16425,47451,2.075,8.069,-6355,-0.803,14.532,586,592,7168
2016,335,4656,5374,344059,345139,275,5.086,341,6.307,23419,3719,19700,1.078,6.785,25734,5384,20350,1.560,7.456,-2315,-0.671,13.571,252,252,2448
2016,336,9040,11134,1470150,1453283,624,5.590,681,6.101,123270,13609,109661,0.936,8.482,89711,19995,69716,1.376,6.173,33559,2.309,12.346,479,490,7137
2016,337,13776,14337,370066,364677,961,6.683,1046,7.274,38271,7626,30645,2.091,10.495,27618,9375,18243,2.571,7.573,10653,2.921,15.147,812,817,6351
2016,339,23101,24461,539381,538179,1819,7.420,1925,7.853,52077,11494,40583,2.136,9.677,49476,15632,33844,2.905,9.193,2601,0.483,18.386,1537,1540,9740
2016,423,152280,225781,3451553,3449119,16031,7.102,15927,7.056,381728,107079,274649,3.105,11.067,376599,126704,249895,3.674,10.919,5129,0.149,21.837,10401,10754,59280
2016,424,88373,121305,2349306,2343270,9042,7.433,9720,7.991,246336,67881,178455,2.897,10.512,234432,78044,156388,3.331,10.004,11904,0.508,20.009,6774,7036,42040
2016,425,36363,38802,304081,300780,4480,11.582,4236,10.951,45269,12375,32894,4.114,15.051,38661,14548,24113,4.837,12.854,6608,2.197,25.707,3351,3387,10635
2016,441,75057,112772,1971638,1941903,7272,6.467,6610,5.879,200452,62432,138020,3.215,10.322,141097,45982,95115,2.368,7.266,59355,3.057,14.532,4955,5071,34295
2016,442,30465,48136,459133,454298,3152,6.533,3372,6.989,54325,19403,34922,4.271,11.958,44069,15454,28615,3.402,9.700,10256,2.258,19.401,2201,2316,7992
2016,443,20345,38991,378316,385077,2253,5.633,4265,10.663,35168,9652,25516,2.507,9.133,48765,20788,27977,5.398,12.664,-13597,-3.531,18.265,2501,2854,13827
2016,444,46326,72965,1328429,1301516,3415,4.682,3368,4.617,117769,21501,96268,1.652,9.049,64451,15822,48629,1.216,4.952,53318,4.097,9.904,2477,2559,10833
2016,445,104603,139568,3179868,3156049,12986,9.348,11683,8.410,325111,128175,196936,4.061,10.301,276971,96203,180768,3.048,8.776,48140,1.525,17.552,8295,8416,37448
2016,446,39955,93202,1050838,1044635,10228,11.252,5629,6.192,169238,64559,104679,6.180,16.201,156381,46081,110300,4.411,14.970,12857,1.231,29.940,3137,3317,16855
2016,447,61698,107358,947527,937852,6766,6.302,6772,6.308,124355,44605,79750,4.756,13.260,105135,35354,69781,3.770,11.210,19220,2.049,22.420,4235,4540,21587
2016,448,51650,137642,1734995,1722965,9117,6.587,10632,7.682,223621,72406,151215,4.202,12.979,202143,61937,140206,3.595,11.732,21478,1.247,23.465,4997,6562,26952
2016,451,28076,43100,569133,572691,3352,7.782,3304,7.670,59533,22031,37502,3.847,10.395,68214,16190,52024,2.827,11.911,-8681,-1.516,20.791,2391,2439,8615
2016,452,7200,52327,2923101,2911414,2332,4.495,1436,2.768,181027,39230,141797,1.347,6.218,159552,16237,143315,0.558,5.480,21475,0.738,10.960,872,1057,5452
2016,453,74053,101453,778774,766817,10704,10.642,8960,8.908,120765,46519,74246,6.067,15.749,96518,39049,57469,5.092,12.587,24247,3.162,25.174,6753,6932,22064
2016,454,51620,58587,660016,645634,8309,14.421,6367,11.051,119450,60598,58852,9.386,18.501,89541,38205,51336,5.917,13.869,29909,4.633,27.737,5006,5043,19989
2016,481,2266,4261,466011,459838,350,8.165,401,9.355,65296,3596,61700,0.782,14.200,53432,37228,16204,8.096,11.620,11864,2.580,23.240,217,301,35123
2016,483,1059,1504,65022,66388,165,11.059,141,9.450,5726,1735,3991,2.613,8.625,8557,2298,6259,3.461,12.889,-2831,-4.264,17.250,101,102,521
2016,484,92648,107360,1452706,1445302,16493,15.593,13310,12.584,191276,71022,120254,4.914,13.234,177196,61421,115775,4.250,12.260,14080,0.974,24.520,10026,10081,39290
2016,485,15024,18162,516038,505706,2437,13.539,2114,11.744,70362,19882,50480,3.932,13.914,49623,17132,32491,3.388,9.813,20739,4.101,19.625,1634,1644,10611
2016,486,224,3643,54137,53057,172,4.745,135,3.725,6327,2316,4011,4.365,11.925,4206,1177,3029,2.218,7.927,2121,3.998,15.855,17,17,127
2016,487,1982,2104,29153,27853,309,15.004,220,10.682,5658,1284,4374,4.610,20.314,2943,1231,1712,4.420,10.566,2715,9.748,21.133,154,154,1084
2016,488,30215,40693,687918,678896,3855,9.537,3310,8.189,92190,25367,66823,3.737,13.579,73952,25520,48432,3.759,10.893,18238,2.686,21.786,2203,2267,12064
2016,492,7294,13652,612332,603026,1597,11.637,1740,12.679,63333,25289,38044,4.194,10.503,43170,16842,26328,2.793,7.159,20163,3.344,14.318,1117,1122,5335
2016,493,7229,15107,837976,819179,1481,9.977,955,6.434,107958,33875,74083,4.135,13.179,72278,22970,49308,2.804,8.823,35680,4.356,17.646,379,408,4167
2016,511,17787,25548,879704,875607,2658,10.483,2273,8.965,113449,48769,64680,5.570,12.957,105373,28255,77118,3.227,12.034,8076,0.922,24.069,1377,1529,11970
2016,512,16752,20242,408405,412248,2823,14.061,2494,12.422,65499,18954,46545,4.598,15.888,71432,24340,47092,5.904,17.327,-5933,-1.439,31.777,1710,1726,7216
2016,515,4324,8094,262768,261649,514,6.355,502,6.207,27309,9265,18044,3.541,10.437,24804,8905,15899,3.403,9.480,2505,0.957,18.960,237,243,1806
2016,517,8926,57022,1069457,1054253,8464,15.536,3377,6.199,139984,69202,70782,6.564,13.278,110672,39753,70919,3.771,10.498,29312,2.780,20.995,842,877,4985
2016,518,8664,12942,472369,470629,1422,11.033,1315,10.203,62278,16084,46194,3.418,13.233,58664,26521,32143,5.635,12.465,3614,0.768,24.930,856,870,9722
2016,519,8570,10899,284604,278376,1539,14.259,1327,12.295,46104,12404,33700,4.456,16.562,33903,11393,22510,4.093,12.179,12201,4.383,24.358,1003,1016,6182
2016,521,15,61,19369,19280,(D),(D),0,0.000,717,(D),716,(D),3.719,514,0,514,0.000,2.666,203,1.053,5.332,0,0,0
2016,522,35751,188339,2850827,2803757,11001,5.859,9872,5.257,379808,79750,300058,2.844,13.546,291113,80281,210832,2.863,10.383,88695,3.163,20.766,2601,3069,22086
2016,523,54466,91935,901809,895933,11688,12.958,8218,9.111,114161,42765,71396,4.773,12.742,102246,33216,69030,3.707,11.412,11915,1.330,22.824,4451,4502,13964
2016,524,123388,170317,2493172,2452251,19394,11.567,14087,8.402,352807,138089,214718,5.631,14.387,269569,85917,183652,3.504,10.993,83238,3.394,21.985,7582,7733,27874
2016,525,1639,1753,25704,18084,638,44.076,27,1.865,16926,15469,1457,85.540,93.597,1380,87,1293,0.481,7.631,15546,85.965,15.262,6,6,16
2016,531,224173,283444,1553982,1530549,37520,13.488,26982,9.700,266036,125008,141028,8.168,17.382,220078,94332,125746,6.163,14.379,45958,3.003,28.758,17696,17941,57516
2016,532,19919,50121,512643,510319,4029,8.078,3538,7.094,70248,27715,42533,5.431,13.766,65974,18212,47762,3.569,12.928,4274,0.838,25.856,1785,1886,9123
2016,533,2007,2164,35500,34644,215,9.912,225,10.373,5684,1191,4493,3.438,16.407,4085,1233,2852,3.559,11.792,1599,4.616,23.583,183,183,1052
2016,541,680320,781080,8778979,8669284,92619,11.938,82130,10.586,1302287,438887,863400,5.063,15.022,1083758,376245,707513,4.340,12.501,218529,2.521,25.002,59086,59676,229383
2016,551,26691,53789,3352436,3340554,4807,9.048,3484,6.558,444589,116848,327741,3.498,13.309,422732,93200,329532,2.790,12.655,21857,0.654,25.309,704,737,13627
2016,561,270096,334261,10545804,10465194,43356,13.167,33370,10.135,1844245,532718,1311527,5.090,17.623,1679429,561202,1118227,5.363,16.048,164816,1.575,32.096,22599,22780,232501
2016,562,16662,23478,388082,385622,2209,9.551,1508,6.520,52263,16353,35910,4.241,13.553,47736,12260,35476,3.179,12.379,4527,1.174,24.758,1112,1148,8384
2016,611,81747,93595,3661847,3626332,9719,10.568,6455,7.019,299341,65730,233611,1.813,8.255,227326,40299,187027,1.111,6.269,72015,1.986,12.538,4759,4873,25748
2016,621,443307,573242,7272507,7135078,47212,8.299,38507,6.769,1036746,346942,689804,4.862,14.530,758092,250704,507388,3.514,10.625,278654,3.905,21.250,27822,28619,160248
2016,622,3075,6769,5713953,5659496,175,2.593,134,1.986,259643,23184,236459,0.410,4.588,151927,24855,127072,0.439,2.684,107716,1.903,5.369,61,61,8850
2016,623,36603,86535,3503739,3487647,6351,7.445,3903,4.575,350157,126018,224139,3.613,10.040,317288,100899,216389,2.893,9.097,32869,0.942,18.195,2211,2328,62069
2016,624,126036,169857,3127549,3084175,17918,10.710,12806,7.654,422207,118045,304162,3.827,13.689,336894,85845,251049,2.783,10.923,85313,2.766,21.847,9172,9397,60272
2016,711,35819,36891,500744,490272,5900,16.297,4523,12.494,78907,24460,54447,4.989,16.095,57567,16863,40704,3.440,11.742,21340,4.353,23.484,3183,3188,12055
2016,712,6697,7183,151363,148716,376,5.272,274,3.842,12902,1388,11514,0.933,8.676,7591,1069,6522,0.719,5.104,5311,3.571,10.209,198,198,825
2016,713,56707,66424,1658864,1628875,8149,12.470,5997,9.177,215769,74213,141556,4.556,13.247,154352,54675,99677,3.357,9.476,61417,3.771,18.952,4728,4786,41140
2016,721,48085,59990,2048583,2040652,5297,8.883,4576,7.674,217656,95051,122605,4.658,10.666,201227,86861,114366,4.257,9.861,16429,0.805,19.722,2972,3016,42270
2016,722,419179,585075,11642643,11407857,63335,10.991,45693,7.929,1838302,894400,943902,7.840,16.114,1372462,473376,899086,4.150,12.031,465840,4.084,24.062,34714,35761,340483
2016,811,180799,198916,1265120,1250101,17899,9.044,15868,8.018,186055,65714,120341,5.257,14.883,155482,56298,99184,4.503,12.438,30573,2.446,24.875,12218,12365,41391
2016,812,169566,207638,1442372,1421003,23821,11.605,19080,9.295,227158,95904,131254,6.749,15.986,184723,74481,110242,5.241,12.999,42435,2.986,25.999,14173,14463,53497
2016,813,285999,295541,2796670,2767290,15366,5.288,5443,1.873,266457,56490,209967,2.041,9.629,208960,26456,182504,0.956,7.551,57497,2.078,15.102,3981,3999,13347
2017,211,4666,5930,112184,115058,388,6.260,925,14.923,17201,6803,10398,5.913,14.950,23041,11732,11309,10.197,20.026,-5840,-5.076,29.900,548,566,2797
2017,212,3236,5828,176184,175885,357,6.072,460,7.824,26144,6695,19449,3.806,14.864,25980,8221,17759,4.674,14.771,164,0.093,29.542,233,237,1681
2017,213,9460,12052,293361,292360,1525,12.384,2049,16.640,59684,19547,40137,6.686,20.415,58258,24597,33661,8.413,19.927,1426,0.488,39.854,1249,1301,11595
2017,221,5594,17899,638659,638400,1103,6.193,926,5.199,49735,18406,31329,2.883,7.791,49327,9692,39635,1.518,7.727,408,0.064,15.453,242,246,1459
2017,236,175635,178576,1378065,1349359,28099,15.978,22675,12.893,266164,89569,176595,6.638,19.725,209173,74462,134711,5.518,15.502,56991,4.224,31.003,16846,16855,53679
2017,237,31417,34145,937099,933690,2652,7.734,2942,8.580,137861,22284,115577,2.387,14.765,130548,30327,100221,3.248,13.982,7313,0.783,27.964,2081,2096,14287
2017,238,389178,396845,4177726,4110814,45236,11.513,37372,9.512,704894,167301,537593,4.070,17.147,571152,155048,416104,3.772,13.894,133742,3.253,27.788,27747,27784,114247
2017,311,21455,25826,1539851,1521337,2202,8.583,1860,7.250,149628,29121,120507,1.914,9.835,113433,29953,83480,1.969,7.456,36195,2.379,14.912,1446,1466,16725
2017,312,7507,8229,221007,209535,1314,16.824,477,6.107,36895,10878,26017,5.192,17.608,13716,3636,10080,1.735,6.546,23179,11.062,13.092,352,352,2138
2017,313,1655,1879,96154,98157,121,6.370,162,8.529,7664,1897,5767,1.933,7.808,11809,3569,8240,3.636,12.031,-4145,-4.223,15.616,118,125,1895
2017,314,5259,5469,109282,109153,407,7.392,481,8.736,12154,3131,9023,2.868,11.135,12096,4062,8034,3.721,11.082,58,0.053,22.163,372,373,1490
2017,315,5008,5076,92818,95923,654,12.594,888,17.100,12629,5491,7138,5.724,13.166,18786,6533,12253,6.811,19.585,-6157,-6.419,26.332,788,790,5634
2017,316,1094,1129,27906,27412,100,8.834,106,9.364,3187,531,2656,1.937,11.626,2201,545,1656,1.988,8.029,986,3.597,16.059,89,89,308
2017,321,11484,13516,406856,398768,1089,8.102,939,6.986,51013,13070,37943,3.278,12.793,34461,11783,22678,2.955,8.642,16552,4.151,17.284,720,726,7462
2017,322,2416,3944,344295,346516,128,3.216,199,5.001,23717,4867,18850,1.405,6.844,28331,6947,21384,2.005,8.176,-4614,-1.332,13.689,124,127,1895
2017,323,22533,23998,444067,448118,1402,5.792,1821,7.522,40173,12359,27814,2.758,8.965,48477,14749,33728,3.291,10.818,-8304,-1.853,17.930,1483,1493,9157
2017,324,921,2096,104528,104144,97,4.604,119,5.648,6937,824,6113,0.791,6.661,6249,1822,4427,1.750,6.000,688,0.661,12.001,38,38,556
2017,325,9235,12928,783911,776484,841,6.498,868,6.707,81092,14482,66610,1.865,10.443,65642,21500,44142,2.769,8.454,15450,1.990,16.907,535,549,8199
2017,326,8895,11767,767346,761530,420,3.544,585,4.937,68010,9749,58261,1.280,8.931,56203,15529,40674,2.039,7.380,11807,1.550,14.761,396,405,6881
2017,327,8767,14491,393978,390244,765,5.275,787,5.427,44300,9028,35272,2.313,11.352,36704,10574,26130,2.710,9.405,7596,1.946,18.811,458,463,5024
2017,331,3176,4105,368576,371183,189,4.586,222,5.386,28512,6829,21683,1.840,7.681,34198,9055,25143,2.440,9.213,-5686,-1.532,15.363,151,157,5265
2017,332,47974,52110,1398384,1401109,2572,4.903,3278,6.248,135567,30881,104686,2.204,9.676,140983,44053,96930,3.144,10.062,-5416,-0.387,19.351,2489,2515,27274
2017,333,19902,22396,1032473,1032925,1024,4.534,1398,6.190,91552,17198,74354,1.665,8.863,92795,26349,66446,2.551,8.984,-1243,-0.120,17.727,985,990,11778
2017,334,10058,11534,785941,790574,619,5.308,875,7.503,59464,8821,50643,1.116,7.522,68740,19935,48805,2.522,8.695,-9276,-1.173,15.043,643,646,7745
2017,335,4562,5273,338967,339361,308,5.812,361,6.812,26582,4970,21612,1.465,7.833,27291,7554,19737,2.226,8.042,-709,-0.209,15.666,249,249,3419
2017,336,8707,10785,1497989,1483067,625,5.755,774,7.127,129561,16649,112912,1.123,8.736,99872,25479,74393,1.718,6.734,29689,2.002,13.468,532,541,9025
2017,337,13586,14159,375149,372880,910,6.385,1095,7.683,38743,6825,31918,1.830,10.390,34068,12417,21651,3.330,9.136,4675,1.254,18.273,845,851,7611
2017,339,22658,24085,539096,534581,1856,7.679,2025,8.378,59259,13104,46155,2.451,11.085,50138,17358,32780,3.247,9.379,9121,1.706,18.758,1613,1616,10870
2017,423,148950,222994,3463679,3458756,14285,6.365,17136,7.636,413159,101249,311910,2.927,11.945,402391,133467,268924,3.859,11.634,10768,0.311,23.268,10539,10987,65037
2017,424,86945,119666,2334859,2329723,8577,7.125,10011,8.316,273105,71453,201652,3.067,11.723,263021,94013,169008,4.035,11.290,10084,0.433,22.580,6744,6902,42051
2017,425,36552,38973,315935,309854,4502,11.572,4364,11.217,60156,14320,45836,4.622,19.414,47396,19408,27988,6.264,15.296,12760,4.118,30.592,3428,3458,10932
2017,441,74694,113124,2019406,1996464,7369,6.524,7016,6.212,218594,66511,152083,3.331,10.949,172780,56438,116342,2.827,8.654,45814,2.295,17.309,5010,5128,35442
2017,442,29991,47862,463610,461513,3227,6.721,3537,7.366,56342,16170,40172,3.504,12.208,52301,15772,36529,3.417,11.333,4041,0.876,22.665,2343,2440,8921
2017,443,18165,29885,329218,344802,1670,5.052,8015,24.246,33289,7287,26002,2.113,9.655,65430,40109,25321,11.632,18.976,-32141,-9.322,19.309,2551,2894,13095
2017,444,45452,72033,1316509,1320902,3332,4.610,3835,5.305,100043,21771,78272,1.648,7.574,106449,20879,85570,1.581,8.059,-6406,-0.485,15.148,2552,2671,13400
2017,445,104871,139919,3146989,3152434,12172,8.725,11348,8.134,295003,110402,184601,3.502,9.358,307995,93969,214026,2.981,9.770,-12992,-0.412,18.716,8290,8420,38169
2017,446,39768,93908,1037154,1043555,5478,5.857,4721,5.048,172322,37948,134374,3.636,16.513,185187,25668,159519,2.460,17.746,-12865,-1.233,33.026,3323,3442,17322
2017,447,61733,107667,951882,949895,7192,6.692,6799,6.326,133917,46607,87310,4.907,14.098,129751,35573,94178,3.745,13.660,4166,0.439,27.319,4160,4616,21502
2017,448,51085,136175,1754804,1743045,9508,6.945,10977,8.018,228953,83599,145354,4.796,13.135,208236,61497,146739,3.528,11.947,20717,1.189,23.893,5137,5852,23760
2017,451,27717,42279,539861,554899,3432,8.034,4311,10.092,67711,21441,46270,3.864,12.202,94374,40149,54225,7.235,17.007,-26663,-4.805,24.405,2478,2908,14895
2017,452,7264,51993,2713661,2731064,2563,4.911,2947,5.647,160067,35948,124119,1.316,5.861,191638,85763,105875,3.140,7.017,-31571,-1.156,11.722,808,816,2478
2017,453,73249,100787,766765,773362,9464,9.360,10107,9.996,110751,40320,70431,5.214,14.321,124324,38831,85493,5.021,16.076,-13573,-1.755,28.641,7219,7443,25294
2017,454,52832,59841,672345,662555,8408,14.207,7090,11.980,119823,37766,82057,5.700,18.085,98929,46401,52528,7.003,14.931,20894,3.154,29.863,5551,5596,23376
2017,481,2259,4317,471543,468903,399,9.300,346,8.064,39118,6578,32540,1.403,8.342,34042,4547,29495,0.970,7.260,5076,1.083,14.520,204,220,1118
2017,483,1121,1587,64005,65007,197,12.548,163,10.382,6056,1470,4586,2.261,9.316,7961,1455,6506,2.238,12.246,-1905,-2.930,18.632,107,121,502
2017,484,93707,108234,1470609,1462684,15130,14.034,14283,13.248,195849,58877,136972,4.025,13.390,181312,64503,116809,4.410,12.396,14537,0.994,24.792,10823,10946,42450
2017,485,14991,18188,514643,514129,2278,12.536,2245,12.355,51590,16883,34707,3.284,10.034,51019,22003,29016,4.280,9.923,571,0.111,19.847,1827,1841,12587
2017,486,220,3672,52177,53035,248,6.782,217,5.935,5722,2233,3489,4.210,10.789,7390,2047,5343,3.860,13.934,-1668,-3.145,21.578,22,22,123
2017,487,1999,2116,28783,28890,286,13.645,246,11.737,4116,1291,2825,4.469,14.247,4453,1783,2670,6.172,15.414,-337,-1.167,28.495,178,180,713
2017,488,30167,41019,703042,694946,4069,9.966,3691,9.040,108570,29590,78980,4.258,15.623,92384,32262,60122,4.642,13.294,16186,2.329,26.587,2426,2488,12207
2017,492,7007,13071,634351,623437,1032,7.732,1584,11.868,56854,12378,44476,1.985,9.119,34243,12714,21529,2.039,5.493,22611,3.627,10.985,996,1003,5376
2017,493,7221,15450,946853,888985,1378,8.984,1156,7.536,206160,75438,130722,8.486,23.191,84369,24470,59899,2.753,9.490,121791,13.700,18.981,395,410,4009
2017,511,17916,25656,888927,886288,2680,10.443,2693,10.494,112004,36581,75423,4.127,12.637,106388,36987,69401,4.173,12.004,5616,0.634,24.008,1611,1667,15282
2017,512,16798,20255,326167,367064,2468,12.179,2487,12.273,46114,18036,28078,4.914,12.563,127126,14593,112533,3.976,34.633,-81012,-22.070,25.126,1799,1815,8550
2017,515,4281,8037,257820,260292,372,4.609,441,5.464,18866,4910,13956,1.886,7.248,23609,5851,17758,2.248,9.070,-4743,-1.822,14.496,262,270,2822
2017,517,9763,57886,1071628,1080069,6838,11.637,8591,14.620,162247,45378,116869,4.201,15.022,181687,60829,120858,5.632,16.822,-19440,-1.800,30.044,1117,1193,6886
2017,518,8668,14591,494253,486135,3218,23.312,1644,11.910,101037,48914,52123,10.062,20.784,84702,33216,51486,6.833,17.424,16335,3.360,34.847,849,897,13743
2017,519,8665,10892,303520,296277,1410,12.946,1409,12.937,52211,10763,41448,3.633,17.622,37793,12799,24994,4.320,12.756,14418,4.866,25.512,1037,1066,6844
2017,521,16,62,19758,19564,(D),(D),(D),(D),695,(D),678,(D),3.553,309,(D),308,(D),1.579,386,1.973,3.159,(D),(D),(D)
2017,522,35067,186611,2839463,2846269,10196,5.438,11989,6.394,352924,90649,262275,3.185,12.400,365705,103904,261801,3.651,12.849,-12781,-0.449,24.799,2455,2889,18586
2017,523,54919,92510,901100,901134,9066,9.827,8562,9.280,105324,36837,68487,4.088,11.688,106111,33783,72328,3.749,11.775,-787,-0.087,23.376,4618,4681,16565
2017,524,123244,165376,2500479,2502760,14086,8.394,18954,11.295,373483,150292,223191,6.005,14.923,380651,164079,216572,6.556,15.209,-7168,-0.286,29.846,8169,8318,31380
2017,525,1857,1899,34498,22211,724,46.785,21,1.357,27095,25555,1540,115.058,121.992,1853,54,1799,0.243,8.343,25242,113.649,16.686,8,8,33
2017,531,230615,294624,1609236,1583334,38868,13.449,27616,9.556,276661,119096,157565,7.522,17.473,222542,92836,129706,5.863,14.055,54119,3.418,28.111,19277,19676,59687
2017,532,19678,50343,501856,506584,5076,10.109,4811,9.582,71090,21179,49911,4.181,14.033,79222,25614,53608,5.056,15.638,-8132,-1.605,28.066,1802,1904,10461
2017,533,2017,2163,36968,36390,242,11.173,248,11.450,6099,1219,4880,3.350,16.760,5064,1894,3170,5.205,13.916,1035,2.844,27.832,165,166,870
2017,541,683480,783953,8934704,8830392,86833,11.102,83244,10.643,1306274,374434,931840,4.240,14.793,1095635,440981,654654,4.994,12.408,210639,2.385,24.815,61053,61699,258198
2017,551,26324,54773,3472342,3402700,5125,9.421,4373,8.039,545239,135994,409245,3.997,16.024,408092,117364,290728,3.449,11.993,137147,4.031,23.986,801,832,15339
2017,561,271876,333209,10694576,10606057,38337,11.485,39533,11.843,1889829,504009,1385820,4.752,17.818,1712623,557267,1155356,5.254,16.148,177206,1.671,32.295,24996,25346,262053
2017,562,16807,23721,406507,398902,1676,7.084,1550,6.552,54288,13286,41002,3.331,13.609,38851,14628,24223,3.667,9.739,15437,3.870,19.479,1143,1172,8558
2017,611,83237,94774,3705599,3671445,9635,10.309,7011,7.501,303817,62559,241258,1.704,8.275,234112,37857,196255,1.031,6.377,69705,1.899,12.753,5148,5406,27381
2017,621,442630,577376,7517669,7391765,47680,8.288,43465,7.556,1137587,328681,808906,4.447,15.390,887587,326715,560872,4.420,12.008,250000,3.382,24.016,28554,29541,174214
2017,622,2950,6713,5884074,5790700,219,3.273,177,2.645,377516,36809,340707,0.636,6.519,190457,34959,155498,0.604,3.289,187059,3.230,6.578,66,66,15798
2017,623,36985,86428,3494687,3507824,5889,6.812,5936,6.866,374034,126989,247045,3.620,10.663,402102,160247,241855,4.568,11.463,-28068,-0.800,21.326,2465,2710,74797
2017,624,128216,171866,3209663,3178942,17143,10.045,14728,8.630,477018,117647,359371,3.701,15.006,416720,107830,308890,3.392,13.109,60298,1.897,26.218,10110,10342,64097
2017,711,37073,38132,511791,506719,6022,16.050,4798,12.788,85655,24139,61516,4.764,16.904,75018,25900,49118,5.111,14.805,10637,2.099,29.609,3494,3496,13244
2017,712,6730,7235,155126,153243,338,4.687,292,4.049,13225,1917,11308,1.251,8.630,9496,1764,7732,1.151,6.197,3729,2.433,12.393,213,213,1433
2017,713,58044,68669,1710472,1684547,8696,12.876,6430,9.521,231902,85384,146518,5.069,13.766,180075,59585,120490,3.537,10.690,51827,3.077,21.380,4981,5022,42252
2017,721,48762,60780,2072348,2060084,5390,8.930,4549,7.537,229197,91948,137249,4.463,11.126,205930,77715,128215,3.772,9.996,23267,1.129,19.992,3139,3216,44561
2017,722,426910,596602,11927200,11782314,63375,10.724,52081,8.813,1965416,899850,1065566,7.637,16.681,1685139,620819,1064320,5.269,14.302,280277,2.379,28.605,36144,37601,383310
2017,811,180935,199950,1291824,1278523,17771,8.908,16869,8.456,204737,76639,128098,5.994,16.014,177198,64837,112361,5.071,13.860,27539,2.154,27.719,12984,13232,46062
2017,812,173670,211360,1467112,1455188,24045,11.479,20258,9.671,243688,98756,144932,6.786,16.746,218481,84541,133940,5.810,15.014,25207,1.732,30.028,14960,15308,58736
2017,813,286287,295794,2811011,2791520,14376,4.932,5793,1.987,256474,44716,211758,1.602,9.188,218085,24425,193660,0.875,7.812,38389,1.375,15.625,4234,4282,16922
2018,211,4516,5791,109676,111245,377,6.416,547,9.309,10775,3213,7562,2.888,9.686,14095,4073,10022,3.661,12.670,-3320,-2.984,19.372,412,426,1604
2018,212,3212,5779,175567,176126,305,5.252,362,6.233,18674,3547,15127,2.014,10.603,19522,4633,14889,2.631,11.084,-848,-0.481,21.205,231,241,2198
2018,213,9606,12148,328430,311276,1484,12.260,1396,11.533,78255,14999,63256,4.819,25.140,43485,20376,23109,6.546,13.970,34770,11.170,27.940,977,1016,7396
2018,221,5600,18315,640096,639702,1928,10.647,1516,8.372,75758,40138,35620,6.274,11.843,74703,37067,37636,5.794,11.678,1055,0.165,23.356,249,259,1204
2018,236,182156,185111,1448667,1413033,29506,16.224,23022,12.659,283139,94861,188278,6.713,20.038,211381,70440,140941,4.985,14.959,71758,5.078,29.919,18999,19025,57821
2018,237,31325,34102,981881,960631,2549,7.467,2619,7.672,157373,30728,126645,3.199,16.382,114992,20778,94214,2.163,11.970,42381,4.412,23.941,2121,2137,13763
2018,238,396721,404482,4356545,4268906,45707,11.407,38148,9.520,729898,181593,548305,4.254,17.098,554906,152482,402424,3.572,12.999,174992,4.099,25.998,31226,31277,122970
2018,311,21480,25893,1563674,1548968,2019,7.820,1868,7.235,139191,27220,111971,1.757,8.986,109315,26928,82387,1.738,7.057,29876,1.929,14.115,1580,1595,14650
2018,312,8289,9036,241087,231428,1281,14.838,475,5.502,36174,11601,24573,5.013,15.631,16683,4017,12666,1.736,7.209,19491,8.422,14.417,405,409,3160
2018,313,1634,1852,94793,95252,121,6.481,151,8.088,7526,1328,6198,1.394,7.901,8556,1977,6579,2.076,8.983,-1030,-1.081,15.802,130,130,1331
2018,314,5206,5419,109149,109738,404,7.435,434,7.987,10674,2692,7982,2.453,9.727,12043,2699,9344,2.459,10.974,-1369,-1.248,19.454,372,372,1881
2018,315,4825,4892,84758,88742,651,13.071,828,16.625,11139,4653,6486,5.243,12.552,19357,8191,11166,9.230,21.813,-8218,-9.261,25.104,746,746,6784
2018,316,1065,1098,26354,27019,88,7.924,113,10.176,2212,720,1492,2.665,8.187,3560,616,2944,2.280,13.176,-1348,-4.989,16.374,103,103,447
2018,321,11522,13574,413742,410364,950,7.008,915,6.750,43464,10714,32750,2.611,10.592,36921,11677,25244,2.846,8.997,6543,1.594,17.994,740,743,7378
2018,322,2351,3891,341780,341848,117,2.980,187,4.763,22202,3600,18602,1.053,6.495,22133,5423,16710,1.586,6.475,69,0.020,12.949,142,142,3408
2018,323,21927,23308,429767,436728,1241,5.249,1909,8.075,36475,8317,28158,1.904,8.352,50041,18281,31760,4.186,11.458,-13566,-3.106,16.704,1586,1595,10138
2018,324,897,2066,106603,105920,56,2.685,95,4.555,7127,1004,6123,0.948,6.729,5697,927,4770,0.875,5.379,1430,1.350,10.757,59,59,438
2018,325,9222,12910,795388,790009,772,5.979,775,6.002,78614,15201,63413,1.924,9.951,67694,22583,45111,2.859,8.569,10920,1.382,17.138,554,591,11882
2018,326,8728,11646,783668,775180,431,3.684,537,4.590,70682,12817,57865,1.653,9.118,54055,10882,43173,1.404,6.973,16627,2.145,13.946,421,424,6066
2018,327,8648,14421,400266,397197,737,5.100,799,5.529,41688,10267,31421,2.585,10.496,35348,7756,27592,1.953,8.899,6340,1.596,17.799,505,517,4271
2018,331,3114,4041,373318,370434,181,4.458,219,5.394,29729,5214,24515,1.408,8.025,23581,3797,19784,1.025,6.366,6148,1.660,12.732,173,177,2424
2018,332,48030,52208,1431859,1414934,2648,5.055,3003,5.733,151019,32035,118984,2.264,10.673,117502,32823,84679,2.320,8.304,33517,2.369,16.609,2542,2561,22565
2018,333,19509,22166,1059248,1047886,1155,5.206,1192,5.373,97285,18516,78769,1.767,9.284,74602,17017,57585,1.624,7.119,22683,2.165,14.239,959,969,10066
2018,334,9796,11392,772957,777459,749,6.547,845,7.386,60673,12668,48005,1.629,7.804,69428,14764,54664,1.899,8.930,-8755,-1.126,15.608,685,689,6235
2018,335,4509,5297,347335,344227,349,6.617,303,5.745,29787,7257,22530,2.108,8.653,23589,5776,17813,1.678,6.853,6198,1.801,13.706,245,245,2378
2018,336,8666,10989,1543514,1521285,881,8.091,680,6.245,133843,30733,103110,2.020,8.798,91821,18058,73763,1.187,6.036,42022,2.762,12.072,556,558,6656
2018,337,13364,13931,378888,377160,797,5.675,1022,7.277,34751,7271,27480,1.928,9.214,31328,7936,23392,2.104,8.306,3423,0.908,16.613,874,879,5788
2018,339,22058,23936,561264,550167,2134,8.946,1971,8.263,69074,28469,40605,5.175,12.555,48032,14465,33567,2.629,8.730,21042,3.825,17.461,1734,1738,10033
2018,423,146369,218911,3498148,3476802,13100,5.932,16984,7.690,391639,84575,307064,2.433,11.264,348688,112202,236486,3.227,10.029,42951,1.235,20.058,10624,11266,65325
2018,424,85498,117658,2356402,2348024,7378,6.219,9351,7.882,254313,60554,193759,2.579,10.831,237313,81013,156300,3.450,10.107,17000,0.724,20.214,6953,7160,43550
2018,425,36008,38398,312123,314236,3902,10.093,4424,11.444,33269,12642,20627,4.023,10.587,37250,14466,22784,4.604,11.854,-3981,-1.267,21.175,3792,3815,11930
2018,441,74020,112597,2015114,2019042,6348,5.624,6881,6.097,186115,56712,129403,2.809,9.218,192821,51987,140834,2.575,9.550,-6706,-0.332,18.436,5524,5776,41032
2018,442,29427,47272,474189,468720,2766,5.816,3340,7.023,70761,20122,50639,4.293,15.097,61559,14652,46907,3.126,13.133,9202,1.963,26.267,2435,2564,9661
2018,443,16980,27809,321652,325514,1364,4.731,3408,11.821,36183,5542,30641,1.703,11.116,44243,20396,23847,6.266,13.592,-8060,-2.476,22.231,2099,2624,13475
2018,444,44506,71372,1374303,1345022,3032,4.231,3609,5.036,130862,19414,111448,1.443,9.729,73125,18497,54628,1.375,5.437,57737,4.293,10.873,2676,2835,14127
2018,445,105813,140638,3105920,3126220,12085,8.613,11434,8.149,257879,106544,151335,3.408,8.249,302051,85438,216613,2.733,9.662,-44172,-1.413,16.498,8728,9038,47880
2018,446,39760,90738,1065367,1051318,5034,5.453,8198,8.880,216450,33947,182503,3.229,20.588,188381,113214,75167,10.769,17.919,28069,2.670,35.837,3268,3592,17219
2018,447,60945,107545,978452,964729,6572,6.112,6545,6.087,143660,45732,97928,4.740,14.891,113487,34662,78825,3.593,11.764,30173,3.128,23.527,4326,4683,22396
2018,448,50070,132689,1711150,1731890,7878,5.858,11481,8.537,209551,63149,146402,3.646,12.100,251331,67778,183553,3.914,14.512,-41780,-2.412,24.199,5403,6171,25691
2018,451,27090,41215,520196,529802,2706,6.484,3745,8.973,46550,14923,31627,2.817,8.786,65904,15852,50052,2.992,12.439,-19354,-3.653,17.573,2634,3052,10542
2018,452,7130,52536,2678087,2695793,2131,4.077,1598,3.057,101590,17138,84452,0.636,3.768,135953,39199,96754,1.454,5.043,-34363,-1.275,7.537,859,930,4359
2018,453,72484,99602,770450,768609,8199,8.186,9322,9.307,109127,36045,73082,4.690,14.198,106222,36052,70170,4.691,13.820,2905,0.378,27.640,7311,7675,26971
2018,454,53894,60758,763965,753342,8417,13.959,7497,12.433,110209,46073,64136,6.116,14.629,89437,32475,56962,4.311,11.872,20772,2.757,23.744,6226,6304,23782
2018,481,2219,4249,481791,476892,291,6.797,355,8.292,31126,2628,28498,0.551,6.527,21886,3601,18285,0.755,4.589,9240,1.938,9.179,215,224,1654
2018,483,1120,1567,65421,64701,144,9.152,157,9.978,7420,1257,6163,1.943,11.468,5875,2071,3804,3.201,9.080,1545,2.388,18.160,98,99,734
2018,484,97826,112718,1516684,1493399,17470,15.813,12993,11.761,218846,74418,144428,4.983,14.654,170657,51990,118667,3.481,11.427,48189,3.227,22.855,10736,10808,38531
2018,485,14950,18131,515751,514812,2285,12.587,2330,12.835,61995,19012,42983,3.693,12.042,60557,24113,36444,4.684,11.763,1438,0.279,23.526,1884,1922,14935
2018,486,227,3438,49221,49810,134,3.792,326,9.225,4930,1190,3740,2.389,9.898,6154,2821,3333,5.664,12.355,-1224,-2.457,19.795,22,22,277
2018,487,2043,2160,28886,28844,290,13.561,247,11.550,4063,1097,2966,3.803,14.086,3995,1574,2421,5.457,13.851,68,0.236,27.701,210,212,1395
2018,488,30211,40828,725454,713886,3516,8.594,3683,9.002,105443,24512,80931,3.434,14.770,81856,29062,52794,4.071,11.466,23587,3.304,22.933,2499,2557,12790
2018,492,6876,13108,674507,654499,1187,9.065,1159,8.851,87212,15194,72018,2.321,13.325,46849,12056,34793,1.842,7.158,40363,6.167,14.316,915,946,7258
2018,493,7322,15537,921880,895145,1204,7.796,1017,6.585,122203,41080,81123,4.589,13.652,68752,18017,50735,2.013,7.681,53451,5.971,15.361,409,437,5692
2018,511,18339,25608,884911,882240,2728,10.637,2805,10.937,116782,40534,76248,4.594,13.237,111538,35469,76069,4.020,12.643,5244,0.594,25.285,1740,1842,12917
2018,512,16805,20241,334351,334557,2494,12.316,2513,12.410,41414,15814,25600,4.727,12.379,41271,13181,28090,3.940,12.336,143,0.043,24.672,1994,2008,8911
2018,515,4128,7793,250478,254436,257,3.248,496,6.269,15054,3447,11607,1.355,5.917,23419,5227,18192,2.054,9.204,-8365,-3.288,11.833,297,313,1708
2018,517,10423,59742,1127048,1116624,6127,10.414,4315,7.334,160585,65141,95444,5.834,14.381,140212,41129,99083,3.683,12.557,20373,1.825,25.114,1196,1416,9546
2018,518,8629,15116,527444,515990,2037,13.693,1558,10.473,90100,24559,65541,4.760,17.462,66974,28289,38685,5.482,12.980,23126,4.482,25.959,912,945,10433
2018,519,8770,10879,319913,311965,1428,13.141,1403,12.911,54993,19485,35508,6.246,17.628,38496,13318,25178,4.269,12.340,16497,5.288,24.680,966,1072,9302
2018,521,15,61,19797,19776,0,0.000,0,0.000,347,0,347,0.000,1.755,308,0,308,0.000,1.557,39,0.197,3.115,0,0,0
2018,522,34436,184576,2841584,2843663,8980,4.839,10990,5.922,305483,76086,229397,2.676,10.743,313172,78771,234401,2.770,11.013,-7689,-0.270,21.485,2681,3758,27725
2018,523,55711,93792,928140,914395,10131,10.877,8832,9.482,141553,57612,83941,6.301,15.481,113978,33727,80251,3.688,12.465,27575,3.016,24.930,4833,4905,17251
2018,524,122986,167263,2594488,2553025,17188,10.334,15300,9.199,418918,204330,214588,8.003,16.409,332896,99858,233038,3.911,13.039,86022,3.369,26.079,9045,9203,33284
2018,525,1883,1923,76180,42368,775,50.276,12,0.778,69004,67020,1984,158.185,162.868,830,21,809,0.050,1.959,68174,160.909,3.918,(D),(D),(D)
2018,531,238176,303021,1660447,1634943,37779,12.642,29429,9.848,284678,122521,162157,7.494,17.412,234005,99926,134079,6.112,14.313,50673,3.099,28.625,21087,21655,62622
2018,532,19486,49619,515012,507162,3419,6.850,4010,8.034,74130,16306,57824,3.215,14.617,59216,20164,39052,3.976,11.676,14914,2.941,23.352,1913,2024,10660
2018,533,2060,2195,37721,37272,281,12.911,244,11.211,4822,1656,3166,4.443,12.937,3879,1078,2801,2.892,10.407,943,2.530,20.815,196,197,817
2018,541,686978,786231,9216089,9104331,85594,10.903,83182,10.596,1307414,381812,925602,4.194,14.360,1083903,417572,666331,4.587,11.905,223511,2.455,23.811,65955,67271,260190
2018,551,25928,53898,3582558,3527902,2484,4.574,3293,6.064,514190,128611,385579,3.646,14.575,402532,105521,297011,2.991,11.410,111658,3.165,22.820,899,932,15850
2018,561,275317,333681,10900390,10756850,37703,11.307,37219,11.162,1737713,444596,1293117,4.133,16.154,1442718,417249,1025469,3.879,13.412,294995,2.742,26.824,26754,27074,220970
2018,562,17025,23937,424922,416285,1743,7.310,1556,6.526,55953,17476,38477,4.198,13.441,38357,12984,25373,3.119,9.214,17596,4.227,18.428,1188,1218,8322
2018,611,84730,96129,3734942,3704990,9127,9.618,6660,7.018,284844,58777,226067,1.586,7.688,224020,32707,191313,0.883,6.046,60824,1.642,12.093,5484,5565,26992
2018,621,442962,580879,7715484,7617419,45852,7.916,42517,7.340,1091318,333115,758203,4.373,14.327,893766,291808,601958,3.831,11.733,197552,2.593,23.466,30305,31426,173711
2018,622,3042,6826,6009695,5991780,340,5.057,136,2.023,244427,62769,181658,1.048,4.079,209792,21421,188371,0.358,3.501,34635,0.578,7.003,41,41,7674
2018,623,37417,87136,3515683,3507756,5199,5.986,4631,5.332,372720,136128,236592,3.881,10.626,357163,118896,238267,3.390,10.182,15557,0.444,20.364,2563,2799,58754
2018,624,121391,164852,3259583,3217194,14249,8.711,11711,7.159,444223,114972,329251,3.574,13.808,355977,100364,255613,3.120,11.065,88246,2.743,22.130,8694,8984,63825
2018,711,38146,39188,529081,519163,5968,15.435,4921,12.727,82796,22661,60135,4.365,15.948,62492,20079,42413,3.868,12.037,20304,3.911,24.074,3966,3974,14698
2018,712,6780,7286,157815,156520,293,4.034,247,3.401,12410,1117,11293,0.714,7.929,9664,1199,8465,0.766,6.174,2746,1.754,12.349,200,202,1006
2018,713,59537,70179,1745787,1728274,8065,11.621,6504,9.372,220771,87024,133747,5.035,12.774,185154,55053,130101,3.185,10.713,35617,2.061,21.426,5228,5357,43783
2018,721,49244,61525,2077085,2072438,5274,8.627,4498,7.357,239696,106710,132986,5.149,11.566,230700,80591,150109,3.889,11.132,8996,0.434,22.264,3354,3482,48821
2018,722,433928,603716,12216265,12071735,57669,9.609,50586,8.429,1822260,757377,1064883,6.274,15.095,1533341,565699,967642,4.686,12.702,288919,2.393,25.404,38786,41079,422899
2018,811,180562,199504,1320315,1305066,16339,8.183,16671,8.349,198895,65563,133332,5.024,15.240,168701,60372,108329,4.626,12.927,30194,2.314,25.853,13853,14176,47376
2018,812,177811,214066,1498574,1481242,23846,11.212,21063,9.904,246941,102111,144830,6.894,16.671,211470,83572,127898,5.642,14.277,35471,2.395,28.553,16040,16554,64458
2018,813,286196,296064,2830685,2808258,14381,4.930,5638,1.933,258498,49308,209190,1.756,9.205,213725,24307,189418,0.866,7.611,44773,1.594,15.221,4597,4667,18345
