year,sector,firms,estabs,emp,denom,estabs_entry,estabs_entry_rate,estabs_exit,estabs_exit_rate,job_creation,job_creation_births,job_creation_continuers,job_creation_rate_births,job_creation_rate,job_destruction,job_destruction_deaths,job_destruction_continuers,job_destruction_rate_deaths,job_destruction_rate,net_job_creation,net_job_creation_rate,reallocation_rate,firmdeath_firms,firmdeath_estabs,firmdeath_emp
1978,21,19249,24814,707332,706704,4242,17.423,3307,13.583,173829,67336,106493,9.528,24.597,172799,63019,109780,8.917,24.451,1030,0.146,48.903,1761,1789,16595
1979,21,19821,25459,810623,760019,4175,16.67,3346,13.36,219540,57061,162479,7.507999999999999,28.886,118391,55741,62650,7.334,15.577,101149,13.309,31.155,1854,1871,19096
1980,21,20770,26571,854871,834199,4378,16.81,3323,12.759,181879,67080,114799,8.041,21.803,140241,46243,93998,5.542999999999998,16.811,41638,4.9910000000000005,33.623000000000005,2113,2177,23721
1981,21,23878,30025,963730,910181,6185,21.75,3008,10.578,239754,84738,155016,9.31,26.341,131897,48755,83142,5.357,14.491,107857,11.85,28.983,1778,1796,22196
1982,21,26296,32834,1022235,992050,6743,21.427,4013,12.752,266174,100942,165232,10.175,26.831,206451,76173,130278,7.678,20.811,59723,6.02,41.621,2608,2635,32117
1983,21,25522,31811,796554,909716,4433,13.689,5577,17.222,126248,56521,69727,6.212999999999999,13.878,353155,91443,261712,10.052,38.82,-226907,-24.943,27.755,3799,3824,40602
1984,21,25394,31873,812172,801222,4596,14.425999999999998,4567,14.335,182434,52201,130233,6.515,22.769,162433,55277,107156,6.899,20.273,20001,2.496,40.546,3235,3264,27166
1985,21,25332,31706,772994,781205,4373,13.741,4611,14.489,145170,47657,97513,6.1,18.583,161952,63638,98314,8.146,20.731,-16782,-2.148,37.166,3246,3274,30477
1986,21,24312,30358,695114,734841,3583,11.542,4951,15.949000000000002,117303,43828,73475,5.964,15.963,196984,59796,137188,8.137,26.806,-79681,-10.843,31.926,3422,3457,27140
1987,21,21680,27320,583185,638397,3344,11.622,6252,21.728,101389,43519,57870,6.817,15.882,211932,81549,130383,12.774,33.198,-110543,-17.316,31.764,4041,4080,33080
1988,21,21297,26575,581396,583455,3486,12.939,4219,15.66,123708,40550,83158,6.95,21.203000000000007,128337,52767,75570,9.044,21.996,-4629,-0.7929999999999999,42.405,2672,2701,19148
1989,21,20628,25846,566823,574765,3032,11.562,3787,14.441,107619,42619,65000,7.415,18.724,123667,51977,71690,9.043,21.516,-16048,-2.792,37.448,2550,2587,22437
1990,21,20441,25553,577225,571195,3059,11.896,3380,13.145,108317,34794,73523,6.091,18.963,96098,39191,56907,6.8610000000000015,16.824,12219,2.139,33.648,2226,2261,17227
1991,21,21117,26185,575048,578561,3086,11.746,3262,12.416,101474,38674,62800,6.685,17.539,108271,42223,66048,7.297999999999999,18.714,-6797,-1.175,35.078,2181,2212,19788
1992,21,19884,24741,524370,547362,2644,10.453,3751,14.829,89124,32752,56372,5.984,16.282,134647,46682,87965,8.529,24.599,-45523,-8.317,32.565,2336,2362,18476
1993,21,19316,24016,485716,502943,2632,10.824000000000002,3232,13.292,84798,31627,53171,6.2879999999999985,16.86,119540,38594,80946,7.673999999999999,23.768,-34742,-6.908,33.721,2072,2092,15178
1994,21,18988,23808,493424,491673,2535,10.569,2888,12.041,89283,30567,58716,6.2170000000000005,18.159,85814,31842,53972,6.476,17.453,3469,0.706,34.907,1917,1937,13993
1995,21,18622,23333,489194,491275,2310,9.802,2775,11.776,83278,24905,58373,5.069,16.951,87574,31206,56368,6.352,17.826,-4296,-0.8740000000000001,33.903,1836,1855,13439
1996,21,17939,22681,471095,476936,2206,9.621,2701,11.78,75333,19427,55906,4.073,15.795,86983,34672,52311,7.27,18.238,-11650,-2.443,31.59,1825,1857,17333
1997,21,17637,22303,481267,476079,2442,10.902,2635,11.764,101288,35963,65325,7.5539999999999985,21.275,90026,39276,50750,8.25,18.91,11262,2.366,37.82,1617,1641,14101
1998,21,17472,22144,488983,486644,2224,9.988,2468,11.084,92918,27240,65678,5.598,19.094,88102,32761,55341,6.732,18.104,4816,0.99,36.208,1506,1561,15020
1999,21,16553,21330,445459,467307,1910,8.788,2717,12.501,58532,19371,39161,4.145,12.525,101838,31245,70593,6.686,21.793000000000006,-43306,-9.267,25.051,1712,1759,16240
2000,21,16360,21351,453576,452518,2196,10.28,2218,10.383,85143,30562,54581,6.754,18.815,83946,25670,58276,5.672999999999999,18.551,1197,0.265,37.102,1380,1409,9454
2001,21,16772,21928,484091,469794,2375,10.928,1985,9.134,90249,25462,64787,5.42,19.21,61871,21323,40548,4.539,13.17,28378,6.041,26.34,1237,1269,9175
2002,21,16806,22353,479930,488930,2639,11.859000000000002,2440,10.965,83996,35129,48867,7.185,17.18,103286,36925,66361,7.552,21.125,-19290,-3.945,34.359,1285,1303,12438
2003,21,16274,21471,455506,462720,1907,8.791,2348,10.825,71630,19578,52052,4.231,15.48,85397,27981,57416,6.0470000000000015,18.455,-13767,-2.975,30.96,1246,1281,10414
2004,21,16555,21671,466067,459674,2126,9.85,1953,9.048,73966,23237,50729,5.055,16.090999999999998,60909,22523,38386,4.9,13.25,13057,2.84,26.501,1093,1124,9562
2005,21,16870,21994,490580,477728,2253,10.344,1825,8.379,86786,24409,62377,5.109,18.166,60730,19837,40893,4.152,12.712,26056,5.454,25.425,1054,1086,7849
2006,21,17786,23232,549629,520615,3096,13.675999999999998,1907,8.424,117034,44083,72951,8.467,22.48,58337,24177,34160,4.644,11.205,58697,11.275,22.411,1202,1227,9489
2007,21,18488,24092,703411,622049,3360,14.338,2045,8.726,234527,58240,176287,9.363,37.702,71227,28916,42311,4.649,11.45,163300,26.252,22.901,1138,1155,10709
2008,21,18559,24524,619825,661577,2778,11.467,2184,9.015,104351,30513,73838,4.612,15.773,187959,33230,154729,5.023,28.411,-83608,-12.638,31.546,1401,1409,13013
2009,21,18705,24747,601702,612998,2591,10.504,2429,9.848,88905,28376,60529,4.629,14.503,111639,27850,83789,4.543,18.212,-22734,-3.709,29.007,1424,1455,13410
2010,21,18410,24606,586391,596057,2319,9.378,2565,10.372,87198,31934,55264,5.358,14.629,106714,25752,80962,4.32,17.903,-19516,-3.274,29.258000000000006,1563,1575,12101
2011,21,18796,25237,648500,617940,2801,11.242,2156,8.654,134106,33798,100308,5.4689999999999985,21.702,72252,20476,51776,3.314,11.692,61854,10.01,23.385,1390,1408,10120
2012,21,19596,26261,724800,687635,2994,11.588,2148,8.312999999999999,155071,39744,115327,5.78,22.551,81480,28862,52618,4.197,11.849,73591,10.702,23.699,1271,1299,11853
2013,21,19402,26034,724048,720681,2712,10.45,2547,9.814,116060,34375,81685,4.77,16.104,109529,39451,70078,5.474,15.198,6531,0.906,30.396,1542,1576,12842
2014,21,20003,26891,753923,740289,2878,10.813,2330,8.754,128172,40630,87542,5.488,17.314,100789,32218,68571,4.352,13.615,27383,3.699,27.23,1488,1519,14227
2015,21,19880,26926,740825,749372,2824,10.493,2800,10.404000000000002,108738,40593,68145,5.417000000000002,14.511,126500,36722,89778,4.9,16.881,-17762,-2.37,29.021,1830,1846,14950
2016,21,18183,25079,583097,661968,1953,7.5139999999999985,3780,14.543,53707,26286,27421,3.971,8.113,211051,41865,169186,6.324,31.882,-157344,-23.769,16.226,2472,2503,18962
2017,21,17219,23810,581729,583303,2270,9.306,3434,14.078,103063,33045,70018,5.665,17.669,107319,44550,62769,7.638,18.399,-4256,-0.73,35.338,2029,2104,16073
2018,21,17204,23718,613673,598647,2166,9.106,2305,9.69,107816,21759,86057,3.635,18.01,77125,29082,48043,4.8580000000000005,12.883,30691,5.127000000000002,25.766,1616,1683,11198
1978,22,5674,11799,657194,641515,928,7.967,626,5.374,82181,22114,60067,3.447,12.81,51340,13986,37354,2.18,8.003,30841,4.808,16.006,216,219,1795
1979,22,5450,11588,675077,663656,788,6.938,326,2.87,60637,21757,38880,3.278,9.137,38468,7696,30772,1.16,5.796,22169,3.34,11.593,40,40,324
1980,22,5470,11771,692744,683580,652,5.646,206,1.784,44858,13554,31304,1.983,6.562,26578,6542,20036,0.957,3.888,18280,2.674,7.776,47,52,286
1981,22,5481,11811,712570,702761,587,5.041,255,2.19,42333,8934,33399,1.271,6.024,22728,6490,16238,0.924,3.234,19605,2.79,6.468,57,58,143
1982,22,5857,12277,746752,729519,961,8.064,242,2.031,57183,17880,39303,2.451,7.837999999999999,23511,4423,19088,0.606,3.2230000000000003,33672,4.6160000000000005,6.4460000000000015,128,131,514
1983,22,5599,12022,748383,740879,615,5.247999999999998,10,0.085,52058,15352,36706,2.072,7.027,36863,51,36812,0.006999999999999999,4.976,15195,2.051,9.951,8,8,47
1984,22,5738,12230,755846,749541,702,5.891,76,0.638,42278,11760,30518,1.569,5.641,29703,315,29388,0.042,3.963,12575,1.6780000000000002,7.926,58,58,220
1985,22,5746,12180,761807,754211,605,5.072,103,0.863,43352,8269,35083,1.096,5.747999999999998,28301,972,27329,0.129,3.752,15051,1.996,7.505,85,85,907
1986,22,5707,12121,763261,757708,634,5.348,100,0.8440000000000001,49782,15495,34287,2.045,6.57,37941,394,37547,0.052000000000000005,5.007,11841,1.5630000000000002,10.015,85,85,373
1987,22,5639,11854,756298,749690,633,5.465,90,0.777,44029,13662,30367,1.822,5.872999999999998,30903,386,30517,0.051,4.122,13126,1.751,8.244,75,75,334
1988,22,6046,12654,771111,762828,966,7.926,35,0.287,50573,19888,30685,2.607,6.63,33810,172,33638,0.023,4.432,16763,2.197,8.863999999999997,27,27,129
1989,22,6312,12914,767664,765405,860,6.8370000000000015,189,1.503,41913,14739,27174,1.926,5.476,37689,2864,34825,0.374,4.924,4224,0.552,9.848,63,63,348
1990,22,6400,13151,773002,766195,921,7.228,104,0.816,48198,16355,31843,2.135,6.291,34952,1218,33734,0.159,4.562,13246,1.729,9.124,88,88,896
1991,22,6524,13897,774448,770728,1276,9.578,126,0.946,56512,26138,30374,3.391,7.332000000000002,48989,1283,47706,0.166,6.356,7523,0.976,12.712,102,102,346
1992,22,5718,13624,771759,760487,1113,8.501,51,0.39,82183,41118,41065,5.407,10.807,58904,711,58193,0.093,7.746,23279,3.0610000000000004,15.491,40,40,181
1993,22,6039,14058,759085,765329,906,6.516,598,4.301,59297,17110,42187,2.236,7.747999999999998,72132,9691,62441,1.266,9.425,-12835,-1.6769999999999998,15.496,221,225,1354
1994,22,6003,14126,740789,750509,821,5.853,623,4.441,42874,15573,27301,2.075,5.712999999999999,62219,8441,53778,1.125,8.29,-19345,-2.5780000000000003,11.425,270,285,1466
1995,22,6136,14498,721065,731612,984,6.877000000000002,606,4.235,41807,14148,27659,1.934,5.714,63287,6275,57012,0.858,8.65,-21480,-2.9360000000000004,11.429,236,238,1259
1996,22,6204,14958,691832,708306,1210,8.211,768,5.211,51182,26186,24996,3.697,7.226,84187,12976,71211,1.832,11.886,-33005,-4.66,14.452,265,274,1790
1997,22,6148,14887,687013,694491,925,6.216,915,6.148,55304,18765,36539,2.702,7.962999999999999,69777,12164,57613,1.751,10.047,-14473,-2.084,15.925999999999998,312,316,2458
1998,22,6179,15440,688461,688295,1402,9.245,851,5.612,69525,34205,35320,4.97,10.101,69691,10706,58985,1.555,10.125,-166,-0.024,20.202,278,286,2071
1999,22,6161,15938,662661,670553,1564,9.967,1073,6.837999999999999,68422,31504,36918,4.698,10.204,83246,22892,60354,3.414,12.415,-14824,-2.211,20.408,279,301,2254
2000,22,6404,16468,647767,654896,1624,10.03,1071,6.615,71576,32801,38775,5.009,10.929,86396,23276,63120,3.554,13.192,-14820,-2.263,21.859,301,321,2568
2001,22,6526,16748,651664,651405,1533,9.204,1350,8.105,82046,37301,44745,5.726,12.595,82435,23285,59150,3.575,12.655,-389,-0.06,25.19,301,332,3190
2002,22,6479,17334,664650,666071,1277,7.441,933,5.436,74263,36474,37789,5.476,11.149,77506,19937,57569,2.9930000000000003,11.636,-3243,-0.487,22.299,339,350,2839
2003,22,6461,17560,661501,661546,1471,8.459,1129,6.4929999999999986,76964,26561,50403,4.015,11.634,76767,20142,56625,3.045,11.604,197,0.03,23.208,243,254,1900
2004,22,6339,17243,629492,645353,1239,7.16,1361,7.865,55720,20888,34832,3.237,8.634,87293,23420,63873,3.629,13.526,-31573,-4.892,17.268,283,286,1426
2005,22,6176,16770,632233,629544,1051,6.207000000000002,1377,8.132,61521,19342,42179,3.072,9.772,56607,21460,35147,3.409,8.992,4914,0.7809999999999999,17.983,231,244,1151
2006,22,6071,16700,617881,625350,1140,6.8279999999999985,1131,6.774,51746,18699,33047,2.99,8.275,66305,13992,52313,2.237,10.603,-14559,-2.3280000000000003,16.549,279,284,2139
2007,22,5544,16192,643135,633347,1039,6.412000000000001,1063,6.56,69969,17188,52781,2.714,11.047,50686,13777,36909,2.175,8.003,19283,3.045,16.006,233,245,1584
2008,22,5509,16371,632105,634938,1309,8.044,1113,6.84,64045,23316,40729,3.672,10.087,69526,19028,50498,2.997,10.95,-5481,-0.863,20.174,224,227,1415
2009,22,5346,16803,642160,637895,1288,7.762,869,5.237,65785,23016,42769,3.608,10.313,57805,16745,41060,2.625,9.062,7980,1.251,18.124,234,321,5198
2010,22,5411,17144,639164,639236,1085,6.409,655,3.869,41276,15035,26241,2.352,6.457000000000002,41220,9244,31976,1.446,6.448,56,0.009000000000000001,12.897,178,180,1274
2011,22,5436,17128,641505,641806,985,5.7429999999999986,1030,6.006,47687,17182,30505,2.677,7.43,48475,16218,32257,2.527,7.553,-788,-0.123,14.86,191,199,974
2012,22,5485,17311,641305,641762,936,5.434,763,4.43,45651,14783,30868,2.3040000000000003,7.113,46876,9986,36890,1.556,7.3039999999999985,-1225,-0.191,14.227,193,200,1743
2013,22,5521,17405,634510,637066,991,5.711,888,5.117,45220,16753,28467,2.63,7.098,50300,11208,39092,1.759,7.896,-5080,-0.797,14.196,207,216,1927
2014,22,5563,17491,633823,634296,884,5.0680000000000005,790,4.529,44183,9769,34414,1.54,6.966,44842,10164,34678,1.602,7.07,-659,-0.104,13.931,194,205,1301
2015,22,5557,17506,640135,637693,921,5.2620000000000005,916,5.233,48278,11619,36659,1.822,7.5710000000000015,43559,9357,34202,1.467,6.831,4719,0.74,13.661,227,229,1018
2016,22,5567,17723,638798,638796,1068,6.073,796,4.526,43153,12804,30349,2.004,6.755,42951,11367,31584,1.779,6.724,202,0.032,13.447,255,261,1445
2017,22,5594,17899,638659,638400,1103,6.193,926,5.199,49735,18406,31329,2.883,7.791,49327,9692,39635,1.518,7.727,408,0.064,15.453,242,246,1459
2018,22,5600,18315,640096,639702,1928,10.647,1516,8.372,75758,40138,35620,6.274,11.843,74703,(S),37636,(S),11.678,1055,0.165,23.356,249,259,1204
1978,23,425377,430942,4078349,3800208,91660,22.164,56876,13.753,1343450,435346,908104,11.456,35.352,785956,276559,509397,7.277,20.682,557494,14.67,41.364,43848,43884,190215
1979,23,447194,452777,4552120,4330487,84423,19.089,63399,14.335,1374449,389876,984573,9.003,31.739,931201,313579,617622,7.241,21.503,443248,10.236,43.007,49144,49178,226198
1980,23,437255,442664,4400614,4467436,70481,15.754,79914,17.863,1094318,328624,765694,7.356,24.495,1229341,358144,871197,8.017000000000001,27.518,-135023,-3.022,48.99100000000001,61352,61390,262266
1981,23,419321,424821,4258290,4324467,59901,13.851,75182,17.385,1039773,300960,738813,6.959,24.044,1168836,312964,855872,7.237,27.028,-129063,-2.984,48.088,54013,54053,216242
1982,23,386149,392213,3884197,4045711,52693,12.941,82615,20.29,921083,261177,659906,6.456,22.767,1244468,358962,885506,8.873,30.76,-323385,-7.9929999999999986,45.534,57258,57292,251433
1983,23,391308,397271,3793374,3870627,63438,16.049,59446,15.039,957487,291087,666400,7.52,24.737,1112592,284520,828072,7.351,28.744,-155105,-4.007,49.475,41798,41844,202078
1984,23,421993,428033,4287414,4043208,81223,19.644,52117,12.604,1356104,386370,969734,9.556,33.54,869828,247997,621831,6.134,21.513,486276,12.027,43.027,38498,38533,186655
1985,23,443417,449549,4648582,4476742,83999,19.145,62409,14.224,1431550,440252,991298,9.834,31.977,1089199,356308,732891,7.959,24.33,342351,7.647,48.66,46154,46193,265153
1986,23,462914,468805,4817535,4716975,84062,18.313,64523,14.056,1365210,409091,956119,8.673,28.942,1163024,359862,803162,7.629,24.656,202186,4.2860000000000005,49.312,47304,47357,258931
1987,23,485814,492223,4963067,4874849,90552,18.851,66803,13.907,1408052,443454,964598,9.097,28.884,1233034,407300,825734,8.355,25.294,175018,3.59,50.588,49787,49827,282863
1988,23,495799,502269,5067939,5033461,83669,16.822,73876,14.853,1328000,392044,935956,7.789,26.383000000000006,1259855,410055,849800,8.147,25.03,68145,1.354,50.059,55972,56048,294652
1989,23,504217,510447,5195581,5129986,80295,15.858,72081,14.236,1355010,390967,964043,7.621,26.414,1224170,391540,832630,7.6320000000000014,23.863000000000003,130840,2.55,47.726000000000006,54793,54878,286729
1990,23,513712,519902,5310457,5252306,81641,15.847,72231,14.02,1368208,386473,981735,7.358,26.05,1251538,386294,865244,7.355,23.828000000000007,116670,2.221,47.657,55007,55077,298795
1991,23,510312,516567,4750234,5047661,71423,13.694,81445,15.615,1001864,306360,695504,6.069,19.848,1598688,446555,1152133,8.847000000000003,31.672,-596824,-11.824000000000002,39.696,58865,58962,334011
1992,23,498328,504464,4498509,4588438,72899,14.358,79431,15.644,1059369,298270,761099,6.5,23.088,1239173,367569,871604,8.011000000000001,27.006,-179804,-3.919,46.176,57534,57597,271177
1993,23,502690,508763,4532328,4506877,79034,15.664,70651,14.002,1123229,316037,807192,7.0120000000000005,24.923,1072750,320917,751833,7.121,23.803,50479,1.12,47.605,51814,51857,241559
1994,23,519709,525822,4743509,4641395,83911,16.223,66757,12.906,1211260,338547,872713,7.294,26.097,1007795,306083,701712,6.595,21.713,203465,4.384,43.426,49371,49410,233116
1995,23,541311,547621,5075670,4908080,88440,16.479,66532,12.397,1270983,364972,906011,7.436,25.896,934886,298647,636239,6.085,19.048,336097,6.848,38.096,49981,50056,231563
1996,23,552598,558855,5191587,5115165,81813,14.783,70927,12.816,1184059,337088,846971,6.59,23.148000000000003,1032596,315631,716965,6.17,20.187,151463,2.9610000000000003,40.374,53080,53128,239958
1997,23,569838,575952,5511000,5357559,84262,14.815,69915,12.292,1315923,355574,960349,6.6370000000000005,24.562,1010269,336069,674200,6.273,18.857,305654,5.705,37.714,52572,52641,247914
1998,23,579130,585800,5767434,5657960,80643,13.882,70906,12.206,1297965,365368,932597,6.457999999999998,22.941,1077807,329294,748513,5.82,19.049,220158,3.891,38.099,51994,52039,237127
1999,23,592239,599313,6165269,5959952,81735,13.803,67442,11.389,1421973,365791,1056182,6.1370000000000005,23.859,1011495,326939,684556,5.4860000000000015,16.972,410478,6.8870000000000005,33.943000000000005,49752,49805,240999
2000,23,600459,608464,6588343,6379268,78486,13.001,68980,11.425999999999998,1501970,378600,1123370,5.935,23.545,1083169,337321,745848,5.2879999999999985,16.98,418801,6.565,33.959,50428,50493,243026
2001,23,598112,606479,6524290,6491886,75419,12.481,71050,11.758,1309569,349721,959848,5.3870000000000005,20.172,1244487,379922,864565,5.852,19.17,65082,1.003,38.34,50317,50365,256955
2002,23,593113,602522,6448135,6532633,80420,13.358,79462,13.199000000000002,1304900,415133,889767,6.355,19.975,1475720,416536,1059184,6.376,22.59,-170820,-2.615,39.95,52861,52980,277919
2003,23,599393,608783,6356984,6362825,86072,14.238,77535,12.826,1308549,384199,924350,6.0379999999999985,20.566,1319197,366665,952532,5.763,20.733,-10648,-0.16699999999999998,41.131,52953,53006,246529
2004,23,620285,629687,6619724,6483884,97449,15.746,75863,12.258,1457940,394012,1063928,6.077000000000001,22.486,1188148,375471,812677,5.791,18.325,269792,4.1610000000000005,36.649,52862,52944,264556
2005,23,645288,655565,6782774,6710199,102819,15.962,79949,12.412,1464578,460776,1003802,6.867000000000001,21.826,1319052,387238,931814,5.771,19.657,145526,2.169,39.315,55793,55842,263588
2006,23,675476,686720,7350004,7062825,116694,17.399,84647,12.621,1745525,534997,1210528,7.575,24.714,1174445,382421,792024,5.415,16.629,571080,8.086,33.257,64143,64280,283654
2007,23,684567,696133,7287316,7333273,97734,14.116,90200,13.028,1417412,394918,1022494,5.385,19.329,1512756,398463,1114293,5.434,20.629,-95344,-1.3,38.657,67358,67418,280513
2008,23,660031,672020,6985242,7138364,80775,11.794,106521,15.553,1272772,332056,940716,4.652,17.83,1579610,414018,1165592,5.8,22.128,-306838,-4.298,35.66,79368,79410,295257
2009,23,598367,610476,5942909,6479899,63411,9.872,127153,19.795,858107,263243,594864,4.062,13.243,1931428,478541,1452887,7.385,29.806,-1073321,-16.564,26.485,87608,87678,332972
2010,23,559059,571516,5348797,5640704,69402,11.76,106659,18.073,900735,286859,613876,5.086,15.968,1487041,380370,1106671,6.7429999999999986,26.363000000000003,-586306,-10.394,31.937,68688,68808,253541
2011,23,541297,553868,5166886,5261201,73889,13.130999999999998,91590,16.276,967576,255576,712000,4.8580000000000005,18.391,1154272,329547,824725,6.2639999999999985,21.939,-186696,-3.549,36.782,58698,58850,216706
2012,23,545438,557412,5298296,5226979,76510,13.78,72137,12.992,1060213,260462,799751,4.9830000000000005,20.283,917192,289895,627297,5.546,17.547,143021,2.736,35.095,46102,46279,187975
2013,23,545073,557109,5451901,5374008,70661,12.688,70247,12.614,1048936,251697,797239,4.684,19.519,893342,270100,623242,5.026,16.623,155594,2.895,33.247,44992,45108,184397
2014,23,552620,565183,5691940,5567220,72850,12.99,64115,11.432,1100495,289355,811140,5.197,19.767,850122,247414,602708,4.444,15.27,250373,4.497,30.54,42145,42219,159322
2015,23,566252,579527,6002763,5849423,75064,13.116,60629,10.594,1149054,298730,850324,5.107,19.644,843359,237195,606164,4.055,14.418,305695,5.226,28.836,41335,41393,160254
2016,23,583710,597416,6307335,6152479,78006,13.268,59058,10.045,1162329,294480,867849,4.7860000000000005,18.892,852232,241683,610549,3.928,13.852,310097,5.04,27.704,42232,42298,168924
2017,23,595734,609566,6492890,6393863,75987,12.6,62989,10.445,1108961,279154,829807,4.3660000000000005,17.344,910863,259837,651026,4.064,14.246,198098,3.0980000000000003,28.492,46669,46735,182213
2018,23,609705,623695,6787093,6642570,77762,12.609000000000002,63789,10.343,1170414,307182,863232,4.624,17.62,881292,243700,637592,3.669,13.267,289122,4.353,26.535,52340,52439,194554
1978,31-33,262447,309140,18118738,17695911,34851,11.394,28289,9.249,2561684,703506,1858178,3.976,14.476,1717524,736021,981503,4.159,9.706,844160,4.77,19.412,19107,19255,225619
1979,31-33,255685,302989,18901965,18524057,31115,10.229,33510,11.015999999999998,2590741,707357,1883384,3.819,13.986,1829752,741721,1088031,4.004,9.878,760989,4.1080000000000005,19.755,19503,19689,223738
1980,31-33,255012,303608,18745186,18799095,31566,10.412,30687,10.122,2210624,765257,1445367,4.0710000000000015,11.759,2325169,639161,1686008,3.4,12.369000000000002,-114545,-0.609,23.518,20796,21005,258463
1981,31-33,270724,319525,18217604,18474014,40425,12.955,25442,8.154,2005871,760258,1245613,4.115,10.858,2518366,706121,1812245,3.822,13.632,-512495,-2.774,21.716,16098,16285,200163
1982,31-33,271895,320897,17478675,17871092,30855,9.622,30404,9.481,1868227,659375,1208852,3.69,10.454,2653318,693351,1959967,3.88,14.847,-785091,-4.393,20.908,21299,21469,223998
1983,31-33,272876,320871,16278683,16899943,30365,9.465,30275,9.437,1693650,527996,1165654,3.124,10.022,2935460,790037,2145423,4.675,17.37,-1241810,-7.348,20.043,21087,21275,253212
1984,31-33,274067,321880,17380723,16845956,30331,9.444,28916,9.003,2675986,608703,2067283,3.613,15.885,1606262,628585,977677,3.731,9.535,1069724,6.35,19.07,21047,21223,216039
1985,31-33,282402,329831,17440468,17406195,39765,12.211,31389,9.639,2316101,789685,1526416,4.537,13.306,2244307,908584,1335723,5.22,12.894,71794,0.412,25.787,22768,22968,334557
1986,31-33,281621,328891,16991715,17113953,34124,10.386,33439,10.178,2118682,731105,1387577,4.272,12.38,2360637,864591,1496046,5.052,13.794,-241955,-1.414,24.76,24109,24304,300705
1987,31-33,282101,328603,16628758,16805793,34938,10.64,34439,10.488,1990238,633879,1356359,3.772,11.843,2349348,935721,1413627,5.568,13.979,-359110,-2.137,23.685,23877,24132,309395
1988,31-33,288204,335732,17128298,16954555,36593,10.986,31286,9.393,2383291,828233,1555058,4.885,14.057,2038496,806668,1231828,4.758,12.023,344795,2.0340000000000003,24.047,22762,22966,305417
1989,31-33,291626,339124,17352837,17219222,35276,10.455,31821,9.431,2225412,667415,1557997,3.876,12.924,1957587,747631,1209956,4.342,11.369000000000002,267825,1.555,22.737,23078,23339,284024
1990,31-33,293873,341704,17081635,17218105,33808,9.936,30900,9.082,1801799,579484,1222315,3.366,10.465,2074995,622821,1452174,3.617,12.050999999999998,-273196,-1.587,20.929,23303,23504,265615
1991,31-33,294523,341921,16099387,16590901,29948,8.709,33860,9.847,1497512,476767,1020745,2.874,9.026,2480439,817637,1662802,4.928,14.951,-982927,-5.924,18.052,25169,25484,424166
1992,31-33,286929,333232,15893415,15994900,27866,8.301,32790,9.768,1704074,482942,1221132,3.019,10.654000000000002,1908515,642790,1265725,4.019,11.932,-204441,-1.278,21.308000000000003,23915,24087,251062
1993,31-33,289102,334916,15903383,15905545,30036,8.985,28765,8.605,1735751,476276,1259475,2.994,10.913,1735658,542926,1192732,3.4130000000000003,10.912,93,0.001,21.825,21299,21520,218344
1994,31-33,291221,337397,16076631,16038619,30364,9.023,28620,8.505,1797579,494869,1302710,3.085,11.208,1722529,573458,1149071,3.575,10.74,75050,0.468,21.48,21522,21731,242465
1995,31-33,293001,339281,16497873,16257822,30375,8.993,27315,8.087,1938156,476608,1461548,2.932,11.921,1452819,470024,982795,2.891,8.936,485337,2.985,17.872,20870,20997,213344
1996,31-33,292240,338408,16134500,16251585,28635,8.465,28370,8.387,1594262,423005,1171257,2.603,9.81,1829574,580214,1249360,3.57,11.258,-235312,-1.4480000000000002,19.62,21533,21769,248465
1997,31-33,292545,337948,16361886,16285740,28275,8.354,29288,8.652999999999999,1831002,461939,1369063,2.8360000000000003,11.243,1673193,589562,1083631,3.62,10.274,157809,0.969,20.548,21763,21968,252646
1998,31-33,294325,340671,16711134,16595666,27760,8.163,26525,7.8,1848292,499585,1348707,3.01,11.137,1616558,517498,1099060,3.1180000000000003,9.741,231734,1.396,19.482,19268,19472,215320
1999,31-33,290178,337124,16460120,16587341,24731,7.3,28067,8.283999999999999,1636512,443637,1192875,2.675,9.866,1888303,588409,1299894,3.547,11.384,-251791,-1.518,19.732,20379,20584,248171
2000,31-33,285603,332845,16373179,16410900,24169,7.222,27782,8.302,1779222,484897,1294325,2.955,10.842,1855431,644330,1211101,3.926,11.306,-76209,-0.464,21.683000000000003,19960,20186,225301
2001,31-33,284859,332190,15901839,16163758,24042,7.197,27784,8.317,1505749,428969,1076780,2.654,9.316,2026219,596657,1429562,3.691,12.536,-520470,-3.22,18.631,19907,20145,247074
2002,31-33,282948,329782,14523927,15326903,24236,7.252000000000002,33051,9.89,1292172,443354,848818,2.893,8.431000000000001,2898406,850353,2048053,5.547999999999999,18.911,-1606234,-10.48,16.861,22917,23349,394507
2003,31-33,276616,322342,14048766,14284639,22060,6.771,28976,8.894,1359205,333946,1025259,2.338,9.515,1834652,578324,1256328,4.049,12.844,-475447,-3.3280000000000003,19.03,20605,20859,223187
2004,31-33,273530,318476,13722079,13872301,22185,6.917000000000002,26717,8.33,1318847,333492,985355,2.404,9.507,1618175,504440,1113735,3.636,11.665,-299328,-2.158,19.014,19159,19370,206116
2005,31-33,269305,313809,13650122,13666107,22137,7.0139999999999985,25782,8.168,1393899,315434,1078465,2.3080000000000003,10.2,1424669,437887,986782,3.204,10.425,-30770,-0.225,20.399,18797,18978,196552
2006,31-33,268640,313572,13611611,13605115,25088,7.987999999999999,26083,8.305,1384237,347614,1036623,2.555,10.174,1369870,430065,939805,3.161,10.069,14367,0.106,20.138,19809,19971,194870
2007,31-33,269146,313934,13337202,13482376,21767,6.902,24650,7.816,1247790,291604,956186,2.1630000000000003,9.255,1542179,467217,1074962,3.465,11.438,-294389,-2.184,18.51,17569,17765,195361
2008,31-33,260613,304221,12920822,13079181,19123,6.228,24799,8.076,1143621,262179,881442,2.005,8.744,1459689,434227,1025462,3.32,11.16,-316068,-2.417,17.488,18236,18409,192701
2009,31-33,250392,292784,11559307,12239036,16499,5.525,28185,9.438,801899,231452,570447,1.891,6.5520000000000005,2165507,454968,1710539,3.717,17.692999999999994,-1363608,-11.140999999999998,13.104,19857,20052,196507
2010,31-33,241529,282700,10829797,11181399,16326,5.674,26369,9.165,827394,198955,628439,1.779,7.4,1529724,384721,1145003,3.4410000000000003,13.681,-702330,-6.2810000000000015,14.799,18105,18241,152049
2011,31-33,238562,279265,10926328,10857169,17950,6.385,21706,7.721,1064014,194516,869498,1.7919999999999998,9.8,925748,271019,654729,2.496,8.527000000000001,138266,1.273,17.053,15406,15571,125650
2012,31-33,239601,280127,11159235,11063882,18168,6.473,19303,6.877000000000002,1086426,188172,898254,1.7009999999999998,9.82,894905,260242,634663,2.352,8.089,191521,1.731,16.177,13435,13576,128847
2013,31-33,235157,275190,11214938,11171443,16866,6.104,19150,6.93,990881,186148,804733,1.666,8.87,905803,271143,634660,2.427,8.107999999999999,85078,0.762,16.215999999999998,13645,13765,125657
2014,31-33,235435,275989,11347152,11283381,17551,6.353,18060,6.5379999999999985,1038907,221764,817143,1.965,9.207,908518,251444,657074,2.228,8.052,130389,1.156,16.104,13231,13320,117974
2015,31-33,234928,276196,11539467,11439057,18086,6.55,17973,6.509,1075047,227176,847871,1.986,9.398,872833,233643,639190,2.043,7.63,202214,1.768,15.261,13451,13546,121532
2016,31-33,234204,276174,11536552,11536199,18019,6.524,18063,6.54,967719,190813,776906,1.654,8.389,965067,238171,726896,2.065,8.366,2652,0.023,16.730999999999998,13820,13929,122071
2017,31-33,232123,274795,11668574,11612996,17643,6.401,19320,7.009,1106455,220705,885750,1.901,9.528,995971,293402,702569,2.526,8.576,110484,0.951,17.153,14403,14561,150351
2018,31-33,230134,273966,11859412,11761940,17762,6.477,18321,6.681,1113145,252297,860848,2.145,9.464,921075,236593,684482,2.012,7.831,192070,1.633,15.662,15097,15242,137979
1978,42,245096,318821,3949115,3822742,41445,13.207,31418,10.012,845431,302402,543029,7.911,22.116,592783,282148,310635,7.381,15.507,252648,6.609,31.014,18726,19143,104858
1979,42,255813,331097,4224051,4114260,37373,11.406,30501,9.309,808462,276054,532408,6.71,19.65,588559,248434,340125,6.0379999999999985,14.305,219903,5.345,28.611,18291,18663,98474
1980,42,258678,335967,4283386,4263996,36091,10.805,32217,9.645,688646,253380,435266,5.942,16.15,650180,242015,408165,5.676,15.248,38466,0.902,30.496,20441,20921,113808
1981,42,268756,347948,4378853,4329656,41115,12.026,28979,8.476,743309,297669,445640,6.875,17.168,645199,211229,433970,4.879,14.902,98110,2.266,29.804,17627,18139,94355
1982,42,273319,353362,4378355,4384775,39170,11.134,36029,10.242,764284,265931,498353,6.065,17.43,778366,263625,514741,6.0120000000000005,17.752,-14082,-0.321,34.861,22485,23006,119479
1983,42,276829,355716,4239074,4308581,39325,11.098,36578,10.323,659534,228528,431006,5.3039999999999985,15.307,796479,262277,534202,6.0870000000000015,18.486,-136945,-3.178,30.615,23224,23816,131726
1984,42,282496,362167,4511092,4379708,41127,11.456,34764,9.684,844270,268849,575421,6.1389999999999985,19.277,581026,224455,356571,5.125,13.265999999999998,263244,6.011,26.533,23498,24048,122829
1985,42,284906,365182,4665087,4597521,42508,11.686,39616,10.890999999999998,848187,279995,568192,6.09,18.449,714529,315870,398659,6.87,15.542,133658,2.907,31.083,27218,27878,180582
1986,42,288114,369905,4728889,4704157,44116,11.995,39899,10.848,820686,281990,538696,5.994,17.445999999999998,769233,294765,474468,6.266,16.352,51453,1.094,32.704,26397,26980,150230
1987,42,292140,374441,4858865,4824623,45373,12.130999999999998,44547,11.91,923264,328327,594937,6.805,19.137,853250,348998,504252,7.234,17.685,70014,1.4509999999999998,35.371,27370,28099,166902
1988,42,296187,380217,4966745,4928104,44821,11.863,40057,10.602,905822,313467,592355,6.3610000000000015,18.381,831422,340266,491156,6.905,16.871,74400,1.51,33.742,26596,27443,175630
1989,42,298171,383796,5118922,5046322,42967,11.249,39285,10.285,916441,298002,618439,5.905,18.161,770415,324309,446106,6.4270000000000005,15.267,146026,2.894,30.534,26498,27365,162581
1990,42,300183,387911,5224595,5171244,42181,10.934,37911,9.827,860111,288651,571460,5.582000000000002,16.633,754146,281712,472434,5.448,14.583,105965,2.049,29.167,26388,27281,164878
1991,42,288414,377179,4938879,5019527,41736,11.067,41643,11.042,737998,273852,464146,5.456,14.703,902228,354432,547796,7.061,17.974,-164230,-3.272,29.405,27922,28825,210283
1992,42,301688,387728,4988449,5016123,40577,10.443,42234,10.869000000000002,811161,260682,550479,5.197,16.171,866510,326400,540110,6.5070000000000014,17.274,-55349,-1.103,32.342,25308,26393,144235
1993,42,305410,390811,5047739,5011779,40620,10.431,37806,9.709,789557,242657,546900,4.842,15.754,717105,251338,465767,5.015,14.308,72452,1.446,28.617,25214,25923,138349
1994,42,309336,395330,5180244,5136862,40913,10.387,38035,9.656,800593,237358,563235,4.621,15.585,712451,259995,452456,5.061,13.869000000000002,88142,1.716,27.739,25798,26688,143430
1995,42,314564,402430,5413879,5296190,42763,10.72,35737,8.959,888698,281197,607501,5.309,16.78,652756,237642,415114,4.487,12.325,235942,4.455,24.65,24858,25731,142380
1996,42,318190,406708,5413951,5392660,43639,10.785,39447,9.749,831429,263407,568022,4.885,15.418,789664,295832,493832,5.4860000000000015,14.643,41765,0.774,29.287,26343,27233,161763
1997,42,314694,397796,5386622,5329288,42025,10.545,43478,10.91,936873,275634,661239,5.1720000000000015,17.58,822906,336228,486678,6.309,15.441,113967,2.139,30.882,27711,28708,172299
1998,42,315795,399932,5589389,5521230,40064,10.022,39701,9.931,925807,287650,638157,5.21,16.768,785179,290171,495008,5.256,14.220999999999998,140628,2.547,28.442,26091,27042,154760
1999,42,312561,398528,5673442,5640699,36628,9.167,38667,9.678,852787,257646,595141,4.5680000000000005,15.118,786860,296173,490687,5.251,13.95,65927,1.169,27.899,26180,27408,164149
2000,42,311099,397934,5821156,5763489,37889,9.507,39132,9.818,950378,311083,639295,5.397,16.49,837140,348757,488383,6.051,14.525,113238,1.965,29.05,25092,26250,156819
2001,42,308022,398385,5947422,5911508,39562,9.928,39739,9.973,975446,365152,610294,6.1770000000000005,16.500999999999998,902337,333348,568989,5.6389999999999985,15.264,73109,1.237,30.528,25252,26381,163180
2002,42,306516,398786,5796957,5957671,38586,9.57,47428,11.763,918013,332544,585469,5.582000000000002,15.409,1235982,480722,755260,8.068999999999999,20.746,-317969,-5.3370000000000015,30.818,27056,28744,241818
2003,42,305080,394534,5812134,5792886,36821,9.297,39851,10.062,888587,289554,599033,4.998,15.339,849500,303242,546258,5.235,14.665,39087,0.675,29.329,24541,25333,138406
2004,42,303453,395135,5902561,5865880,36133,9.16,34783,8.818,858984,288231,570753,4.914,14.644,788142,290490,497652,4.952,13.436,70842,1.208,26.872,23012,23735,132248
2005,42,304642,398060,5959965,5952810,35702,8.981,34641,8.714,802668,252343,550325,4.239,13.484000000000002,787859,258126,529733,4.336,13.235,14809,0.249,26.47,23596,24337,129148
2006,42,305334,402214,6034933,5998739,40208,10.045,36376,9.087,854899,291315,563584,4.856,14.251,782932,269729,513203,4.496,13.052,71967,1.2,26.103,24834,25558,141381
2007,42,301906,400934,6106904,6127463,36169,9.013,36910,9.198,878351,270867,607484,4.421,14.335,920613,322074,598539,5.256,15.024,-42262,-0.69,28.669,22954,23579,131188
2008,42,298402,398391,6107783,6118712,34559,8.644,37397,9.354,834444,250717,583727,4.098,13.638,860345,289720,570625,4.735,14.061,-25901,-0.423,27.275,23698,24517,132532
2009,42,290655,392042,5809298,5980157,30026,7.569,39292,9.905,634912,200420,434492,3.3510000000000004,10.617,976153,283708,692445,4.744,16.323,-341241,-5.706,21.234,25358,26072,140670
2010,42,284062,386243,5592144,5698861,30782,7.916,35987,9.255,616046,208522,407524,3.659,10.81,827643,234793,592850,4.12,14.523,-211597,-3.713,21.62,23055,23833,122109
2011,42,281584,386376,5632262,5613231,32210,8.332,32587,8.43,688656,208188,480468,3.709,12.268,650014,222223,427791,3.959,11.58,38642,0.688,23.16,21325,21968,105937
2012,42,283584,387490,5752712,5707028,31187,8.029,33059,8.511000000000001,785695,200316,585379,3.51,13.767,691765,222791,468974,3.904,12.121,93930,1.646,24.243,19140,19799,101159
2013,42,282163,387747,5875555,5820575,31523,8.129,31551,8.137,795482,243838,551644,4.189,13.667,684891,236697,448194,4.067,11.767,110591,1.9,23.533,19870,20368,105878
2014,42,280724,387311,5943501,5902157,29867,7.707000000000002,30280,7.814,708723,181005,527718,3.067,12.008,624778,228060,396718,3.864,10.586,83945,1.422,21.171,19446,19958,100954
2015,42,278509,385740,6051924,5995164,28989,7.499,30641,7.926,709287,195947,513340,3.268,11.831,593773,200288,393485,3.341,9.904,115514,1.927,19.808,20075,20574,104073
2016,42,275643,385888,6104940,6093168,29553,7.655,29883,7.741,673405,187335,486070,3.075,11.052,649727,219296,430431,3.599,10.663,23678,0.389,21.326,20504,21177,111955
2017,42,271211,381633,6114473,6098333,27364,7.131,31511,8.212,746561,187022,559539,3.067,12.242,712879,246888,465991,4.048,11.69,33682,0.552,23.379,20697,21347,118020
2018,42,266686,374967,6166673,6139061,24380,6.447,30759,8.134,679211,157771,521440,2.57,11.064,623292,207681,415611,3.383,10.153,55919,0.911,20.306,21348,22241,120805
1978,44-45,731989,983956,9765832,9416833,140211,14.392,120737,12.393,2168750,926810,1241940,9.842,23.031,1474417,682060,792357,7.2429999999999986,15.657,694333,7.372999999999998,31.314,77419,79294,312135
1979,44-45,743360,1001208,10207909,10010932,126130,12.695,110792,11.151,1899004,784186,1114818,7.832999999999998,18.969,1502114,607695,894419,6.07,15.005,396890,3.965,30.009,72224,73880,298836
1980,44-45,737786,1005348,10118827,10194961,119079,11.865,115632,11.521,1636000,783462,852538,7.685,16.047,1778797,589744,1189053,5.785,17.448,-142797,-1.401,32.094,78582,80843,334759
1981,44-45,732898,1012684,10086313,10096542,112946,11.207,103224,10.242,1596708,732381,864327,7.254,15.814,1614542,514351,1100191,5.0939999999999985,15.991,-17834,-0.177,31.629,66660,69388,279518
1982,44-45,713229,1007910,10010272,10040338,120493,11.935,123863,12.269,1701547,749837,951710,7.468,16.947,1760871,623951,1136920,6.214,17.538,-59324,-0.591,33.894,83591,86469,343113
1983,44-45,721731,1017836,10014854,10033925,118465,11.692,109303,10.787,1668423,714409,954014,7.12,16.628,1708197,655185,1053012,6.53,17.024,-39774,-0.396,33.256,69518,72331,308093
1984,44-45,733177,1035715,10657822,10342303,124978,12.169,107537,10.470999999999998,1966525,786723,1179802,7.607,19.014,1333266,539362,793904,5.215,12.890999999999998,633259,6.122999999999998,25.783,74033,76383,305373
1985,44-45,727285,1030521,11100735,10876234,124774,12.079,129773,12.562,2009779,806402,1203377,7.414,18.479,1560654,736035,824619,6.767,14.349,449125,4.129,28.698,87309,90848,418225
1986,44-45,727703,1046173,11514310,11315524,135578,13.059,119654,11.525,2187619,981051,1206568,8.67,19.333,1795714,682681,1113033,6.033,15.869000000000002,391905,3.463,31.739,80646,83583,370576
1987,44-45,721023,1049004,11836217,11660499,136146,13.019,129644,12.397,2315354,1021119,1294235,8.757,19.856,1961717,845412,1116305,7.25,16.824,353637,3.033,33.647,81806,84938,409119
1988,44-45,727148,1066761,12209898,12051074,134153,12.663,119477,11.278,2313276,1021516,1291760,8.477,19.196,1997956,793196,1204760,6.582000000000002,16.579,315320,2.617,33.158,76973,80598,386046
1989,44-45,729342,1079885,12612850,12417541,127875,11.911,115282,10.738,2250931,966251,1284680,7.7810000000000015,18.127,1868090,706519,1161571,5.69,15.044,382841,3.083,30.088,77546,82127,401704
1990,44-45,725885,1084149,12842061,12733066,120605,11.145,116683,10.782,2102968,884434,1218534,6.9460000000000015,16.516,1884897,702891,1182006,5.52,14.803,218071,1.713,29.606,79454,84117,415680
1991,44-45,707320,1067389,12474185,12658401,110448,10.271,126349,11.75,1825512,811396,1014116,6.41,14.421,2196609,819696,1376913,6.476,17.352999999999998,-371097,-2.932,28.843000000000004,82491,87566,479111
1992,44-45,684632,1039354,12206531,12279894,108486,10.358,124538,11.89,1841520,785017,1056503,6.393,14.996,1989419,745821,1243598,6.074,16.201,-147899,-1.204,29.992,73744,78231,368654
1993,44-45,685739,1036417,12513580,12359810,104040,10.023,107154,10.323,2000901,811173,1189728,6.563,16.189,1702429,629035,1073394,5.089,13.774,298472,2.415,27.548,65693,69084,316203
1994,44-45,686221,1042695,12950220,12763163,107573,10.333,104273,10.016,2053068,863456,1189612,6.765,16.086,1681237,621841,1059396,4.872,13.173,371831,2.9130000000000003,26.345,67246,70742,314982
1995,44-45,688493,1046182,13421721,13186977,108599,10.399,104873,10.042,2131358,909239,1222119,6.895,16.163,1657622,675179,982443,5.12,12.57,473736,3.592,25.14,64524,68498,300446
1996,44-45,677235,1038932,13491780,13389775,107007,10.32,102871,9.921,2070931,879088,1191843,6.565,15.467,1877807,667425,1210382,4.985,14.024,193124,1.442,28.048,66510,70083,329657
1997,44-45,670865,1036877,13928461,13764796,110041,10.586,115376,11.099,2361288,915543,1445745,6.651,17.155,2038200,747261,1290939,5.4289999999999985,14.807,323088,2.347,29.615,68225,73340,348698
1998,44-45,674189,1042829,14314426,14165484,100141,9.607,99338,9.529,2187539,833890,1353649,5.8870000000000005,15.443,1883217,669803,1213414,4.728,13.294,304322,2.148,26.589,60103,63754,302786
1999,44-45,667353,1038166,14532514,14429450,95104,9.141,99570,9.57,2102340,785029,1317311,5.44,14.57,1900293,639342,1260951,4.431,13.17,202047,1.4,26.339,61073,64910,320554
2000,44-45,664346,1039355,14902448,14726423,97688,9.402,97038,9.339,2223160,843433,1379727,5.727,15.095999999999998,1863083,731245,1131838,4.966,12.651,360077,2.445,25.303,58888,62721,322817
2001,44-45,660139,1036360,14889630,14916701,93460,8.988999999999997,100109,9.629,2035309,790835,1244474,5.3020000000000005,13.644,2099646,727604,1372042,4.878,14.076,-64337,-0.431,27.289,61047,66217,339768
2002,44-45,645690,1022070,14577148,14635790,108624,10.613,111543,10.898,2251832,993910,1257922,6.791,15.386,2379310,822020,1557290,5.617000000000001,16.257,-127478,-0.871,30.772,65974,72276,459472
2003,44-45,652575,1029813,14903174,14766048,102516,9.985,96360,9.385,2108628,783162,1325466,5.3039999999999985,14.28,1833181,635288,1197893,4.302,12.415,275447,1.865,24.83,57800,61154,305304
2004,44-45,656938,1033449,15385666,15146377,98765,9.575,94819,9.193,2227787,736164,1491623,4.86,14.708,1752305,627320,1124985,4.142,11.569,475482,3.139,23.138,60093,64199,312271
2005,44-45,654513,1035589,15307059,15330880,101841,9.864,95579,9.257,1953349,762327,1191022,4.972,12.741,2003985,586472,1417513,3.825,13.072,-50636,-0.33,25.483,63045,66063,311438
2006,44-45,648867,1039573,15729778,15527090,109492,10.567,102602,9.902,2229533,944306,1285227,6.082000000000002,14.359000000000002,1833175,591485,1241690,3.809,11.806,396358,2.553,23.613000000000003,71960,75040,339357
2007,44-45,643244,1044970,15605976,15632897,108876,10.464,99973,9.608,2181392,855720,1325672,5.474,13.954,2231900,658041,1573859,4.209,14.277,-50508,-0.32299999999999995,27.908,62713,65465,321257
2008,44-45,629485,1032075,15559633,15577753,86403,8.33,96670,9.32,1911918,665402,1246516,4.271,12.273,1956354,575772,1380582,3.696,12.559,-44436,-0.285,24.547,63566,66501,303328
2009,44-45,609662,1010298,14730893,15156654,77308,7.563,101054,9.886,1428417,591617,836800,3.903,9.424,2285868,667238,1618630,4.402,15.082,-857451,-5.657,18.849,65177,69195,368015
2010,44-45,598835,996114,14446093,14583102,74581,7.439,87505,8.728,1424791,491558,933233,3.3710000000000004,9.77,1692103,511517,1180586,3.508,11.603,-267312,-1.833,19.54,55024,59802,305769
2011,44-45,591871,995918,14637506,14539942,81784,8.215,81032,8.139,1622972,527722,1095250,3.629,11.162,1425800,427572,998228,2.9410000000000003,9.806,197172,1.356,19.612,53005,55563,225179
2012,44-45,589832,989977,14753922,14646035,80906,8.177999999999999,79586,8.045,1716897,531844,1185053,3.631,11.723,1500022,459662,1040360,3.138,10.242,216875,1.481,20.484,47718,50627,224456
2013,44-45,589106,993254,14990679,14879268,78203,7.885,75227,7.585,1632621,510239,1122382,3.429,10.972,1405447,428116,977331,2.877,9.446,227174,1.527,18.891,47904,49999,211019
2014,44-45,588352,995767,15342752,15161813,77694,7.819,73549,7.402,1591538,517946,1073592,3.4160000000000004,10.497,1234780,374142,860638,2.468,8.144,356758,2.353,16.288,48074,50141,202622
2015,44-45,586958,1000072,15702791,15506795,78339,7.854,73031,7.322,1713620,647546,1066074,4.176,11.050999999999998,1321078,402085,918993,2.593,8.519,392542,2.531,17.039,48608,51513,223529
2016,44-45,587648,1006101,15981768,15840848,79886,7.97,72398,7.223,1736764,591111,1145653,3.732,10.964,1459290,447302,1011988,2.824,9.212,277474,1.7519999999999998,18.424,47760,51106,225909
2017,44-45,583728,995473,15712204,15734487,73815,7.39,80703,8.079,1694506,525770,1168736,3.342,10.769,1736693,561049,1175644,3.5660000000000003,11.037,-42187,-0.268,21.539,49359,52226,237654
2018,44-45,579166,984771,15778845,15779999,66532,6.72,77058,7.782999999999999,1614855,465341,1149514,2.949,10.234,1623598,530202,1093396,3.36,10.289,-8743,-0.055,20.467,51397,55244,257135
1978,48-49,90142,109831,2428438,2343630,19083,17.643,15739,14.552,561680,194681,366999,8.307,23.966,393763,160296,233467,6.84,16.801,167917,7.165,33.603,10788,10839,56548
1979,48-49,93327,113543,2582118,2491264,19519,17.766,12162,11.07,513456,171660,341796,6.89,20.61,330884,115428,215456,4.633,13.282,182572,7.3279999999999985,26.564,8155,8201,35103
1980,48-49,93447,114790,2562411,2561565,17964,15.973,13310,11.835,419021,163517,255504,6.382999999999999,16.358,417825,108399,309426,4.232,16.311,1196,0.047,32.623000000000005,9773,9870,41575
1981,48-49,93320,115524,2504270,2523488,16275,14.303,12805,11.253,351022,127359,223663,5.047,13.91,389156,93095,296061,3.689,15.421,-38134,-1.511,27.82,8863,8914,36912
1982,48-49,91659,114826,2456691,2459872,16413,14.842,7937,7.1770000000000005,369046,139205,229841,5.659,15.003,375405,70199,305206,2.854,15.261,-6359,-0.259,30.005,5418,5494,30163
1983,48-49,92940,116022,2382703,2358194,17209,15.885,1832,1.6909999999999998,370862,129322,241540,5.484,15.727,322047,23920,298127,1.014,13.657,48815,2.07,27.313,994,1013,5986
1984,48-49,96465,119829,2514604,2394468,19379,17.357,3025,2.709,477857,134798,343059,5.63,19.957,238722,22676,216046,0.947,9.97,239135,9.987,19.939,2094,2103,9176
1985,48-49,98048,121634,2605301,2497950,19409,17.022000000000002,4193,3.677,475501,135783,339718,5.436,19.036,261379,31478,229901,1.26,10.464,214122,8.572000000000001,20.927,3156,3165,14531
1986,48-49,97628,121744,2644220,2567750,18830,16.436,4478,3.909,475785,157482,318303,6.132999999999999,18.529,322189,32557,289632,1.268,12.548,153596,5.982,25.095,3242,3247,15423
1987,48-49,101786,126311,2811086,2677310,22013,18.726,4499,3.827,572860,188735,384125,7.049,21.397,305260,44844,260416,1.675,11.402,267600,9.995,22.803,3220,3225,17872
1988,48-49,105309,132458,3000422,2909754,22837,17.688,16144,12.504,627802,220068,407734,7.563,21.576,442110,139096,303014,4.78,15.194,185692,6.3820000000000014,30.388,11826,11975,68217
1989,48-49,107530,135293,3084524,3021849,21395,16.129,16112,12.146,581813,198283,383530,6.562,19.254,459579,147384,312195,4.877,15.209,122234,4.045,30.417,11671,11897,70824
1990,48-49,109167,137514,3216853,3132329,20819,15.402,16141,11.941,582915,184932,397983,5.904,18.61,411932,124779,287153,3.984,13.151,170983,5.459,26.302,12145,12321,75526
1991,48-49,109144,138656,3187476,3178500,20874,15.245,17403,12.71,537378,189897,347481,5.974,16.907,517733,167063,350670,5.256,16.289,19645,0.618,32.577,12402,12621,96630
1992,48-49,111791,142510,3158399,3145872,20999,15.01,15775,11.276,514506,177730,336776,5.65,16.355,492185,123424,368761,3.923,15.645,22321,0.71,31.291,11287,11446,66634
1993,48-49,115663,146094,3202491,3180358,21201,14.692,17628,12.216,499140,143177,355963,4.502,15.694,454596,146373,308223,4.602,14.294,44544,1.401,28.588,12456,12659,79041
1994,48-49,119386,150997,3314878,3260593,23061,15.522,18202,12.252,528131,173339,354792,5.316,16.197,420513,148712,271801,4.561,12.897,107618,3.301,25.794,13228,13507,78077
1995,48-49,124547,157347,3496980,3401358,24595,15.965,18012,11.692,592053,182124,409929,5.354,17.406,402716,138574,264142,4.074,11.84,189337,5.567,23.68,13384,13648,79856
1996,48-49,127546,160858,3606274,3542020,23834,15.005999999999998,19785,12.456,584987,187791,397196,5.3020000000000005,16.516,456706,171318,285388,4.837,12.894,128281,3.622,25.788,14404,14649,83568
1997,48-49,130228,164285,3740663,3682110,24971,15.35,21750,13.37,643200,219265,423935,5.955,17.468,526727,185884,340843,5.048,14.305,116473,3.1630000000000003,28.61,15419,15688,96795
1998,48-49,133886,169745,3892379,3825242,25371,15.172,20320,12.152,647473,239733,407740,6.267,16.926,515275,177065,338210,4.629,13.47,132198,3.4560000000000004,26.941,14304,14652,82383
1999,48-49,137230,173526,4043102,3953861,25075,14.637,20651,12.054,675631,244966,430665,6.1960000000000015,17.088,495454,178591,316863,4.517,12.531,180177,4.557,25.062,14698,15095,94340
2000,48-49,138209,175689,4215303,4116948,24845,14.227,22728,13.015,728913,228015,500898,5.5379999999999985,17.705,534196,210081,324115,5.103,12.976,194717,4.73,25.951,15649,16258,90239
2001,48-49,139189,178099,4211720,4217457,24884,14.036,23261,13.12,620422,219057,401365,5.194,14.711,630735,208003,422732,4.932,14.955,-10313,-0.245,29.422,15972,16399,100993
2002,48-49,138587,177187,4032124,4111446,24071,13.517,25865,14.524,590102,229132,360970,5.573,14.353,746899,236613,510286,5.755,18.166,-156797,-3.814,28.705,16856,17427,122954
2003,48-49,138883,179132,3973002,4006904,25897,14.543,23777,13.352,734897,370336,364561,9.242,18.341,800537,225073,575464,5.617000000000001,19.979,-65640,-1.638,36.682,15904,16139,89650
2004,48-49,140478,182066,4116880,4055906,25427,14.078,22531,12.474,653540,243229,410311,5.997000000000001,16.113,533492,184779,348713,4.556,13.153,120048,2.96,26.307,15439,15702,85779
2005,48-49,143966,186131,4157775,4148328,26213,14.225,22497,12.209,575081,208616,366465,5.029,13.863,553483,164103,389380,3.956,13.342,21598,0.521,26.685,15281,15556,79378
2006,48-49,147841,191504,4323598,4247556,29795,15.79,24189,12.819,669587,253352,416235,5.965,15.764,518906,174740,344166,4.114,12.217,150681,3.547,24.433000000000003,17084,17409,89249
2007,48-49,150091,195277,4419528,4384941,28111,14.53,24494,12.66,691621,230126,461495,5.247999999999998,15.773,622508,217781,404727,4.967,14.196,69113,1.5759999999999998,28.393,16344,16537,81326
2008,48-49,148214,193994,4425269,4429225,25206,12.945,26639,13.681,578839,168645,410194,3.808,13.069,583581,193636,389945,4.372,13.175999999999998,-4742,-0.107,26.137,17891,18035,87823
2009,48-49,143145,189017,4156827,4303225,22142,11.543,27747,14.465,448428,175807,272621,4.085,10.421,745330,212354,532976,4.935,17.32,-296902,-6.9,20.841,18296,18676,109989
2010,48-49,139631,185309,4012676,4087386,21019,11.23,24736,13.216,464277,153927,310350,3.766,11.359000000000002,611471,198192,413279,4.849,14.96,-147194,-3.6010000000000004,22.718000000000004,15592,15874,76697
2011,48-49,142473,187838,4113946,4060877,25394,13.628,22402,12.022,530751,163332,367419,4.022,13.07,420394,141861,278533,3.4930000000000003,10.352,110357,2.718,20.705,14519,14707,64422
2012,48-49,145703,191075,4222973,4175028,24461,12.923,20864,11.023,525798,154324,371474,3.696,12.594,428503,138398,290105,3.315,10.263,97295,2.33,20.527,13659,13863,67887
2013,48-49,147304,192223,4275758,4248296,23052,12.025,22000,11.476,560760,156378,404382,3.681,13.2,507403,206389,301014,4.8580000000000005,11.944,53357,1.256,23.887,13857,14026,69233
2014,48-49,149358,195474,4405371,4341057,24039,12.4,20807,10.733,558459,166622,391837,3.838,12.865,429072,142381,286691,3.28,9.884,129387,2.9810000000000003,19.768,14106,14300,68198
2015,48-49,153823,201861,4595452,4501682,27581,13.882,21232,10.686,651601,205895,445706,4.574,14.475,463345,172785,290560,3.838,10.293,188256,4.182,20.585,14046,14230,66724
2016,48-49,156766,206486,4721293,4659241,26859,13.152,22326,10.932,608474,184366,424108,3.957,13.06,485725,185819,299906,3.988,10.425,122749,2.635,20.85,15840,16096,108322
2017,48-49,157518,207654,4886006,4800013,25017,12.079,23931,11.555,674245,204738,469507,4.265,14.047,496780,165784,330996,3.454,10.35,177465,3.697,20.699,16966,17231,79085
2018,48-49,161648,211736,4979595,4891986,26521,12.653,22267,10.623,641848,180388,461460,3.687,13.12,465629,145305,320324,2.97,9.518,176219,3.602,19.036,16976,17227,83266
1978,51,38383,62803,2136318,2075151,8442,13.671,6342,10.27,389064,102024,287040,4.916,18.749,266549,91690,174859,4.418,12.845,122515,5.904,25.69,3372,3490,31255
1979,51,40404,64460,2246347,2194700,8214,12.936,6290,9.906,419888,94471,325417,4.305,19.132,316617,93078,223539,4.2410000000000005,14.425999999999998,103271,4.705,28.853,2955,2988,21415
1980,51,41689,66445,2328330,2282108,8478,13.009,5925,9.092,499924,99432,400492,4.357,21.906,408395,68039,340356,2.9810000000000003,17.896,91529,4.011,35.791,3471,3587,30998
1981,51,44992,70029,2391364,2357670,9525,13.997,5566,8.179,454255,99807,354448,4.2330000000000005,19.267,389686,60210,329476,2.5540000000000003,16.528,64569,2.739,33.056999999999995,3045,3135,20265
1982,51,46476,72127,2463438,2429886,9437,13.355,6508,9.21,335142,108542,226600,4.467,13.793,272154,57972,214182,2.386,11.2,62988,2.592,22.401,4249,4327,28251
1983,51,47992,71838,2471574,2365733,9979,14.257,6288,8.984,714741,118131,(S),4.993,30.212,498635,60169,438466,2.543,21.077,216106,9.135,42.155,3969,4074,27232
1984,51,49831,76451,2559157,2450398,13641,18.722,6459,8.865,629399,356692,272707,14.556,25.686,401638,59264,342374,2.419,16.391,227761,9.295,32.781,4316,4403,27648
1985,51,50828,78162,2589512,2538094,11999,15.812,7446,9.812,504794,213970,290824,8.43,19.889,405714,105247,300467,4.147,15.985,99080,3.904,31.97,5124,5222,40722
1986,51,50075,75878,2524676,2495899,10156,13.573,8045,10.752,404713,134047,270666,5.371,16.215,351421,91264,260157,3.657,14.08,53292,2.135,28.16,5250,5334,36153
1987,51,45461,73245,2516872,2476750,12096,16.94,8417,11.788,509538,274544,234994,11.085,20.573,426331,96375,329956,3.891,17.213,83207,3.36,34.427,5415,5515,38425
1988,51,48044,77955,2611424,2562026,11139,14.719,6582,8.698,403718,177958,225760,6.9460000000000015,15.758,306307,81895,224412,3.196,11.956,97411,3.802,23.911,4353,4503,34869
1989,51,49672,81924,2647112,2598169,13563,17.261,6865,8.737,452051,164248,287803,6.322,17.399,350889,85744,265145,3.3,13.505,101162,3.894,27.01,4359,4484,33706
1990,51,50912,83483,2748194,2673085,11635,14.362,6694,8.263,438866,160690,278176,6.011,16.418,288576,78492,210084,2.9360000000000004,10.796,150290,5.622000000000001,21.591,4618,4686,34410
1991,51,50377,87307,2707411,2704145,14878,17.792,7511,8.982000000000003,441349,224067,217282,8.286,16.320999999999998,437434,98293,339141,3.635,16.176,3915,0.145,32.353,4900,5005,46313
1992,51,50508,88019,2656204,2698343,11556,13.51,6595,7.71,400376,160583,239793,5.9510000000000005,14.838,485956,110326,375630,4.089,18.009,-85580,-3.172,29.676,4073,4188,52927
1993,51,52303,89072,2691205,2683004,11310,12.769,10309,11.639,419388,148324,271064,5.528,15.630999999999998,402626,147317,255309,5.4910000000000005,15.007,16762,0.625,30.013,4828,4995,45222
1994,51,54489,92035,2718599,2705330,12589,13.888,9817,10.83,434946,154983,279963,5.729,16.077,411174,153072,258102,5.658,15.199000000000002,23772,0.879,30.397,5172,5358,48875
1995,51,57125,95519,2828558,2774437,13595,14.5,10080,10.751,488238,194781,293457,7.021,17.598,381910,127364,254546,4.591,13.765,106328,3.832,27.531,5352,5558,50304
1996,51,60030,99571,2896890,2860958,15753,16.14,11818,12.108,529508,213958,315550,7.479,18.508,457726,174521,283205,6.1,15.999,71782,2.509,31.998,5914,6173,50721
1997,51,61841,102002,3014900,2960010,15328,15.199000000000002,13027,12.917,611714,240845,370869,8.137,20.666,498982,192631,306351,6.507999999999999,16.857,112732,3.809,33.715,6773,6997,63579
1998,51,63112,107733,3174709,3103642,18059,17.208,12486,11.897,670676,281272,389404,9.063,21.609,525725,226292,299433,7.291,16.939,144951,4.67,33.878,6431,6717,57262
1999,51,64156,111383,3272148,3231502,18574,16.94,15095,13.767,691692,300768,390924,9.307,21.405,614144,261643,352501,8.097000000000001,19.005,77548,2.4,38.01,6885,7222,69587
2000,51,66611,115807,3482641,3433870,20788,18.27,16740,14.712,757346,336602,420744,9.802,22.055,653420,282146,371274,8.217,19.029,103926,3.026,38.057,7200,7901,78784
2001,51,66119,125282,3792630,3652752,26326,21.849,16739,13.893,874015,449162,424853,12.297,23.928,603536,251456,352080,6.884,16.523,270479,7.405,33.046,8031,8563,90520
2002,51,63652,125014,3705470,3835195,21680,17.262,22835,18.182,775120,431318,343802,11.246,20.211,1032666,374834,657832,9.774,26.926,-257546,-6.715,40.421,8695,9062,125051
2003,51,63521,125200,3593747,3639268,17587,14.074000000000002,17100,13.685,561854,225595,336259,6.199,15.439,656826,296030,360796,8.134,18.048,-94972,-2.61,30.877,7222,7441,64881
2004,51,63318,125918,3452506,3529253,18354,14.634,17358,13.84,555990,189572,366418,5.371,15.754,704200,253204,450996,7.174,19.953,-148210,-4.199,31.508000000000006,6660,6976,52537
2005,51,63158,127063,3391273,3420853,15850,12.538,14555,11.514,471817,181734,290083,5.313,13.792,531372,177805,353567,5.198,15.533,-59555,-1.741,27.585,6454,6864,57334
2006,51,63300,129978,3418090,3411751,18609,14.489,15515,12.08,531644,211205,320439,6.191,15.583,524033,171734,352299,5.034,15.36,7611,0.223,30.719,6607,6923,54782
2007,51,62403,128014,3447019,3443886,17273,13.438,18313,14.248,580580,217367,363213,6.312,16.858,574729,237213,337516,6.888,16.688,5851,0.17,33.376999999999995,6244,6498,53420
2008,51,62258,128176,3385492,3389369,15983,12.457,16250,12.665,527210,196668,330542,5.8020000000000005,15.555,539533,181450,358083,5.354,15.918,-12323,-0.364,31.11,6198,6299,54324
2009,51,61242,125138,3285039,3357282,16625,13.071,20734,16.301,426875,186596,240279,5.558,12.715,571528,186531,384997,5.556,17.024,-144653,-4.309,25.43,6567,6819,57359
2010,51,60134,123564,3120535,3197383,13184,10.605,14691,11.817,365273,150721,214552,4.714,11.424,516081,170064,346017,5.319,16.141,-150808,-4.717,22.848000000000006,5937,6067,38793
2011,51,59819,125115,3146537,3137404,16714,13.443,15140,12.177,467610,197336,270274,6.29,14.904000000000002,451413,154923,296490,4.938,14.388,16197,0.516,28.776,5627,5757,37732
2012,51,61173,125538,3236594,3222810,14620,11.586,15909,12.608,501011,162426,338585,5.04,15.546,478367,186073,292294,5.774,14.843,22644,0.703,29.686,5223,5456,35591
2013,51,60992,123550,3248488,3224096,14323,11.566,14894,12.027,508706,187944,320762,5.829,15.778,461550,189210,272340,5.869,14.316,47156,1.463,28.631,5717,5920,44384
2014,51,62205,127830,3330216,3294962,17954,14.268,13964,11.097,524851,183906,340945,5.581,15.929,453291,139920,313371,4.246,13.757,71560,2.172,27.514,5430,5553,35051
2015,51,62916,128327,3365619,3349651,13714,10.695,13505,10.532,459184,131004,328180,3.911,13.708,426327,137149,289178,4.0939999999999985,12.728,32857,0.981,25.455,5849,6140,47692
2016,51,64493,134747,3377307,3352761,17420,13.229,11288,8.572000000000001,454705,174678,280027,5.21,13.562,404418,139167,265251,4.151,12.062,50287,1.5,24.124,6020,6261,41881
2017,51,65556,137317,3342315,3376123,16986,12.357,17265,12.56,492621,164582,328039,4.875,14.591,561109,164275,396834,4.8660000000000005,16.62,-68488,-2.029,29.183000000000003,6669,6908,54127
2018,51,66579,139379,3444145,3415810,15071,10.89,13090,9.459,479004,168980,310024,4.947,14.023,421850,136613,285237,3.999,12.35,57154,1.673,24.7,7104,7596,52817
1978,52,146165,230936,4030219,3922972,26155,11.518,18445,8.123,692564,197952,494612,5.046,17.654,475631,184386,291245,4.7,12.124,216933,5.53,24.249,8642,8763,38253
1979,52,150938,243413,4049592,3901430,28988,12.474,6929,2.982,650032,229509,420523,5.882999999999999,16.660999999999998,354107,86775,267332,2.224,9.076,295925,7.585,18.153,1705,1751,10773
1980,52,152475,249186,4169735,4070620,24274,10.078,7603,3.157,548892,201781,347111,4.957,13.484000000000002,350287,91340,258947,2.244,8.605,198605,4.879,17.211,2257,2442,14847
1981,52,154317,254674,4308464,4211815,24605,9.971,8772,3.555,579709,219637,360072,5.215,13.764,386170,92743,293427,2.202,9.169,193539,4.595,18.337,2218,2355,11612
1982,52,156226,256103,4723483,4498768,23735,9.471,12766,5.0939999999999985,862902,483795,379107,10.754,19.181,415541,96125,319416,2.137,9.237,447361,9.944,18.474,5259,5532,22096
1983,52,165690,267533,4668630,4469607,34296,13.668,1077,0.429,782287,309533,472754,6.925,17.502,388655,6887,381768,0.154,8.696,393632,8.807,17.391,824,824,4166
1984,52,170282,274298,4826548,4638099,31842,12.249,3150,1.212,802931,282881,520050,6.099,17.312,426344,16705,409639,0.36,9.192,376587,8.119,18.384,2542,2543,12877
1985,52,167726,273146,4877500,4681494,29670,11.38,4827,1.851,812425,248567,563858,5.31,17.354,421798,27086,394712,0.579,9.01,390627,8.344,18.02,3943,3944,22392
1986,52,161486,263069,4935003,4725771,23595,9.308,4432,1.7480000000000002,833587,230117,603470,4.869,17.639,415265,23225,392040,0.491,8.787,418322,8.852,17.574,3451,3453,17906
1987,52,160613,265351,5042876,4839192,31542,12.535,4104,1.631,843583,282660,560923,5.841,17.432000000000002,432819,24249,408570,0.501,8.943999999999997,410764,8.488,17.887999999999995,3286,3286,18808
1988,52,173894,295794,5141006,5016798,40734,14.745,1643,0.595,837453,336617,500836,6.71,16.692999999999998,583305,9002,574303,0.179,11.627,254148,5.066,23.254,1278,1279,7031
1989,52,176030,303404,5335151,5141176,44185,15.511,7097,2.491,948079,411302,536777,8.0,18.441,570496,42788,527708,0.8320000000000001,11.097,377583,7.3439999999999985,22.193,2448,2449,13364
1990,52,179003,312625,5562051,5385587,37860,12.792,4535,1.5319999999999998,936716,350253,586463,6.504,17.393,582997,33492,549505,0.622,10.825,353719,6.568,21.65,3592,3598,22498
1991,52,177681,336908,5700839,5606736,55663,17.831,6173,1.977,1132518,612038,520480,10.916,20.199,952422,61365,891057,1.094,16.987000000000002,180096,3.212,33.974000000000004,4663,4685,47528
1992,52,180687,343066,5682950,5553817,36493,11.186,2822,0.865,971211,311960,659251,5.617000000000001,17.487000000000002,713759,17965,695794,0.32299999999999995,12.852,257452,4.636,25.703000000000007,1955,1956,10802
1993,52,184264,341665,5538870,5593655,35669,10.414,37335,10.901,953573,303623,649950,5.428,17.047,1069703,469121,600582,8.387,19.124,-116130,-2.076,34.095,14599,15423,127902
1994,52,185450,350413,5510735,5523898,44205,12.777,35345,10.216,1039887,446300,593587,8.079,18.825,1058022,518280,539742,9.383,19.154,-18135,-0.328,37.65,16710,17423,255969
1995,52,185672,356900,5389119,5446396,39366,11.133,32767,9.267,768313,304365,463948,5.587999999999999,14.107,879695,320936,558759,5.893,16.152,-111382,-2.045,28.214,16036,17285,157622
1996,52,188829,363598,5478526,5423658,39486,10.974,31905,8.867,879938,337282,542656,6.2189999999999985,16.224,768916,269564,499352,4.97,14.177,111022,2.047,28.354,14034,15141,82987
1997,52,195521,374615,5710578,5630555,50379,13.621,40893,11.056,1153911,472727,681184,8.396,20.494,987476,440330,547146,7.82,17.538,166435,2.9560000000000004,35.076,14235,15208,87443
1998,52,198887,381685,5785500,5746303,47833,12.673,39333,10.421,1096343,401281,695062,6.983,19.079,1032159,425064,607095,7.397,17.962,64184,1.117,35.924,13510,14281,77199
1999,52,201330,391456,5966763,5889549,51430,13.327,40361,10.458,1137278,437158,700120,7.422999999999999,19.31,988664,426430,562234,7.24,16.787,148614,2.523,33.574,14826,16505,103675
2000,52,203240,397957,5926471,5927538,51738,13.11,45124,11.434,1092272,449297,642975,7.58,18.427,1096438,446915,649523,7.54,18.497,-4166,-0.07,36.854,15909,17375,97393
2001,52,208230,401344,6212579,6083744,53321,13.318,51397,12.837,1284326,558144,726182,9.174,21.111,1012347,424475,587872,6.977,16.64,271979,4.471,33.28,16350,17759,98389
2002,52,211506,417641,6466491,6389528,55198,13.466,39726,9.692,1278317,536135,742182,8.391,20.006,1119008,412761,706247,6.46,17.512999999999998,159309,2.4930000000000003,35.026,16625,17457,118198
2003,52,216146,428858,6394866,6410120,55052,13.038,41851,9.911,1095108,421355,673753,6.573,17.084,1136026,413364,722662,6.449,17.722,-40918,-0.638,34.168,15263,16006,73051
2004,52,223616,436571,6446471,6434634,53684,12.403,46231,10.681,1115879,443489,672390,6.892,17.342,1097604,443731,653873,6.896,17.058,18275,0.284,34.116,15324,15907,80386
2005,52,228472,444017,6399018,6425034,59114,13.452,49984,11.374,1036430,476656,559774,7.419,16.131,1082219,472610,609609,7.356,16.844,-45789,-0.713,32.262,16796,17552,89988
2006,52,233739,463327,6599926,6495384,65945,14.565,44789,9.893,1190747,541925,648822,8.343,18.332,980593,399153,581440,6.145,15.097,210154,3.235,30.194000000000006,19426,19922,81571
2007,52,236646,476679,6642712,6662255,62119,13.186,50937,10.813,1122914,454169,668745,6.817,16.855,1162388,444510,717878,6.6720000000000015,17.447,-39474,-0.593,33.71,19351,20321,103716
2008,52,228664,471365,6462007,6531087,49224,10.399,53161,11.231,976046,389488,586558,5.964,14.945,1109936,428408,681528,6.56,16.995,-133890,-2.05,29.889,24100,25602,129715
2009,52,218159,455104,6161521,6283112,41130,8.907,54506,11.803,785658,320156,465502,5.096,12.504,1028097,329475,698622,5.244,16.363,-242439,-3.859,25.009,23673,25254,105675
2010,52,214301,444081,5912624,6034231,39158,8.717,49439,11.005,771974,290979,480995,4.822,12.793,1012562,334316,678246,5.54,16.78,-240588,-3.987,25.586,18101,19291,79537
2011,52,211265,439006,5892809,5898555,37832,8.568999999999999,42798,9.694,750487,251507,498980,4.2639999999999985,12.723,764667,250561,514106,4.248,12.964,-14180,-0.24,25.446,17056,17961,67885
2012,52,210757,443350,5984748,5944176,42782,9.708,37469,8.502,849261,287844,561417,4.842,14.287,770128,284223,485905,4.782,12.956,79133,1.331,25.912,14497,15220,56826
2013,52,211468,437268,6025719,5997216,35669,8.107999999999999,40978,9.315,774739,226207,548532,3.772,12.918,719198,255387,463811,4.258,11.992,55541,0.926,23.984,13939,14451,70031
2014,52,211857,440994,6092006,6073002,37801,8.618,33030,7.5310000000000015,773172,279159,494013,4.597,12.731,737989,200338,537651,3.299,12.152,35183,0.579,24.304,13950,14420,53787
2015,52,213043,442096,6105920,6073687,39086,8.859,37303,8.455,812379,253656,558723,4.176,13.375,744887,220579,524308,3.632,12.264,67492,1.111,24.528,14113,14753,57518
2016,52,214140,452405,6290881,6189304,42722,9.554,32204,7.202000000000001,864519,276074,588445,4.461,13.968,664889,199501,465388,3.2230000000000003,10.743,199630,3.225,21.485,14638,15310,63940
2017,52,214012,446458,6295298,6291936,34074,7.586,39527,8.8,859875,303350,556525,4.8210000000000015,13.666,854513,301821,552692,4.797,13.581,5362,0.085,27.162,15247,15897,66565
2018,52,213970,447615,6460189,6373226,37074,8.301,35134,7.866,936492,405048,531444,6.355,14.694,761220,212377,548843,3.332,11.944,175272,2.75,23.888,16554,17867,78262
1978,53,168607,177394,1014197,967016,30507,17.538,23613,13.575,297058,129044,168014,13.345,30.719,201870,99105,102765,10.249,20.876,95188,9.843,41.75100000000001,(S),(S),59388
1979,53,178133,188106,1108670,1034075,32198,18.408,5804,3.318,304747,125365,179382,12.123,29.471,156512,41420,115092,4.006,15.135,148235,14.335,30.271,3509,3556,16212
1980,53,177174,187547,1104024,1073215,28283,15.982,7116,4.021,265452,110009,155443,10.25,24.734,204848,48104,156744,4.482,19.087,60604,5.647,38.175,4511,4586,19574
1981,53,174957,185903,1127259,1090108,25623,14.495,7355,4.1610000000000005,263717,112840,150877,10.351,24.192,190771,41723,149048,3.827,17.5,72946,6.692,35.0,4287,4422,16648
1982,53,166730,178453,1114737,1097819,24342,14.026,14545,8.381,250747,105516,145231,9.611,22.84,217055,59007,158048,5.375,19.771,33692,3.069,39.543,11020,11101,34878
1983,53,169500,181564,1130940,1091429,27215,15.92,5981,3.499,260585,115209,145376,10.556,23.876,183526,32980,150546,3.022,16.815,77059,7.06,33.63,4071,4134,17928
1984,53,176818,191131,1266124,1167238,33757,18.938,8000,4.488,356282,173332,182950,14.85,30.524,155429,34292,121137,2.938,13.316,200853,17.208,26.632,5871,5956,23523
1985,53,180584,196005,1352665,1268207,34446,18.723,10383,5.644,355107,152481,202626,12.023,28.001,187653,48247,139406,3.804,14.797,167454,13.204,29.593000000000004,7781,7855,30922
1986,53,175778,192462,1374658,1305446,30138,16.503,10447,5.721,347123,137196,209927,10.51,26.59,208250,50102,158148,3.838,15.952,138873,10.638,31.905,7825,7930,34519
1987,53,180532,199499,1404181,1338259,36052,19.22,12198,6.502999999999999,375582,172681,202901,12.903,28.065,246013,80307,165706,6.001,18.383,129569,9.682,36.766,8519,8649,40153
1988,53,197455,220209,1538460,1458823,36458,17.631,9606,4.645,398252,185799,212453,12.736,27.3,238381,48820,189561,3.347,16.340999999999998,159871,10.959,32.681,7089,7319,32646
1989,53,200658,224978,1607790,1529615,35443,16.637999999999998,11544,5.419,391428,166015,225413,10.853,25.59,235605,55793,179812,3.648,15.403,155823,10.187,30.806,8507,8872,36901
1990,53,202282,228351,1671500,1600867,34005,15.561,14369,6.575,389749,174233,215516,10.884,24.346,249391,60397,188994,3.773,15.579,140358,8.767999999999999,31.157,11174,11526,47717
1991,53,192296,226126,1567513,1543988,36575,16.930999999999994,16382,7.582999999999998,376251,204877,171374,13.269,24.369,330064,85050,245014,5.507999999999999,21.377,46187,2.991,42.755,12365,12708,60200
1992,53,193579,229938,1567069,1535455,31280,14.182,12537,5.684,345690,148767,196923,9.689,22.514,281988,56804,225184,3.699,18.365,63702,4.149,36.73,8575,9011,37424
1993,53,198178,234559,1605360,1589220,30869,13.277,26746,11.504,349788,133553,216235,8.404,22.01,317593,127026,190567,7.9929999999999986,19.984,32195,2.026,39.968,18886,19316,77748
1994,53,201840,239979,1640706,1622465,32152,13.539,27131,11.425,345489,148960,196529,9.181,21.294,311958,125314,186644,7.724,19.227,33531,2.067,38.455,19401,20083,79534
1995,53,203986,244949,1687373,1662584,32717,13.494000000000002,27737,11.44,354420,152732,201688,9.186,21.317,304773,122670,182103,7.377999999999999,18.331,49647,2.986,36.663,20219,20897,82889
1996,53,204625,246802,1655887,1662627,30905,12.581,28608,11.646,324477,132714,191763,7.982,19.516,334703,125881,208822,7.5710000000000015,20.131,-10226,-0.615,39.032,20372,21300,87330
1997,53,206352,252816,1710527,1682248,34037,13.571,30031,11.973,387526,158528,228998,9.424,23.036,331979,152403,179576,9.059,19.734,55547,3.302,39.469,20944,21713,97763
1998,53,209010,256543,1786003,1761835,31617,12.390999999999998,28843,11.304,382577,148814,233763,8.447000000000001,21.715,333014,143173,189841,8.126,18.902,49563,2.813,37.803,18856,20108,88055
1999,53,211346,264493,1851681,1826638,35299,13.519,28528,10.925999999999998,385209,178163,207046,9.754,21.088,335504,140786,194718,7.707000000000002,18.367,49705,2.721,36.735,19759,20725,88734
2000,53,211493,265457,1909224,1885008,30872,11.645,30193,11.389,371307,146433,224874,7.768,19.698,320959,140844,180115,7.472,17.027,50348,2.6710000000000003,34.054,19400,20458,79034
2001,53,212534,270673,1959754,1941542,33020,12.295,28784,10.718,371844,157824,214020,8.129,19.152,334995,133388,201607,6.87,17.254,36849,1.898,34.508,19111,19855,77059
2002,53,218515,279892,1937302,1948988,35891,12.953,30259,10.921,375074,171188,203886,8.783,19.245,399570,158575,240995,8.136000000000001,20.501,-24496,-1.257,38.489,18989,19746,94753
2003,53,226023,288027,2036861,1998790,36483,12.839,28738,10.114,396800,152059,244741,7.608,19.852,321431,125662,195769,6.287000000000001,16.081,75369,3.771,32.163000000000004,18156,18700,69890
2004,53,233533,298198,2076443,2053521,39409,13.466,28335,9.682,369986,158783,211203,7.732,18.017,322292,128705,193587,6.268,15.695,47694,2.323,31.389,18467,19521,79100
2005,53,243017,312159,2114308,2096396,46599,15.286,31964,10.485,395172,196214,198958,9.36,18.85,359450,127709,231741,6.0920000000000005,17.146,35722,1.704,34.292,20871,21870,76247
2006,53,251224,326598,2180239,2144594,52391,16.408,37780,11.832,426119,201083,225036,9.376,19.869,354121,146493,207628,6.831,16.512,71998,3.357,33.025,26401,26867,91461
2007,53,251458,327478,2174188,2174018,45471,13.935,43147,13.222,419843,174591,245252,8.031,19.312,420403,170037,250366,7.8210000000000015,19.338,-560,-0.026,38.624,27747,28175,91621
2008,53,239489,317713,2133236,2149396,38728,12.007,48419,15.011,381563,153802,227761,7.1560000000000015,17.752,413968,177005,236963,8.235,19.26,-32405,-1.508,35.504,31524,31916,99398
2009,53,226684,305014,1998849,2080241,31881,10.185,47911,15.306,290073,124895,165178,6.004,13.944,454478,185192,269286,8.902000000000003,21.847,-164405,-7.903,27.888,28723,29151,92964
2010,53,223863,303058,1928323,1958491,34301,11.29,35816,11.789,290280,135469,154811,6.917000000000002,14.822,349929,143659,206270,7.335,17.867,-59649,-3.0460000000000003,29.643,21563,22003,68798
2011,53,220746,299010,1904500,1916176,34674,11.531,38067,12.659,289796,125565,164231,6.553,15.124,314551,148155,166396,7.732,16.416,-24755,-1.2919999999999998,30.247,20999,24366,81575
2012,53,223968,302358,1898796,1895425,36254,12.041,33724,11.201,346371,153021,193350,8.073,18.274,337942,129064,208878,6.809,17.829,8429,0.445,35.659,18036,18837,59439
2013,53,229304,307971,1940556,1921372,37687,12.364,31375,10.293,335189,142833,192356,7.434,17.445,297258,127484,169774,6.635,15.470999999999998,37931,1.974,30.942,17402,17801,58439
2014,53,234213,316845,2006440,1971080,38171,12.219,29272,9.37,344109,143997,200112,7.305,17.458,271115,112110,159005,5.688,13.755,72994,3.703,27.509,17932,18332,59684
2015,53,239671,324886,2060756,2034481,38318,11.946,30075,9.376,326762,134185,192577,6.596,16.061,274451,118075,156376,5.8039999999999985,13.49,52311,2.571,26.98,18730,19215,64367
2016,53,246001,335729,2102125,2075512,41764,12.647,30745,9.31,341716,153914,187802,7.416,16.464000000000002,290042,113777,176265,5.482,13.974,51674,2.49,27.949,19663,20010,67691
2017,53,252218,347130,2148060,2126307,44186,12.944,32675,9.572,353571,141494,212077,6.654,16.628,306959,120344,186615,5.66,14.436,46612,2.192,28.873,21243,21746,71018
2018,53,259636,354835,2213180,2179377,41479,11.82,33683,9.598,363425,140483,222942,6.4460000000000015,16.676,296906,121168,175738,5.56,13.623,66519,3.052,27.247,23196,23876,74099
1978,54,235184,249937,2202280,2102184,42625,17.652,25699,10.643,545018,210338,334680,10.006,25.926,345876,166175,179701,7.905,16.453,199142,9.473,32.906,17877,18163,103978
1979,54,252893,268528,2427814,2319325,44972,17.331,26888,10.362,542186,207450,334736,8.943999999999997,23.377,324270,134282,189988,5.79,13.981,217916,9.396,27.962,19512,19712,78319
1980,54,264151,280378,2533389,2491715,44608,16.253,32782,11.944,500911,194089,306822,7.789,20.103,415650,178030,237620,7.145,16.680999999999994,85261,3.422,33.363,24245,24394,93452
1981,54,277210,294892,2703692,2622668,46207,16.073,31377,10.915,550057,213682,336375,8.148,20.973000000000006,387658,131451,256207,5.012,14.781,162399,6.192,29.562,21715,21901,72738
1982,54,278221,296887,2616683,2579693,48843,16.746,38397,13.165,560928,236057,324871,9.151,21.744,487644,180346,307298,6.9910000000000005,18.903,73284,2.841,37.806,28525,28679,105769
1983,54,314513,335281,2923647,2888355,57688,17.867,32867,10.18,570728,241221,329507,8.352,19.76,501947,156783,345164,5.428,17.378,68781,2.381,34.757,23447,23699,96989
1984,54,335022,356548,3200857,3064857,60163,17.428,37501,10.863,716668,265117,451551,8.65,23.383000000000006,443997,170128,273869,5.551,14.487,272671,8.897,28.973000000000006,27560,27785,111154
1985,54,351403,373823,3462640,3328836,63603,17.457,44625,12.248,786908,291559,495349,8.759,23.639,517869,217980,299889,6.547999999999999,15.557,269039,8.082,31.114,33714,33951,150756
1986,54,367095,391293,3679165,3565088,64341,16.873,44426,11.65,801476,295866,505610,8.299,22.481,571585,213669,357916,5.9929999999999986,16.033,229891,6.448,32.066,33040,33238,145179
1987,54,385016,411885,3972781,3878478,66447,16.474,49355,12.237,882957,321347,561610,8.285,22.766,692828,281617,411211,7.261,17.863,190129,4.902,35.727,36197,36410,171579
1988,54,401018,430242,4248849,4130510,69793,16.57,51690,12.272,933820,356416,577404,8.629,22.608,698425,267553,430872,6.477,16.909000000000002,235395,5.699,33.818000000000005,38379,38762,165937
1989,54,412211,442851,4525152,4384349,66567,15.296,51239,11.774,985908,356206,629702,8.124,22.487,706153,295098,411055,6.731,16.105999999999998,279755,6.381,32.212,38356,38765,165728
1990,54,424031,456210,4765355,4647529,66176,14.757,50633,11.291,938732,333323,605409,7.1720000000000015,20.199,705150,251896,453254,5.42,15.173,233582,5.026,30.345,38525,38853,173422
1991,54,423111,459400,4673197,4689686,65745,14.486,54633,12.038,825179,312872,512307,6.671,17.596,860870,327329,533541,6.98,18.357,-35691,-0.7609999999999999,35.191,41216,41628,214282
1992,54,431870,469441,4641025,4626626,63211,13.64,51182,11.044,857513,304791,552722,6.587999999999999,18.534,823793,331496,492297,7.165,17.805,33720,0.7290000000000001,35.611,35999,36323,221163
1993,54,447282,484250,4826381,4776679,65564,13.776,48940,10.283,885079,304698,580381,6.379,18.529,790268,228840,561428,4.791,16.544,94811,1.985,33.089,34094,35891,138022
1994,54,463728,502384,4957471,4884451,68308,13.863,49006,9.946,892558,310384,582174,6.355,18.273,745066,244809,500257,5.012,15.254,147492,3.02,30.508000000000006,35347,35775,147944
1995,54,483572,524295,5191008,5068236,73275,14.299,49578,9.675,977511,364030,613481,7.183,19.287,730808,237654,493154,4.689,14.419,246703,4.868,28.839,36021,36481,143276
1996,54,501888,544487,5431497,5329383,75193,14.104,52447,9.838,1008506,359416,649090,6.744,18.924,805931,276944,528987,5.197,15.122,202575,3.801,30.245,38420,38881,158364
1997,54,518998,562463,5652670,5503479,80442,14.582,58821,10.663,1203893,423586,780307,7.697,21.875,903090,343486,559604,6.2410000000000005,16.409000000000002,300803,5.466,32.819,42043,42653,201681
1998,54,542549,588988,6214123,5966453,84618,14.695,58281,10.121,1367246,512739,854507,8.594,22.916,869393,315927,553466,5.295,14.571,497853,8.344,29.143,40183,40581,163603
1999,54,559919,610736,6583141,6411749,84336,14.065,62126,10.361,1340705,462836,877869,7.2189999999999985,20.91,995887,356818,639069,5.565,15.532,344818,5.377999999999999,31.064,43314,43894,190778
2000,54,571296,625332,6974856,6771093,82372,13.345999999999998,66159,10.719,1454785,506010,948775,7.473,21.485,1045005,393263,651742,5.808,15.433,409780,6.0520000000000005,30.867,45963,46552,200792
2001,54,584159,640843,7276186,7121592,86344,13.633,71324,11.262,1499032,520290,978742,7.306,21.049,1190220,428537,761683,6.017,16.713,308812,4.336,33.426,48820,49393,231756
2002,54,590196,652952,7040276,7168479,90934,14.014,82786,12.758,1419928,613060,806868,8.552,19.808,1679796,(S),987158,(S),23.433000000000003,-259868,-3.625,39.616,54433,55008,312788
2003,54,597800,661396,7141911,7108896,86207,13.113,78263,11.904000000000002,1313164,455325,857839,6.405,18.472,1253585,445847,807738,6.272,17.634,59579,0.838,35.268,52377,52907,227921
2004,54,610742,678168,7232381,7184936,89524,13.36,73390,10.952,1261069,457165,803904,6.363,17.552,1169733,448970,720763,6.249,16.28,91336,1.271,32.561,49626,50202,233277
2005,54,627833,696072,7390605,7317672,91690,13.332,75054,10.913,1288773,453027,835746,6.191,17.612000000000005,1137724,387924,749800,5.301,15.548,151049,2.064,31.095,50437,51043,210184
2006,54,647888,722571,7777098,7590287,107001,15.084,80629,11.366,1483193,526674,956519,6.939,19.541,1110819,417233,693586,5.497000000000001,14.635,372374,4.9060000000000015,29.269,56432,56919,235136
2007,54,657506,732969,7788152,7742816,95468,13.167,79608,10.98,1371814,450877,920937,5.823,17.717,1286274,449528,836746,5.806,16.612000000000002,85540,1.105,33.225,53759,54172,225037
2008,54,660549,736037,7900187,7840634,88470,12.037,86390,11.754,1338369,445390,892979,5.681,17.07,1213963,456107,757856,5.817,15.483,124406,1.587,30.966,58263,58726,225341
2009,54,648313,729216,7771643,7862371,83850,11.439,91513,12.484000000000002,1195994,466677,729317,5.936,15.212,1376422,464092,912330,5.903,17.506,-180428,-2.295,30.423,61658,62167,250598
2010,54,644247,728370,7703682,7749135,86625,11.887,87369,11.989,1153854,432607,721247,5.582999999999998,14.89,1246574,391280,855294,5.049,16.087,-92720,-1.197,29.78,56423,57012,210631
2011,54,645696,732521,7817154,7769225,89214,12.216,84734,11.603,1262390,403930,858460,5.199,16.249000000000002,1170669,423238,747431,5.448,15.068,91721,1.181,30.136,56034,56608,203023
2012,54,652855,737308,7899734,7852495,88110,12.01,80819,11.015999999999998,1290407,413502,876905,5.266,16.433,1193804,438574,755230,5.585,15.203,96603,1.23,30.406,51677,52284,209844
2013,54,660467,747116,8112366,7970849,91331,12.304,81702,11.007,1388924,530123,858801,6.651,17.425,1106963,414172,692791,5.1960000000000015,13.888,281961,3.537,27.775,52685,53004,211374
2014,54,667692,759347,8412878,8293177,93272,12.38,81449,10.81,1348106,457745,890361,5.52,16.256,1110026,362944,747082,4.376,13.385,238080,2.8710000000000004,26.77,54023,54634,196831
2015,54,673797,770641,8638445,8513822,93470,12.223,81641,10.675999999999998,1438178,520594,917584,6.115,16.892,1184877,405471,779406,4.763,13.917,253301,2.975,27.834,56186,56692,214847
2016,54,680320,781080,8778979,8669284,92619,11.938,82130,10.586,1302287,438887,863400,5.063,15.022,1083758,376245,707513,4.34,12.501,218529,2.521,25.002,59086,59676,229383
2017,54,683480,783953,8934704,8830392,86833,11.102,83244,10.643,1306274,374434,931840,4.24,14.793,1095635,440981,654654,4.994,12.408,210639,2.385,24.815,61053,61699,258198
2018,54,686978,786231,9216089,9104331,85594,10.903,83182,10.595999999999998,1307414,381812,925602,4.194,14.36,1083903,417572,666331,4.587,11.905,223511,2.455,23.811,65955,67271,260190
1978,55,18835,35415,2364453,2300369,4520,12.917,3675,10.502,539165,169761,369404,7.38,23.438,409795,122483,287312,5.324,17.814,129370,5.624,35.629,421,457,5431
1979,55,19894,36998,2510793,2442427,4730,13.064,3146,8.689,476592,169274,307318,6.931,19.513,338453,97085,241368,3.975,13.857,138139,5.6560000000000015,27.714,302,308,3637
1980,55,20456,38585,2605442,2557845,4520,12.008,2633,6.995,435392,149790,285602,5.856,17.022000000000002,338448,97239,241209,3.802,13.232,96944,3.79,26.464,363,392,4681
1981,55,21333,41058,2706293,2659617,5013,12.584,2570,6.4510000000000005,442831,158994,283837,5.978,16.65,349624,75055,274569,2.822,13.146,93207,3.505,26.291,351,362,4226
1982,55,22083,42667,2766875,2737171,4852,11.604,3145,7.521,538382,200797,337585,7.336,19.669,475376,119371,356005,4.3610000000000015,17.367,63006,2.302,34.735,468,481,5595
1983,55,22650,42538,2715940,2730201,4428,10.494000000000002,3740,8.863999999999997,451618,145615,306003,5.332999999999998,16.542,480030,105748,374282,3.873,17.582,-28412,-1.041,33.083,298,314,4041
1984,55,23391,43595,2822048,2761986,4524,10.607,2636,6.18,480803,150285,330518,5.441,17.408,360750,76630,284120,2.774,13.061,120053,4.347,26.123,394,408,5006
1985,55,23728,43776,2971387,2888703,4275,9.882,3241,7.492000000000001,550797,158827,391970,5.497999999999998,19.067,387705,116168,271537,4.021,13.421,163092,5.646,26.843000000000004,522,535,6957
1986,55,24059,44163,3025647,2988098,5093,11.762,3369,7.78,550636,187581,363055,6.278,18.428,474331,119648,354683,4.004,15.874,76305,2.5540000000000003,31.748,517,568,6049
1987,55,24020,43747,2976730,2996466,5303,12.262,4305,9.954,551311,177702,373609,5.93,18.399,592082,166141,425941,5.545,19.759,-40771,-1.361,36.797,526,556,9626
1988,55,25464,47163,3036287,3008226,8213,18.155,4361,9.64,647321,219551,427770,7.297999999999999,21.518,591395,175780,415615,5.843,19.659,55926,1.859,39.319,442,492,9432
1989,55,26500,49590,3159336,3093660,6859,14.309,3546,7.398,620752,242372,378380,7.834,20.065,492494,107605,384889,3.478,15.919,128258,4.146,31.839,559,586,9903
1990,55,27566,51802,3233682,3180213,6867,13.69,3581,7.1389999999999985,556198,187683,368515,5.902,17.489,448395,94731,353664,2.979,14.1,107803,3.39,28.199,625,651,8721
1991,55,28441,54328,3204695,3210672,6924,13.139,3664,6.9529999999999985,516271,188134,328137,5.86,16.08,528393,119806,408587,3.731,16.457,-12122,-0.378,32.16,694,718,7638
1992,55,28338,53264,3191270,3191839,4892,9.2,4708,8.854,563373,151543,411830,4.748,17.65,563139,124687,438452,3.906,17.643,234,0.006999999999999999,35.286,442,465,5804
1993,55,28213,51178,3137460,3166005,4540,8.7,6554,12.559,531591,137584,394007,4.346,16.791,590489,164135,426354,5.184,18.651,-58898,-1.86,33.581,860,905,12059
1994,55,28406,51174,3136996,3148617,4871,9.511,4953,9.671,476745,149824,326921,4.758,15.140999999999998,500428,146420,354008,4.65,15.894,-23683,-0.752,30.283,965,1022,13837
1995,55,28556,51726,3207995,3171350,5025,9.771,4433,8.619,528494,175024,353470,5.519,16.665,454966,123514,331452,3.895,14.345999999999998,73528,2.319,28.692,1010,1046,12767
1996,55,28235,51664,3183720,3188999,4851,9.41,4622,8.966000000000003,508205,150407,357798,4.716,15.936,519257,154447,364810,4.843,16.283,-11052,-0.34700000000000003,31.872,1023,1075,16028
1997,55,27804,50221,3177821,3189393,5062,9.941,6458,12.683,594592,171243,423349,5.369,18.643,613219,223181,390038,6.997999999999998,19.227,-18627,-0.584,37.286,1304,1406,24581
1998,55,28047,50203,3244225,3217932,5487,10.884,5910,11.723,617858,180006,437852,5.5939999999999985,19.2,565592,195945,369647,6.089,17.576,52266,1.624,35.153,1126,1198,17317
1999,55,28056,51439,3244237,3251947,6733,13.27,5332,10.509,570685,211006,359679,6.489,17.549,583195,189667,393528,5.832000000000002,17.934,-12510,-0.385,35.098,1282,1353,25691
2000,55,28199,52476,3291882,3275404,6504,12.518,5467,10.522,623843,215907,407936,6.5920000000000005,19.046,596809,186614,410195,5.697,18.221,27034,0.825,36.442,1271,1428,21540
2001,55,28118,52274,3284061,3295647,5658,10.804,5852,11.174,583607,195600,388007,5.935,17.708,607962,186797,421165,5.667999999999998,18.447,-24355,-0.7390000000000001,35.417,1308,1351,24377
2002,55,26438,46899,2791331,2896405,5297,11.052,7353,15.342,500585,171152,329433,5.909,17.283,708864,275546,433318,9.513,24.474,-208279,-7.191,34.566,1570,1725,(S)
2003,55,26441,46477,2789551,2811005,4768,10.196,5342,11.423,483404,142284,341120,5.062,17.197,521708,163162,358546,5.8039999999999985,18.559,-38304,-1.3630000000000002,34.394,1132,1201,16072
2004,55,26101,46470,2756159,2790194,4167,8.972000000000003,4115,8.86,422681,141561,281120,5.074,15.149,487747,161451,326296,5.7860000000000005,17.480999999999998,-65066,-2.332,30.298,1131,1194,20403
2005,55,25778,47475,2807540,2817392,4583,9.762,3529,7.517,415571,138422,277149,4.913,14.75,435852,121321,314531,4.306,15.47,-20281,-0.72,29.5,1062,1103,17215
2006,55,26141,48931,2908676,2892104,5492,11.365,4280,8.857000000000003,488562,153568,334994,5.31,16.893,457452,110543,346909,3.822,15.817,31110,1.0759999999999998,31.635,1089,1122,14602
2007,55,26043,49425,2846634,2823432,5784,11.744000000000002,5439,11.043,564901,171984,392917,6.091,20.008,512951,192575,320376,6.8210000000000015,18.168,51950,1.84,36.335,870,904,10848
2008,55,26358,49885,2894220,2947688,4455,8.904,4751,9.496,463294,132405,330889,4.492,15.717,572397,141844,430553,4.812,19.419,-109103,-3.701,31.434,981,1026,16283
2009,55,26668,49946,2803042,2842381,4278,8.523,4779,9.521,403513,136340,267173,4.797,14.196,482335,129109,353226,4.542,16.969,-78822,-2.773,28.393,986,1116,18080
2010,55,26631,49750,2823941,2828514,4056,8.112,4562,9.123,390771,122493,268278,4.331,13.815,398040,103400,294640,3.656,14.072,-7269,-0.257,27.631,907,976,15777
2011,55,26502,50403,2944738,2894385,4255,8.501,3551,7.095,469248,144554,324694,4.994,16.212,366957,85437,281520,2.952,12.678,102291,3.534,25.356,821,850,12484
2012,55,25903,51099,3030877,3013210,4697,9.21,4500,8.823,471031,107710,363321,3.575,15.632,434359,130014,304345,4.315,14.415,36672,1.217,28.83,817,862,11196
2013,55,25902,51178,3091965,3075173,3674,7.182,3629,7.0939999999999985,450809,112534,338275,3.659,14.66,420743,115974,304769,3.771,13.682,30066,0.978,27.364,636,655,7811
2014,55,26183,52287,3227848,3214127,4264,8.209,3572,6.877000000000002,435875,132602,303273,4.126,13.561,403970,86509,317461,2.692,12.569,31905,0.993,25.137,699,726,11861
2015,55,26491,52607,3323833,3289475,4265,8.135,3908,7.454,488309,145530,342779,4.424,14.845,420383,92113,328270,2.8,12.78,67926,2.065,25.559,697,732,10977
2016,55,26691,53789,3352436,3340554,4807,9.048,3484,6.558,444589,116848,327741,3.498,13.309,422732,93200,329532,2.79,12.655,21857,0.654,25.309,704,737,13627
2017,55,26324,54773,3472342,3402700,5125,9.421,4373,8.039,545239,135994,409245,3.997,16.024,408092,117364,290728,3.449,11.993,137147,4.0310000000000015,23.986,801,832,15339
2018,55,25928,53898,3582558,3527902,2484,4.574,3293,6.064,514190,128611,385579,3.646,14.575,402532,105521,297011,2.991,11.41,111658,3.165,22.82,899,932,15850
1978,56,106356,119314,1943160,1813545,25901,22.671,15764,13.798,635715,232071,403644,12.797,35.054,375965,144904,231061,7.99,20.731,259750,14.323,41.462,11533,11605,75897
1979,56,116008,129665,2191260,2068746,27109,21.842,16008,12.898,635397,222227,413170,10.742,30.714,390906,141397,249509,6.835,18.896,244491,11.818,37.792,11691,11779,74718
1980,56,123103,138076,2296931,2247279,26903,20.118,18202,13.611,559129,207001,352128,9.211,24.88,460705,129558,331147,5.765,20.501,98424,4.38,41.00100000000001,13868,13938,78326
1981,56,131080,147219,2336658,2312193,27488,19.291,18035,12.657,546472,211642,334830,9.153,23.634,497221,139228,357993,6.021,21.504,49251,2.13,43.00899999999999,12828,12953,73390
1982,56,142634,160925,2565526,2522485,29287,18.8,18999,12.196,604996,214726,390270,8.512,23.984,519842,145336,374506,5.7620000000000005,20.608,85154,3.3760000000000003,41.217,14272,14336,83172
1983,56,138703,155766,2401072,2379751,29277,19.448,18829,12.507,569616,193651,375965,8.137,23.936,525669,155616,370053,6.539,22.089,43947,1.847,44.178,14027,14141,94887
1984,56,148495,166335,2759864,2578823,31718,19.872,18273,11.448,756567,219861,536706,8.526,29.338,392869,131381,261488,5.095,15.234000000000002,363698,14.103,30.469,14062,14162,83771
1985,56,156763,175722,3161160,2954060,34251,20.224,21522,12.708,918450,269476,648974,9.122,31.091,503962,173588,330374,5.876,17.06,414488,14.031,34.12,16777,16935,118853
1986,56,163831,184174,3429497,3281046,35252,19.834,22373,12.588,904166,318027,586139,9.693,27.557,608426,187014,421412,5.7,18.544,295740,9.014,37.087,16945,17051,119115
1987,56,173706,195390,3541581,3443479,39102,20.759,25044,13.296,982688,377087,605601,10.951,28.538,785279,271865,513414,7.895,22.805,197409,5.733,45.61,18546,18832,147589
1988,56,185186,209708,3870269,3711542,41225,20.432,25345,12.561,1142663,437181,705482,11.779000000000002,30.787,823091,288388,534703,7.77,22.177,319572,8.61,44.353,19180,19376,161308
1989,56,194312,221486,4220353,4038529,41633,19.471,26301,12.300999999999998,1176941,425002,751939,10.524,29.143,816960,274646,542314,6.801,20.229,359981,8.914,40.458,20115,20359,167847
1990,56,203102,231898,4549343,4384903,41632,18.51,27679,12.306,1211455,423828,787627,9.666,27.628,883051,289853,593198,6.61,20.138,328404,7.489,40.277,21186,21498,177802
1991,56,208170,239356,4511613,4518314,40651,17.36,30270,12.927,1101275,435940,665335,9.648,24.374,1113383,376814,736569,8.34,24.642,-12108,-0.268,48.747,22820,23152,250243
1992,56,208854,241334,4716217,4617883,39421,16.631,30822,13.003,1209354,443305,766049,9.6,26.188,1009226,350230,658996,7.584,21.855,200128,4.334,43.709,22493,22736,209119
1993,56,218487,250649,5100455,4900043,41362,16.939,28440,11.647,1382783,438597,944186,8.951,28.22,979451,348850,630601,7.119,19.989,403332,8.231,39.977,20424,20921,203983
1994,56,227773,261525,5556715,5331342,43366,17.073,28312,11.147,1468147,464861,1003286,8.719,27.538,1018316,351493,666823,6.593,19.101,449831,8.437000000000001,38.201,21445,21815,233300
1995,56,239769,275949,6097579,5835372,46773,17.542,28142,10.555,1602617,581753,1020864,9.969,27.464,1076603,342336,734267,5.867000000000001,18.45,526014,9.014,36.899,21459,21965,224596
1996,56,241111,279832,6287632,6098316,46482,17.075,31252,11.481,1626901,553944,1072957,9.084,26.678,1253822,414109,839713,6.791,20.56,373079,6.1179999999999986,41.12,23175,23583,247138
1997,56,251853,294442,6932641,6676323,50136,17.493,34476,12.029000000000002,1949742,736426,1213316,11.03,29.204,1437752,494601,943151,7.407999999999999,21.535,511990,7.669,43.07,24690,25126,277320
1998,56,257986,305184,7700487,7359836,47660,16.015,32487,10.916,2025623,685574,1340049,9.315,27.523000000000003,1333351,427763,905588,5.812,18.117,692272,9.406,36.233,23208,23733,235933
1999,56,258761,308398,8243686,7972342,43932,14.464,34586,11.387,2161867,705510,1456357,8.849,27.117,1606678,539768,1066910,6.771,20.153,555189,6.964,40.306,24209,24702,281222
2000,56,258399,309795,9009740,8652273,42461,13.861,35525,11.597,2324312,659750,1664562,7.625,26.864,1617603,617703,999900,7.1389999999999985,18.696,706709,8.168,37.391,23770,24241,245710
2001,56,263490,317494,8927966,9014354,43954,14.073,33613,10.762,2042387,669117,1373270,7.422999999999999,22.657,2225032,696077,1528955,7.722,24.683000000000003,-182645,-2.026,45.31399999999999,22549,22999,264635
2002,56,251021,302745,8353310,8638676,44133,14.664,40549,13.474,2047992,714379,1333613,8.27,23.707,2630727,871628,1759099,10.09,30.453000000000007,-582735,-6.746,47.414,24709,25348,397010
2003,56,254031,302855,8248115,8301280,42983,14.187,43203,14.26,1868004,516126,1351878,6.2170000000000005,22.503,1964096,679526,1284570,8.186,23.66,-96092,-1.158,45.005,26230,26668,310926
2004,56,261529,310842,8433060,8380658,45665,14.84,39405,12.806,1851995,538545,1313450,6.426,22.098000000000006,1764715,637126,1127589,7.602,21.057,87280,1.041,42.114,25319,25879,280906
2005,56,267570,317684,8959748,8714009,46400,14.754,40027,12.727,2061249,637668,1423581,7.318,23.654,1566674,553419,1013255,6.351,17.979,494575,5.676,35.958,26011,26400,311025
2006,56,276272,332016,9663602,9325107,54863,16.877,40983,12.607,2281483,738060,1543423,7.915,24.466,1609951,542188,1067763,5.814,17.265,671532,7.2010000000000005,34.529,28685,29014,294813
2007,56,280068,336794,9746571,9720863,48316,14.482,41989,12.585,1966490,597482,1369008,6.146,20.23,1921217,591191,1330026,6.082000000000002,19.764,45273,0.466,39.528,26926,27247,307046
2008,56,278987,337854,9635027,9649647,46230,13.73,43954,13.054,1898515,615048,1283467,6.374,19.674,1941900,614794,1327106,6.371,20.124,-43385,-0.45,39.349,28688,29079,299576
2009,56,274045,332758,8593939,9134310,40760,12.118,47935,14.252,1358316,478054,880262,5.234,14.87,2445138,604238,1840900,6.615,26.769,-1086822,-11.898,29.741,29284,29666,316120
2010,56,270773,328693,8620711,8618471,40207,12.158,44234,13.376,1626425,456684,1169741,5.299,18.871,1624009,510090,1113919,5.919,18.843,2416,0.028,37.687,26592,27150,249832
2011,56,270370,328889,9051389,8835565,41769,12.709,41316,12.571,1867001,403212,1463789,4.564,21.131,1423579,476627,946952,5.394,16.112000000000002,443422,5.019,32.224000000000004,25377,25863,221487
2012,56,275942,333539,9438887,9223660,41490,12.539,36162,10.929,1759039,399543,1359496,4.332,19.071,1327137,439990,887147,4.77,14.388,431902,4.683,28.777,22655,23018,237457
2013,56,275374,338432,9933195,9764228,44350,13.212,38857,11.575,1784556,447540,1337016,4.583,18.276,1447017,458938,988079,4.7,14.82,337539,3.457,29.639,23704,23951,217946
2014,56,276728,342101,10150359,9962692,42610,12.548,37535,11.054,1952233,504216,1448017,5.061,19.595,1586995,564915,1022080,5.67,15.929,365238,3.666,31.859,23158,23461,216947
2015,56,279370,346361,10637218,10422694,43354,12.602,38675,11.242,1795607,453177,1342430,4.348,17.227999999999998,1362280,427536,934744,4.102,13.07,433327,4.158,26.141,23250,23509,228806
2016,56,286659,357739,10933886,10850816,45565,12.93,34878,9.897,1896588,549071,1347517,5.06,17.479,1727238,573462,1153776,5.285,15.918,169350,1.561,31.836,23711,23928,240885
2017,56,288580,356930,11101083,11004958,40013,11.194,41083,11.493,1944235,517295,1426940,4.7010000000000005,17.667,1751653,571895,1179758,5.197,15.917,192582,1.75,31.834,26139,26518,270611
2018,56,292239,357618,11325312,11173135,39446,11.041,38775,10.853,1793742,462072,1331670,4.136,16.054000000000002,1481192,430233,1050959,3.851,13.257,312550,2.797,26.513,27940,28292,229292
1978,61,29461,31402,1242160,1167944,4305,13.986,3062,9.948,269512,33072,236440,2.832,23.076,123397,57896,65501,4.957,10.565,146115,12.51,21.131,2252,2285,(S)
1979,61,29708,31668,1298235,1248932,4019,12.899,2998,9.622,197332,27220,170112,2.1790000000000003,15.8,97675,(S),76165,(S),7.8210000000000015,99657,7.979,15.640999999999998,2221,2259,14156
1980,61,28120,30118,1272876,1295320,3382,11.0,4637,15.082,142377,18045,124332,1.393,10.992,187798,(S),91767,(S),14.498,-45421,-3.507,21.983,2651,2671,15398
1981,61,28389,30443,1339312,1310130,3352,11.084,2952,9.761,154120,25139,128981,1.919,11.764,95425,19460,75965,1.485,7.284,58695,4.48,14.567,2095,2122,10735
1982,61,30350,32771,1444391,1387130,5731,18.256,2973,9.471,220335,104947,115388,7.566,15.884,104415,17098,87317,1.233,7.527,115920,8.357000000000001,15.055,2232,2246,10269
1983,61,30880,33083,1470336,1440358,4111,12.769,2337,7.258999999999999,153679,30304,123375,2.104,10.67,93890,11888,82002,0.825,6.519,59789,4.151,13.037,1709,1749,7878
1984,61,32217,34521,1497957,1472325,4473,13.329,2548,7.593,157805,27558,130247,1.872,10.718,106802,13339,93463,0.906,7.254,51003,3.464,14.508,1966,1993,10039
1985,61,32538,34946,1518624,1495942,4274,12.432,3142,9.139,175037,27649,147388,1.848,11.701,129148,24229,104919,1.62,8.633,45889,3.068,17.266,2430,2451,10801
1986,61,32921,35617,1568251,1541598,4414,12.657,2926,8.39,175406,29427,145979,1.909,11.378,122074,14987,107087,0.972,7.919,53332,3.46,15.837,2255,2292,10723
1987,61,33434,37000,1611225,1579707,4442,12.225,3111,8.562000000000001,180692,32853,147839,2.08,11.438,116889,20285,96604,1.284,7.399,63803,4.039,14.799,2356,2384,13231
1988,61,35179,39128,1684661,1661342,5019,13.197,2826,7.431,179879,34884,144995,2.1,10.827,133308,17117,116191,1.03,8.024,46571,2.803,16.048,2106,2141,12391
1989,61,36584,40768,1746048,1704219,5118,12.9,2929,7.382999999999999,199686,42938,156748,2.52,11.717,115871,17565,98306,1.031,6.799,83815,4.918,13.598,2181,2238,12740
1990,61,38230,42602,1818846,1772545,5481,13.265,2918,7.062,209157,54704,154453,3.0860000000000003,11.8,116447,18121,98326,1.022,6.569,92710,5.23,13.139,2170,2211,12192
1991,61,40764,45354,1879417,1850386,5463,12.33,3370,7.606,193806,43639,150167,2.358,10.474,136936,24995,111941,1.351,7.4,56870,3.073,14.800999999999998,2408,2476,17868
1992,61,41138,46458,1941365,1903126,5505,12.162,3118,6.888,198081,35465,162616,1.864,10.408,121142,17292,103850,0.909,6.365,76939,4.043,12.731,2208,2256,12429
1993,61,42823,48105,2010877,1966881,5773,12.315,3320,7.082000000000002,219292,50813,168479,2.583,11.149,130910,19789,111121,1.006,6.6560000000000015,88382,4.494,13.311,2359,2416,13699
1994,61,44987,50358,2071896,2039276,6409,13.089,3619,7.391,198149,37247,160902,1.826,9.717,133232,19067,114165,0.935,6.533,64917,3.1830000000000003,13.067,2650,2783,13476
1995,61,47067,52715,2129382,2094692,6598,12.873,3680,7.18,200025,42162,157863,2.013,9.549,130846,19249,111597,0.919,6.247000000000001,69179,3.303,12.493,2768,2860,14754
1996,61,48793,54610,2105680,2083597,6830,12.82,4166,7.819,185975,42719,143256,2.05,8.926,141896,21892,120004,1.051,6.81,44079,2.116,13.62,3236,3288,15928
1997,61,50205,56352,2198837,2151720,6791,12.323,4300,7.803,226834,43965,182869,2.043,10.542,132013,21477,110536,0.998,6.135,94821,4.407,12.27,3243,3278,15591
1998,61,51774,57986,2333986,2284261,6546,11.515,4272,7.515,244443,50388,194055,2.206,10.701,144706,24068,120638,1.054,6.335,99737,4.3660000000000005,12.67,3114,3146,14153
1999,61,52938,59467,2425859,2376559,6659,11.423,4315,7.402,241390,54679,186711,2.301,10.157,144180,22201,121979,0.934,6.067,97210,4.09,12.134,3161,3222,15011
2000,61,54395,61425,2542910,2484500,6779,11.259,4350,7.225,263161,58855,204306,2.369,10.592,146107,20207,125900,0.813,5.881,117054,4.711,11.761,3131,3195,14547
2001,61,54325,61474,2468712,2424080,6912,11.48,4385,7.282999999999999,241482,51552,189930,2.127,9.962,151199,24870,126329,1.026,6.237,90283,3.724,12.475,3152,3200,16682
2002,61,58509,65995,2717010,2661103,7866,12.192,4910,7.61,316786,80959,235827,3.042,11.904000000000002,205079,33105,171974,1.244,7.707000000000002,111707,4.198,15.413,3192,3313,20209
2003,61,60496,67874,2782966,2736610,7911,11.923,4868,7.3370000000000015,298141,54200,243941,1.981,10.895,206207,28997,177210,1.06,7.535,91934,3.359,15.07,3367,3453,19199
2004,61,62758,70265,2882857,2816723,7921,11.524,4858,7.068,293165,63382,229783,2.25,10.408,160615,24539,136076,0.871,5.702000000000001,132550,4.706,11.404000000000002,3466,3519,17281
2005,61,63584,71745,2890720,2866008,8827,12.605,5392,7.7,295729,96872,198857,3.38,10.319,248251,26302,221949,0.918,8.662,47478,1.6569999999999998,17.324,3789,3828,17764
2006,61,65731,74876,2979804,2922457,9906,13.59,5940,8.149,316538,88198,228340,3.018,10.831,201543,29367,172176,1.005,6.896,114995,3.935,13.793,4483,4547,20957
2007,61,68312,77868,3043161,3003465,8958,11.755,5636,7.396,285540,70071,215469,2.333,9.507,207312,31590,175722,1.052,6.902,78228,2.605,13.805,3967,4001,18254
2008,61,69508,79328,3123887,3071990,8547,10.948,6029,7.723,284679,57244,227435,1.863,9.267,181025,31794,149231,1.035,5.893,103654,3.374,11.786,4394,4473,22509
2009,61,70374,80397,3188018,3143366,8230,10.354,6403,8.056000000000001,280569,55308,225261,1.76,8.926,192075,37724,154351,1.2,6.11,88494,2.815,12.220999999999998,4592,4637,26829
2010,61,70954,81621,3265118,3217936,8770,10.904000000000002,6381,7.934,293356,72271,221085,2.246,9.116,198973,31571,167402,0.981,6.183,94383,2.9330000000000003,12.366,4389,4428,20497
2011,61,72369,83224,3384123,3315314,9001,10.997,6249,7.635,341301,81225,260076,2.45,10.295,203611,29461,174150,0.889,6.142,137690,4.1530000000000005,12.283,4366,4415,18487
2012,61,74688,85831,3458828,3407790,9224,10.966,5786,6.879,312690,64129,248561,1.882,9.176,209372,31095,178277,0.912,6.144,103318,3.032,12.288,3980,4021,18338
2013,61,76893,88332,3506685,3478622,9289,10.704,6194,7.1370000000000005,288174,64528,223646,1.855,8.283999999999999,231234,38293,192941,1.101,6.647,56940,1.6369999999999998,13.295,4267,4355,25327
2014,61,78105,89688,3560342,3518828,8931,10.111,6211,7.032,315165,85198,229967,2.421,8.957,229964,32988,196976,0.937,6.535,85201,2.421,13.07,4423,4478,21236
2015,61,79985,91936,3637574,3584398,9794,10.861,6273,6.956,303480,62575,240905,1.746,8.467,198217,28701,169516,0.8009999999999999,5.53,105263,2.937,11.06,4635,4806,20910
2016,61,81747,93595,3661847,3626332,9719,10.568,6455,7.019,299341,65730,233611,1.813,8.255,227326,40299,187027,1.111,6.269,72015,1.986,12.538,4759,4873,25748
2017,61,83237,94774,3705599,3671445,9635,10.309,7011,7.501,303817,62559,241258,1.704,8.275,234112,37857,196255,1.031,6.377000000000002,69705,1.899,12.753,5148,5406,27381
2018,61,84730,96129,3734942,3704990,9127,9.618,6660,7.018,284844,58777,226067,1.586,7.688,224020,32707,191313,0.883,6.046,60824,1.642,12.093,5484,5565,26992
1978,62,313542,339943,5529897,5266650,41236,12.493,21518,6.519,1008695,308855,699840,5.864,19.152,480496,202149,278347,3.838,9.123,528199,10.029,18.247,14736,14945,104548
1979,62,329524,357992,5862138,5692404,38943,11.151,21435,6.138,854407,274016,580391,4.814,15.01,515512,195038,320474,3.426,9.056,338895,5.9529999999999985,18.112,15319,15507,112280
1980,62,338280,368534,6016377,5959346,39029,10.747,28285,7.789,767220,272339,494881,4.57,12.874,648520,267428,381092,4.488,10.882,118700,1.992,21.765,18460,18696,131649
1981,62,354322,387000,6398992,6213278,41468,10.974,23246,6.152,902180,335556,566624,5.401,14.52,527861,188430,339431,3.033,8.496,374319,6.025,16.991,15356,15547,102455
1982,62,373917,409271,6784796,6605838,50244,12.594,29586,7.416,1028190,447778,580412,6.779,15.565,671137,221458,449679,3.352,10.16,357053,5.405,20.32,21530,22096,142633
1983,62,391385,430208,7377657,7058305,45823,10.921,24569,5.856,1284753,714492,570261,10.123,18.202,639191,169277,469914,2.398,9.056,645562,9.146,18.112,17371,17724,105471
1984,62,404821,445753,7701729,7557475,43897,10.024,28255,6.452000000000001,1064023,491390,572633,6.502000000000002,14.079,778260,192226,586034,2.544,10.298,285763,3.781,20.596,20933,21271,129597
1985,62,413674,456320,8047862,7817762,45303,10.049,34310,7.6110000000000015,1362444,649153,713291,8.304,17.428,905775,272886,632889,3.491,11.586,456669,5.841,23.172,26351,26775,175856
1986,62,423477,471495,8531807,8336684,49216,10.61,33961,7.3210000000000015,1246204,511799,734405,6.1389999999999985,14.948,854218,226444,627774,2.716,10.246,391986,4.702,20.493,25281,25630,153044
1987,62,430547,483201,9234015,9325582,49135,10.286,38066,7.9689999999999985,1787453,924497,862956,9.914,19.167,(S),294613,(S),3.159,(S),(S),-1.96,(S),27865,28211,189165
1988,62,438511,496924,9454241,9305891,49938,10.19,36231,7.393,1355323,511365,843958,5.495,14.564,1061736,394930,666806,4.244,11.409,293587,3.155,22.819000000000006,26224,26734,236236
1989,62,446635,509708,9889150,9658995,49402,9.816,36497,7.252000000000002,1333883,453632,880251,4.6960000000000015,13.81,871211,337976,533235,3.499,9.02,462672,4.79,18.039,27291,27954,207856
1990,62,455726,523503,10410304,10173855,48838,9.452,35256,6.823,1304941,409425,895516,4.024,12.826,831953,300393,531560,2.9530000000000003,8.177,472988,4.649,16.355,26813,27389,179810
1991,62,459490,533923,10714827,10560164,48837,9.24,38065,7.202000000000001,1301497,429494,872003,4.067,12.325,990070,370381,619689,3.507,9.376,311427,2.949,18.751,28730,29306,245454
1992,62,467036,547092,11363074,11061193,49019,9.069,35880,6.638,1654480,571479,1083001,5.167000000000002,14.958,1050625,318858,731767,2.883,9.498,603855,5.459,18.997,25167,25679,196935
1993,62,474409,557941,11722443,11542578,48488,8.777000000000001,37515,6.791,1499609,455421,1044188,3.946,12.992,1146962,417180,729782,3.614,9.937,352647,3.055,19.874,26546,27223,187451
1994,62,478398,569178,12043747,11889438,49906,8.847000000000003,39801,7.055,1403680,486504,917176,4.092,11.806,1092389,372873,719516,3.136,9.188,311291,2.6180000000000003,18.376,29278,30230,224016
1995,62,481412,578793,12349196,12183195,51650,8.999,41910,7.302,1504572,530049,974523,4.351,12.35,1173032,414622,758410,3.403,9.628,331540,2.721,19.257,31162,32198,255665
1996,62,479977,583441,12394803,12314073,52086,8.976,45723,7.88,1483223,540452,942771,4.3889999999999985,12.045,1318297,458430,859867,3.723,10.706,164926,1.339,21.411,33057,34249,270901
1997,62,481687,596254,12838471,12687635,60726,10.272,50528,8.547,1943093,729911,1213182,5.752999999999999,15.315,1639890,588123,1051767,4.635,12.925,303203,2.39,25.85,34547,35776,332364
1998,62,487007,605598,13603739,13465823,53490,8.878,47270,7.846,1744763,572534,1172229,4.252,12.957,1466225,505986,960239,3.758,10.888,278538,2.068,21.777,31637,32795,258869
1999,62,486439,607514,13661747,13647470,53123,8.759,51039,8.416,1668124,558558,1109566,4.093,12.223,1642602,665032,977570,4.873,12.036,25522,0.187,24.072,33071,34677,296243
2000,62,489757,614005,13997388,13840525,54606,8.937000000000003,48629,7.959,1751525,600185,1151340,4.336,12.655,1441642,548227,893415,3.961,10.416,309883,2.239,20.832,30235,31735,252826
2001,62,494303,623772,14307012,14131219,57997,9.388,45961,7.44,1712882,551887,1160995,3.905,12.121,1362612,487760,874852,3.452,9.643,350270,2.479,19.285,28677,29893,229336
2002,62,512098,651064,14814048,14642636,71466,11.154000000000002,50723,7.917000000000002,2158257,795527,1362730,5.433,14.74,1821835,688794,1133041,4.704,12.442,336422,2.298,24.884,29492,30619,357281
2003,62,525005,664512,15319885,15069200,59578,9.06,45737,6.955,1930866,537941,1392925,3.57,12.813,1428226,457829,970397,3.0380000000000003,9.478,502640,3.3360000000000003,18.956,27961,29425,219326
2004,62,536396,679336,15658483,15482509,58502,8.707,43563,6.484,1682402,499590,1182812,3.227,10.866,1332872,411239,921633,2.656,8.609,349530,2.258,17.218,29223,30211,220221
2005,62,548331,696473,15902893,15805379,62089,9.018,46152,6.7029999999999985,1659563,541351,1118212,3.425,10.5,1467281,417984,1049297,2.645,9.283,192282,1.217,18.567,31137,32011,221889
2006,62,557402,716021,16387002,16159292,71120,10.068,51843,7.338999999999999,1863761,671222,1192539,4.154,11.534,1405911,457684,948227,2.832,8.7,457850,2.833,17.401,35964,36869,259934
2007,62,564073,729742,16732042,16547557,66872,9.258,52062,7.207000000000002,1982840,613298,1369542,3.706,11.983,1614102,482085,1132017,2.9130000000000003,9.754,368738,2.228,19.509,32255,33257,245895
2008,62,570173,738822,17120325,16923641,62087,8.457,52680,7.176,1934498,530722,1403776,3.136,11.431,1548004,506546,1041458,2.9930000000000003,9.147,386494,2.2840000000000003,18.294,32649,33452,246204
2009,62,577925,751878,17470289,17320345,60032,8.04,49608,6.644,1784740,517881,1266859,2.99,10.304,1480273,473248,1007025,2.732,8.546,304467,1.758,17.093,32456,33374,286277
2010,62,583951,767394,17724525,17600687,62663,8.249,47207,6.214,1698803,578310,1120493,3.286,9.652,1449540,378178,1071362,2.149,8.236,249263,1.416,16.471,30923,31809,209454
2011,62,587224,776326,17996874,17851408,59040,7.652,49508,6.417000000000002,1686042,483725,1202317,2.71,9.445,1394062,399587,994475,2.238,7.809,291980,1.636,15.619000000000002,32860,33929,232425
2012,62,590772,780976,18263909,18104748,59606,7.659,54236,6.9689999999999985,1919402,548701,1370701,3.031,10.602,1603962,463891,1140071,2.562,8.859,315440,1.742,17.719,32905,35436,265131
2013,62,594023,788836,18436980,18329550,61936,7.894,53359,6.801,1861032,523183,1337849,2.854,10.153,1646896,480407,1166489,2.6210000000000004,8.985,214136,1.168,17.97,34844,35639,275879
2014,62,597393,801872,18677489,18526507,66524,8.362,53875,6.772,1820690,592007,1228683,3.195,9.827,1514230,442862,1071368,2.39,8.173,306460,1.654,16.347,36336,37554,258725
2015,62,599241,819883,19105922,18904431,74440,9.18,56539,6.972,2140184,745087,1395097,3.941,11.321,1735861,507904,1227957,2.687,9.182,404323,2.139,18.365,38117,39155,271410
2016,62,603805,836403,19617748,19366395,71656,8.651,55350,6.683,2068307,614189,1454118,3.1710000000000003,10.68,1563602,462303,1101299,2.387,8.074,504705,2.6060000000000003,16.148,39247,40405,291439
2017,62,605650,842383,20106093,19869230,70931,8.454,64306,7.664,2365203,610126,1755077,3.071,11.904000000000002,1895643,629751,1265892,3.169,9.541,469560,2.363,19.081,41169,42659,328906
2018,62,599751,839693,20500445,20334148,65640,7.848,58995,7.0539999999999985,2151502,646984,1504518,3.182,10.581,1815670,532489,1283181,2.619,8.929,335832,1.652,17.858,41569,43250,303964
1978,71,43157,45299,659140,623170,7796,17.684,5369,12.179,171891,63335,108556,10.163,27.583,99935,37979,61956,6.0939999999999985,16.037,71956,11.547,32.073,3926,3943,23316
1979,71,45394,47560,713119,687769,7834,16.903,5409,11.671,176338,54842,121496,7.974,25.639,125564,41391,84173,6.018,18.257,50774,7.3820000000000014,36.51300000000001,3979,4004,26914
1980,71,45889,48309,720142,717273,7556,15.800999999999998,6578,13.755999999999998,146012,53652,92360,7.48,20.357,140254,46926,93328,6.542000000000002,19.554,5758,0.8029999999999999,39.108,4515,4542,28236
1981,71,47594,50123,749834,734900,7546,15.349,5623,11.438,156223,59662,96561,8.118,21.258000000000006,125478,35284,90194,4.801,17.074,30745,4.184,34.148,3797,3825,20709
1982,71,49119,52157,763692,745603,9433,18.536,6900,13.559,168022,67416,100606,9.042,22.535,131955,40068,91887,5.374,17.698,36067,4.837,35.396,5142,5167,29080
1983,71,53297,56427,779749,771122,10363,18.998,6603,12.105,162606,68795,93811,8.921,21.087,144760,45255,99505,5.869,18.773,17846,2.314,37.545,4834,4890,30546
1984,71,55004,58193,816304,796310,10287,18.033,7989,14.005,174658,64087,110571,8.048,21.933000000000003,134725,47475,87250,5.9620000000000015,16.919,39933,5.015,33.837,6092,6147,32435
1985,71,56926,60145,858896,838246,10739,18.208,8408,14.255999999999998,205583,76238,129345,9.095,24.525,163904,64386,99518,7.681,19.553,41679,4.972,39.106,6431,6494,50372
1986,71,58501,62191,896043,876112,10947,17.942,8590,14.079,198453,76861,121592,8.773,22.652,158466,55623,102843,6.349,18.087,39987,4.564,36.175,6418,6458,39124
1987,71,59553,64219,954338,932085,11443,18.154,9071,14.390999999999998,221807,85884,135923,9.214,23.797,177422,59850,117572,6.421,19.035,44385,4.762,38.07,6902,6925,43239
1988,71,63371,68114,996217,976512,13188,19.905,9467,14.289,228023,86399,141624,8.847999999999997,23.351,188248,71073,117175,7.278,19.278,39775,4.073,38.555,7056,7155,48041
1989,71,65916,70950,1055434,1028379,12562,18.044,9896,14.215,232964,81952,151012,7.9689999999999985,22.654,177815,64267,113548,6.249,17.291,55149,5.363,34.582,7570,7684,47428
1990,71,66366,71338,1116081,1085043,10811,15.214,10256,14.433,234463,76766,157697,7.075,21.609,172123,66522,105601,6.131,15.863,62340,5.745,31.726,7832,7926,48869
1991,71,63473,68519,1108958,1102562,9485,13.800999999999998,9901,14.406,207761,79578,128183,7.218,18.843,195660,70578,125082,6.401,17.746,12101,1.098,35.492,7645,7784,51618
1992,71,64049,69161,1147178,1128862,9707,14.137,8716,12.693,239432,81667,157765,7.234,21.21,201560,83989,117571,7.44,17.855,37872,3.355,35.71,6326,6383,44971
1993,71,66072,71272,1200690,1173856,9982,14.206,7975,11.349,240559,87303,153256,7.437,20.493,186290,58299,127991,4.966,15.87,54269,4.623,31.74,5793,5862,41046
1994,71,68365,73843,1268107,1236592,10553,14.534,8085,11.135,253761,95689,158072,7.737999999999999,20.521,190057,62987,127070,5.0939999999999985,15.369000000000002,63704,5.152,30.739,6015,6141,46496
1995,71,70809,76587,1339284,1300124,10745,14.287,7986,10.619000000000002,267206,104061,163145,8.004,20.552,188479,59304,129175,4.561,14.497,78727,6.055,28.994,5982,6065,42843
1996,71,72239,78179,1380313,1353987,10576,13.717,8417,10.917,264200,101115,163085,7.468,19.513,211491,63797,147694,4.712,15.62,52709,3.893,31.24,6332,6397,48368
1997,71,74833,80910,1509250,1480812,10433,12.993,9212,11.472,284949,100294,184655,6.773,19.243,229145,85632,143513,5.783,15.474,55804,3.768,30.949,6732,6787,58132
1998,71,76572,82808,1570838,1542429,10421,12.706,8833,10.77,287437,100005,187432,6.484,18.635,229556,77739,151817,5.04,14.883,57881,3.753,29.766,6098,6200,49439
1999,71,77738,84283,1618910,1591287,10146,12.136,8779,10.501,278350,85557,192793,5.377000000000002,17.492,220959,71047,149912,4.465,13.886,57391,3.607,27.771,6259,6333,48411
2000,71,78721,85318,1729429,1673507,9913,11.674,9114,10.733,320846,91378,229468,5.46,19.172,208296,71437,136859,4.269,12.447,112550,6.725,24.893,6292,6515,47303
2001,71,78672,85486,1743315,1728057,10038,11.8,9198,10.813,266329,87126,179203,5.042,15.412,236668,76901,159767,4.45,13.696,29661,1.716,27.391,6460,6531,50027
2002,71,80524,87762,1776216,1764166,11704,13.393,10959,12.54,316348,112734,203614,6.39,17.932000000000006,292870,95441,197429,5.41,16.601,23478,1.331,33.202,7137,7249,65391
2003,71,83250,90618,1833081,1806974,12616,14.132,9925,11.118,330048,100537,229511,5.564,18.265,277406,80861,196545,4.475,15.352,52642,2.9130000000000003,30.704,6758,6815,52244
2004,71,86679,94243,1884908,1860723,13370,14.45,9939,10.742,295851,98280,197571,5.282,15.9,248671,76628,172043,4.118,13.364,47180,2.536,26.728,6902,6940,47702
2005,71,89349,97047,1940152,1919557,13605,14.217,10899,11.389,311002,116656,194346,6.077000000000001,16.202,270438,76918,193520,4.007,14.089,40564,2.113,28.177,7665,7716,52020
2006,71,91479,99663,1980746,1958149,15001,15.261,12272,12.484000000000002,306241,113378,192863,5.79,15.639,260887,84628,176259,4.322,13.323,45354,2.316,26.646,9163,9215,62902
2007,71,92640,101409,2033088,2018900,13812,13.741,12024,11.962,308155,99312,208843,4.919,15.264,280746,85304,195442,4.225,13.906,27409,1.358,27.812,8672,8724,54806
2008,71,92210,100991,2061802,2042412,12573,12.425,12974,12.821,297356,90803,206553,4.4460000000000015,14.559,257720,88163,169557,4.317,12.618,39636,1.941,25.237,9317,9378,56360
2009,71,91002,100125,2007603,2039036,11349,11.257,12736,12.633,245215,81642,163573,4.004,12.026,309030,83226,225804,4.082,15.156,-63815,-3.13,24.052,9200,9258,60141
2010,71,89980,99439,1995086,2002688,11116,11.153,11574,11.613,242595,90552,152043,4.522,12.113,258697,69715,188982,3.4810000000000003,12.917,-16102,-0.804,24.227,8198,8278,51675
2011,71,89834,99446,1994365,1995470,11514,11.589,11332,11.406,250158,81844,168314,4.101,12.536,253250,72599,180651,3.638,12.691,-3092,-0.155,25.073,8013,8086,48007
2012,71,90992,100766,2063201,2021670,12161,12.169,10495,10.502,295957,91845,204112,4.543,14.639,212693,65818,146875,3.256,10.521,83264,4.119,21.041,7209,7279,43239
2013,71,92345,102153,2109583,2085907,12033,11.864,10574,10.425999999999998,278495,96733,181762,4.637,13.351,230466,68097,162369,3.265,11.049,48029,2.303,22.097,7334,7361,44607
2014,71,93802,104289,2167757,2132357,12630,12.233,10542,10.211,291676,102459,189217,4.805,13.679,219665,70729,148936,3.317,10.302,72011,3.377,20.603,7580,7664,49795
2015,71,95956,106785,2230232,2195108,13229,12.535,10735,10.172,288646,96094,192552,4.378,13.15,217813,74441,143372,3.391,9.923,70833,3.227,19.845,7638,7703,51450
2016,71,99126,110498,2310971,2267862,14425,13.273,10794,9.932,307492,100061,207431,4.412,13.559,219440,72607,146833,3.202,9.676,88052,3.883,19.352,8108,8172,54020
2017,71,101750,114036,2377389,2344509,15056,13.411,11520,10.261,330680,111440,219240,4.753,14.104,264457,87249,177208,3.721,11.28,66223,2.825,22.56,8688,8731,56929
2018,71,104365,116653,2432683,2403957,14326,12.422,11672,10.121,315884,110802,205082,4.609,13.14,257268,76331,180937,3.175,10.702,58616,2.438,21.404,9394,9533,59487
1978,72,285947,339855,5155025,4878801,62558,18.61,55158,16.409000000000002,1550021,821321,728700,16.834,31.771,997323,538919,458404,11.046,20.442,552698,11.329,40.884,38333,38922,301859
1979,72,292495,350671,5501683,5343777,60868,17.596,51369,14.85,1444243,780143,664100,14.599,27.027,1131655,503205,628450,9.417,21.177,312588,5.85,42.354,35982,36530,291732
1980,72,290586,353304,5630341,5596111,57117,16.223,54638,15.519,1340652,736474,604178,13.16,23.957,1271199,502336,768863,8.977,22.716,69453,1.241,45.432,40951,41635,333361
1981,72,291963,357445,5748529,5679805,53347,15.015,49017,13.797,1260378,680978,579400,11.989,22.191,1123386,436467,686919,7.685,19.779,136992,2.412,39.557,33015,33760,256612
1982,72,287204,356326,5861374,5807020,54260,15.204,55349,15.51,1365775,701313,664462,12.077,23.519,1251651,510159,741492,8.785,21.554,114124,1.965,43.108,41246,41900,333067
1983,72,298319,369172,5992951,5927603,60070,16.56,47199,13.012,1355055,720148,634907,12.149,22.86,1221915,500381,721534,8.442,20.614,133140,2.246,41.228,33091,33864,294755
1984,72,302930,376246,6389032,6198478,61617,16.529,54708,14.675,1496291,779679,716612,12.579,24.14,1115457,543276,572181,8.765,17.996,380834,6.144,35.991,40173,40902,330767
1985,72,301993,378185,6699441,6550359,63017,16.701,61279,16.241,1626655,869042,757613,13.267,24.833,1325870,667003,658867,10.183,20.241,300785,4.592,40.482,45560,46633,413295
1986,72,305162,387150,7098769,6907608,67917,17.748,58950,15.405,1774340,1017912,756428,14.736,25.687,1392281,619748,772533,8.972000000000003,20.156,382059,5.5310000000000015,40.312,42694,43638,400138
1987,72,309646,400464,7431015,7284596,72875,18.492,60132,15.258,1836709,1015610,821099,13.942,25.214,1546269,709097,837172,9.734,21.227,290440,3.987,42.453,43982,44925,443629
1988,72,315609,411869,7660672,7554949,69534,17.107,58726,14.448,1798383,944487,853896,12.502,23.804,1595029,668333,926696,8.846,21.112,203354,2.692,42.225,40926,41998,409644
1989,72,321334,421947,7953269,7810220,67787,16.257,57823,13.868,1761687,907246,854441,11.616,22.556,1474161,661263,812898,8.467,18.875,287526,3.681,37.75,41998,43368,423730
1990,72,325281,429155,8148206,8051569,65895,15.484000000000002,58741,13.803,1698727,868950,829777,10.792,21.098000000000006,1505153,647757,857396,8.045,18.694000000000006,193574,2.404,37.38800000000001,42878,44086,423821
1991,72,324633,431037,7965464,8050651,62656,14.595,59148,13.778,1503607,825765,677842,10.257,18.677,1671755,673651,998104,8.368,20.765,-168148,-2.089,37.354,42773,44272,449448
1992,72,329661,437942,8132891,8072076,63288,14.533,58352,13.4,1611980,808247,803733,10.013,19.97,1494326,667258,827068,8.266,18.512,117654,1.4580000000000002,37.025,39131,40204,385825
1993,72,338101,445442,8244674,8185107,61406,13.902,53909,12.205,1573741,771357,802384,9.424,19.227,1451914,594684,857230,7.265,17.738,121827,1.4880000000000002,35.477,36429,37636,344252
1994,72,343694,452840,8555545,8419897,61950,13.777,55575,12.36,1677970,890308,787662,10.574000000000002,19.929,1405973,594275,811698,7.058,16.698,271997,3.23,33.396,39763,41154,386432
1995,72,350275,464299,8845931,8693282,65870,14.365,54394,11.862,1781546,933143,848403,10.734000000000002,20.493,1479397,631862,847535,7.268,17.018,302149,3.4760000000000004,34.035,39544,40941,392622
1996,72,354781,473286,9027434,8922028,65779,14.043,56047,11.965,1740993,959969,781024,10.76,19.513,1528352,642161,886191,7.197,17.13,212641,2.383,34.26,41024,42279,405368
1997,72,357486,480599,9233124,9152604,69234,14.497,63189,13.231,1893762,1017267,876495,11.115,20.691,1727464,727546,999918,7.949,18.874,166298,1.817,37.74800000000001,44115,45708,440568
1998,72,360637,482844,9440606,9364657,58384,12.105,57317,11.884,1808867,847393,961474,9.049,19.316,1647563,695834,951729,7.43,17.593,161304,1.722,35.187,37719,38828,358631
1999,72,360594,484945,9637231,9546075,57399,11.862,55325,11.433,1749318,882904,866414,9.249,18.325,1569531,650869,918662,6.818,16.442,179787,1.883,32.883,36915,38929,372670
2000,72,359526,485829,9906929,9778551,54291,11.188,53166,10.956,1745927,808996,936931,8.273,17.855,1487607,595787,891820,6.093,15.213,258320,2.642,30.426,35930,37794,343252
2001,72,362200,491228,9986898,9961685,57286,11.706,53548,10.942,1651894,796278,855616,7.9929999999999986,16.582,1606068,626193,979875,6.2860000000000005,16.122,45826,0.46,32.245,35695,37514,364291
2002,72,367816,500985,10067545,10070157,68582,13.823,58890,11.87,1894792,995975,898817,9.89,18.816,1889682,695899,1193783,6.9110000000000005,18.765,5110,0.051,37.53,38010,39400,387422
2003,72,376687,511771,10432976,10249296,65088,12.851,54483,10.757,1925614,885572,1040042,8.64,18.788,1560038,607412,952626,5.926,15.220999999999998,365576,3.567,30.442,36318,37326,331901
2004,72,386254,521072,10714457,10577094,64318,12.45,55429,10.729,1848551,860748,987803,8.138,17.477,1582168,601611,980557,5.688,14.958,266383,2.518,29.917,38304,39427,358123
2005,72,398006,537449,11029719,10887656,71281,13.442,56992,10.747,1962041,1014326,947715,9.316,18.021,1684086,605303,1078783,5.56,15.468,277955,2.553,30.936,42139,43288,400118
2006,72,407630,552978,11413560,11233669,78509,14.392,63551,11.65,2071042,1077586,993456,9.592,18.436,1712252,660138,1052114,5.876,15.242,358790,3.194,30.484,49765,50782,459268
2007,72,415103,568468,11605338,11540367,76551,13.651,61181,10.91,2069011,1034545,1034466,8.965,17.928,1929892,683338,1246554,5.921,16.723,139119,1.205,33.446,43377,44363,410837
2008,72,418566,575862,11869345,11746524,70050,12.239,63070,11.019,2050958,944889,1106069,8.044,17.46,1815326,671596,1143730,5.7170000000000005,15.454,235632,2.006,30.908,45485,46452,430323
2009,72,419417,579754,11433401,11669728,64452,11.136,62446,10.79,1602028,833122,768906,7.1389999999999985,13.728,2074136,655274,1418862,5.615,17.774,-472108,-4.046,27.456,45828,47056,435312
2010,72,424932,587335,11295042,11366825,62400,10.696,54478,9.338,1492578,754021,738557,6.634,13.130999999999998,1627150,518141,1109009,4.558,14.315,-134572,-1.1840000000000002,26.262,39401,40475,340272
2011,72,430085,594675,11548797,11433130,61576,10.419,54233,9.176,1600912,746134,854778,6.526,14.002,1366564,486680,879884,4.257,11.953,234348,2.05,23.905,40488,41591,341279
2012,72,438456,602040,11973551,11787213,64131,10.719,56646,9.468,1836167,793443,1042724,6.731,15.578,1460101,559390,900711,4.746,12.387,376066,3.19,24.774,39075,40296,354007
2013,72,445396,612934,12369916,12172307,67883,11.179,56525,9.308,1927071,871163,1055908,7.157,15.832,1526455,603551,922904,4.958,12.54,400616,3.2910000000000004,25.081,41222,42253,369355
2014,72,450640,620212,12776063,12583602,64971,10.541,57292,9.295,1887527,860875,1026652,6.841,15.0,1500159,566612,933547,4.503,11.922,387368,3.0780000000000003,23.843000000000004,43376,44490,393560
2015,72,455987,626607,13189863,12980732,63643,10.21,57093,9.159,2037381,926851,1110530,7.14,15.695,1620881,640115,980766,4.931,12.487,416500,3.209,24.974,39475,40753,405068
2016,72,466950,645065,13691226,13448509,68632,10.793,50269,7.905,2055369,989451,1065918,7.357,15.283,1573454,560237,1013217,4.166,11.7,481915,3.583,23.4,37682,38777,382753
2017,72,475346,657382,13999548,13842397,68765,10.558,56630,8.695,2194284,991798,1202486,7.165,15.852,1890814,698534,1192280,5.046,13.66,303470,2.192,27.319000000000006,39278,40817,427871
2018,72,482867,665241,14293350,14144173,62943,9.518,55084,8.33,2061798,864087,1197711,6.109,14.577,1763970,646290,1117680,4.569,12.470999999999998,297828,2.106,24.943,42132,44561,471720
1978,81,430201,463149,3161810,3014955,62072,13.617,47478,10.415,766928,243825,523103,8.087,25.437,471356,185808,285548,6.1629999999999985,15.634,295572,9.804,31.268,33799,34154,114748
1979,81,434635,468994,3279771,3203728,59670,12.959,42607,9.253,658802,232152,426650,7.246,20.564,507625,163841,343784,5.114,15.845,151177,4.7189999999999985,31.69,31280,31607,110623
1980,81,431195,467368,3224211,3270644,53310,11.433,51169,10.973,558888,201465,357423,6.16,17.088,652864,215819,437045,6.599,19.961,-93976,-2.873,34.176,36320,36628,123084
1981,81,432747,469689,3260616,3240505,50782,10.879,44955,9.631,577533,213884,363649,6.6,17.822,537231,165549,371682,5.109,16.579,40302,1.244,33.157,31043,31509,98803
1982,81,446685,484619,3436558,3354452,68521,14.4,50936,10.705,742724,345294,397430,10.294,22.141,576261,178476,397785,5.3210000000000015,17.179000000000002,166463,4.962,34.358000000000004,36672,36993,117230
1983,81,456780,496510,3438509,3395184,62748,12.925,40697,8.383,630654,238262,392392,7.018,18.575,546074,160895,385179,4.739,16.084,84580,2.491,32.168,29138,29606,110075
1984,81,504732,544901,3742374,3585251,96176,18.546,43521,8.392000000000001,807296,333380,473916,9.299,22.517,492549,158658,333891,4.425,13.738,314747,8.779,27.476,32439,32940,111821
1985,81,512798,553525,3909211,3808115,69845,12.811,53178,9.754,766041,261800,504241,6.875,20.116,565056,207034,358022,5.437,14.838,200985,5.278,29.676,39414,39988,152615
1986,81,520286,563160,4029170,3951535,68779,12.405,51337,9.259,750347,280725,469622,7.104,18.989,595324,195316,400008,4.9430000000000005,15.066,155023,3.923,30.131,37273,37880,138472
1987,81,525038,569627,4049319,3987719,70257,12.518,53520,9.536,764340,286206,478134,7.1770000000000005,19.167,641237,222900,418337,5.59,16.08,123103,3.087,32.161,38779,39276,150125
1988,81,539707,586768,4208387,4125105,70134,12.167,49417,8.573,793663,297188,496475,7.204,19.24,627863,194601,433262,4.717,15.220999999999998,165800,4.019,30.441,36233,36800,134028
1989,81,550138,600529,4399011,4289914,70328,11.914,49841,8.443999999999999,829340,306861,522479,7.153,19.332,612876,204247,408629,4.761,14.286,216464,5.046,28.573,37495,38483,146012
1990,81,559024,610813,4529777,4459277,67679,11.232,51155,8.49,794100,275004,519096,6.167000000000002,17.808,653056,208352,444704,4.672,14.645,141044,3.1630000000000003,29.29,38807,39530,148564
1991,81,565981,621304,4514913,4517305,64252,10.438,52807,8.578,733494,266962,466532,5.91,16.237000000000002,737628,229538,508090,5.081,16.329,-4134,-0.092,32.475,39345,40072,170046
1992,81,573034,630252,4561014,4528820,62809,10.056,51503,8.246,753967,245399,508568,5.419,16.648,689640,202946,486694,4.481,15.228,64327,1.42,30.456,35780,36327,136564
1993,81,580051,636079,4635647,4580778,60180,9.559,47151,7.489,746234,222971,523263,4.868,16.291,637913,183734,454179,4.011,13.925999999999998,108321,2.365,27.852,33509,34219,120788
1994,81,588057,644008,4712546,4670355,61446,9.639,48320,7.58,748376,239668,508708,5.1320000000000014,16.024,662267,190388,471879,4.077,14.18,86109,1.844,28.36,34775,35641,131475
1995,81,597479,654125,4870331,4787035,63056,9.766,46164,7.15,776777,248974,527803,5.2010000000000005,16.227,608579,173005,435574,3.614,12.713,168198,3.514,25.426,34306,35256,126757
1996,81,604643,662445,4973068,4902937,63200,9.653,47789,7.298999999999999,777260,253258,524002,5.165,15.853,635107,187297,447810,3.82,12.954,142153,2.899,25.907,35577,36414,135986
1997,81,599083,656070,4916388,4851048,62030,9.53,51619,7.931,801328,248256,553072,5.118,16.519000000000002,672138,223213,448925,4.601,13.856,129190,2.6630000000000003,27.711,36832,37726,142699
1998,81,605558,663809,5037421,4982334,61571,9.371,48097,7.32,792952,258496,534456,5.188,15.915,680700,200088,480612,4.016,13.662,112252,2.253,27.325,33577,34521,126891
1999,81,606377,665709,5134092,5076499,57165,8.652999999999999,46962,7.109,760933,234483,526450,4.619,14.989,646544,199419,447125,3.928,12.736,114389,2.253,25.472,33402,34278,129454
2000,81,606098,665924,5276292,5198662,55547,8.391,47624,7.194,789365,233676,555689,4.495,15.184,635040,197489,437551,3.799,12.215,154325,2.969,24.431,32878,33914,125720
2001,81,594953,655509,5246158,5199752,54139,8.304,47024,7.212999999999999,738372,221219,517153,4.254,14.2,646053,193731,452322,3.726,12.425,92319,1.775,24.849,33032,33766,126163
2002,81,607545,669591,5265641,5245932,63145,9.532,48806,7.3679999999999986,831151,287168,543983,5.474,15.844,791682,224197,567485,4.274,15.091,39469,0.752,30.183000000000003,32926,33454,139909
2003,81,614031,675857,5357725,5295900,60473,9.044,46017,6.8820000000000014,814104,234866,579238,4.435,15.372,690598,187484,503114,3.54,13.04,123506,2.332,26.08,31923,32719,120756
2004,81,615171,678091,5403111,5358294,57344,8.527000000000001,46168,6.865,765729,237848,527881,4.439,14.291,676681,187508,489173,3.499,12.629,89048,1.662,25.257,33966,34480,125800
2005,81,618637,681746,5348587,5371642,60721,8.984,49034,7.255,719497,243469,476028,4.532,13.394,766217,188028,578189,3.5,14.264,-46720,-0.87,26.789,35217,35888,129410
2006,81,615002,678722,5411720,5363074,65094,9.649,56950,8.441,779871,270177,509694,5.038,14.541,682922,215672,467250,4.021,12.734000000000002,96949,1.808,25.468000000000004,42749,43590,153084
2007,81,615252,678524,5365245,5342342,61056,9.072,50046,7.436,777008,249494,527514,4.67,14.544,730200,200202,529998,3.747,13.668,46808,0.8759999999999999,27.336,34644,35182,123115
2008,81,614807,678542,5436123,5392193,56416,8.361,48890,7.245,783510,228161,555349,4.231,14.53,694320,198111,496209,3.674,12.876,89190,1.654,25.753,34213,35011,127442
2009,81,611932,674227,5252523,5332923,50538,7.502999999999999,49161,7.298999999999999,612527,188690,423837,3.5380000000000003,11.486,774265,192444,581821,3.609,14.519,-161738,-3.033,22.972,34157,35099,128347
2010,81,612324,675535,5192542,5207403,51883,7.731,42952,6.401,622636,203932,418704,3.916,11.957,652972,163843,489129,3.1460000000000004,12.539,-30336,-0.583,23.913,29900,30312,103259
2011,81,611867,675178,5179743,5172607,52473,7.827000000000001,42944,6.4060000000000015,633313,191550,441763,3.703,12.244000000000002,621331,151772,469559,2.934,12.012,11982,0.232,24.024,30097,30644,101046
2012,81,617344,679596,5221945,5175399,54376,8.087,39975,5.945,678915,204713,474202,3.956,13.118,585227,158747,426480,3.067,11.308,93688,1.81,22.616,26737,27371,96233
2013,81,621079,682953,5268568,5238956,53015,7.83,41343,6.106,649038,203560,445478,3.886,12.389,587878,162860,425018,3.109,11.220999999999998,61160,1.167,22.443,28013,28400,100281
2014,81,623983,687735,5325425,5283882,53407,7.841,40246,5.908,646551,220524,426027,4.174,12.236,562926,151875,411051,2.874,10.654000000000002,83625,1.5830000000000002,21.307,28814,29190,100385
2015,81,628097,692937,5409186,5360233,54514,7.945,40907,5.9620000000000015,652980,211759,441221,3.951,12.182,556139,165729,390410,3.092,10.375,96841,1.807,20.751,29019,29539,102436
2016,81,636247,702095,5504162,5438393,57086,8.229,40391,5.822,679491,218108,461383,4.011,12.494000000000002,549016,157235,391781,2.891,10.095,130475,2.399,20.19,30370,30827,108235
2017,81,640785,707104,5569947,5525230,56192,8.022,42920,6.127000000000002,704732,220111,484621,3.984,12.755,613596,173803,439793,3.1460000000000004,11.105,91136,1.649,22.211,32177,32822,121720
2018,81,644461,709634,5649574,5594566,54566,7.75,43372,6.16,704229,216982,487247,3.878,12.588,593802,168251,425551,3.007,10.614,110427,1.974,21.228,34490,35397,130179
