year,ifsize,firms,estabs,emp,denom,estabs_entry,estabs_entry_rate,estabs_exit,estabs_exit_rate,job_creation,job_creation_births,job_creation_continuers,job_creation_rate_births,job_creation_rate,job_destruction,job_destruction_deaths,job_destruction_continuers,job_destruction_rate_deaths,job_destruction_rate,net_job_creation,net_job_creation_rate,reallocation_rate,firmdeath_firms,firmdeath_estabs,firmdeath_emp
1978,a) 1 to 4,2092190,2098688,5428303,4796321,405514,19.776,309176,15.078,2108351,760702,1347649,15.86,43.958,843080,561641,281439,11.71,17.578,1265271,26.38,35.155,248559,248850,457314
1979,a) 1 to 4,2077669,2085149,5309778,4745159,397890,19.656,276131,13.640999999999998,1988860,744821,1244039,15.696,41.913,867637,518153,349484,10.92,18.285,1121223,23.629,36.569,218196,218578,412908
1980,a) 1 to 4,2040988,2048551,4961656,4662985,369242,18.23,323061,15.95,1696734,686798,1009936,14.729,36.387,1108039,589287,518752,12.638,23.762,588695,12.625,47.525,255865,256347,468756
1981,a) 1 to 4,2091560,2099303,5210004,4755893,358310,17.303,301214,14.546,1831255,663244,1168011,13.946,38.505,930359,542670,387689,11.41,19.562,900896,18.943,39.124,224463,225128,407744
1982,a) 1 to 4,2069838,2077606,5180812,4754843,366627,17.718,349824,16.906,1849142,695638,1153504,14.63,38.89,1002897,629463,373434,13.238,21.092,846245,17.798,42.184,273434,274056,500051
1983,a) 1 to 4,2165715,2173051,5307981,4836261,406380,19.31,269354,12.799,1820652,747355,1073297,15.453,37.646,884683,503396,381287,10.409,18.293,935969,19.353,36.585,210666,211175,401608
1984,a) 1 to 4,2287186,2295275,5849829,5185702,459798,20.789,292814,13.239,2207280,864089,1343191,16.663,42.565,882863,536867,345996,10.353,17.025,1324417,25.54,34.05,234478,235146,437580
1985,a) 1 to 4,2284361,2292134,5851117,5248635,447974,20.032,336260,15.037,2176266,846265,1330001,16.124000000000002,41.463,976067,618263,357804,11.78,18.597,1200199,22.867,37.19300000000001,269627,270395,503983
1986,a) 1 to 4,2286149,2294162,5862811,5291422,426821,19.002,330848,14.729,2132147,805770,1326377,15.228,40.294,993931,619448,374483,11.707,18.784,1138216,21.511,37.56800000000001,262323,263116,499015
1987,a) 1 to 4,2311859,2319496,5924044,5346026,444023,19.59,338295,14.925,2169785,837267,1332518,15.661,40.587,1020265,634200,386065,11.863,19.085,1149520,21.502,38.169,270694,271498,515554
1988,a) 1 to 4,2366954,2373413,5993277,5443731,445821,19.207,341217,14.701,2145186,836478,1308708,15.366,39.407,1054862,631581,423281,11.602,19.378,1090324,20.029,38.755,272720,273505,511763
1989,a) 1 to 4,2398724,2406524,6108290,5531815,438082,18.586,339176,14.39,2179485,823551,1355934,14.888,39.399,1034029,626084,407945,11.318,18.692,1145456,20.707,37.385,274958,275721,515378
1990,a) 1 to 4,2419215,2427297,6140645,5583282,433303,18.176,346523,14.536,2155781,814865,1340916,14.595,38.611,1049862,638682,411180,11.439,18.804,1105919,19.808,37.607,282269,283344,529341
1991,a) 1 to 4,2391822,2400851,5923520,5511666,400570,16.807000000000002,365480,15.335,1953895,744185,1209710,13.502,35.45,1142521,676338,466183,12.271,20.729,811374,14.720999999999998,41.458,292253,293388,550203
1992,a) 1 to 4,2431824,2438294,6107671,5620584,398320,16.508,347488,14.401,2046702,739189,1307513,13.151,36.414,1081784,633046,448738,11.263,19.247,964918,17.168,38.494,272164,273340,505678
1993,a) 1 to 4,2485855,2490649,6252640,5703766,421114,17.165,346592,14.127,2127145,774207,1352938,13.574000000000002,37.294,1035526,625950,409576,10.974,18.155,1091619,19.139,36.31,275927,276551,507187
1994,a) 1 to 4,2530793,2536610,6229844,5744119,429165,17.172,354513,14.185,2052832,788885,1263947,13.734000000000002,35.738,1090470,641598,448872,11.17,18.984,962362,16.754,37.968,284229,284903,523338
1995,a) 1 to 4,2599975,2605906,6389788,5856731,445243,17.391,353732,13.817,2115407,818692,1296715,13.979,36.119,1055810,634812,420998,10.839,18.027,1059597,18.092,36.055,284869,285632,520525
1996,a) 1 to 4,2621927,2627925,6379691,5885583,440042,16.977999999999998,367801,14.191,2066425,808081,1258344,13.73,35.11,1085424,659757,425667,11.21,18.442,981001,16.668,36.884,296400,297221,541291
1997,a) 1 to 4,2653993,2658956,6519095,5996246,443506,16.884,379161,14.434,2141352,819009,1322343,13.659,35.712,1102414,681973,420441,11.373,18.385,1038938,17.326,36.77,305660,306654,559098
1998,a) 1 to 4,2679271,2682611,6565677,6050738,430321,16.236,365769,13.800999999999998,2123527,786461,1337066,12.998,35.095,1099118,657141,441977,10.861,18.165,1024409,16.93,36.33,286995,287510,522408
1999,a) 1 to 4,2695067,2698814,6595693,6092911,422065,15.789,370793,13.871,2119769,770281,1349488,12.642,34.791,1124442,663784,460658,10.894,18.455,995327,16.336,36.91,290300,290783,526087
2000,a) 1 to 4,2690124,2694299,6627005,6105929,407142,15.204,374170,13.973,2130523,753257,1377266,12.336,34.893,1094448,667502,426946,10.932,17.924,1036075,16.968,35.84900000000001,289513,290144,522150
2001,a) 1 to 4,2674448,2679664,6451046,6011780,412010,15.475,377387,14.175,2004080,756976,1247104,12.592,33.336,1133737,675641,458096,11.239,18.859,870343,14.477,37.717,290550,291247,525410
2002,a) 1 to 4,2691164,2695347,6525198,6063735,428896,15.988,403387,15.037,2084543,800900,1283643,13.208,34.376999999999995,1172074,716526,455548,11.817,19.329,912469,15.048,38.658,300892,301868,544442
2003,a) 1 to 4,2750251,2753731,6778377,6238297,454698,16.697,393760,14.459,2234121,839896,1394225,13.464,35.813,1159993,701842,458151,11.251,18.595,1074128,17.218,37.189,298988,299552,542552
2004,a) 1 to 4,2803832,2807949,6867283,6320304,472389,17.065,392695,14.186,2228999,858748,1370251,13.587,35.267,1146954,700040,446914,11.076,18.147,1082045,17.12,36.294,298226,298682,541355
2005,a) 1 to 4,2847756,2852430,6769421,6345769,492335,17.507,411880,14.646,2148652,886367,1262285,13.968,33.86,1315179,733147,582032,11.553,20.725,833473,13.134,41.451,312754,313447,566187
2006,a) 1 to 4,2928924,2934119,6994756,6466750,535473,18.508,453729,15.682,2284364,957988,1326376,14.814,35.325,1237414,797614,439800,12.334,19.135,1046950,16.19,38.27,360005,360743,645019
2007,a) 1 to 4,2942746,2947897,6949213,6470592,490004,16.781,434160,14.869000000000002,2178532,862523,1316009,13.33,33.668,1238332,751391,486941,11.612,19.138,940200,14.53,38.276,338295,339143,595052
2008,a) 1 to 4,2899046,2902625,6763272,6400710,435446,14.895,476961,16.315,2019150,762882,1256268,11.919,31.546,1304482,811172,493310,12.673,20.38,714668,11.165,40.761,370300,370847,639636
2009,a) 1 to 4,2808348,2812902,6473195,6235440,390872,13.597,514530,17.898,1854088,683740,1170348,10.965,29.735,1391328,878734,512594,14.093,22.313,462760,7.421,44.62600000000001,383043,383673,665182
2010,a) 1 to 4,2816872,2822263,6498163,6198251,400961,14.07,455920,15.999,1832461,705248,1127213,11.378,29.564,1242504,778104,464400,12.554,20.046,589957,9.518,40.092,330230,331065,574190
2011,a) 1 to 4,2838794,2844686,6582037,6222859,421705,14.797,432206,15.165,1879425,738005,1141420,11.86,30.202,1170326,735344,434982,11.817,18.807,709099,11.395,37.614,317197,318163,549465
2012,a) 1 to 4,2884605,2889334,6695856,6247440,435366,15.219,378137,13.218,1934499,764090,1170409,12.23,30.965,1046635,644985,401650,10.324000000000002,16.753,887864,14.212,33.506,279110,280084,487899
2013,a) 1 to 4,2883731,2887075,6622211,6226757,419815,14.635,382962,13.35,1847270,729902,1117368,11.722,29.667,1065679,656338,409341,10.541,17.115,781591,12.552,34.229,285194,285626,498344
2014,a) 1 to 4,2900947,2905076,6639432,6241062,422964,14.666,380789,13.204,1839014,736289,1102725,11.797,29.466,1049277,648942,400335,10.398,16.812,789737,12.654000000000002,33.625,288665,289087,501315
2015,a) 1 to 4,2920181,2924528,6664218,6257806,427554,14.75,375804,12.965,1845473,740451,1105022,11.832,29.491,1043355,643530,399825,10.284,16.673,802118,12.818,33.346,289289,289745,503422
2016,a) 1 to 4,2955157,2959832,6726673,6297897,444506,15.195,375368,12.832,1888161,771652,1116509,12.253,29.981,1039458,638741,400717,10.142,16.505,848703,13.476,33.01,296464,296911,512297
2017,a) 1 to 4,2968775,2973350,6684885,6299603,435555,14.772,385724,13.082,1835309,744775,1090534,11.823,29.134,1076835,654614,422221,10.390999999999998,17.094,758474,12.04,34.187,312559,313100,536972
2018,a) 1 to 4,2986139,2989556,6777211,6344049,433582,14.617,387100,13.05,1905281,743837,1161444,11.725,30.033,1047896,651293,396603,10.265999999999998,16.518,857385,13.515,33.036,334774,335359,567638
1978,b) 5 to 9,709125,730010,5122048,4805181,84591,11.822,55692,7.782999999999999,1426951,529087,897864,11.011,29.696,787164,347522,439642,7.232,16.382,639787,13.315,32.763000000000005,45155,45759,291329
1979,b) 5 to 9,755245,775644,5273421,5050984,80333,10.497,59679,7.797999999999999,1387661,527450,860211,10.443,27.473000000000006,936020,371888,564132,7.362999999999999,18.531,451641,8.942,37.063,45812,46527,296177
1980,b) 5 to 9,765782,785387,5017531,5021268,74449,9.53,66128,8.465,1146603,470840,675763,9.377,22.835,1146962,413465,733497,8.234,22.842,-359,-0.006999999999999999,45.67,50330,51118,326551
1981,b) 5 to 9,769985,790367,5125640,5016137,77055,9.889,54749,7.026,1213429,493169,720260,9.832,24.191,987052,341845,645207,6.815,19.678,226377,4.513,39.355,40401,41446,261623
1982,b) 5 to 9,778541,799098,5147459,5082566,80784,10.203,66083,8.346,1222447,500896,721551,9.855,24.052,1085339,407437,677902,8.016,21.354,137108,2.698,42.708,51848,52730,336155
1983,b) 5 to 9,792772,814750,5275593,5166791,79896,9.953,55934,6.968,1199292,497804,701488,9.635,23.212,975582,347849,627733,6.732,18.882,223710,4.33,37.764,45468,46444,294485
1984,b) 5 to 9,827557,849538,5821630,5515310,92299,11.087,58278,7.0,1531628,587494,944134,10.652,27.77,915765,363096,552669,6.582999999999998,16.604,615863,11.166,33.208,47482,48510,307992
1985,b) 5 to 9,857029,877819,5934077,5702573,93057,10.737,70878,8.177999999999999,1518769,594476,924293,10.425,26.633000000000006,1048960,446906,602054,7.8370000000000015,18.395,469809,8.238999999999999,36.789,58105,59444,378865
1986,b) 5 to 9,876365,897886,6003461,5812294,92229,10.399,70323,7.9289999999999985,1475581,584747,890834,10.061,25.387,1087414,444106,643308,7.641,18.709,388167,6.678,37.418,57548,58636,374529
1987,b) 5 to 9,895554,916140,6158742,5948815,96341,10.628,76993,8.494,1553870,604707,949163,10.165,26.121,1127272,472426,654846,7.942,18.95,426598,7.171,37.899,60642,61617,393249
1988,b) 5 to 9,921492,942532,6272268,6089527,94193,10.119,70834,7.61,1506389,593416,912973,9.745,24.737,1133748,446053,687695,7.325,18.618,372641,6.119,37.236,58503,59638,380007
1989,b) 5 to 9,937648,959259,6399151,6209823,92815,9.784,71569,7.544,1517908,588956,928952,9.484,24.444000000000006,1132578,452662,679916,7.289,18.238,385330,6.205,36.477,60204,61513,391536
1990,b) 5 to 9,952044,973854,6473998,6303126,91692,9.508,72671,7.536,1515554,583579,931975,9.259,24.044,1166506,458670,707836,7.277,18.507,349048,5.5379999999999985,37.014,61655,63191,400594
1991,b) 5 to 9,950768,973389,6231339,6234188,81296,8.371,76858,7.914,1311030,512597,798433,8.222000000000001,21.03,1307995,485661,822334,7.79,20.981,3035,0.049,41.962,64614,66107,420317
1992,b) 5 to 9,944360,963039,6328344,6229243,79701,8.302,73559,7.6629999999999985,1377286,499459,877827,8.017999999999999,22.11,1171420,441817,729603,7.093,18.805,205866,3.305,37.61,56133,57594,364195
1993,b) 5 to 9,954747,973205,6437204,6295768,82786,8.582,65670,6.808,1407452,522058,885395,8.292,22.356,1116095,413063,703032,6.561,17.727999999999994,291357,4.628,35.455,55032,56006,356017
1994,b) 5 to 9,972701,991443,6557881,6428696,81858,8.312000000000001,68680,6.974,1427301,517610,909691,8.052,22.202,1160527,428466,732061,6.665,18.052,266774,4.15,36.105,57063,58325,370236
1995,b) 5 to 9,981158,1000218,6684072,6508633,84628,8.539,66388,6.698,1470592,535478,935114,8.227,22.594,1111993,418324,693669,6.4270000000000005,17.085,358599,5.51,34.17,56077,57262,364721
1996,b) 5 to 9,988844,1007339,6671287,6538556,83394,8.337,69379,6.936,1424178,530066,894112,8.107000000000001,21.781,1149506,436402,713104,6.674,17.58,274672,4.2010000000000005,35.161,58778,59948,381262
1997,b) 5 to 9,997546,1013262,6799296,6654707,83500,8.265,77627,7.683,1486434,527967,958467,7.934,22.337,1188690,475949,712741,7.152,17.862000000000005,297744,4.474,35.725,62279,63895,404623
1998,b) 5 to 9,1011505,1025669,6864286,6722056,78110,7.654,67792,6.643,1449122,498955,950167,7.422999999999999,21.558000000000003,1155066,428424,726642,6.372999999999998,17.183,294056,4.374,34.366,54660,55529,354602
1999,b) 5 to 9,1013309,1026461,6878184,6754391,73623,7.19,68564,6.6960000000000015,1422060,468721,953339,6.94,21.054,1163648,435981,727667,6.455,17.227999999999998,258412,3.826,34.456,55293,56212,358689
2000,b) 5 to 9,1017412,1030767,6964319,6801004,75998,7.401,68124,6.634,1470146,483316,986830,7.107,21.617,1132849,431636,701213,6.347,16.657,337297,4.96,33.314,54022,55097,350682
2001,b) 5 to 9,1021363,1035460,6854379,6765892,75632,7.326,69512,6.733,1377265,478329,898936,7.07,20.356,1190646,441204,749442,6.521,17.598,186619,2.758,35.196,55098,56263,358054
2002,b) 5 to 9,1019279,1031279,6770555,6721701,79425,7.7120000000000015,76541,7.432,1387208,501512,885696,7.461,20.638,1280420,473339,807081,7.042000000000002,19.049,106788,1.589,38.098,59437,60581,386942
2003,b) 5 to 9,1022761,1035160,6918689,6774297,78152,7.599,64734,6.294,1450699,493798,956901,7.289,21.415,1150200,409219,740981,6.041,16.979,300499,4.436,33.958,52939,53811,343716
2004,b) 5 to 9,1037469,1050424,7053088,6888515,78259,7.497999999999998,64782,6.207000000000002,1467765,498356,969409,7.235,21.307,1128752,413002,715750,5.996,16.386,339013,4.921,32.772,53663,54334,346806
2005,b) 5 to 9,1055572,1069058,6991024,6924548,82233,7.741,68753,6.472,1411133,525696,885437,7.592,20.379,1265591,435713,829878,6.292000000000002,18.277,145542,2.102,36.554,56479,57413,365023
2006,b) 5 to 9,1065775,1079969,7188244,7044175,90709,8.461,74929,6.989,1510579,581223,929356,8.251,21.444000000000006,1211323,476941,734382,6.771,17.195999999999998,299256,4.248,34.392,64708,65656,419424
2007,b) 5 to 9,1068691,1081562,7040401,7009058,75772,7.025,69893,6.48,1342348,481231,861117,6.8660000000000005,19.152,1266965,434888,832077,6.205,18.076,75383,1.0759999999999998,36.152,56278,57160,364482
2008,b) 5 to 9,1058128,1070699,6912653,6936407,68764,6.4220000000000015,68887,6.433,1253872,438141,815731,6.317,18.077,1288888,435576,853312,6.28,18.581,-35016,-0.505,36.153,57486,58258,371965
2009,b) 5 to 9,1029574,1043047,6528299,6702487,57885,5.511,72380,6.891,1069341,368407,700934,5.497000000000001,15.954,1403120,460023,943097,6.863,20.934,-333779,-4.98,31.909,59746,60574,386350
2010,b) 5 to 9,995472,1010103,6485722,6533059,55402,5.468,61491,6.069,1069400,351478,717922,5.38,16.369,1150849,388034,762815,5.94,17.616,-81449,-1.247,32.738,50097,51096,323570
2011,b) 5 to 9,970897,985736,6439347,6396518,59264,6.021,56372,5.727,1112652,377314,735338,5.899,17.395,1016822,354122,662700,5.5360000000000005,15.896,95830,1.4980000000000002,31.793000000000006,46201,47325,298617
2012,b) 5 to 9,988777,1001238,6641445,6541748,60937,6.101,55927,5.6,1180870,388849,792021,5.944,18.051,972946,341681,631265,5.223,14.873,207924,3.178,29.746,44384,45392,287216
2013,b) 5 to 9,996182,1007838,6635193,6579758,58751,5.84,55000,5.4670000000000005,1123920,372811,751109,5.666,17.081,1001861,348194,653667,5.292000000000002,15.226,122059,1.855,30.453000000000007,45617,46212,296272
2014,b) 5 to 9,998315,1010800,6693499,6608326,59457,5.901,53149,5.275,1147202,377693,769509,5.715,17.36,966375,337945,628430,5.114,14.624,180827,2.736,29.247,44896,45496,290788
2015,b) 5 to 9,1004846,1017757,6741948,6655423,60510,5.962999999999999,54348,5.356,1160848,385304,775544,5.789,17.442,977868,345335,632533,5.189,14.693,182980,2.749,29.386,45671,46340,295535
2016,b) 5 to 9,1012987,1026446,6807878,6710528,63137,6.178,54168,5.3,1197869,402515,795354,5.997999999999998,17.851,993184,345272,647912,5.145,14.8,204685,3.05,29.601,46465,47171,301955
2017,b) 5 to 9,1017773,1030233,6804955,6741704,60185,5.851,57091,5.55,1168706,383584,785122,5.69,17.335,1032058,358717,673341,5.3210000000000015,15.309,136648,2.027,30.617,47692,48496,310209
2018,b) 5 to 9,1011591,1022798,6804895,6721818,59411,5.82,55534,5.44,1183376,384139,799237,5.715,17.605,1005797,354111,651686,5.268,14.963,177579,2.642,29.926,49416,50199,321676
1978,c) 10 to 19,404657,447521,5882549,5566321,46468,10.595,28570,6.5139999999999985,1457133,536479,920654,9.638,26.178,824291,327928,496363,5.891,14.809,632842,11.369000000000002,29.617,20139,21115,266284
1979,c) 10 to 19,441865,482273,6175820,5991583,40605,8.493,32258,6.747000000000001,1383454,493459,889995,8.236,23.09,1014833,375884,638949,6.274,16.938,368621,6.152,33.875,21960,22993,290056
1980,c) 10 to 19,457436,496840,6012187,6073942,37565,7.5710000000000015,36271,7.31,1156789,447874,708915,7.374,19.045,1280017,426658,853359,7.024,21.074,-123228,-2.029,38.09,24669,25766,326449
1981,c) 10 to 19,454353,494011,6035490,5994341,38244,7.8210000000000015,28166,5.76,1190119,473766,716353,7.904,19.854,1107800,333091,774709,5.557,18.481,82319,1.3730000000000002,36.962,19089,20491,252630
1982,c) 10 to 19,459587,499557,6055282,6053996,43104,8.702,34618,6.989,1236708,495922,740786,8.192,20.428,1232359,394382,837977,6.5139999999999985,20.356,4349,0.07200000000000001,40.712,24090,25214,320164
1983,c) 10 to 19,455622,498475,6053258,6029711,38747,7.841,30066,6.085,1163789,454249,709540,7.534,19.301,1117108,350010,767098,5.805,18.527,46681,0.774,37.053,22103,23398,293141
1984,c) 10 to 19,465294,507959,6579822,6333029,40643,8.088,29718,5.914,1467665,505993,961672,7.99,23.175,974596,350462,624134,5.534,15.389,493069,7.786,30.778,22360,23691,296927
1985,c) 10 to 19,486654,527425,6784087,6603878,43556,8.308,37245,7.104,1506146,543144,963002,8.225,22.807,1143290,453583,689707,6.8679999999999986,17.312,362856,5.495,34.625,28847,30459,383762
1986,c) 10 to 19,501735,544128,6917315,6769295,45589,8.459,35271,6.544,1478643,540487,938156,7.984,21.843000000000004,1181409,433820,747589,6.409,17.452,297234,4.391,34.905,27763,29083,368986
1987,c) 10 to 19,514829,556637,7060880,6924287,49032,8.86,42558,7.69,1545056,568303,976753,8.207,22.314,1271195,482145,789050,6.962999999999999,18.358,273861,3.955,36.717,29713,31090,393666
1988,c) 10 to 19,531837,577478,7277658,7148369,46583,8.139,36374,6.355,1499682,547353,952329,7.657,20.979,1239826,437182,802644,6.1160000000000005,17.344,259856,3.635,34.688,28182,29769,373375
1989,c) 10 to 19,544614,590877,7484093,7344546,45171,7.6960000000000015,37250,6.347,1521133,552362,968771,7.521,20.711,1240678,453895,786783,6.18,16.893,280455,3.819,33.785,29915,31884,397248
1990,c) 10 to 19,556244,602239,7571272,7481477,43548,7.266,37712,6.292000000000002,1481296,528694,952602,7.067,19.8,1301043,460006,841037,6.149,17.39,180253,2.4090000000000003,34.78,30601,32735,405857
1991,c) 10 to 19,558701,610009,7276608,7392321,44912,7.392,40069,6.595,1277793,507047,770746,6.859,17.285,1507606,494240,1013366,6.686,20.394,-229813,-3.109,34.571,32474,34154,432272
1992,c) 10 to 19,548178,598841,7350175,7336782,43234,7.225,42367,7.08,1389748,477337,912411,6.506,18.942,1361665,461659,900006,6.292000000000002,18.559,28083,0.383,37.119,28000,29801,371181
1993,c) 10 to 19,549524,602331,7413476,7357953,38513,6.4129999999999985,35026,5.832000000000002,1350356,464148,886208,6.308,18.352,1238765,414387,824378,5.6320000000000014,16.836,111591,1.517,33.671,26786,28363,354857
1994,c) 10 to 19,559471,609791,7598585,7526666,39857,6.55,37211,6.1160000000000005,1410050,478286,931764,6.355,18.734,1265438,432214,833224,5.742000000000001,16.813,144612,1.921,33.625,28006,30070,372383
1995,c) 10 to 19,566403,615233,7808543,7664186,39938,6.516,35298,5.759,1464840,487996,976844,6.367000000000001,19.113,1175490,418934,756556,5.466,15.337,289350,3.775,30.675,27609,29591,366508
1996,c) 10 to 19,573346,620138,7790150,7715207,39613,6.402,36772,5.943,1400558,487736,912822,6.322,18.153,1249036,440589,808447,5.711,16.189,151522,1.964,32.379,28947,30894,386393
1997,c) 10 to 19,580821,623487,7982159,7878739,42377,6.785,44472,7.121,1511752,498427,1013325,6.3260000000000005,19.188,1304560,498682,805878,6.329,16.558,207192,2.63,33.116,30915,33008,412449
1998,c) 10 to 19,592141,633728,8118446,8027008,36281,5.724,36481,5.756,1462974,462174,1000800,5.757999999999999,18.226,1277774,435066,842708,5.42,15.918,185200,2.307,31.837,26777,28477,357547
1999,c) 10 to 19,596243,634328,8162946,8097533,33304,5.237,36642,5.761,1399574,424366,975208,5.2410000000000005,17.284000000000002,1268213,450888,817325,5.568,15.662,131361,1.622,31.323,28165,30026,375353
2000,c) 10 to 19,604607,641194,8373418,8245780,35404,5.519,36013,5.614,1495178,451822,1043356,5.479,18.133,1240304,441955,798349,5.36,15.042,254874,3.091,30.083,27254,29124,363658
2001,c) 10 to 19,612827,648691,8290160,8271416,35307,5.435,37120,5.714,1376740,440084,936656,5.3210000000000015,16.645,1337707,456652,881055,5.521,16.173,39033,0.472,32.345,27963,29931,373065
2002,c) 10 to 19,615577,651139,8196837,8225249,46321,7.12,45266,6.957000000000002,1466262,534902,931360,6.502999999999999,17.826,1521276,526248,995028,6.398,18.495,-55014,-0.669,35.653,32049,33654,429890
2003,c) 10 to 19,616511,653590,8383317,8308454,38525,5.907,35710,5.475,1485418,476164,1009254,5.731,17.878,1335080,425669,909411,5.122999999999998,16.069000000000006,150338,1.809,32.138000000000005,26890,28293,357201
2004,c) 10 to 19,623209,659634,8517424,8422799,37047,5.631,33672,5.118,1480862,475571,1005291,5.646,17.582,1291148,424517,866631,5.04,15.329,189714,2.252,30.658,26972,28208,359561
2005,c) 10 to 19,637555,673648,8483957,8502783,40769,6.0760000000000005,35517,5.292999999999998,1438875,520728,918147,6.124,16.922,1474640,444399,1030241,5.227,17.343,-35765,-0.421,33.845,28246,29796,376324
2006,c) 10 to 19,638572,675449,8741989,8597639,47377,7.063,38037,5.671,1601398,595704,1005694,6.9289999999999985,18.626,1311680,478804,832876,5.569,15.255999999999998,289718,3.37,30.513,32000,33282,424367
2007,c) 10 to 19,650038,685749,8632369,8655571,41418,6.046,40082,5.851,1425092,505148,919944,5.836,16.464000000000002,1470952,471580,999372,5.448,16.994,-45860,-0.53,32.929,29122,30416,385354
2008,c) 10 to 19,643134,679642,8505721,8573365,37606,5.532,38000,5.59,1325460,459366,866094,5.358,15.46,1460489,461622,998867,5.384,17.035,-135029,-1.575,30.92,29737,31073,394685
2009,c) 10 to 19,628383,665065,7969686,8232806,32022,4.8,36214,5.428,1064103,399508,664595,4.853,12.925,1588098,453525,1134573,5.509,19.29,-523995,-6.365,25.85,29382,30719,388929
2010,c) 10 to 19,615899,654558,7956238,8070466,37350,5.728,32269,4.949,1134971,462595,672376,5.732,14.063,1361781,395475,966306,4.9,16.874000000000002,-226810,-2.81,28.127,25473,27016,336720
2011,c) 10 to 19,616325,657024,8090678,8182143,33284,5.066,33224,5.057,1201312,411324,789988,5.027,14.682,1383313,405869,977444,4.96,16.906,-182001,-2.224,29.364,25772,27242,339219
2012,c) 10 to 19,595600,632137,8070342,8016412,32160,5.081,33857,5.349,1247780,398655,849125,4.973,15.565,1138440,379731,758709,4.737,14.201,109340,1.364,28.403,23410,24782,310590
2013,c) 10 to 19,596138,632123,8069789,8017017,32879,5.212999999999999,30024,4.76,1187327,401485,785842,5.008,14.81,1080462,361496,718966,4.509,13.477,106865,1.3330000000000002,26.954,23251,24371,308774
2014,c) 10 to 19,602625,638340,8201546,8127624,31227,4.9030000000000005,28444,4.466,1197089,389670,807419,4.794,14.729,1049291,352375,696916,4.336,12.91,147798,1.818,25.82,23169,24259,306663
2015,c) 10 to 19,610324,646859,8338348,8257140,31373,4.86,28777,4.458,1212860,389568,823292,4.718,14.689,1050324,359434,690890,4.353,12.72,162536,1.968,25.44,23341,24566,311235
2016,c) 10 to 19,620245,657173,8470723,8380885,33013,5.038,29203,4.457,1251714,411320,840394,4.908,14.935,1071419,366277,705142,4.37,12.784,180295,2.151,25.568,24288,25420,323888
2017,c) 10 to 19,628542,664094,8589214,8511674,33330,5.02,32912,4.957,1301810,412559,889251,4.847,15.294,1146280,392728,753552,4.614,13.467,155530,1.827,26.934,25283,26501,337642
2018,c) 10 to 19,633520,665815,8620294,8549790,33623,5.057,31727,4.772,1289200,433901,855299,5.075,15.079,1146693,394669,752024,4.6160000000000005,13.412,142507,1.6669999999999998,26.824,26913,28225,359559
1978,d) 20 to 99,306120,433258,12702615,12138604,43728,10.237,31491,7.372999999999998,2830028,976603,1853425,8.045,23.314,1702933,655960,1046973,5.404,14.029000000000002,1127095,9.285,28.058000000000003,11989,14083,442642
1979,d) 20 to 99,340887,471994,13686808,13374764,35945,7.681,27862,5.954,2612262,841424,1770838,6.291,19.531,1984224,662470,1321754,4.953,14.836,628038,4.6960000000000015,29.671,12442,14167,450000
1980,d) 20 to 99,358548,488737,13623827,13785605,32462,6.6560000000000015,30368,6.227,2201727,774320,1427407,5.617000000000001,15.970999999999998,2526156,750564,1775592,5.445,18.325,-324429,-2.353,31.942,14141,16243,514797
1981,d) 20 to 99,357896,487441,13571545,13625896,33925,7.026,24736,5.122999999999998,2220877,864417,1356460,6.3439999999999985,16.299,2326409,607282,1719127,4.457,17.073,-105532,-0.774,32.598,11160,13250,405493
1982,d) 20 to 99,361770,494797,13680198,13743842,39324,8.033999999999999,28611,5.846,2423379,958449,1464930,6.974,17.632,2551460,680912,1870548,4.954,18.564,-128081,-0.932,35.265,14228,16302,519173
1983,d) 20 to 99,356283,493078,13425027,13560969,35019,7.141,29682,6.0520000000000005,2210580,819276,1391304,6.041,16.301,2480481,688298,1792183,5.0760000000000005,18.291,-269901,-1.99,32.602,13927,16552,511060
1984,d) 20 to 99,355946,493182,14503574,14046067,33054,6.747999999999998,26310,5.371,2833930,858551,1975379,6.112,20.176,1918634,641927,1276707,4.57,13.66,915296,6.516,27.319000000000006,13779,16129,500867
1985,d) 20 to 99,377783,513513,15113800,14893999,34764,6.791,31549,6.1629999999999985,2839109,941628,1897481,6.322,19.062,2397867,912564,1485303,6.127000000000002,16.1,441242,2.963,32.199,19579,22353,737148
1986,d) 20 to 99,394697,535559,15537262,15354586,47641,9.029,31797,6.026,2923668,1077303,1846365,7.016,19.041,2558113,819483,1738630,5.3370000000000015,16.66,365555,2.381,33.321,17405,20153,642592
1987,d) 20 to 99,406301,554551,16017181,15882685,49575,9.036,37806,6.891,3107668,1125753,1981915,7.087999999999999,19.566,2839211,939920,1899291,5.917999999999998,17.875999999999994,268457,1.69,35.75199999999999,19729,22209,732444
1988,d) 20 to 99,418855,576126,16487543,16341358,45986,8.067,33879,5.943,2995025,1057139,1937886,6.4689999999999985,18.328,2703299,860566,1842733,5.266,16.543,291726,1.785,33.085,18661,22084,691836
1989,d) 20 to 99,429778,589762,17079171,16870256,42749,7.294,35411,6.042000000000002,3046610,1043897,2002713,6.188,18.059,2627932,916643,1711289,5.433,15.577,418679,2.482,31.155,19868,24431,747078
1990,d) 20 to 99,443659,603927,17323914,17278529,41442,6.907,33551,5.5920000000000005,2866088,1017824,1848264,5.891,16.588,2776372,887324,1889048,5.135,16.067999999999998,89716,0.519,32.137,20193,24094,743083
1991,d) 20 to 99,444552,627285,16590744,17068296,62834,10.177,43101,6.981,2659227,1131296,1527931,6.627999999999999,15.58,3615171,1141224,2473947,6.686,21.181,-955944,-5.601,31.16,24229,28710,937690
1992,d) 20 to 99,430779,622326,16598903,16682866,47833,7.756,36681,5.947,2818856,964414,1854442,5.7810000000000015,16.897000000000002,2988748,870653,2118095,5.2189999999999985,17.915,-169892,-1.018,33.793,18316,21612,678705
1993,d) 20 to 99,431699,622730,16839414,16802356,35618,5.7170000000000005,36177,5.807,2745419,875098,1870321,5.207999999999998,16.339000000000002,2676913,813411,1863502,4.841,15.932,68506,0.408,31.864,17363,21098,638934
1994,d) 20 to 99,441322,633451,17413192,17297518,39104,6.192,35150,5.566,2844624,926416,1918208,5.356,16.445,2613067,856715,1756352,4.953,15.107,231557,1.339,30.213,18883,23629,707142
1995,d) 20 to 99,450896,641587,18062848,17801450,37772,5.908,33335,5.214,2938286,934703,2003583,5.251,16.506,2417149,825334,1591815,4.636,13.578,521137,2.927,27.157,18517,23543,692249
1996,d) 20 to 99,461274,651311,18087662,18044767,38649,5.952000000000001,34719,5.347,2759812,954280,1805532,5.2879999999999985,15.294,2674523,879820,1794703,4.876,14.822,85289,0.473,29.643,19647,24635,739988
1997,d) 20 to 99,467741,657271,18676136,18504953,45450,6.921,44222,6.734,3211632,983562,2228070,5.315,17.355999999999998,2870440,1035583,1834857,5.596,15.512,341192,1.844,31.023000000000003,21403,26508,807147
1998,d) 20 to 99,483378,668385,19289153,19128583,33080,4.931,38145,5.685,3100582,921726,2178856,4.819,16.209,2780293,894482,1885811,4.676,14.535,320289,1.6740000000000002,29.07,18458,23081,690233
1999,d) 20 to 99,488593,664894,19454920,19400153,30254,4.527,36921,5.525,2829946,806562,2023384,4.158,14.587,2719092,955738,1763354,4.926,14.015999999999998,110854,0.5710000000000001,28.032,20524,26936,782188
2000,d) 20 to 99,498899,668775,20134339,19946264,31231,4.658,34569,5.1560000000000015,3071165,860240,2210925,4.313,15.397,2692165,904749,1787416,4.5360000000000005,13.497,379000,1.9,26.994,19339,25310,732989
2001,d) 20 to 99,510912,676003,20140544,20166378,32781,4.842,34702,5.126,2840248,850424,1989824,4.217,14.084,2894289,933827,1960462,4.631,14.352,-54041,-0.268,28.168000000000006,19837,25149,756124
2002,d) 20 to 99,516357,693896,19692634,20013752,62759,9.147,47266,6.8889999999999985,3218202,1343512,1874690,6.712999999999999,16.08,3856303,1246407,2609896,6.228,19.268,-638101,-3.188,32.16,25256,29292,979909
2003,d) 20 to 99,508861,687267,20064393,19943684,37675,5.483,37484,5.455,3146372,951784,2194588,4.772,15.776,2903676,868090,2035586,4.353,14.559,242696,1.217,29.119,17968,21865,667106
2004,d) 20 to 99,515335,689851,20283653,20210504,31303,4.541,30161,4.376,2883983,904925,1979058,4.477,14.27,2737356,834181,1903175,4.127,13.544,146627,0.725,27.088,18306,22326,684079
2005,d) 20 to 99,527999,701677,20451224,20524340,34865,4.982,31083,4.442,2901576,988131,1913445,4.814,14.137,3044033,858425,2185608,4.182,14.831,-142457,-0.6940000000000001,28.274,18823,22833,701695
2006,d) 20 to 99,525075,709151,20970854,20686618,50324,7.19,31793,4.543,3315963,1203708,2112255,5.819,16.03,2747373,889453,1857920,4.3,13.281,568590,2.749,26.562,20203,23667,745177
2007,d) 20 to 99,536334,721818,20871762,20958130,43702,6.077000000000001,38400,5.34,3043356,1039871,2003485,4.962,14.521,3213492,977892,2235600,4.666,15.333,-170136,-0.812,29.042,19330,22571,722229
2008,d) 20 to 99,530805,720209,20682522,20775837,39633,5.51,37848,5.2620000000000005,2837774,937404,1900370,4.512,13.659,3026677,917455,2109222,4.416,14.568,-188903,-0.909,27.318,19545,23381,726391
2009,d) 20 to 99,522178,708282,19167617,19899682,30236,4.267,30921,4.364,2033701,770521,1263180,3.872,10.22,3496264,858512,2637752,4.314,17.569000000000006,-1462563,-7.35,20.44,19214,23331,720607
2010,d) 20 to 99,493515,682719,18577207,18959932,28686,4.205,27571,4.042,2031263,717681,1313582,3.785,10.713,2795022,719993,2075029,3.797,14.742,-763759,-4.0280000000000005,21.427,16120,19925,593045
2011,d) 20 to 99,476220,668865,18732479,18633086,30985,4.651,25582,3.84,2341045,760642,1580403,4.082,12.564,2141093,652600,1488493,3.502,11.491,199952,1.073,22.982,14626,18092,537354
2012,d) 20 to 99,484691,672560,19346166,19106311,34576,5.1389999999999985,35166,5.226,2762954,877204,1885750,4.591,14.461,2283411,760839,1522572,3.982,11.951,479543,2.51,23.902,14931,18524,555360
2013,d) 20 to 99,495521,687087,19629827,19479917,35542,5.19,30925,4.516,2580256,844903,1735353,4.337,13.246,2277136,731993,1545143,3.758,11.69,303120,1.556,23.379,15325,18159,572389
2014,d) 20 to 99,504047,693950,19999100,19822815,32577,4.715,26570,3.845,2480758,826870,1653888,4.171,12.515,2127933,692831,1435102,3.495,10.735,352825,1.78,21.47,15361,18747,567650
2015,d) 20 to 99,514212,705548,20472538,20277053,33230,4.729,27583,3.925,2540069,854071,1685998,4.212,12.527,2152657,740386,1412271,3.651,10.616,387412,1.911,21.232,16451,19848,614163
2016,d) 20 to 99,526937,721076,20927754,20769969,34898,4.864,27709,3.862,2599486,884337,1715149,4.258,12.515999999999998,2284486,761435,1523051,3.666,10.999,315000,1.517,21.998,17051,20489,638861
2017,d) 20 to 99,536816,726926,21457930,21266408,35756,4.913,37357,5.132999999999999,3021689,915173,2106516,4.303,14.209,2640698,927256,1713442,4.36,12.417,380991,1.7919999999999998,24.834,19299,23690,731259
2018,d) 20 to 99,542826,727233,21448631,21345524,26920,3.69,31621,4.334,2693371,835872,1857499,3.916,12.618,2487420,814064,1673356,3.814,11.653,205951,0.965,23.306,19318,24762,720600
1978,e) 100 to 499,44585,166027,8872108,8587608,23901,14.651,18129,11.112,1917661,720867,1196794,8.394,22.331,1351340,562769,788571,6.553,15.736,566321,6.595,31.472,1186,2103,214617
1979,e) 100 to 499,49452,176321,9594793,9431200,18596,10.737,12329,7.119,1659301,569553,1089748,6.039,17.594,1335033,439104,895929,4.6560000000000015,14.155,324268,3.438,28.311,1034,1632,182065
1980,e) 100 to 499,52502,187167,9803656,9900105,17856,9.693,11935,6.479,1431290,523700,907590,5.29,14.457,1622878,492519,1130359,4.975,16.393,-191588,-1.935,28.915,1245,2368,220490
1981,e) 100 to 499,53409,192529,9826770,9885898,19050,10.094,11426,6.055,1456989,618635,838354,6.257999999999999,14.738,1574036,403082,1170954,4.077,15.922,-117047,-1.1840000000000002,29.476,913,1830,159934
1982,e) 100 to 499,54629,198441,10021132,10041502,17023,8.735,9903,5.082,1639064,717266,921798,7.143,16.323,1679638,379494,1300144,3.779,16.727,-40574,-0.404,32.646,1113,2013,194679
1983,e) 100 to 499,54601,201682,9823430,10025619,17838,8.93,13980,6.999,1496257,571283,924974,5.698,14.924,1895974,443896,1452078,4.428,18.911,-399717,-3.987,29.849,1185,2413,207000
1984,e) 100 to 499,53283,204176,10429250,10181888,17532,8.721,11261,5.601,1798742,558183,1240559,5.482,17.666,1304517,357745,946772,3.514,12.812,494225,4.854,25.624,1002,1606,169842
1985,e) 100 to 499,57135,209547,11044008,10944414,16056,7.744,11643,5.615,1853775,606811,1246964,5.544,16.938,1653599,556863,1096736,5.088,15.109000000000002,200176,1.829,30.218000000000004,1953,3089,340852
1986,e) 100 to 499,61185,218593,11354935,11338709,24384,11.41,14622,6.8420000000000005,2019818,796348,1223470,7.023,17.813,1985885,544975,1440910,4.806,17.514,33933,0.299,35.028,1618,2677,286637
1987,e) 100 to 499,63429,225773,11903838,11877215,26210,11.911,14774,6.714,2216179,927566,1288613,7.81,18.659,2165827,602635,1563192,5.074,18.235,50352,0.424,36.47,1948,3325,342380
1988,e) 100 to 499,66224,243686,12412446,12389075,28280,11.909,15853,6.676,2194055,855843,1338212,6.908,17.71,2145412,637973,1507439,5.149,17.317,48643,0.393,34.634,1968,3706,362144
1989,e) 100 to 499,67767,249600,12937060,12804413,26876,10.983,17103,6.989,2210187,817549,1392638,6.385,17.261,1945000,643857,1301143,5.0280000000000005,15.19,265187,2.071,30.38,1974,4463,347971
1990,e) 100 to 499,70719,260213,13289845,13276793,25480,9.984,15473,6.063,2038036,777218,1260818,5.854,15.35,2012466,588017,1424449,4.4289999999999985,15.158,25570,0.193,30.316,1966,3680,354933
1991,e) 100 to 499,70396,270495,12800275,13179719,31232,11.821,18670,7.066,1874547,832726,1041821,6.318,14.223,2634527,832071,1802456,6.313,19.989,-759980,-5.766,28.446,3037,5760,553438
1992,e) 100 to 499,67944,273774,12747841,12786816,23286,8.622,15880,5.88,1951944,703241,1248703,5.5,15.265,2026763,554751,1472012,4.338,15.85,-74819,-0.585,30.531,1801,3785,328055
1993,e) 100 to 499,68787,276086,13149699,13108505,19460,7.015,22108,7.9689999999999985,2049062,640631,1408431,4.887,15.632,1965969,625636,1340333,4.773,14.998,83093,0.634,29.995,1812,4754,332328
1994,e) 100 to 499,70949,283741,13688021,13617809,21637,7.694,16617,5.909,2067898,700730,1367168,5.146,15.185,1926954,662243,1264711,4.863,14.15,140944,1.035,28.301,2268,4919,431240
1995,e) 100 to 499,72922,288523,14134629,13988278,23173,8.128,16300,5.718,2159746,735042,1424704,5.255,15.44,1867586,618794,1248792,4.424,13.351,292160,2.089,26.702,2184,5312,397581
1996,e) 100 to 499,74173,291160,14031636,14079411,22346,7.75,16664,5.78,1978855,715858,1262997,5.084,14.055,2075318,632400,1442918,4.492,14.74,-96463,-0.685,28.11,2250,5473,405497
1997,e) 100 to 499,74691,296466,14350669,14262880,27552,9.427,19176,6.561,2358329,794835,1563494,5.573,16.535,2179936,731517,1448419,5.129,15.284,178393,1.251,30.568,2458,5711,454474
1998,e) 100 to 499,79083,302438,15251256,15154800,22812,7.577000000000001,20099,6.676,2381169,765163,1616006,5.049,15.712,2189870,652894,1536976,4.308,14.45,191299,1.262,28.9,2037,5596,372943
1999,e) 100 to 499,79690,306584,15402655,15387586,25060,8.253,19220,6.329,2219960,725059,1494901,4.712,14.427,2189378,721669,1467709,4.69,14.228,30582,0.199,28.456,2504,6404,453063
2000,e) 100 to 499,81372,311137,15939400,15753837,25123,8.161,18508,6.0120000000000005,2400728,749344,1651384,4.757,15.239,2028097,635430,1392667,4.033,12.874,372631,2.365,25.747,2110,6086,380226
2001,e) 100 to 499,84060,317653,16026996,16102157,26581,8.463,19447,6.192,2194867,724803,1470064,4.501,13.630999999999998,2344738,698901,1645837,4.34,14.562,-149871,-0.931,27.262,2362,5407,432372
2002,e) 100 to 499,85829,329586,15670544,16032173,33218,10.255,21917,6.766,2468977,1139652,1329325,7.109,15.4,3191400,978997,2212403,6.106,19.906,-722423,-4.506,30.8,3709,7366,672635
2003,e) 100 to 499,83101,328493,15915169,15884785,22494,6.867000000000001,20647,6.303,2358254,694894,1663360,4.375,14.845999999999998,2297714,681360,1616354,4.289,14.465,60540,0.381,28.93,2066,4675,377486
2004,e) 100 to 499,85245,330977,16340119,16354108,17739,5.37,16405,4.967,2073562,669306,1404256,4.093,12.679,2101614,618348,1483266,3.781,12.851,-28052,-0.172,25.358,2066,4882,382299
2005,e) 100 to 499,86939,337462,16761065,16704009,22361,6.697,15185,4.548,2244366,715587,1528779,4.284,13.436,2131938,583900,1548038,3.4960000000000004,12.763,112428,0.6729999999999999,25.526,1984,4496,358620
2006,e) 100 to 499,88491,353463,17205596,17032020,33842,9.832,15298,4.445,2500580,993174,1507406,5.831,14.682,2152790,597553,1555237,3.508,12.64,347790,2.042,25.279,2084,4414,369083
2007,e) 100 to 499,90981,360915,17201324,17335081,26978,7.558,19043,5.335,2304809,744442,1560367,4.294,13.296,2569634,697056,1872578,4.021,14.823,-264825,-1.528,26.591,2121,4721,383739
2008,e) 100 to 499,88775,354012,17045288,17071169,21859,6.2010000000000005,18796,5.332000000000002,2202901,637072,1565829,3.732,12.904000000000002,2255210,645342,1609868,3.78,13.211,-52309,-0.306,25.808000000000003,2133,4252,388260
2009,e) 100 to 499,89499,359669,16062346,16747794,19743,5.5120000000000005,16794,4.689,1543781,551860,991921,3.295,9.218,2911542,686008,2225534,4.096,17.385,-1367761,-8.167,18.436,2547,5392,464762
2010,e) 100 to 499,84533,362392,15724456,15898919,25248,7.063,15418,4.313,1796634,714355,1082279,4.493,11.3,2149251,454332,1694919,2.858,13.518,-352617,-2.218,22.601,1517,4090,264366
2011,e) 100 to 499,81739,360939,15857397,15818859,19967,5.573,14599,4.075,1835533,533872,1301661,3.375,11.603,1757295,446108,1311187,2.82,11.109000000000002,78238,0.495,22.218000000000004,1518,4065,267435
2012,e) 100 to 499,82280,355814,16139075,15983723,19062,5.362,18495,5.202000000000001,2119956,577603,1542353,3.614,13.263,1810312,513602,1296710,3.213,11.326,309644,1.937,22.652,1475,3854,268337
2013,e) 100 to 499,83822,357477,16507383,16353253,18210,5.109,16144,4.529,2012354,519472,1492882,3.177,12.306,1703166,508103,1195063,3.107,10.415,309188,1.891,20.83,1653,3220,300479
2014,e) 100 to 499,85994,365247,16960830,16761935,21547,5.965,13561,3.754,1961928,618190,1343738,3.688,11.705,1563927,446253,1117674,2.662,9.33,398001,2.374,18.66,1571,3746,282103
2015,e) 100 to 499,88263,371867,17429127,17224303,24870,6.779,14878,4.055,2082091,652622,1429469,3.789,12.088,1672745,473992,1198753,2.752,9.712,409346,2.377,19.423,1681,3919,296809
2016,e) 100 to 499,90007,379169,17732302,17593201,23210,6.191,14712,3.924,2026999,622588,1404411,3.539,11.521,1746955,476708,1270247,2.71,9.93,280044,1.592,19.859,1754,4316,311548
2017,e) 100 to 499,91220,376401,18029508,17890887,20521,5.4670000000000005,18475,4.922,2436949,629774,1807175,3.52,13.621,2158716,630248,1528468,3.523,12.066,278233,1.555,24.132,2111,4572,376017
2018,e) 100 to 499,92019,372597,18140271,18090546,10968,2.93,14550,3.886,2007135,476663,1530472,2.635,11.095,1909168,525674,1383494,2.906,10.553,97967,0.542,21.107,2093,6786,379401
1978,f) 500 to 999,5180,53357,3391961,3303038,8329,15.904000000000002,6353,12.130999999999998,678270,275349,402921,8.336,20.535,503827,221791,282036,6.715,15.253,174443,5.2810000000000015,30.507,58,350,38168
1979,f) 500 to 999,5429,54143,3563442,3499939,6008,11.248,4552,8.522,578106,199018,379088,5.686,16.518,447899,163772,284127,4.6789999999999985,12.797,130207,3.72,25.595,36,109,20765
1980,f) 500 to 999,5469,55516,3522000,3521880,5881,10.785,3906,7.1629999999999985,482090,195818,286272,5.56,13.688,481765,146985,334780,4.173,13.679,325,0.009000000000000001,27.358,54,296,33923
1981,f) 500 to 999,5647,58854,3526594,3533906,6342,11.055,3373,5.879,467215,188993,278222,5.348,13.220999999999998,479448,115735,363713,3.275,13.567,-12233,-0.34600000000000003,26.442,38,216,24953
1982,f) 500 to 999,5672,60921,3589270,3548694,6156,10.318,3636,6.0939999999999985,541742,258486,283256,7.284,15.265999999999998,460964,107293,353671,3.023,12.99,80778,2.276,25.979,34,374,23202
1983,f) 500 to 999,5795,63277,3476240,3518061,5611,8.977,4066,6.505,461196,191040,270156,5.43,13.109000000000002,546117,116228,429889,3.304,15.523,-84921,-2.414,26.219,29,135,18337
1984,f) 500 to 999,5761,64138,3753142,3664489,5864,9.355,2948,4.703,581701,187537,394164,5.118,15.874,405139,97197,307942,2.652,11.056,176562,4.8180000000000005,22.112,28,133,18019
1985,f) 500 to 999,6114,66618,3936222,3876354,6799,10.416,4111,6.297999999999999,625941,218361,407580,5.632999999999999,16.148,504865,144339,360526,3.724,13.024,121076,3.123,26.048,60,473,41721
1986,f) 500 to 999,6487,68351,4015596,4003771,7030,10.569,3358,5.048,621381,242489,378892,6.057,15.52,596798,129874,466924,3.244,14.906,24583,0.614,29.812,47,116,30977
1987,f) 500 to 999,6838,71621,4285601,4294725,8943,12.832,5091,7.305,778243,374958,403285,8.731,18.121,797010,185453,611557,4.3180000000000005,18.558,-18767,-0.4370000000000001,36.242,84,412,58167
1988,f) 500 to 999,7315,76168,4548069,4506653,10176,13.76,5747,7.771,781148,333911,447237,7.409,17.333,699025,201753,497272,4.477,15.511,82123,1.822,31.022,92,486,66442
1989,f) 500 to 999,7429,80647,4698464,4632912,8988,11.437,4867,6.193,722286,267093,455193,5.765,15.59,589467,178554,410913,3.854,12.723,132819,2.867,25.447,68,344,44954
1990,f) 500 to 999,7569,82509,4793678,4764304,7726,9.506,5251,6.461,672517,248087,424430,5.207000000000002,14.116,613903,167405,446498,3.514,12.885,58614,1.23,25.771,76,413,50146
1991,f) 500 to 999,7615,82560,4684310,4764393,8841,10.878,6263,7.706,601752,251808,349944,5.285,12.63,762260,223759,538501,4.6960000000000015,15.999,-160508,-3.369,25.26,136,743,91234
1992,f) 500 to 999,7448,82355,4690847,4702620,7632,9.409,5151,6.35,630480,230436,400044,4.9,13.407,654548,160857,493691,3.4210000000000003,13.919,-24068,-0.512,26.814,65,453,43480
1993,f) 500 to 999,7549,84004,4753864,4751512,7011,8.352,6893,8.211,664164,219387,444777,4.617,13.978,660447,204476,455971,4.303,13.9,3717,0.078,27.799,100,880,67717
1994,f) 500 to 999,7806,83320,4946317,4918644,7909,9.608,5911,7.18,698917,235857,463060,4.795,14.21,642904,225805,417099,4.591,13.071,56013,1.139,26.142,148,445,102265
1995,f) 500 to 999,8001,87175,5093232,5052773,7942,9.231,5665,6.584,706684,240263,466421,4.755,13.986,624603,192628,431975,3.812,12.362,82081,1.624,24.723000000000006,115,539,76417
1996,f) 500 to 999,8092,91684,5096309,5076734,8912,9.887,5825,6.4620000000000015,693563,241845,451718,4.7639999999999985,13.662,653720,191786,461934,3.778,12.877,39843,0.785,25.754,102,496,68522
1997,f) 500 to 999,8059,93876,5218454,5161224,10664,11.618,6482,7.062,825925,297940,527985,5.773,16.003,711431,223888,487543,4.338,13.784,114494,2.218,27.568,142,951,96414
1998,f) 500 to 999,8693,97596,5519425,5460627,10432,10.857,7409,7.711,852636,290841,561795,5.3260000000000005,15.614,735512,225630,509882,4.132,13.469,117124,2.145,26.939,126,1466,85681
1999,f) 500 to 999,8743,100169,5599266,5557455,12093,12.336,7820,7.977,860201,320936,539265,5.775,15.478,776882,238581,538301,4.293,13.979,83319,1.499,27.958,124,1276,82392
2000,f) 500 to 999,8865,100162,5750209,5678093,9962,10.075,7401,7.485,875125,289439,585686,5.097,15.412,729017,230774,498243,4.064,12.839,146108,2.573,25.678,120,1141,82344
2001,f) 500 to 999,8979,101729,5805012,5817363,8991,8.898,7625,7.546,790168,246721,543447,4.2410000000000005,13.583,816092,241637,574455,4.154,14.029000000000002,-25924,-0.446,27.166,119,941,82180
2002,f) 500 to 999,9089,101348,5592017,5753072,9175,9.097,8201,8.131,751077,286443,464634,4.979,13.055,1074093,317594,756499,5.52,18.67,-323016,-5.615,26.11,217,1459,146753
2003,f) 500 to 999,9020,105006,5618339,5637625,7934,7.564,7712,7.352,772258,243201,529057,4.314,13.698,806022,232056,573966,4.1160000000000005,14.297,-33764,-0.599,27.397,113,739,77252
2004,f) 500 to 999,8955,106907,5706446,5715339,8007,7.526,6976,6.557,694814,208206,486608,3.643,12.157,713037,211884,501153,3.707,12.476,-18223,-0.319,24.314,123,1198,85923
2005,f) 500 to 999,9076,110848,5842242,5787549,10137,9.336,5610,5.166,780500,284227,496273,4.9110000000000005,13.486,670930,176145,494785,3.044,11.593,109570,1.893,23.185,90,386,62054
2006,f) 500 to 999,9270,112715,6122925,6056627,9865,8.881,6585,5.928,846253,278695,567558,4.601,13.972,712445,201056,511389,3.32,11.763,133808,2.209,23.526,116,745,78002
2007,f) 500 to 999,9625,114408,6140362,6144984,9955,8.853,6039,5.37,780391,219485,560906,3.572,12.7,787926,190787,597139,3.105,12.822,-7535,-0.123,25.399,103,525,69272
2008,f) 500 to 999,9762,118197,6215653,6210089,8729,7.455,6516,5.565,777901,222746,555155,3.587,12.526,767843,186390,581453,3.0010000000000003,12.364,10058,0.162,24.729,92,714,61168
2009,f) 500 to 999,9474,119702,5815582,6022325,9125,7.692,6978,5.8820000000000014,585206,202002,383204,3.354,9.717,996417,224088,772329,3.721,16.545,-411211,-6.8279999999999985,19.435,131,633,92606
2010,f) 500 to 999,9187,122011,5810020,5859953,9613,7.9689999999999985,6840,5.67,642009,219688,422321,3.749,10.956,742900,168920,573980,2.883,12.678,-100891,-1.722,21.912,89,1026,62482
2011,f) 500 to 999,8954,125690,5959057,5902330,8112,6.507999999999999,6029,4.837,674932,172204,502728,2.918,11.435,562627,131244,431383,2.224,9.532,112305,1.903,19.065,58,318,39508
2012,f) 500 to 999,9226,125288,6129923,6075827,7186,5.738,7084,5.6560000000000015,720777,165655,555122,2.7260000000000004,11.863,610783,155000,455783,2.551,10.053,109994,1.81,20.105,86,725,59320
2013,f) 500 to 999,9512,124801,6326244,6278969,6947,5.605,5219,4.211,737175,163816,573359,2.609,11.74,640309,155298,485011,2.4730000000000003,10.198,96866,1.543,20.395,78,216,53167
2014,f) 500 to 999,9802,126892,6514327,6456814,8809,7.033,5529,4.414,779595,209462,570133,3.244,12.074000000000002,664328,150038,514290,2.324,10.289,115267,1.785,20.578000000000007,72,507,49177
2015,f) 500 to 999,10054,129093,6652053,6583917,9124,7.151,6123,4.799,794873,227965,566908,3.462,12.073,659553,148164,511389,2.25,10.018,135320,2.055,20.035,80,722,54203
2016,f) 500 to 999,10247,130859,6734241,6688917,9282,7.181,6066,4.6930000000000005,801847,223221,578626,3.337,11.988,710073,157115,552958,2.349,10.616,91774,1.372,21.231,80,527,55525
2017,f) 500 to 999,10433,133843,6833386,6772699,8051,6.045,6720,5.046,852120,209503,642617,3.093,12.582,730194,175726,554468,2.595,10.781,121926,1.8,21.563,104,641,67096
2018,f) 500 to 999,10319,135750,7046278,6995914,7347,5.432,6334,4.683,864972,224417,640555,3.208,12.364,762320,165097,597223,2.36,10.897,102652,1.467,21.793000000000006,84,1130,56782
1978,g) 1000 to 2499,3070,64310,4194129,4150356,7937,12.363,7717,12.02,720200,248283,471917,5.982,17.352999999999998,634192,297603,336589,7.171,15.28,86008,2.072,30.561,33,150,47937
1979,g) 1000 to 2499,3213,69506,4520519,4410938,8348,12.175,6470,9.436,709120,261723,447397,5.934,16.076,489433,200076,289357,4.5360000000000005,11.095999999999998,219687,4.981,22.192,15,132,17364
1980,g) 1000 to 2499,3326,71160,4669618,4613708,8728,12.572,5253,7.567,648657,276455,372202,5.992000000000001,14.059,536210,177445,358765,3.846,11.622,112447,2.437,23.244,23,91,27291
1981,g) 1000 to 2499,3493,73912,4695631,4687071,7970,10.998,5087,7.019,576626,249522,327104,5.324,12.302,558104,148767,409337,3.174,11.907,18522,0.395,23.815,14,281,20424
1982,g) 1000 to 2499,3564,75158,4833623,4769877,7410,10.043,4664,6.3210000000000015,663526,332003,331523,6.96,13.911,534730,141739,392991,2.972,11.211,128796,2.7,22.421,8,39,11368
1983,g) 1000 to 2499,3772,77322,4772749,4813963,7196,9.438,5048,6.621,575966,235297,340669,4.888,11.964,657108,133463,523645,2.772,13.65,-81142,-1.686,23.929,6,42,7826
1984,g) 1000 to 2499,3696,79839,5113551,4984320,7628,9.775,4023,5.155,724164,261523,462641,5.247000000000001,14.529000000000002,469689,93071,376618,1.867,9.423,254475,5.106,18.847,(D),(D),(D)
1985,g) 1000 to 2499,3944,82578,5318249,5214393,8454,10.468,4824,5.973,805323,342135,463188,6.561,15.444,594539,158298,436241,3.036,11.402,210784,4.042,22.804,20,147,24989
1986,g) 1000 to 2499,4214,87210,5597938,5558755,10470,12.442,4353,5.172999999999999,811101,330823,480278,5.9510000000000005,14.591,728934,165170,563764,2.971,13.113,82167,1.4780000000000002,26.227,18,185,24510
1987,g) 1000 to 2499,4320,88656,5808129,5785297,9530,10.99,5648,6.513,961306,467530,493776,8.081,16.616,915778,219998,695780,3.803,15.829,45528,0.787,31.659,21,233,26634
1988,g) 1000 to 2499,4578,92392,6186588,6075616,11358,12.703,5397,6.0360000000000005,1002489,410620,591869,6.757999999999999,16.5,782325,256709,525616,4.225,12.876,220164,3.624,25.753,40,265,57441
1989,g) 1000 to 2499,4734,99280,6445824,6329720,11138,11.533,5727,5.93,941233,353340,587893,5.582000000000002,14.87,708962,207877,501085,3.284,11.201,232271,3.67,22.401,25,284,35815
1990,g) 1000 to 2499,4861,104009,6684655,6605652,11318,11.172,5922,5.845,870351,319095,551256,4.831,13.175999999999998,714395,170315,544080,2.5780000000000003,10.815,155956,2.361,21.63,18,53,26494
1991,g) 1000 to 2499,4914,107907,6582153,6635725,11182,10.541,7534,7.102,774098,296631,477467,4.47,11.666,881209,259056,622153,3.904,13.28,-107111,-1.614,23.331,52,186,73640
1992,g) 1000 to 2499,4811,111278,6664384,6621332,11169,10.201,7591,6.933,887190,329640,557550,4.978,13.399,803851,220608,583243,3.332,12.14,83339,1.259,24.281,23,368,33795
1993,g) 1000 to 2499,4887,108509,6686928,6665736,8809,8.115,8897,8.196,840914,269019,571895,4.0360000000000005,12.615,796792,262664,534128,3.941,11.954,44122,0.662,23.907,30,294,46057
1994,g) 1000 to 2499,5110,113197,6930433,6860787,10804,9.659,8124,7.263,881299,294110,587189,4.287,12.845,741873,226931,514942,3.3080000000000003,10.813,139426,2.032,21.626,41,341,60711
1995,g) 1000 to 2499,5070,115122,7054928,6938809,11784,10.445,7174,6.359,942514,335226,607288,4.831,13.583,709133,194718,514415,2.806,10.22,233381,3.363,20.44,31,475,43439
1996,g) 1000 to 2499,5154,114367,7023195,7000381,10305,9.088,8354,7.367000000000001,904985,324132,580853,4.63,12.928,859443,252883,606560,3.612,12.277,45542,0.6509999999999999,24.554,43,408,60842
1997,g) 1000 to 2499,5096,116403,7115541,7097981,13374,11.626,10642,9.251,1050022,388634,661388,5.475,14.793,1012799,330032,682767,4.65,14.269,37223,0.524,28.538,65,949,101276
1998,g) 1000 to 2499,5425,122211,7430131,7336497,12975,10.788,9089,7.557,1075486,372562,702924,5.078,14.659,885762,292865,592897,3.992,12.073,189724,2.5860000000000003,24.147,47,348,67320
1999,g) 1000 to 2499,5444,124499,7541274,7494175,13099,10.66,9866,8.029,1046865,369633,677232,4.932,13.969,948893,305731,643162,4.08,12.662,97972,1.307,25.323,62,908,94806
2000,g) 1000 to 2499,5561,128100,7818058,7699321,13914,11.057,9399,7.4689999999999985,1153463,412290,741173,5.355,14.981,915858,294697,621161,3.828,11.895,237605,3.0860000000000003,23.791,47,752,63038
2001,g) 1000 to 2499,5514,130763,7679616,7687389,13784,10.68,10384,8.046,1014854,351525,663329,4.573,13.202,1029881,311774,718107,4.056,13.397,-15027,-0.195,26.403,53,1603,81460
2002,g) 1000 to 2499,5676,127648,7461956,7666025,11818,9.228,12651,9.879,1019342,372903,646439,4.864,13.297,1425464,469503,955961,6.124,18.595,-406122,-5.297999999999999,26.594,95,1875,142542
2003,g) 1000 to 2499,5663,127186,7471723,7518819,10248,8.103,8819,6.973,923827,285861,637966,3.802,12.287,1015352,294489,720863,3.917,13.504,-91525,-1.217,24.574,50,682,79352
2004,g) 1000 to 2499,5511,129409,7559088,7540228,9567,7.411,8944,6.928,889645,273881,615764,3.632,11.799,859752,252163,607589,3.344,11.402,29893,0.396,22.804,35,1268,47385
2005,g) 1000 to 2499,5587,133087,7827464,7778210,12450,9.481,8907,6.783,987582,361455,626127,4.647,12.697,887257,256865,630392,3.302,11.407,100325,1.29,22.814,45,1129,65069
2006,g) 1000 to 2499,5629,133659,8029815,7936399,12950,9.868,8090,6.165,1007384,315220,692164,3.972,12.693,821689,231943,589746,2.923,10.353,185695,2.34,20.707,36,904,55523
2007,g) 1000 to 2499,5942,139217,8253842,8184400,13215,9.652,8601,6.282,1059869,298505,761364,3.647,12.95,922555,247539,675016,3.025,11.272,137314,1.6780000000000002,22.544,38,321,57946
2008,g) 1000 to 2499,5895,139671,8238415,8254152,10535,7.544,10489,7.511,970698,277764,692934,3.365,11.76,1005862,270392,735470,3.276,12.186,-35164,-0.426,23.52,42,434,60572
2009,g) 1000 to 2499,5822,142596,7891477,8112746,11191,7.866,10558,7.421,784783,288358,496425,3.554,9.673,1224619,289648,934971,3.57,15.095,-439836,-5.4220000000000015,19.347,60,1120,92298
2010,g) 1000 to 2499,5636,144408,7763255,7873339,9992,6.955,8499,5.916,752841,257210,495631,3.267,9.562,973808,226588,747220,2.878,12.368,-220967,-2.807,19.124,40,356,58901
2011,g) 1000 to 2499,5538,149065,8087994,8012957,8245,5.561,6668,4.497,868565,195190,673375,2.436,10.84,717241,166184,551057,2.074,8.951,151324,1.888,17.902,22,296,33669
2012,g) 1000 to 2499,5668,146489,8241803,8153867,8264,5.644,8123,5.547999999999999,927464,202338,725126,2.481,11.375,749176,191609,557567,2.35,9.188,178288,2.187,18.376,26,233,36149
2013,g) 1000 to 2499,5878,149139,8368065,8310783,9172,6.166,8398,5.646,931606,222709,708897,2.68,11.21,817734,212575,605159,2.5580000000000003,9.839,113872,1.37,19.679,39,630,58983
2014,g) 1000 to 2499,5936,152753,8504773,8406674,10957,7.262,7206,4.776,979765,264550,715215,3.147,11.655,782969,175311,607658,2.085,9.314,196796,2.341,18.627,21,217,32581
2015,g) 1000 to 2499,6019,156898,8834306,8698319,11966,7.737,7507,4.854,1063328,306487,756841,3.524,12.225,792322,184100,608222,2.117,9.109,271006,3.116,18.218,35,246,49529
2016,g) 1000 to 2499,6146,161398,8930630,8865792,12004,7.527,8183,5.131,1001834,277759,724075,3.133,11.3,873914,183037,690877,2.065,9.857,127920,1.443,19.714,34,1058,48921
2017,g) 1000 to 2499,6338,160785,8992977,8938421,10221,6.395,8296,5.191,976122,258701,717421,2.894,10.921,865769,208572,657197,2.333,9.686,110353,1.235,19.372,33,776,50886
2018,g) 1000 to 2499,6184,161905,9174797,9081138,9918,6.1110000000000015,10680,6.581,1069608,306512,763096,3.375,11.778,881349,198051,683298,2.181,9.705,188259,2.073,19.411,32,1085,44796
1978,h) 2500 to 4999,1163,55493,3231022,3205016,6160,11.052,6644,11.921,545596,197020,348576,6.147,17.023,493514,242796,250718,7.576,15.398,52082,1.625,30.796,10,14,31632
1979,h) 2500 to 4999,1151,52845,3432189,3363560,6300,12.153,4285,8.266,536534,210482,326052,6.257999999999999,15.951,403026,172645,230381,5.132999999999999,11.982,133508,3.969,23.964,4,9,5537
1980,h) 2500 to 4999,1152,53983,3379354,3334606,6487,12.351,3566,6.789,458368,218364,240004,6.547999999999999,13.746,363871,104618,259253,3.137,10.912,94497,2.834,21.824,(D),(D),(D)
1981,h) 2500 to 4999,1204,57654,3486045,3479490,5590,9.94,2753,4.895,414322,167784,246538,4.822,11.908,400007,104488,295519,3.003,11.496,14315,0.411,22.992,(D),(D),(D)
1982,h) 2500 to 4999,1328,61968,3716047,3652982,5840,9.543,4299,7.025,568219,291261,276958,7.973,15.555,443472,133829,309643,3.664,12.14,124747,3.415,24.28,(D),(D),(D)
1983,h) 2500 to 4999,1364,59562,3547443,3579903,4873,8.298,3201,5.4510000000000005,446813,187180,259633,5.229,12.481,513077,106823,406254,2.984,14.332,-66264,-1.851,24.962,(D),(D),(D)
1984,h) 2500 to 4999,1303,59994,3682907,3589343,5817,9.963,2603,4.458,549014,225315,323699,6.277,15.296,364586,93402,271184,2.602,10.157,184428,5.138,20.315,(D),(D),(D)
1985,h) 2500 to 4999,1373,61728,3825109,3744718,6609,11.050999999999998,2763,4.62,606467,256242,350225,6.843,16.195,446704,102523,344181,2.738,11.929,159763,4.266,23.858,(D),(D),(D)
1986,h) 2500 to 4999,1493,64002,4004478,3923059,6792,10.877,3671,5.879,647644,287474,360170,7.3279999999999985,16.509,487312,111057,376255,2.8310000000000004,12.422,160332,4.087,24.843000000000004,(D),(D),(D)
1987,h) 2500 to 4999,1583,70081,4177505,4190490,8457,12.475,3875,5.716,678673,328181,350492,7.832000000000002,16.195999999999998,705267,173875,531392,4.149,16.83,-26594,-0.635,32.391,5,65,15880
1988,h) 2500 to 4999,1644,77577,4335421,4254511,10412,13.888,5199,6.935,729976,337603,392373,7.935,17.158,563538,182627,380911,4.293,13.246,166438,3.912,26.491,8,21,26459
1989,h) 2500 to 4999,1730,83816,4627724,4548598,9138,11.183,4927,6.03,660796,253213,407583,5.567,14.527,502809,152260,350549,3.347,11.054,157987,3.4730000000000003,22.108,6,109,19682
1990,h) 2500 to 4999,1732,85698,4835515,4777193,7660,9.086,4884,5.792999999999998,651632,230876,420756,4.833,13.64,531348,135385,395963,2.834,11.123,120284,2.518,22.245,4,398,12027
1991,h) 2500 to 4999,1679,82157,4668841,4682116,8390,10.461,4482,5.587999999999999,569115,236196,332919,5.045,12.155,594486,175539,418947,3.749,12.697,-25371,-0.542,24.31,11,16,35128
1992,h) 2500 to 4999,1668,80413,4727223,4712880,7369,9.238,6077,7.6179999999999986,599879,214031,385848,4.541,12.729,571165,175703,395462,3.728,12.119000000000002,28714,0.609,24.238000000000003,5,5,19143
1993,h) 2500 to 4999,1748,87301,4963936,4942181,7024,8.097999999999999,5898,6.8,596279,205584,390695,4.16,12.065,552156,178325,373831,3.608,11.172,44123,0.893,22.345,5,7,17059
1994,h) 2500 to 4999,1952,91016,5179087,5129082,8951,10.007,5809,6.494,626894,243884,383010,4.755,12.222,525952,171907,354045,3.352,10.254,100942,1.968,20.509,9,275,28048
1995,h) 2500 to 4999,2007,92804,5458560,5391269,9503,10.407,6524,7.145,688208,261214,426994,4.845,12.765,554430,166970,387460,3.097,10.284,133778,2.481,20.568,8,414,24725
1996,h) 2500 to 4999,2035,97440,5634592,5613606,8173,8.424,7323,7.547999999999999,684805,229329,455476,4.085,12.199000000000002,646693,186621,460072,3.324,11.52,38112,0.679,23.04,4,12,10856
1997,h) 2500 to 4999,1883,96392,5519510,5469798,10638,11.182,8124,8.539,855820,360649,495171,6.593,15.646,758789,227297,531492,4.155,13.872,97031,1.774,27.745,8,319,23925
1998,h) 2500 to 4999,2149,96180,5923598,5827715,11338,12.0,7945,8.408999999999999,867408,305936,561472,5.25,14.884,673193,213466,459727,3.663,11.552,194215,3.333,23.103,3,150,10818
1999,h) 2500 to 4999,1993,98573,5798489,5744250,10572,10.909,7246,7.477,846421,335542,510879,5.841,14.735,730975,231353,499622,4.0280000000000005,12.725,115446,2.01,25.451,7,237,27244
2000,h) 2500 to 4999,2140,102346,5941696,5905208,11176,11.075,8314,8.238999999999999,834754,314635,520119,5.3279999999999985,14.136,765128,258556,506572,4.378,12.957,69626,1.179,25.914,11,684,39841
2001,h) 2500 to 4999,2085,99699,6090756,6086050,10934,11.0,10344,10.406,832275,284728,547547,4.678,13.675,822109,253739,568370,4.169,13.508,10166,0.16699999999999998,27.016,15,1302,48093
2002,h) 2500 to 4999,2172,100789,5793269,5951779,8961,8.832,10315,10.166,777552,287935,489617,4.838,13.064,1094525,365186,729339,6.136,18.39,-316973,-5.3260000000000005,26.128,27,1213,90101
2003,h) 2500 to 4999,2190,101189,5837829,5865936,8764,8.641,9240,9.11,766424,248352,518072,4.234,13.066,817419,249743,567676,4.258,13.935,-50995,-0.8690000000000001,26.131,12,710,44157
2004,h) 2500 to 4999,2063,106274,5973459,5979031,9708,9.232,7474,7.107,742741,239849,502892,4.012,12.422,749094,240564,508530,4.023,12.529000000000002,-6353,-0.106,24.845,13,15,42010
2005,h) 2500 to 4999,2063,104758,6053668,6003820,8651,8.294,7734,7.415,749887,253656,496231,4.225,12.49,647203,200590,446613,3.341,10.78,102684,1.71,21.56,10,182,33948
2006,h) 2500 to 4999,2122,112762,6291204,6230269,10758,9.725,6473,5.852,788931,265753,523178,4.266,12.663,664884,177014,487870,2.841,10.672,124047,1.991,21.344,6,146,23000
2007,h) 2500 to 4999,2248,112291,6468885,6432443,10209,9.191,7769,6.995,817680,247099,570581,3.841,12.712,747280,216763,530517,3.37,11.617,70400,1.094,23.235,13,139,37937
2008,h) 2500 to 4999,2238,116547,6545942,6576881,8413,7.227,8134,6.988,733655,200815,532840,3.053,11.155,796349,237458,558891,3.61,12.108,-62694,-0.953,22.31,14,583,49411
2009,h) 2500 to 4999,2211,116755,6341619,6486785,8910,7.603,9788,8.352,633285,225236,408049,3.472,9.763,924581,224917,699664,3.467,14.253,-291296,-4.4910000000000005,19.525,14,811,41158
2010,h) 2500 to 4999,2016,116769,6025933,6110882,8257,7.0520000000000005,8889,7.592,548008,179087,368921,2.931,8.968,724728,191494,533234,3.134,11.86,-176720,-2.892,17.935,7,599,26702
2011,h) 2500 to 4999,2012,121724,6199826,6186581,7843,6.4620000000000015,7129,5.874,608115,155980,452135,2.521,9.83,579756,149563,430193,2.418,9.371,28359,0.458,18.742,6,44,17416
2012,h) 2500 to 4999,2114,122580,6411995,6370399,7371,6.027,6799,5.56,708135,164207,543928,2.5780000000000003,11.116,623265,187329,435936,2.9410000000000003,9.784,84870,1.332,19.568,13,33,44112
2013,h) 2500 to 4999,2262,124384,6459028,6420884,7980,6.416,7953,6.395,712520,177994,534526,2.772,11.097,636365,170460,465905,2.655,9.911,76155,1.186,19.822,10,383,31734
2014,h) 2500 to 4999,2217,130668,6737024,6666622,8210,6.325,6495,5.003,735286,199553,535733,2.9930000000000003,11.029000000000002,591398,147882,443516,2.218,8.871,143888,2.158,17.742,3,131,11869
2015,h) 2500 to 4999,2280,134397,7049575,6963890,9243,6.933,7095,5.322,806603,211725,594878,3.04,11.583,632449,150755,481694,2.165,9.082,174154,2.501,18.164,3,448,10028
2016,h) 2500 to 4999,2290,136447,7107360,7049289,9013,6.6610000000000005,6720,4.967,782485,222340,560145,3.154,11.1,665269,145345,519924,2.062,9.437,117216,1.663,18.875,8,325,25056
2017,h) 2500 to 4999,2376,135852,7082272,7067243,8549,6.276,9285,6.816,766699,172649,594050,2.443,10.849,733152,208287,524865,2.947,10.374,33547,0.475,20.748,13,431,47282
2018,h) 2500 to 4999,2192,137669,7202416,7130167,9386,6.836,8669,6.313,809950,233592,576358,3.276,11.359000000000002,667733,158892,508841,2.228,9.365,142217,1.995,18.73,9,736,32222
1978,i) 5000 to 9999,684,45512,3502772,3443138,5069,11.1,5375,11.771,590673,186336,404337,5.412000000000001,17.155,469261,198690,270571,5.771,13.629,121412,3.526,27.258000000000006,(D),(D),(D)
1979,i) 5000 to 9999,688,55054,3687755,3583645,8605,16.156,5022,9.429,604635,251567,353068,7.02,16.872,399393,143962,255431,4.017,11.145,205242,5.727,22.29,(D),(D),(D)
1980,i) 5000 to 9999,688,61395,3944148,3887535,7056,11.826,3592,6.02,544291,232041,312250,5.9689999999999985,14.001,430322,124650,305672,3.2060000000000004,11.069,113969,2.932,22.139,0,0,0
1981,i) 5000 to 9999,715,62865,3753889,3722914,6416,10.470999999999998,3239,5.2860000000000005,445335,172060,273275,4.622,11.962,381218,86999,294219,2.337,10.24,64117,1.722,20.48,0,0,0
1982,i) 5000 to 9999,722,65250,3889012,3903086,5663,8.65,6093,9.307,508992,206205,302787,5.283,13.041,531787,172465,359322,4.419,13.625,-22795,-0.584,26.082,(D),(D),(D)
1983,i) 5000 to 9999,821,65133,3897468,3892168,5045,7.772,4606,7.096,579465,271886,307579,6.985,14.888,565502,142376,423126,3.658,14.529000000000002,13963,0.359,29.058000000000003,0,0,0
1984,i) 5000 to 9999,879,67653,4104983,4021938,5991,9.079,2658,4.0280000000000005,614592,259527,355065,6.4529999999999985,15.281,446777,94998,351779,2.362,11.109000000000002,167815,4.172,22.217,(D),(D),(D)
1985,i) 5000 to 9999,864,74959,4147705,4125373,7229,9.895,3418,4.6789999999999985,603950,258915,345035,6.276,14.64,557898,135339,422559,3.281,13.524,46052,1.116,27.047,(D),(D),(D)
1986,i) 5000 to 9999,928,76313,4329163,4273684,6672,8.83,5172,6.845,612188,251407,360781,5.882999999999999,14.325,502344,129740,372604,3.036,11.754,109844,2.57,23.509,0,0,0
1987,i) 5000 to 9999,926,77774,4325565,4359950,7615,9.894,6000,7.796,638407,265033,373374,6.079,14.643,706992,208971,498021,4.793,16.215999999999998,-68585,-1.5730000000000002,29.285,(D),(D),(D)
1988,i) 5000 to 9999,964,79283,4581721,4542436,7760,9.905,5880,7.505,724431,318140,406291,7.004,15.948,642801,230455,412346,5.073,14.151,81630,1.797,28.302,(D),(D),(D)
1989,i) 5000 to 9999,966,79351,4650968,4577487,8057,10.388,4477,5.772,704602,282847,421755,6.1789999999999985,15.393,555427,171731,383696,3.752,12.134,149175,3.259,24.268,0,0,0
1990,i) 5000 to 9999,940,85742,4936290,4874037,8606,10.262,4855,5.789,643549,224324,419225,4.602,13.204,519771,128176,391595,2.63,10.664,123778,2.54,21.328000000000007,0,0,0
1991,i) 5000 to 9999,963,91184,4858243,4873841,8909,9.944,5732,6.398,573185,228397,344788,4.686,11.76,607965,173492,434473,3.56,12.474,-34780,-0.7140000000000001,23.521,(D),(D),(D)
1992,i) 5000 to 9999,966,95261,4899458,4915116,7302,7.739,5490,5.818,594321,206435,387886,4.2,12.092,625796,148991,476805,3.031,12.732,-31475,-0.64,24.183000000000003,3,3,21480
1993,i) 5000 to 9999,968,88470,5035561,5020807,5842,6.5139999999999985,8279,9.231,603903,192267,411636,3.829,12.028,572705,167182,405523,3.33,11.407,31198,0.621,22.813,(D),(D),(D)
1994,i) 5000 to 9999,1039,91784,5052750,5027489,8673,9.583,6115,6.7570000000000014,617582,208902,408680,4.155,12.284,566607,189236,377371,3.764,11.27,50975,1.014,22.54,3,3,17991
1995,i) 5000 to 9999,1130,94594,5135160,5087922,9920,10.71,5979,6.455,677425,262272,415153,5.155,13.314,580402,159825,420577,3.141,11.407,97023,1.907,22.815,(D),(D),(D)
1996,i) 5000 to 9999,1060,97384,5312561,5304024,9790,10.157,7800,8.092,680130,243896,436234,4.598,12.823,664596,208787,455809,3.936,12.53,15534,0.293,25.06,(D),(D),(D)
1997,i) 5000 to 9999,1048,103829,5515686,5490071,11353,10.898,12049,11.566,823603,303005,520598,5.519,15.002,769151,257516,511635,4.691,14.01,54452,0.992,28.02,3,3,21865
1998,i) 5000 to 9999,1166,107430,5900394,5784621,12417,11.762,8700,8.241,926494,332290,594204,5.744,16.017,692756,236492,456264,4.088,11.976,233738,4.041,23.952,0,0,0
1999,i) 5000 to 9999,1191,113064,6315481,6223275,14010,12.688,8721,7.898,1000490,403497,596993,6.484,16.077,814957,243035,571922,3.905,13.095,185533,2.9810000000000003,26.191,(D),(D),(D)
2000,i) 5000 to 9999,1212,115385,6223437,6144874,12344,10.702,12257,10.627,997960,375358,622602,6.108,16.241,841988,283577,558411,4.615,13.702,155972,2.5380000000000003,27.405,(D),(D),(D)
2001,i) 5000 to 9999,1170,123227,6186203,6246063,14116,11.489,13388,10.897,862514,331419,531095,5.306,13.809,977418,329155,648263,5.27,15.649,-114904,-1.84,27.618,5,133,36952
2002,i) 5000 to 9999,1220,114195,6068798,6235591,10996,9.555,12779,11.104,840075,313204,526871,5.023,13.472,1173573,421656,751917,6.7620000000000005,18.821,-333498,-5.348,26.945,10,1036,71655
2003,i) 5000 to 9999,1212,113749,5938492,5998414,9360,8.19,10421,9.119,729835,235545,494290,3.927,12.167,850671,276466,574205,4.609,14.182,-120836,-2.014,24.334,(D),(D),(D)
2004,i) 5000 to 9999,1125,115649,6313616,6339062,11436,9.991,9072,7.925,782212,241820,540392,3.815,12.34,835159,281794,553365,4.445,13.175,-52947,-0.835,24.679,6,722,38330
2005,i) 5000 to 9999,1146,120194,6310234,6293023,10168,8.555,7480,6.294,745056,252071,492985,4.006,11.839,712196,198537,513659,3.155,11.317,32860,0.522,22.634,(D),(D),(D)
2006,i) 5000 to 9999,1133,122835,6499608,6433782,10737,8.826,8373,6.882999999999999,828134,265658,562476,4.129,12.872,699398,201011,498387,3.124,10.871,128736,2.001,21.741,(D),(D),(D)
2007,i) 5000 to 9999,1265,120563,6537634,6529541,12056,10.025,11452,9.523,818277,248618,569659,3.808,12.532,797922,233106,564816,3.57,12.22,20355,0.312,24.44,(D),(D),(D)
2008,i) 5000 to 9999,1244,114519,6690379,6677635,11295,9.922,9937,8.729,815150,250664,564486,3.754,12.207,790376,232980,557396,3.489,11.836,24774,0.371,23.672,5,383,31493
2009,i) 5000 to 9999,1195,119394,6385358,6562978,10299,8.612,10681,8.932,630495,219754,410741,3.3480000000000003,9.607,983885,239103,744782,3.643,14.991,-353390,-5.385,19.214,3,60,19912
2010,i) 5000 to 9999,1110,116658,6310442,6426568,8074,6.874,9663,8.227,619068,158792,460276,2.471,9.633,848324,234819,613505,3.654,13.2,-229256,-3.567,19.266,4,339,27075
2011,i) 5000 to 9999,1062,111125,6354325,6286629,7861,7.072,7913,7.119,680506,153821,526685,2.447,10.825,540826,152113,388713,2.42,8.603,139680,2.222,17.206,(D),(D),(D)
2012,i) 5000 to 9999,1104,116572,6441787,6407421,6897,5.919,6799,5.835,684308,157888,526420,2.464,10.68,617270,155020,462250,2.419,9.634,67038,1.046,19.267,(D),(D),(D)
2013,i) 5000 to 9999,1174,119903,6593546,6552093,9063,7.562,8947,7.465,754543,198620,555923,3.031,11.515999999999998,668834,186251,482583,2.843,10.208,85709,1.308,20.416,3,52,16319
2014,i) 5000 to 9999,1194,121585,6731608,6696276,8412,6.894,9290,7.612999999999999,745947,211421,534526,3.157,11.14,671477,161821,509656,2.417,10.028,74470,1.112,20.055,(D),(D),(D)
2015,i) 5000 to 9999,1169,128728,6908393,6864260,9352,7.322,7336,5.744,713103,190286,522817,2.772,10.389,624709,167038,457671,2.4330000000000003,9.101,88394,1.288,18.202,5,501,32715
2016,i) 5000 to 9999,1255,131791,7147898,7117444,9057,6.932,6793,5.199,730608,192854,537754,2.71,10.265,669825,139221,530604,1.956,9.411,60783,0.8540000000000001,18.822,(D),(D),(D)
2017,i) 5000 to 9999,1350,135310,7247559,7244035,8592,6.3820000000000014,7250,5.385,782404,190777,591627,2.634,10.800999999999998,771941,211816,560125,2.924,10.656,10463,0.14400000000000002,21.312,5,283,26167
2018,i) 5000 to 9999,1156,133950,7300593,7235790,8418,6.314,7169,5.377000000000002,842582,240532,602050,3.324,11.645,710334,210571,499763,2.91,9.817,132248,1.828,19.634,4,225,26385
1978,j) 10000+,794,214911,17015861,16756070,21551,10.114,17904,8.402000000000001,2400858,755603,1645255,4.509,14.328,1875448,647664,1227784,3.865,11.193,525410,3.136,22.385,(D),(D),(D)
1979,j) 10000+,759,225904,18089500,17769300,22541,10.078,18069,8.078,2429855,747088,1682767,4.204,13.674,1775757,580968,1194789,3.27,9.993,654098,3.681,19.987,(D),(D),(D)
1980,j) 10000+,822,241980,18819326,18757678,21705,9.112,14141,5.937,2332630,810385,1522245,4.32,12.436,2205082,519903,1685179,2.772,11.755999999999998,127548,0.68,23.511,0,0,0
1981,j) 10000+,921,256140,19149558,19281722,23400,9.254,16841,6.66,2150225,772149,1378076,4.005,11.152,2410501,612976,1797525,3.179,12.501,-260276,-1.35,22.303,(D),(D),(D)
1982,j) 10000+,990,263546,18579495,18912075,26935,10.345999999999998,20546,7.892,2027830,770936,1256894,4.0760000000000005,10.722,2689335,682591,2006744,3.609,14.22,-661505,-3.498,21.445,0,0,0
1983,j) 10000+,1086,265460,18219017,18385893,22659,8.599,18733,7.109,2562530,899918,1662612,4.895,13.937,2890891,687944,2202947,3.742,15.723,-328361,-1.786,27.875,0,0,0
1984,j) 10000+,1022,278921,18845414,18479341,29371,10.81,14935,5.497000000000001,2736485,1102364,1634121,5.965,14.808,1981517,540072,1441445,2.923,10.723,754968,4.085,21.446,0,0,0
1985,j) 10000+,1079,279703,19674667,19384397,26460,9.51,23518,8.453,2857950,1139754,1718196,5.88,14.744000000000002,2292466,815971,1476495,4.209,11.826,565484,2.917,23.653,0,0,0
1986,j) 10000+,1105,283098,19801584,19736785,26293,9.415,18612,6.665,2452913,937786,1515127,4.751,12.428,2321962,704499,1617463,3.569,11.765,130951,0.6629999999999999,23.529,0,0,0
1987,j) 10000+,1156,292270,19681809,19867969,35354,12.33,24290,8.471,2701517,1144838,1556679,5.7620000000000005,13.597,3061351,979976,2081375,4.932,15.408,-359834,-1.811,27.195,0,0,0
1988,j) 10000+,1053,323197,20266944,20119325,45218,14.505999999999998,22250,7.138,2934803,1155715,1779088,5.744,14.587,2651001,882748,1768253,4.388,13.175999999999998,283802,1.411,26.353,(D),(D),(D)
1989,j) 10000+,1121,338396,20994352,20785922,46014,14.069,23334,7.135,2964919,1174065,1790854,5.648,14.264,2570736,723368,1847368,3.48,12.368,394183,1.896,24.735,0,0,0
1990,j) 10000+,1100,349535,21725874,21503118,33537,9.811,18125,5.3020000000000005,2751337,968284,1783053,4.503,12.795,2299080,583146,1715934,2.712,10.692,452257,2.103,21.384,0,0,0
1991,j) 10000+,1090,363292,21930921,22052701,35387,9.952,19974,5.617000000000001,2553313,1023594,1529719,4.642,11.578,2802370,635882,2166488,2.883,12.708,-249057,-1.129,23.156,(D),(D),(D)
1992,j) 10000+,994,358526,21720409,21830047,29253,8.193,26268,7.357,2668710,993631,1675079,4.552,12.225,2876691,874275,2002416,4.005,13.178,-207981,-0.953,24.45,3,14,73690
1993,j) 10000+,1160,354381,21813291,21924894,30840,8.591000000000001,40045,11.155,2764182,945319,1818863,4.312,12.608,3001305,998568,2002737,4.5539999999999985,13.689,-237123,-1.082,25.215,0,0,0
1994,j) 10000+,1319,366614,22266941,22188358,40714,11.226,32815,9.048,2889618,1200193,1689425,5.409,13.023,2725242,900327,1824915,4.058,12.282,164376,0.741,24.565,0,0,0
1995,j) 10000+,1393,389216,23422146,23187488,40679,10.542,33980,8.806000000000003,3084130,1289684,1794446,5.562,13.300999999999998,2602937,807698,1795239,3.483,11.226,481193,2.075,22.451,0,0,0
1996,j) 10000+,1351,404748,23983446,23948566,41928,10.451,34831,8.682,3176866,1261603,1915263,5.268,13.265,3110543,984430,2126113,4.1110000000000015,12.988,66323,0.277,25.977,0,0,0
1997,j) 10000+,1107,420298,25493782,25230654,52262,12.532,45695,10.958,4082802,1667521,2415281,6.609,16.182000000000002,3540060,1283153,2256907,5.086,14.031,542742,2.151,28.062,0,0,0
1998,j) 10000+,1427,447270,26678850,26437006,58963,13.415,43478,9.892,3920548,1608071,2312477,6.082999999999998,14.83,3414479,1235315,2179164,4.673,12.916,506069,1.914,25.831,0,0,0
1999,j) 10000+,1345,479538,28066501,27966065,60645,12.84,46164,9.774,4106583,1648865,2457718,5.896,14.684,3911890,1365475,2546415,4.883,13.988,194693,0.696,27.976,0,0,0
2000,j) 10000+,1431,501988,29472164,29330527,63383,12.765999999999998,52383,10.550999999999998,4457043,1741056,2715987,5.936,15.196,4178605,1672997,2505608,5.704,14.247,278438,0.949,28.493,(D),(D),(D)
2001,j) 10000+,1303,526216,30480469,30407433,69170,13.345999999999998,53340,10.291,4634781,2022616,2612165,6.652,15.242,4511152,1478295,3032857,4.862,14.836,123629,0.407,29.671,0,0,0
2002,j) 10000+,1446,547512,29866464,30494961,66745,12.263,60307,11.08,4457763,1826905,2630858,5.9910000000000005,14.618,5729487,1871436,3858051,6.1370000000000005,18.788,-1271724,-4.17,29.236,6,507,123117
2003,j) 10000+,1771,553222,29397861,29768220,60269,10.925999999999998,56999,10.334,3744058,1475541,2268517,4.957,12.577,4505835,1504028,3001807,5.052,15.136,-761777,-2.559,25.155,(D),(D),(D)
2004,j) 10000+,1380,561309,29353282,29404878,62956,11.279000000000002,56680,10.155,3904250,1369543,2534707,4.658,13.278,4035417,1426804,2608613,4.852,13.724,-131167,-0.446,26.555,0,0,0
2005,j) 10000+,1369,573752,29835638,29859845,61475,10.793,53153,9.332,3583100,1362267,2220833,4.562,12.0,3630668,1142920,2487748,3.828,12.159,-47568,-0.159,23.999,(D),(D),(D)
2006,j) 10000+,1302,605077,31059884,30759572,70390,11.85,48218,8.118,4145727,1583321,2562406,5.147,13.478,3566898,1070225,2496673,3.479,11.595999999999998,578829,1.882,23.192,(D),(D),(D)
2007,j) 10000+,1551,634166,31600289,31680412,77825,12.404000000000002,64311,10.25,4434437,1616127,2818310,5.101,13.997,4598208,1452972,3145236,4.586,14.514,-163771,-0.517,27.995,(D),(D),(D)
2008,j) 10000+,2178,659087,31835554,32007517,62672,9.555,56343,8.59,3941509,1338247,2603262,4.181,12.314,4312530,1257132,3055398,3.928,13.473,-371021,-1.159,24.629,(D),(D),(D)
2009,j) 10000+,1331,650540,30923137,31622615,57935,8.853,65634,10.03,3139348,1200463,1938885,3.796,9.928,4564455,1167471,3396984,3.692,14.434,-1425107,-4.507,19.855,3,739,72677
2010,j) 10000+,1354,638688,30037652,30423175,48330,7.518,56646,8.812000000000003,2914987,916774,1998213,3.013,9.581,3659068,1001153,2657915,3.2910000000000004,12.027,-744081,-2.446,19.163,(D),(D),(D)
2011,j) 10000+,1161,642639,30479346,30319317,57948,9.054,52685,8.232000000000001,3499244,1020428,2478816,3.366,11.541,3175613,915019,2260594,3.018,10.474,323631,1.067,20.948,(D),(D),(D)
2012,j) 10000+,1201,648107,31062228,31045745,52825,8.148,53210,8.208,3377554,927461,2450093,2.987,10.879,3339917,966947,2372970,3.115,10.758,37637,0.121,21.516,4,2088,56316
2013,j) 10000+,1228,657963,32154078,32039666,58849,8.967,55501,8.457,3575227,1181425,2393802,3.687,11.159,3357191,1046875,2310316,3.267,10.478,218036,0.6809999999999999,20.956,0,0,0
2014,j) 10000+,1255,680240,33018810,32846485,64181,9.563,45933,6.8439999999999985,3670692,1163925,2506767,3.544,11.175,3332238,904381,2427857,2.753,10.145,338454,1.03,20.29,(D),(D),(D)
2015,j) 10000+,1320,693838,34046918,33759395,64666,9.389,54442,7.905,4008812,1358242,2650570,4.023,11.875,3417955,897255,2520700,2.658,10.124,590857,1.75,20.249,0,0,0
2016,j) 10000+,1388,733053,35071229,34891140,66080,9.207,35393,4.931,3707939,1185787,2522152,3.399,10.627,3354713,960442,2394271,2.753,9.615,353226,1.012,19.23,(D),(D),(D)
2017,j) 10000+,1464,735314,35585972,35570095,52374,7.085,60278,8.154,3775903,1193566,2582337,3.3560000000000003,10.615,3750076,1157164,2592912,3.253,10.543,25827,0.073,21.086,0,0,0
2018,j) 10000+,1182,749857,37325253,37073113,47286,6.313,45615,6.09,3680029,1138649,2541380,3.071,9.926,3169813,836847,2332966,2.257,8.55,510216,1.376,17.1,0,0,0
