year,iesize,firms,estabs,emp,denom,estabs_entry,estabs_entry_rate,estabs_exit,estabs_exit_rate,job_creation,job_creation_births,job_creation_continuers,job_creation_rate_births,job_creation_rate,job_destruction,job_destruction_deaths,job_destruction_continuers,job_destruction_rate_deaths,job_destruction_rate,net_job_creation,net_job_creation_rate,reallocation_rate,firmdeath_firms,firmdeath_estabs,firmdeath_emp
1978,a) 1 to 4,2160530,2340350,6292343,5534802,448191,19.587,343957,15.032,2469508,853429,1616079,15.419,44.618,958087,646240,311847,11.675999999999998,17.31,1511421,27.308000000000003,34.62,249775,251513,464146
1979,a) 1 to 4,2145206,2322058,6092212,5436404,431698,19.113,305000,13.503,2262910,816977,1445933,15.028,41.625,962150,587328,374822,10.804,17.698,1300760,23.927,35.397,219420,221186,419182
1980,a) 1 to 4,2106894,2286148,5771287,5309741,401763,17.771,350961,15.524,1996492,762429,1234063,14.359000000000002,37.601,1084190,655819,428371,12.351,20.419,912302,17.182000000000002,40.838,257214,259444,476300
1981,a) 1 to 4,2157545,2345296,6001181,5466537,388685,16.796,326355,14.103,2082457,737063,1345394,13.483,38.095,1023059,602582,420477,11.023,18.715,1059398,19.38,37.43,226106,228836,416988
1982,a) 1 to 4,2137131,2333206,6075079,5529376,404419,17.417,382086,16.455,2196839,788007,1408832,14.251,39.73,1115947,706556,409391,12.778,20.182,1080892,19.548,40.364,274817,277938,509505
1983,a) 1 to 4,2238671,2435944,6212345,5621559,441759,18.684,298693,12.633,2149596,830597,1318999,14.775,38.238,979276,573986,405290,10.21,17.42,1170320,20.818,34.84,212299,214967,411075
1984,a) 1 to 4,2360279,2563254,6774072,5984963,490846,19.825,316138,12.769,2533363,934568,1598795,15.615,42.32899999999999,963488,593064,370424,9.909,16.098,1569875,26.23,32.197,236121,238715,446728
1985,a) 1 to 4,2354993,2556878,6760464,6038752,478191,19.142,360660,14.437,2494396,915464,1578932,15.16,41.306,1062581,676881,385700,11.209,17.596,1431815,23.71,35.192,271873,274996,515923
1986,a) 1 to 4,2358588,2559218,6760875,6064021,466335,18.623,356176,14.223,2470333,898585,1571748,14.818,40.738,1085077,678496,406581,11.189,17.894000000000005,1385256,22.844,35.787,263985,267149,508938
1987,a) 1 to 4,2386405,2592608,6917533,6174014,491439,19.398,373132,14.728,2605692,942849,1662843,15.271,42.20399999999999,1128050,716807,411243,11.61,18.271,1477642,23.933000000000003,36.542,272359,275526,525352
1988,a) 1 to 4,2446287,2668175,7039729,6302079,501747,19.276,371271,14.264,2606303,956133,1650170,15.172,41.356,1141251,699690,441561,11.103,18.109,1465052,23.247,36.218,274676,278110,523228
1989,a) 1 to 4,2478441,2710622,7163571,6416575,491378,18.542,370175,13.969,2615150,940904,1674246,14.664,40.756,1135633,695428,440205,10.838,17.698,1479517,23.058000000000003,35.397,277451,281897,530256
1990,a) 1 to 4,2499197,2736263,7209693,6484518,477803,17.799,374296,13.943,2583981,911400,1672581,14.055,39.848,1146638,703022,443616,10.842,17.683,1437343,22.166,35.365,284743,289197,543592
1991,a) 1 to 4,2474509,2725156,6975378,6407033,457449,16.971,398048,14.767,2365099,877835,1487264,13.701,36.914,1244300,748712,495588,11.686,19.421,1120799,17.493,38.842,294629,299508,564307
1992,a) 1 to 4,2516700,2766752,7265774,6598888,445960,16.278,391806,14.300999999999998,2522235,844162,1678073,12.792,38.222,1203237,735799,467438,11.15,18.234,1318998,19.988,36.468,274331,279193,520000
1993,a) 1 to 4,2574864,2820360,7377798,6701135,458753,16.453,394670,14.154000000000002,2536288,856766,1679522,12.785,37.849,1193510,737218,456292,11.001,17.811,1342778,20.038,35.621,277894,283221,526482
1994,a) 1 to 4,2617572,2867563,7298492,6685805,475082,16.801,395410,13.983,2430337,888314,1542023,13.287,36.351,1216768,731944,484824,10.948,18.199,1213569,18.151,36.399,286665,290866,537998
1995,a) 1 to 4,2686796,2944840,7449489,6801328,490228,16.930999999999994,391274,13.514,2466219,915005,1551214,13.453,36.261,1180433,718324,462109,10.562,17.355999999999998,1285786,18.905,34.712,287344,291981,536365
1996,a) 1 to 4,2706470,2968742,7452680,6841794,483804,16.500999999999998,410097,13.987,2432616,900227,1532389,13.158,35.555,1220891,750737,470154,10.973,17.845,1211725,17.711,35.689,298800,303266,556000
1997,a) 1 to 4,2735770,3002026,7709958,7013163,499878,16.820999999999998,439388,14.785,2658919,937548,1721371,13.368,37.913,1274513,811274,463239,11.568,18.173,1384406,19.74,36.346,308387,313974,576376
1998,a) 1 to 4,2757078,3038671,7780933,7082762,489564,16.313,414431,13.809,2625606,905540,1720066,12.785,37.07,1239515,763605,475910,10.781,17.5,1386091,19.57,35.001,289105,293705,537756
1999,a) 1 to 4,2768979,3058502,7757137,7079333,481378,15.909,415865,13.744000000000002,2578812,891632,1687180,12.595,36.427,1236047,760939,475108,10.749,17.46,1342765,18.967,34.92,292826,297386,542709
2000,a) 1 to 4,2762366,3064466,7825608,7138639,466313,15.314,427279,14.032,2607530,872312,1735218,12.22,36.527,1241860,776395,465465,10.876,17.396,1365670,19.131,34.793,292020,297072,538375
2001,a) 1 to 4,2745675,3056045,7744815,7090355,476436,15.693,436422,14.375,2577194,889294,1687900,12.542,36.348,1278808,795700,483108,11.222,18.036,1298386,18.312,36.072,293077,298192,541929
2002,a) 1 to 4,2764873,3077816,7917790,7202108,498947,16.287,470293,15.352,2761666,951290,1810376,13.208,38.345,1347186,858759,488427,11.924,18.705,1414480,19.64,37.411,302999,309051,561284
2003,a) 1 to 4,2826523,3148394,8050751,7341098,518184,16.63,453474,14.553,2747450,957558,1789892,13.044,37.426,1342770,825337,517433,11.243,18.291,1404680,19.134,36.582,300812,305009,555151
2004,a) 1 to 4,2878407,3210896,8278036,7479021,532002,16.795,445390,14.061,2865021,980266,1884755,13.107,38.307,1280662,803563,477099,10.744000000000002,17.123,1584359,21.184,34.247,299911,304149,553874
2005,a) 1 to 4,2921919,3263048,8063603,7423259,553501,17.198,464391,14.429,2649939,1004951,1644988,13.538,35.698,1383873,837891,545982,11.287,18.642,1266066,17.055,37.285,314591,319213,578641
2006,a) 1 to 4,3005957,3371444,8378372,7637472,608842,18.349,502063,15.130999999999998,2849982,1102361,1747621,14.434,37.316,1378835,892715,486120,11.689,18.054,1471147,19.262,36.107,361766,365629,656193
2007,a) 1 to 4,3018196,3398403,8496671,7744204,572254,17.014,502428,14.938,2913744,1022232,1891512,13.2,37.625,1426591,886635,539956,11.449000000000002,18.421,1487153,19.203,36.843,339908,343968,606220
2008,a) 1 to 4,2976874,3362704,8282947,7680169,503347,14.887,540198,15.977,2669591,892669,1776922,11.623,34.76,1480651,933128,547523,12.15,19.279,1188940,15.481,38.558,371951,375882,650715
2009,a) 1 to 4,2885275,3258656,7795636,7408197,450473,13.554,580279,17.46,2328981,799214,1529767,10.788,31.438,1570932,1003203,567729,13.542,21.205,758049,10.233,42.411,384841,389105,677438
2010,a) 1 to 4,2895666,3282537,7857227,7405163,456633,13.785,516415,15.59,2299312,814210,1485102,10.995,31.05,1408803,893539,515264,12.066,19.025,890509,12.026,38.049,332114,336951,586964
2011,a) 1 to 4,2918412,3318833,7992437,7462704,483501,14.559,487846,14.69,2374686,855124,1519562,11.459,31.821,1328129,839699,488430,11.252,17.797,1046557,14.024,35.594,318989,323727,562133
2012,a) 1 to 4,2959634,3355515,8194295,7538999,491136,14.739,444373,13.336,2533967,869468,1664499,11.533,33.611,1240417,775956,464461,10.293,16.453,1293550,17.158,32.907,280804,285932,500440
2013,a) 1 to 4,2959907,3361461,8073130,7492983,482711,14.439,446083,13.343,2379889,850957,1528932,11.357,31.762,1237365,775855,461510,10.354,16.514,1142524,15.248,33.027,286401,288996,505926
2014,a) 1 to 4,2977004,3390935,8112736,7513169,489420,14.555,432621,12.866,2382877,859871,1523006,11.445,31.716,1199596,748619,450977,9.964,15.967,1183281,15.749,31.933000000000003,290031,293207,510982
2015,a) 1 to 4,2996623,3422715,8160956,7555870,495292,14.602,433561,12.782,2399633,868928,1530705,11.5,31.759,1203195,751124,452071,9.941,15.924,1196438,15.835,31.848000000000006,290733,294104,513015
2016,a) 1 to 4,3031765,3493270,8280824,7641885,515570,14.966,418730,12.155,2438658,906712,1531946,11.865,31.912,1175888,720596,455292,9.43,15.387,1262770,16.524,30.775,297946,301422,521987
2017,a) 1 to 4,3042504,3496644,8363420,7730409,491202,14.128,451637,12.99,2515815,854551,1661264,11.054,32.544000000000004,1265072,778985,486087,10.077,16.365,1250743,16.18,32.73,314166,317848,547796
2018,a) 1 to 4,3057257,3515430,8372919,7733278,482852,13.819,440204,12.598,2478284,830539,1647745,10.74,32.047,1205224,752642,452582,9.733,15.585,1273060,16.462,31.17,336698,341627,581544
1978,b) 5 to 9,757231,899090,6539228,6110253,104716,11.864,71866,8.142000000000001,1865951,681369,1184582,11.151,30.538,1000262,465170,535092,7.612999999999999,16.37,865689,14.168,32.74,45804,46610,300808
1979,b) 5 to 9,804680,956963,6710432,6406690,100001,10.604,72187,7.655,1748920,650792,1098128,10.158,27.298,1133694,469301,664393,7.325,17.695,615226,9.603,35.391,46350,47072,304144
1980,b) 5 to 9,815110,976259,6517853,6414542,93347,9.643,76807,7.935,1527707,606404,921303,9.454,23.816,1306330,499175,807155,7.782,20.365,221377,3.451,40.73,50955,51774,336006
1981,b) 5 to 9,818877,990267,6643279,6466205,97919,10.054,65250,6.7,1556621,638027,918594,9.867,24.073,1191613,421763,769850,6.523,18.428,365008,5.645,36.857,40940,41942,271436
1982,b) 5 to 9,827495,1010193,6777599,6629853,102025,10.22,78219,7.835,1634986,660058,974928,9.956,24.661,1331684,505776,825908,7.629,20.086,303302,4.575,40.172,52348,53565,346844
1983,b) 5 to 9,845683,1031263,6966713,6773490,97355,9.569,69543,6.836,1613194,629488,983706,9.293,23.816,1217223,450531,766692,6.651,17.97,395971,5.846,35.941,46116,47222,305897
1984,b) 5 to 9,880954,1076075,7588087,7178928,111544,10.579,68113,6.46,1941407,721728,1219679,10.053,27.043000000000006,1114177,441540,672637,6.151,15.52,827230,11.523,31.04,48067,49031,317950
1985,b) 5 to 9,909553,1105787,7716582,7397303,112058,10.259,84964,7.779,1923465,727073,1196392,9.829,26.002,1275593,552541,723052,7.4689999999999985,17.244,647872,8.758,34.488,58991,60300,392689
1986,b) 5 to 9,930012,1131224,7827940,7515642,117778,10.573,83248,7.473,1946977,766764,1180213,10.202,25.906,1314149,541830,772319,7.209,17.486,632828,8.42,34.971,58163,59303,385775
1987,b) 5 to 9,949667,1160009,8100983,7754624,124913,10.922,92323,8.072000000000001,2103478,808779,1294699,10.43,27.125,1400535,598104,802431,7.712999999999999,18.061,702943,9.065,36.121,61244,62423,404806
1988,b) 5 to 9,982388,1204665,8330489,7996488,124707,10.52,86326,7.282,2079763,810799,1268964,10.139,26.008000000000006,1401738,559648,842090,6.999,17.529,678025,8.479,35.059,59379,61022,396545
1989,b) 5 to 9,1000349,1236978,8556572,8229737,122197,10.021,87179,7.149,2068352,796567,1271785,9.679,25.133000000000006,1407165,567769,839396,6.899,17.099,661187,8.033999999999999,34.197,61383,63393,412489
1990,b) 5 to 9,1015181,1259625,8685066,8387919,117610,9.45,87454,7.027,2043948,765404,1278544,9.125,24.368,1439853,569817,870036,6.792999999999998,17.166,604095,7.202000000000001,34.332,62624,64649,420221
1991,b) 5 to 9,1018937,1273060,8485366,8352798,119554,9.485,94431,7.492000000000001,1888596,782562,1106034,9.369,22.61,1612754,613882,998872,7.349,19.308,275842,3.302,38.616,65675,67487,439051
1992,b) 5 to 9,1015697,1275406,8694185,8484282,109024,8.612,90025,7.112,1963252,707830,1255422,8.343,23.14,1533543,586031,947512,6.907,18.075,429709,5.065,36.15,56763,58455,378783
1993,b) 5 to 9,1031264,1284401,8839234,8605355,104123,8.144,92384,7.226,1964288,673901,1290387,7.831,22.826,1486115,598346,887769,6.9529999999999985,17.27,478173,5.557,34.539,55961,57876,374932
1994,b) 5 to 9,1047866,1305763,8940290,8706297,108220,8.351,88408,6.822,1958099,704042,1254057,8.087,22.491,1479063,573994,905069,6.593,16.988,479036,5.502000000000002,33.977,58422,60448,392185
1995,b) 5 to 9,1055141,1316118,9080839,8801455,110840,8.5,86608,6.642,1988662,719516,1269146,8.175,22.595,1420010,565546,854464,6.426,16.134,568652,6.461,32.268,57456,59763,388923
1996,b) 5 to 9,1061479,1327756,9052164,8836368,110883,8.418,89688,6.809,1930032,716755,1213277,8.111,21.842,1485882,582804,903078,6.596,16.816,444150,5.026,33.631,60103,62426,405234
1997,b) 5 to 9,1069422,1344642,9334477,9055399,118007,8.827,102556,7.671,2154058,765228,1388830,8.451,23.788,1580369,668786,911583,7.385,17.452,573689,6.335,34.904,63531,66408,431203
1998,b) 5 to 9,1083017,1359891,9483403,9187877,105902,7.824,93202,6.886,2114475,687058,1427417,7.478,23.014,1512720,606806,905914,6.604,16.464000000000002,601755,6.549,32.929,56006,58524,379877
1999,b) 5 to 9,1081988,1363969,9431893,9192225,102933,7.5710000000000015,94310,6.936,2024033,668211,1355822,7.269,22.019,1530725,616281,914444,6.704,16.652,493308,5.367000000000001,33.305,57147,59915,389356
2000,b) 5 to 9,1083827,1371093,9556616,9259893,106558,7.812,92471,6.779,2089994,691900,1398094,7.472,22.57,1484134,603140,880994,6.513,16.028,605860,6.542999999999998,32.055,55672,58725,382278
2001,b) 5 to 9,1085821,1377422,9467290,9238560,107464,7.841,93662,6.834,2018693,698600,1320093,7.562,21.851,1551128,608915,942213,6.591,16.79,467565,5.061,33.579,56567,59832,388240
2002,b) 5 to 9,1086165,1385166,9492585,9273823,118983,8.638,103558,7.518,2152912,777558,1375354,8.384,23.215,1703417,676762,1026655,7.297999999999999,18.368,449495,4.847,36.736,60487,63305,412480
2003,b) 5 to 9,1092696,1394638,9716207,9429366,104418,7.52,92315,6.648,2131493,674317,1457176,7.151,22.605,1544356,602170,942186,6.386,16.378,587137,6.227,32.756,53939,55935,363483
2004,b) 5 to 9,1106037,1405780,9747444,9470000,103363,7.394,87837,6.283,2041198,670998,1370200,7.086,21.554,1476886,571375,905511,6.034,15.595,564312,5.959,31.191,54808,57072,369828
2005,b) 5 to 9,1123397,1431063,9734830,9534162,108899,7.664,88577,6.234,1994745,707757,1286988,7.422999999999999,20.922,1575806,575746,1000060,6.039,16.528,418939,4.394,33.056,57486,59033,381956
2006,b) 5 to 9,1135881,1452242,10010937,9710772,125945,8.766,94864,6.603,2147615,823969,1323646,8.485,22.116,1533935,616766,917169,6.351,15.796,613680,6.32,31.592,65591,67400,437409
2007,b) 5 to 9,1137682,1464674,10006379,9808383,110043,7.553,94444,6.483,2098176,715754,1382422,7.2970000000000015,21.392,1686466,615501,1070965,6.275,17.194000000000006,411710,4.198,34.388000000000005,56989,58422,378581
2008,b) 5 to 9,1129833,1458546,9889964,9765640,96405,6.617000000000001,93194,6.397,1941100,626852,1314248,6.419,19.877,1674694,606933,1067761,6.215,17.149,266406,2.728,34.298,58401,59789,387187
2009,b) 5 to 9,1100353,1438074,9389877,9510043,83531,5.7810000000000015,97245,6.73,1594430,544147,1050283,5.722,16.766,1819715,631441,1188274,6.64,19.135,-225285,-2.369,33.531,60763,63057,407672
2010,b) 5 to 9,1067114,1406417,9347209,9339565,80660,5.728,84136,5.975,1555723,524257,1031466,5.613,16.657,1525448,545982,979466,5.846,16.333,30275,0.324,32.666,51000,52972,342733
2011,b) 5 to 9,1042898,1391131,9466216,9317647,83580,6.023,76671,5.525,1661877,541742,1120135,5.814,17.836,1354952,496089,858863,5.324,14.542,306925,3.294,29.084,46972,50334,324499
2012,b) 5 to 9,1058243,1401640,9660793,9449618,85285,6.099,78740,5.631,1819135,555495,1263640,5.877999999999999,19.251,1385896,512522,873374,5.424,14.666,433239,4.585,29.332,45170,47178,305549
2013,b) 5 to 9,1067706,1406658,9637791,9461107,82644,5.888,76640,5.46,1723911,538710,1185201,5.694,18.221,1359575,501511,858064,5.301,14.37,364336,3.851,28.74,46373,47627,310058
2014,b) 5 to 9,1069508,1416355,9716590,9501941,85525,6.068,71792,5.093,1723018,555889,1167129,5.85,18.133,1280457,466887,813570,4.914,13.476,442561,4.658,26.951,45705,46848,303615
2015,b) 5 to 9,1076312,1426694,9747804,9550252,87129,6.1370000000000005,73310,5.1629999999999985,1722985,567417,1155568,5.941,18.041,1314639,477445,837194,4.999,13.765,408346,4.276,27.531,46468,48115,311880
2016,b) 5 to 9,1084671,1441354,9871785,9646030,89261,6.234,70394,4.916,1758896,581453,1177443,6.028,18.234,1297113,459175,837938,4.76,13.447,461783,4.787,26.894,47296,49191,320529
2017,b) 5 to 9,1087316,1445837,9972748,9770368,84653,5.862,81377,5.635,1859302,550319,1308983,5.632999999999999,19.03,1442319,526030,916289,5.384,14.762,416983,4.268,29.524,48696,50560,329408
2018,b) 5 to 9,1080089,1433496,9834040,9669074,75476,5.266,74937,5.229,1694248,489681,1204567,5.064,17.522000000000002,1346855,488238,858617,5.049,13.93,347393,3.593,27.859,50732,53509,348559
1978,c) 10 to 19,428513,533637,7755904,7340986,54374,10.36,36791,7.01,1966094,722286,1243808,9.839,26.782,1135614,490565,645049,6.683,15.47,830480,11.313,30.939,20294,20846,275654
1979,c) 10 to 19,468261,580859,8160809,7886153,50677,8.827,37191,6.478,1841694,670207,1171487,8.499,23.354,1291853,494926,796927,6.276,16.381,549841,6.972,32.763000000000005,21988,22340,294945
1980,c) 10 to 19,484750,603564,8062168,8038200,46391,7.729,39675,6.61,1597510,613371,984139,7.631,19.874,1544118,527825,1016293,6.566,19.21,53392,0.664,38.419,24796,25370,336080
1981,c) 10 to 19,481181,604220,8109891,8005111,48397,8.115,32800,5.499,1617738,642234,975504,8.023,20.209,1404880,436359,968521,5.4510000000000005,17.55,212858,2.659,35.1,19092,19631,259834
1982,c) 10 to 19,484968,612261,8169885,8107250,50297,8.302999999999999,37290,6.1560000000000015,1679327,663828,1015499,8.187999999999999,20.714,1550113,497172,1052941,6.1320000000000014,19.12,129214,1.594,38.24,24096,24556,325957
1983,c) 10 to 19,483561,610053,8196948,8113596,46298,7.657999999999999,35375,5.851,1629512,612306,1017206,7.5470000000000015,20.084,1463454,471159,992295,5.807,18.037,166058,2.047,36.074,22203,22824,302863
1984,c) 10 to 19,492858,627433,8875359,8512207,52395,8.48,33300,5.3889999999999985,1972886,688861,1284025,8.093,23.177,1239304,444065,795239,5.2170000000000005,14.559,733582,8.618,29.118,22346,22830,303254
1985,c) 10 to 19,515397,653220,9174116,8877440,55061,8.509,42781,6.6110000000000015,2025212,729174,1296038,8.214,22.813,1428043,567301,860742,6.39,16.086,597169,6.727,32.172,28856,29430,391005
1986,c) 10 to 19,531157,676861,9370235,9122106,58317,8.715,42923,6.414,2038691,773758,1264933,8.482000000000001,22.349,1541974,569871,972103,6.247000000000001,16.904,496717,5.445,33.806999999999995,27801,28367,376956
1987,c) 10 to 19,543501,697032,9676320,9410398,62417,9.057,46732,6.7810000000000015,2184605,828087,1356518,8.8,23.215,1651311,621373,1029938,6.603,17.548,533294,5.667000000000002,35.095,29754,30413,403175
1988,c) 10 to 19,567032,730031,10052337,9788409,63004,8.743,44108,6.121,2195732,835733,1359999,8.538,22.432,1666435,586933,1079502,5.996,17.025,529297,5.407,34.049,28416,29327,388545
1989,c) 10 to 19,580855,750346,10420542,10132852,61692,8.309,45889,6.181,2232650,818388,1414262,8.077,22.034,1656042,609417,1046625,6.0139999999999985,16.343,576608,5.69,32.687,30246,31404,416698
1990,c) 10 to 19,593820,770133,10548118,10348462,58613,7.677,45267,5.9289999999999985,2122343,776319,1346024,7.502000000000002,20.509,1719669,602225,1117444,5.819,16.618,402674,3.891,33.235,30756,31677,420288
1991,c) 10 to 19,599608,789495,10392871,10390561,64936,8.304,49902,6.3820000000000014,2000700,863095,1137605,8.307,19.255,1994816,664189,1330627,6.392,19.198,5884,0.057,38.397,32965,34036,453597
1992,c) 10 to 19,586543,781928,10566682,10464183,54411,6.997000000000001,45863,5.898,2066247,719946,1346301,6.88,19.746,1860593,609852,1250741,5.8279999999999985,17.781,205654,1.965,35.561,27980,28766,381281
1993,c) 10 to 19,592771,780044,10660596,10530287,50636,6.505,47351,6.082999999999998,2011842,671829,1340013,6.38,19.105,1751473,627122,1124351,5.955,16.633,260369,2.4730000000000003,33.265,27113,28303,374752
1994,c) 10 to 19,605086,800082,10966691,10787454,55712,7.005,46265,5.817,2087404,742042,1345362,6.879,19.35,1727705,616003,1111702,5.71,16.016,359699,3.334,32.032,28397,29715,395122
1995,c) 10 to 19,613737,813721,11250300,11013633,56993,7.049,46513,5.752999999999999,2149096,759758,1389338,6.898,19.513,1673068,622541,1050527,5.652,15.191,476028,4.322,30.382,28192,29817,395303
1996,c) 10 to 19,621006,828884,11301304,11145513,56726,6.885,46887,5.69,2082957,752914,1330043,6.755,18.689,1769643,624733,1144910,5.605,15.878,313314,2.8110000000000004,31.755,29416,30742,410195
1997,c) 10 to 19,628842,841301,11638417,11403489,64723,7.734,55756,6.6629999999999985,2389260,858111,1531149,7.525,20.952,1911676,747022,1164654,6.551,16.764,477584,4.188,33.528,31402,32897,439111
1998,c) 10 to 19,640851,857229,11900962,11658342,56136,6.5710000000000015,50265,5.884,2318420,749763,1568657,6.431,19.886,1828745,672679,1156066,5.77,15.686,489675,4.2,31.372,27301,28566,380905
1999,c) 10 to 19,646460,871504,12038896,11852717,54991,6.322,51527,5.924,2223759,738800,1484959,6.233,18.762,1852285,688613,1163672,5.81,15.628,371474,3.134,31.255,29101,30996,413578
2000,c) 10 to 19,653917,882854,12347879,12074856,56543,6.426,50607,5.752000000000002,2352803,756232,1596571,6.263,19.485,1804041,677888,1126153,5.614,14.94,548762,4.545,29.881,28056,30090,402171
2001,c) 10 to 19,661667,900889,12335783,12189327,58210,6.482,52448,5.84,2242687,780558,1462129,6.404,18.399,1948374,702780,1245594,5.766,15.984000000000002,294313,2.415,31.969,28673,30499,407117
2002,c) 10 to 19,665633,910893,12301569,12218941,70768,7.814,60376,6.666,2421757,951436,1470321,7.787000000000001,19.82,2257001,811526,1445475,6.642,18.471,164756,1.348,36.94300000000001,32585,34944,468648
2003,c) 10 to 19,669378,914109,12660340,12463158,54556,5.979,51379,5.63,2347957,729133,1618824,5.85,18.839,1953751,684428,1269323,5.492000000000001,15.675999999999998,394206,3.1630000000000003,31.352,27411,28662,380481
2004,c) 10 to 19,676825,926611,12790342,12602279,54107,5.858,48286,5.227,2241037,725487,1515550,5.7570000000000014,17.783,1866813,646181,1220632,5.127000000000002,14.813,374224,2.969,29.627,27557,29061,388142
2005,c) 10 to 19,690984,946767,12802612,12713494,59144,6.282,48523,5.154,2166784,790816,1375968,6.22,17.043,1985347,652633,1332714,5.132999999999999,15.616,181437,1.4269999999999998,31.232,28781,29908,399494
2006,c) 10 to 19,694091,964713,13309493,13003006,73006,7.655,50959,5.343,2481992,972725,1509267,7.481,19.088,1869953,678255,1191698,5.216,14.380999999999998,612039,4.707,28.762,32459,33623,446084
2007,c) 10 to 19,704233,980936,13259354,13178377,62032,6.35,54031,5.5310000000000015,2351873,829151,1522722,6.292000000000002,17.846,2192920,718643,1474277,5.4529999999999985,16.64,158953,1.206,33.281,29492,30482,403523
2008,c) 10 to 19,700499,981129,13249147,13202880,55443,5.66,52225,5.332000000000002,2218086,738299,1479787,5.5920000000000005,16.8,2123952,696037,1427915,5.272,16.087,94134,0.713,32.174,30222,31661,421393
2009,c) 10 to 19,686446,973400,12599878,12865349,50052,5.138,51441,5.2810000000000015,1764217,669329,1094888,5.2029999999999985,13.713,2293248,682798,1610450,5.307,17.825,-529031,-4.112,27.426,30000,31280,414416
2010,c) 10 to 19,672967,962157,12642252,12733760,54201,5.6629999999999985,44247,4.623,1806240,706397,1099843,5.5470000000000015,14.185,1985565,587699,1397866,4.615,15.593,-179325,-1.408,28.369,25878,26907,356250
2011,c) 10 to 19,672650,965360,12979137,12969879,48291,5.012,44582,4.627,1931448,639180,1292268,4.928,14.892,1912941,585232,1327709,4.512,14.749,18507,0.14300000000000002,29.498,26173,27722,363375
2012,c) 10 to 19,649878,948565,13052267,12903977,46911,4.953,43925,4.638,2077191,623460,1453731,4.832,16.097,1776409,585293,1191116,4.5360000000000005,13.765999999999998,300782,2.331,27.533,23825,25189,334311
2013,c) 10 to 19,653589,950257,13108090,12923353,48778,5.152,41878,4.423,2039683,649820,1389863,5.0280000000000005,15.783,1665533,558712,1106821,4.323,12.888,374150,2.895,25.776,23579,24692,328020
2014,c) 10 to 19,660678,962239,13263563,13056531,49437,5.165,39082,4.084,1989037,658684,1330353,5.045,15.234000000000002,1574980,519122,1055858,3.976,12.063,414057,3.1710000000000003,24.126,23604,24629,326226
2015,c) 10 to 19,668804,977174,13498620,13288983,49594,5.098,40955,4.21,2039200,664929,1374271,5.004,15.345,1616860,548525,1068335,4.128,12.167,422340,3.178,24.334,23746,25178,335388
2016,c) 10 to 19,679242,987878,13618608,13398434,51342,5.229,39377,4.01,2038920,694390,1344530,5.183,15.218,1601762,526916,1074846,3.933,11.955,437158,3.263,23.91,24735,25967,346462
2017,c) 10 to 19,685614,998712,13862708,13647364,50043,5.023,45351,4.552,2233733,670905,1562828,4.916,16.368,1806858,606399,1200459,4.4430000000000005,13.24,426875,3.128,26.479,25914,27452,366877
2018,c) 10 to 19,692529,1001824,13831615,13673627,46130,4.61,43613,4.359,2047222,613685,1433537,4.488,14.972,1734664,580845,1153819,4.248,12.686,312558,2.286,25.372,27807,30209,403417
1978,d) 20 to 99,304652,448824,18863745,18109844,40188,9.062,29504,6.653,4191628,1564796,2626832,8.641,23.146,2682528,1149170,1533358,6.346,14.813,1509100,8.333,29.625,11724,12269,450954
1979,d) 20 to 99,340408,493121,20257956,19725090,37342,7.645,27995,5.731,3962848,1450283,2512565,7.352,20.09,2896171,1079706,1816465,5.474,14.683,1066677,5.408,29.365,12172,12530,450595
1980,d) 20 to 99,359702,521956,20607214,20546784,34531,6.6629999999999985,27129,5.235,3507294,1373493,2133801,6.685,17.07,3382227,1031333,2350894,5.019,16.461,125067,0.609,32.922,13910,14448,524745
1981,d) 20 to 99,359182,527852,20774159,20708829,36010,6.903,23643,4.532,3435019,1409453,2025566,6.806,16.587,3295796,910940,2384856,4.399,15.915,139223,0.672,31.83,10829,11359,410672
1982,d) 20 to 99,361319,533416,20725411,20830526,36262,6.859,26813,5.072,3451507,1413780,2037727,6.787000000000001,16.569000000000006,3657137,1028844,2628293,4.939,17.557000000000002,-205630,-0.987,33.139,13942,14372,523508
1983,d) 20 to 99,356778,530679,20678216,20768757,33198,6.292999999999998,26889,5.097,3479629,1290201,2189428,6.2120000000000015,16.754,3656281,1031759,2624522,4.968,17.605,-176652,-0.851,33.508,13542,14054,512589
1984,d) 20 to 99,356295,531375,22196876,21453507,37450,7.1320000000000014,24937,4.749,4305011,1458894,2846117,6.8,20.067,2810960,955348,1855612,4.453,13.103,1494051,6.964,26.205,13325,13726,496811
1985,d) 20 to 99,380171,560348,23098646,22641587,39769,7.14,33004,5.926,4350020,1546842,2803178,6.832000000000002,19.213,3437052,1302565,2134487,5.752999999999999,15.18,912968,4.032,30.361,19125,19810,743841
1986,d) 20 to 99,396936,586339,23798209,23383351,44842,7.737999999999999,31231,5.3889999999999985,4511189,1761627,2749562,7.534,19.292,3679510,1196705,2482805,5.118,15.736,831679,3.557,31.471,16985,17590,648025
1987,d) 20 to 99,405349,603390,24447353,24097933,48471,8.11,37073,6.2029999999999985,4735139,1905963,2829176,7.909,19.65,4033271,1443274,2589997,5.989,16.737000000000002,701868,2.9130000000000003,33.474000000000004,19462,20285,755950
1988,d) 20 to 99,421926,634349,25634884,25270311,48550,7.735,35141,5.599,4864996,1898783,2966213,7.5139999999999985,19.252,4138691,1367331,2771360,5.4110000000000005,16.378,726305,2.874,32.755,18209,19078,705258
1989,d) 20 to 99,432005,651216,26545598,26111937,46692,7.234,35251,5.461,4849276,1824474,3024802,6.987,18.571,3979510,1381246,2598264,5.29,15.24,869766,3.3310000000000004,30.48,19153,20162,753389
1990,d) 20 to 99,447324,674554,27057386,26844267,43677,6.524,33497,5.004,4530876,1685649,2845227,6.279,16.878,4102634,1283902,2818732,4.783,15.283,428242,1.595,30.566,19586,20491,753361
1991,d) 20 to 99,447586,685289,26181317,26680920,45272,6.632999999999999,39716,5.819,4043196,1721947,2321249,6.454,15.154000000000002,5042892,1564302,3478590,5.863,18.901,-999696,-3.747,30.308000000000003,23828,25033,957112
1992,d) 20 to 99,427561,668282,26244890,26300768,39539,5.94,34262,5.147,4226171,1527155,2699016,5.807,16.069000000000006,4332979,1319726,3013253,5.018,16.475,-106808,-0.406,32.137,17921,18815,693835
1993,d) 20 to 99,433116,670233,26818858,26718725,37441,5.593,35918,5.365,4339934,1451609,2888325,5.433,16.243,4143767,1376414,2767353,5.151,15.509,196167,0.7340000000000001,31.018,17048,18188,665174
1994,d) 20 to 99,443813,690023,27815971,27495432,43005,6.267,35369,5.154,4615009,1677089,2937920,6.1,16.785,3972553,1367708,2604845,4.974,14.448,642456,2.337,28.896,18381,19640,728868
1995,d) 20 to 99,454391,712495,28939282,28454402,45352,6.412000000000001,34990,4.947,4835096,1762390,3072706,6.194,16.992,3857816,1346178,2511638,4.731,13.558,977280,3.435,27.116,18018,19180,709866
1996,d) 20 to 99,465597,730247,29164793,28987236,44724,6.157,36991,5.093,4656255,1746806,2909449,6.026,16.063,4301171,1443379,2857792,4.979,14.838,355084,1.225,29.676,19249,20553,764743
1997,d) 20 to 99,471788,740399,30063733,29675453,49437,6.706,43105,5.847,5379323,1915365,3463958,6.454,18.127,4593155,1687027,2906128,5.685,15.478,786168,2.649,30.956,20883,22259,832752
1998,d) 20 to 99,490371,767131,31111647,30747258,46562,6.0939999999999985,40399,5.287000000000001,5295135,1845068,3450067,6.001,17.221,4562219,1580959,2981260,5.142,14.838,732916,2.384,29.676,18055,19361,719590
1999,d) 20 to 99,498199,787991,31966629,31648698,46982,5.978,42824,5.449,5244815,1856710,3388105,5.867000000000001,16.572,4608576,1669848,2938728,5.276,14.562,636239,2.01,29.123,19991,22022,822164
2000,d) 20 to 99,510020,806023,32946664,32528736,47376,5.895,42678,5.31,5442303,1863196,3579107,5.728,16.730999999999998,4603786,1702740,2901046,5.235,14.153,838517,2.5780000000000003,28.306,18796,20781,773536
2001,d) 20 to 99,523534,829413,33217852,33126003,48410,5.855,43201,5.225,5170038,1900224,3269814,5.7360000000000015,15.607,4986550,1699136,3287414,5.129,15.053,183488,0.5539999999999999,30.107,19319,21085,795931
2002,d) 20 to 99,528359,844053,32691140,33136344,59813,7.113,53433,6.355,5419652,2334779,3084873,7.046,16.355999999999998,6300969,2140527,4160442,6.46,19.015,-881317,-2.66,32.711,25034,27350,1057255
2003,d) 20 to 99,521241,835271,33414769,33315363,43720,5.242000000000001,41306,4.952,5155619,1718413,3437206,5.158,15.475,4963901,1638721,3325180,4.919,14.9,191718,0.575,29.799,17652,19028,709723
2004,d) 20 to 99,529714,846556,33927787,33791593,42029,4.974,38793,4.591,4948620,1651173,3297447,4.886,14.645,4682381,1520186,3162195,4.499,13.857,266239,0.7879999999999999,27.713,18057,19318,716022
2005,d) 20 to 99,542402,864177,34354585,34281082,46749,5.437,38041,4.424,4980265,1826807,3153458,5.329,14.528,4834676,1480914,3353762,4.32,14.103,145589,0.425,28.206,18498,19614,724472
2006,d) 20 to 99,540712,873795,35384649,34815648,55991,6.475,37796,4.371,5624643,2164009,3460634,6.216,16.156,4491007,1459511,3031496,4.192,12.899,1133636,3.256,25.799,19897,20876,766526
2007,d) 20 to 99,549500,893515,35258706,35358274,49197,5.528,42009,4.721,5239381,1899488,3339893,5.372000000000001,14.818,5432570,1637197,3795373,4.63,15.364,-193189,-0.546,29.636,19055,20005,742403
2008,d) 20 to 99,546366,892758,35294259,35406767,43016,4.827,39882,4.475,4917784,1656987,3260797,4.68,13.889,5149061,1552334,3596727,4.384,14.543,-231277,-0.653,27.779,19208,20446,754715
2009,d) 20 to 99,539263,887051,33276571,34332327,38284,4.314,38858,4.379,3715756,1479608,2236148,4.31,10.823,5827632,1525577,4302055,4.444,16.974,-2111876,-6.151,21.646,18932,20819,773912
2010,d) 20 to 99,508787,851283,32716120,33245102,34812,4.092,33693,3.961,3749768,1360451,2389317,4.092,11.279000000000002,4794607,1303897,3490710,3.922,14.422,-1044839,-3.143,22.558000000000003,15831,17807,664714
2011,d) 20 to 99,490442,828053,33094376,32862662,35066,4.25,29006,3.516,4200137,1351791,2848346,4.113,12.781,3734525,1113128,2621397,3.387,11.364,465612,1.4169999999999998,22.728,14280,15108,549285
2012,d) 20 to 99,496843,837775,33738753,33450401,36268,4.34,32215,3.855,4541982,1395397,3146585,4.172,13.578,3961634,1238337,2723297,3.702,11.843,580348,1.735,23.687,14599,15940,584561
2013,d) 20 to 99,510532,858071,34480199,34204718,37801,4.421,31695,3.707,4498418,1437465,3060953,4.203,13.151,3944270,1233528,2710742,3.606,11.531,554148,1.62,23.063,15060,15903,587593
2014,d) 20 to 99,520419,880408,35403736,35046882,38350,4.379,29138,3.327,4430127,1470545,2959582,4.1960000000000015,12.640999999999998,3715102,1124475,2590627,3.208,10.6,715025,2.04,21.201,15138,16037,584607
2015,d) 20 to 99,531056,901490,36372737,35887643,43612,4.87,31817,3.553,4774548,1696575,3077973,4.727,13.304,3802486,1230605,2571881,3.429,10.595999999999998,972062,2.709,21.191,16225,17370,644357
2016,d) 20 to 99,544265,928812,37236000,36890361,42313,4.583,31271,3.387,4667075,1626957,3040118,4.41,12.651,3975437,1208781,2766656,3.277,10.776,691638,1.875,21.553,16833,18042,667390
2017,d) 20 to 99,552255,943537,37736874,37586375,41591,4.414,38980,4.137,4987179,1596543,3390636,4.248,13.269,4688788,1542378,3146410,4.104,12.475,298391,0.794,24.949,19030,20613,771527
2018,d) 20 to 99,562337,954155,38227043,38066974,36501,3.827,35635,3.736,4689479,1416724,3272755,3.722,12.319,4374507,1378557,2995950,3.621,11.492,314972,0.8270000000000001,22.983,19104,21330,787754
1978,e) 100 to 499,37934,75393,15103363,14826254,5433,7.247999999999998,4564,6.089,2686090,1005343,1680747,6.7810000000000015,18.117,2133760,869744,1264016,5.8660000000000005,14.392,552330,3.725,28.784,1067,1108,196739
1979,e) 100 to 499,42911,83266,16337655,16126659,5117,6.186,4023,4.863,2572924,957773,1615151,5.939,15.954,2145732,771188,1374544,4.782,13.305,427192,2.649,26.611,955,979,170955
1980,e) 100 to 499,46263,89532,16859971,16950387,5052,5.697,3349,3.776,2235337,935361,1299976,5.518,13.188,2417853,631696,1786157,3.727,14.264,-182516,-1.077,26.375,1112,1147,201890
1981,e) 100 to 499,46535,92204,17075938,17259693,4962,5.432,3259,3.567,2134404,909177,1225227,5.268,12.366,2494457,610413,1884044,3.537,14.452,-360053,-2.086,24.733,810,849,145625
1982,e) 100 to 499,47304,94095,17234378,17490490,5277,5.659,3579,3.838,2271180,1003635,1267545,5.738,12.985,2780480,676025,2104455,3.865,15.897,-509300,-2.912,25.97,1019,1061,184281
1983,e) 100 to 499,46405,90923,16471743,16929022,4290,4.728,3905,4.3039999999999985,2223681,796276,1427405,4.704,13.135,3131805,718938,2412867,4.247,18.5,-908124,-5.364,26.271,1046,1070,184331
1984,e) 100 to 499,45260,89912,17404496,17078091,5291,5.965,2877,3.2430000000000003,2678038,986492,1691546,5.776,15.681,2022517,530179,1492338,3.104,11.843,655521,3.838,23.686,894,913,154839
1985,e) 100 to 499,49510,96622,18430443,18349226,5377,5.591,4472,4.65,2752934,1007511,1745423,5.4910000000000005,15.003,2589008,822665,1766343,4.4830000000000005,14.11,163926,0.893,28.219,1808,1845,320763
1986,e) 100 to 499,52313,101931,19003266,19035465,6197,6.141,4143,4.106,2779817,1140862,1638955,5.9929999999999986,14.603,2839646,773538,2066108,4.064,14.918,-59829,-0.314,29.207,1480,1504,262784
1987,e) 100 to 499,54048,105969,19567762,19690962,7145,6.791,5633,5.354,2965765,1329346,1636419,6.751,15.062,3211569,1060923,2150646,5.388,16.31,-245804,-1.248,30.123,1783,1869,327656
1988,e) 100 to 499,56290,110446,20355869,20422198,7210,6.585,5302,4.842,3094112,1330467,1763645,6.515,15.151,3234085,1009271,2224814,4.942,15.836,-139973,-0.685,30.301,1787,1876,341946
1989,e) 100 to 499,57315,113851,21200341,21166395,6628,5.863,5020,4.441,3068684,1196073,1872611,5.651,14.498,3011677,926658,2085019,4.378,14.229,57007,0.269,28.457,1722,1818,312594
1990,e) 100 to 499,60372,119427,22070594,22071599,6207,5.2410000000000005,4197,3.544,2893874,1131616,1762258,5.127000000000002,13.111,2896463,763072,2133391,3.457,13.123,-2589,-0.012,26.223000000000006,1755,1820,320364
1991,e) 100 to 499,59511,120899,21529169,22118454,5953,4.93,5642,4.673,2545516,1090739,1454777,4.931,11.509,3724582,1035958,2688624,4.684,16.839000000000002,-1179066,-5.331,23.017,2769,2838,509318
1992,e) 100 to 499,55801,116944,21371362,21550991,5737,4.937,4255,3.662,2665790,1050221,1615569,4.873,12.37,3019133,778465,2240668,3.612,14.009,-353343,-1.64,24.739,1606,1664,293986
1993,e) 100 to 499,56894,117887,21926172,21975865,5681,4.837,4828,4.11,2913220,1050498,1862722,4.78,13.255999999999998,3017738,888843,2128895,4.045,13.732,-104518,-0.476,26.513,1547,1620,292264
1994,e) 100 to 499,58465,122599,22935369,22910549,6222,5.1,5023,4.117,3026560,1135155,1891405,4.955,13.21,2979300,943116,2036184,4.117,13.004,47260,0.206,26.008000000000006,1988,2076,388737
1995,e) 100 to 499,60824,127888,24160808,23934684,6687,5.271,4648,3.664,3277750,1219177,2058573,5.0939999999999985,13.695,2822205,858842,1963363,3.588,11.791,455545,1.903,23.583,1845,1906,346053
1996,e) 100 to 499,61913,132092,24501611,24599535,6560,4.989,5342,4.063,3149581,1201718,1947863,4.885,12.803,3349729,972575,2377154,3.954,13.617,-200148,-0.8140000000000001,25.607,1928,2011,359644
1997,e) 100 to 499,62353,135745,25461510,25384129,7990,5.924,6237,4.625,3813280,1459293,2353987,5.749,15.022,3657575,1173309,2484266,4.622,14.409,155705,0.613,28.818,2177,2300,418718
1998,e) 100 to 499,67271,143590,26916217,26851453,7899,5.5360000000000005,6081,4.262,3787330,1469343,2317987,5.472,14.105,3643359,1134666,2508693,4.226,13.569,143971,0.536,27.137,1772,1876,330643
1999,e) 100 to 499,67793,147261,27585424,27660238,7810,5.3210000000000015,6831,4.654,3783670,1449504,2334166,5.24,13.679,3934766,1274308,2660458,4.607,14.225,-151096,-0.546,27.358,2148,2338,412926
2000,e) 100 to 499,69986,151569,28723276,28620778,8214,5.433,7464,4.937,4131801,1542536,2589265,5.39,14.436,3929848,1380134,2549714,4.822,13.731,201953,0.706,27.462,1771,1982,346993
2001,e) 100 to 499,72792,156454,28903922,29193230,8148,5.229,6901,4.4289999999999985,3757260,1512572,2244688,5.181,12.87,4348492,1270517,3077975,4.352,14.896,-591232,-2.025,25.741,2096,2231,398817
2002,e) 100 to 499,73646,155865,27634482,28661284,9138,5.846,10056,6.433,3720110,1668556,2051554,5.822,12.98,5779434,1882653,3896781,6.569,20.165,-2059324,-7.185,25.959,3508,3868,696152
2003,e) 100 to 499,69863,148351,27421684,27708360,6708,4.525,6481,4.372,3401976,1260905,2141071,4.551,12.278,3990556,1219529,2771027,4.401,14.402,-588580,-2.124,24.556,1832,1917,343905
2004,e) 100 to 499,72191,150909,28107522,28270766,6404,4.249,5991,3.975,3291034,1167811,2123223,4.131,11.640999999999998,3626634,1131813,2494821,4.003,12.828,-335600,-1.187,23.282,1811,1894,341204
2005,e) 100 to 499,73783,153616,28688484,28741320,6624,4.33,5341,3.491,3395141,1214896,2180245,4.227,11.813,3503742,985247,2518495,3.428,12.191,-108601,-0.378,23.626,1731,1797,323125
2006,e) 100 to 499,75112,158487,29609649,29533193,8110,5.1610000000000005,5387,3.428,3758318,1454869,2303449,4.926,12.726,3611636,996275,2615361,3.373,12.229,146682,0.4970000000000001,24.458,1846,1910,334050
2007,e) 100 to 499,76084,162171,29772812,30105880,7131,4.408,6310,3.901,3534295,1277520,2256775,4.243,11.74,4201917,1180588,3021329,3.921,13.957,-667622,-2.218,23.479,1927,2015,359552
2008,e) 100 to 499,75456,161146,29691694,30002532,6287,3.907,5860,3.641,3317995,1141956,2176039,3.806,11.059,3953744,1081945,2871799,3.606,13.178,-635749,-2.119,22.118,1927,2019,357775
2009,e) 100 to 499,75793,161931,28141861,29382304,5483,3.379,6195,3.817,2482274,990764,1491510,3.372,8.448,4976196,1144893,3831303,3.897,16.936,-2493922,-8.488,16.896,2308,2622,469413
2010,e) 100 to 499,70109,150345,27046218,27543270,5281,3.524,4340,2.8960000000000004,2575823,942808,1633015,3.423,9.352,3570374,787331,2783043,2.859,12.963,-994551,-3.611,18.704,1290,1382,234981
2011,e) 100 to 499,67545,146945,27487369,27500818,4440,3.026,3971,2.707,2848030,800334,2047696,2.91,10.356,2865118,720820,2144298,2.6210000000000004,10.418,-17088,-0.062,20.712,1296,1382,237910
2012,e) 100 to 499,67763,148975,28120305,28044926,4727,3.181,3964,2.668,2984483,861946,2122537,3.073,10.642,2833396,737391,2096005,2.629,10.103,151087,0.539,20.206,1307,1385,246733
2013,e) 100 to 499,70365,153115,28870643,28839156,4893,3.201,4391,2.872,3008145,903656,2104489,3.133,10.431,2942959,815896,2127063,2.829,10.205,65186,0.226,20.409,1479,1542,279797
2014,e) 100 to 499,72371,156773,29602114,29506169,5162,3.305,3975,2.545,3022986,939570,2083416,3.184,10.245,2827755,736645,2091110,2.497,9.584,195231,0.662,19.167,1357,1394,246938
2015,e) 100 to 499,74329,162034,30620106,30450136,5808,3.605,3938,2.444,3252630,1064705,2187925,3.497,10.682,2903931,710716,2193215,2.334,9.537,348699,1.145,19.073,1427,1478,255859
2016,e) 100 to 499,75785,166029,31311166,31270396,5322,3.216,4214,2.547,3145355,963377,2181978,3.0810000000000004,10.059,3062124,766685,2295439,2.452,9.792,83231,0.266,19.585,1537,1634,281381
2017,e) 100 to 499,76267,167167,31419192,31531165,5157,3.0810000000000004,5631,3.364,3147044,932572,2214472,2.958,9.981,3368184,999369,2368815,3.169,10.682,-221140,-0.701,19.961,1826,1905,328541
2018,e) 100 to 499,79386,171064,32229159,32200814,5274,3.092,4301,2.521,3193523,965045,2228478,2.997,9.918,3138123,766591,2371532,2.381,9.745,55400,0.172,19.491,1625,1745,300841
1978,f) 500 to 999,3856,7500,5146064,5133956,248,3.306,249,3.32,592749,165219,427530,3.218,11.546,567970,166940,401030,3.252,11.063,24779,0.483,22.126,44,44,29265
1979,f) 500 to 999,4171,8072,5582386,5534175,256,3.182,204,2.535,626536,167688,458848,3.03,11.321,527283,137835,389448,2.491,9.528,99253,1.793,19.056,30,31,19156
1980,f) 500 to 999,4324,8383,5549702,5617492,261,3.124,203,2.43,512873,176109,336764,3.135,9.13,651246,138640,512606,2.468,11.593,-138373,-2.463,18.26,32,32,21493
1981,f) 500 to 999,4322,8400,5496222,5595247,245,2.927,188,2.246,485295,165961,319334,2.966,8.673,683883,126294,557589,2.257,12.223,-198588,-3.549,17.347,22,22,14620
1982,f) 500 to 999,4319,8274,5409128,5465997,368,4.492,203,2.478,561405,253375,308030,4.635,10.271,672525,139179,533346,2.546,12.304,-111120,-2.033,20.542,25,26,18218
1983,f) 500 to 999,4267,8103,5104210,5301848,222,2.744,199,2.459,441328,150379,290949,2.8360000000000003,8.324,835508,137063,698445,2.585,15.759,-394180,-7.435,16.648,19,19,12401
1984,f) 500 to 999,4192,7855,5313119,5272040,305,3.925,138,1.776,597252,205395,391857,3.896,11.329,516309,92151,424158,1.7480000000000002,9.793,80943,1.535,19.587,22,23,15228
1985,f) 500 to 999,4422,8281,5558049,5589437,296,3.588,233,2.824,601943,198824,403119,3.557,10.769,660021,156905,503116,2.807,11.808,-58078,-1.039,21.539,46,46,31288
1986,f) 500 to 999,4700,8594,5579222,5686864,305,3.57,203,2.376,561952,208108,353844,3.659,9.882,772961,136844,636117,2.406,13.592,-211009,-3.71,19.763,40,40,26246
1987,f) 500 to 999,4863,8682,5684782,5758395,431,5.001,302,3.504,660793,300100,360693,5.2120000000000015,11.475,807314,204758,602556,3.556,14.02,-146521,-2.544,22.951,60,60,41188
1988,f) 500 to 999,5151,9019,5972908,6022907,408,4.546,318,3.544,691413,270669,420744,4.494,11.48,788833,221890,566943,3.684,13.097,-97420,-1.617,22.959,75,81,58448
1989,f) 500 to 999,5179,9144,6130802,6150315,282,3.092,232,2.544,626603,190860,435743,3.103,10.188,667651,158595,509056,2.579,10.856,-41048,-0.667,20.376,53,53,35969
1990,f) 500 to 999,5345,9452,6291196,6334287,278,2.9560000000000004,186,1.977,598286,189374,408912,2.99,9.445,684791,129438,555353,2.043,10.811,-86505,-1.366,18.89,57,58,38245
1991,f) 500 to 999,5377,9590,6195996,6366694,274,2.855,290,3.0210000000000004,538951,185109,353842,2.907,8.465,877816,194758,683058,3.059,13.788,-338865,-5.322,16.93,107,107,72771
1992,f) 500 to 999,5175,9226,6084912,6161166,279,3.033,227,2.467,605462,189220,416242,3.071,9.827,760208,155557,604651,2.525,12.339,-154746,-2.512,19.654,50,50,33702
1993,f) 500 to 999,5219,9190,6083405,6177854,259,2.812,303,3.289,580969,172883,408086,2.798,9.404,773655,202394,571261,3.276,12.523,-192686,-3.119,18.808,65,67,44498
1994,f) 500 to 999,5331,9318,6207919,6280550,302,3.236,332,3.557,607934,196450,411484,3.128,9.68,747330,228899,518431,3.645,11.899,-139396,-2.219,19.359,124,124,86403
1995,f) 500 to 999,5419,9600,6435779,6464318,325,3.397,257,2.687,643044,218740,424304,3.384,9.948,700250,168397,531853,2.605,10.833,-57206,-0.885,19.895,94,94,62198
1996,f) 500 to 999,5522,9976,6569971,6668634,305,3.056,315,3.156,617688,208392,409296,3.125,9.263,817696,207471,610225,3.111,12.262,-200008,-2.999,18.525,84,87,58641
1997,f) 500 to 999,5721,10296,6855036,6928034,418,4.063,404,3.927,802513,275738,526775,3.98,11.584,946913,269528,677385,3.89,13.668,-144400,-2.084,23.167,102,102,68183
1998,f) 500 to 999,6043,10824,7248898,7272306,441,4.09,357,3.3110000000000004,826969,292503,534466,4.022,11.371,875674,239049,636625,3.287,12.041,-48705,-0.67,22.743,88,89,58343
1999,f) 500 to 999,6209,11255,7428524,7530640,438,3.893,428,3.804,817040,291656,525384,3.873,10.85,1019469,278514,740955,3.698,13.538,-202429,-2.688,21.699,83,88,56228
2000,f) 500 to 999,6249,11531,7743480,7779862,474,4.115,451,3.915,922311,322076,600235,4.14,11.855,996768,304700,692068,3.917,12.812,-74457,-0.957,23.71,88,90,61439
2001,f) 500 to 999,6445,12076,7979759,8082722,437,3.627,385,3.195,871946,296115,575831,3.664,10.788,1080425,262502,817923,3.248,13.367,-208479,-2.579,21.576,88,91,63525
2002,f) 500 to 999,6436,11994,7493326,7897500,430,3.554,637,5.266,771947,293346,478601,3.714,9.775,1583284,428950,1154334,5.431,20.048,-811337,-10.273,19.549,190,224,149311
2003,f) 500 to 999,6048,11220,7310419,7484682,374,3.33,399,3.552,725795,253388,472407,3.385,9.697,1072760,272519,800241,3.641,14.333,-346965,-4.636,19.394,88,92,61876
2004,f) 500 to 999,6014,11048,7319965,7435286,340,3.073,371,3.353,687727,233294,454433,3.138,9.25,920557,250998,669559,3.3760000000000003,12.380999999999998,-232830,-3.131,18.499,94,96,65056
2005,f) 500 to 999,6166,11458,7567302,7659876,348,3.045,287,2.511,731410,236908,494502,3.093,9.549,914240,191168,723072,2.496,11.935,-182830,-2.387,19.097,73,75,50615
2006,f) 500 to 999,6377,11711,7793161,7863457,390,3.338,333,2.85,786110,260027,526083,3.307,9.997,927474,222845,704629,2.834,11.795,-141364,-1.798,19.994,89,89,60146
2007,f) 500 to 999,6528,11934,7902266,8029951,326,2.729,350,2.93,771963,225440,546523,2.807,9.614,1024703,237496,787207,2.958,12.761,-252740,-3.147,19.227,79,84,58109
2008,f) 500 to 999,6688,11953,7856138,8026171,323,2.697,372,3.1060000000000003,720547,219623,500924,2.736,8.977,1065882,248532,817350,3.097,13.28,-345335,-4.303,17.955,78,81,52453
2009,f) 500 to 999,6582,11847,7519347,7819108,265,2.232,318,2.678,538695,178865,359830,2.2880000000000003,6.8889999999999985,1140322,217201,923121,2.778,14.584,-601627,-7.694,13.779000000000002,108,113,80925
2010,f) 500 to 999,6151,11249,7278489,7489450,215,1.909,244,2.166,519705,144620,375085,1.931,6.939,940702,165678,775024,2.212,12.56,-420997,-5.621,13.878,66,66,46017
2011,f) 500 to 999,5927,10661,7227534,7248217,247,2.318,232,2.178,681913,164480,517433,2.269,9.408,722665,156572,566093,2.16,9.97,-40752,-0.562,18.816,44,44,29225
2012,f) 500 to 999,6071,10985,7410658,7465099,214,1.945,244,2.218,631728,149723,482005,2.006,8.462,737013,164245,572768,2.2,9.873,-105285,-1.41,16.925,57,59,39278
2013,f) 500 to 999,6319,11409,7753718,7769576,269,2.361,241,2.115,730909,180457,550452,2.323,9.407,760893,163527,597366,2.105,9.793,-29984,-0.386,18.815,70,75,51078
2014,f) 500 to 999,6528,11791,7998372,8001066,313,2.6630000000000003,240,2.042,773891,212390,561501,2.655,9.672,782944,162303,620641,2.029,9.785,-9053,-0.113,19.345,54,54,37079
2015,f) 500 to 999,6678,12169,8234175,8232816,323,2.668,196,1.619,783184,209717,573467,2.547,9.513,778520,132844,645676,1.614,9.456,4664,0.057,18.913,56,56,37497
2016,f) 500 to 999,6829,12503,8431990,8457660,280,2.245,216,1.732,755532,196419,559113,2.322,8.933,806092,146358,659734,1.73,9.531,-50560,-0.598,17.866,64,66,45120
2017,f) 500 to 999,6867,12614,8530388,8553457,314,2.4930000000000003,279,2.215,794544,207055,587489,2.421,9.289,838390,183044,655346,2.14,9.802,-43846,-0.513,18.578,79,79,51308
2018,f) 500 to 999,7244,13212,8901707,8871086,425,3.2430000000000003,213,1.625,860050,285806,574244,3.222,9.695,796291,144087,652204,1.624,8.976,63759,0.7190000000000001,17.953,62,64,43607
1978,g) 1000+,2172,4293,9642721,9695557,98,2.277,120,2.7880000000000003,900617,193887,706730,2.0,9.289,1006085,276535,729550,2.852,10.377,-105468,-1.088,18.578,39,40,107995
1979,g) 1000+,2256,4494,10192575,10105900,80,1.785,57,1.272,871500,132865,738635,1.315,8.624,695615,88638,606977,0.877,6.882999999999999,175885,1.74,13.767,11,11,15904
1980,g) 1000+,2427,4874,10385108,10682166,86,1.7619999999999998,97,1.988,720383,169428,550955,1.586,6.744,1309876,261606,1048270,2.449,12.262,-589493,-5.518,13.488,15,15,21751
1981,g) 1000+,2445,4837,10280496,10481645,84,1.736,89,1.839,651396,161824,489572,1.544,6.215,1058981,188584,870397,1.7990000000000002,10.103,-407585,-3.889,12.429,12,13,27603
1982,g) 1000+,2616,4897,10300850,10409970,218,4.512,87,1.801,880768,444379,436389,4.269,8.461,1102563,176053,926510,1.6909999999999998,10.591,-221795,-2.131,16.922,7,8,13521
1983,g) 1000+,2645,4825,10168031,10301067,142,2.966,66,1.379,977925,566041,411884,5.495,9.493,1243740,136847,1106893,1.328,12.074000000000002,-265815,-2.58,18.987,5,5,11555
1984,g) 1000+,2639,4771,10532093,10521691,166,3.524,45,0.955,1013957,414638,599319,3.941,9.637,995649,112490,883159,1.069,9.463,18308,0.174,18.926,3,3,15880
1985,g) 1000+,2695,4888,10890741,10844988,206,4.263,95,1.966,1241284,622843,618441,5.7429999999999986,11.446,1161311,265791,895520,2.451,10.708,79973,0.737,21.417,15,15,27557
1986,g) 1000+,2890,5135,11084796,11254910,147,2.875,103,2.014,862070,304930,557140,2.709,7.66,1208445,204888,1003557,1.82,10.737,-346375,-3.0780000000000003,15.319,14,14,21193
1987,g) 1000+,3022,5309,10948561,11591132,264,5.034,135,2.574,1090285,529012,561273,4.564,9.406,2373677,254360,(S),2.194,20.478,-1283392,-11.072,18.812,16,18,32520
1988,g) 1000+,2980,5167,10975719,11108208,161,3.115,164,3.173,977778,343634,634144,3.094,8.802,1242838,322884,919954,2.907,11.188,-265060,-2.386,17.605,41,46,91960
1989,g) 1000+,3057,5355,11407671,11427679,159,2.987,95,1.785,1005954,389607,616347,3.409,8.802999999999997,1049111,187818,861293,1.644,9.18,-43157,-0.378,17.605999999999995,22,22,38267
1990,g) 1000+,3189,5569,11913633,11976459,124,2.237,70,1.263,870081,253084,616997,2.113,7.265,992162,165650,826512,1.383,8.283999999999999,-122081,-1.019,14.53,16,16,26404
1991,g) 1000+,3217,5640,11786857,12078505,115,2.036,134,2.372,763744,243190,520554,2.013,6.323,1355566,275461,1080105,2.281,11.223,-591822,-4.9,12.646,57,58,136510
1992,g) 1000+,3192,5569,11607450,11878008,149,2.684,114,2.053,912944,319279,593665,2.688,7.686,1450324,356930,1093394,3.005,12.21,-537380,-4.524,15.372,27,32,137815
1993,g) 1000+,3234,5551,11639950,11864257,124,2.232,131,2.358,799606,230231,569375,1.941,6.74,1249926,273325,976601,2.3040000000000003,10.535,-450320,-3.796,13.479,25,25,48277
1994,g) 1000+,3256,5619,11698319,11873079,129,2.294,138,2.454,789429,251781,537648,2.121,6.649,1134827,273778,861049,2.306,9.558,-345398,-2.909,13.298,41,41,84041
1995,g) 1000+,3271,5716,11927409,12007717,157,2.764,85,1.496,886137,305984,580153,2.548,7.38,1044487,158209,886278,1.318,8.698,-158350,-1.319,14.759,28,28,53182
1996,g) 1000+,3280,5799,11968006,12127755,150,2.587,148,2.553,899208,270014,629194,2.226,7.414,1223205,291776,931429,2.406,10.086,-323997,-2.672,14.829,31,31,52053
1997,g) 1000+,3278,5831,12127197,12287586,223,3.831,204,3.504,1149192,430266,718926,3.502,9.352,1473252,388644,1084608,3.1630000000000003,11.99,-324060,-2.637,18.705,58,58,114928
1998,g) 1000+,3431,6182,13099156,13129651,225,3.655,172,2.794,1190109,394904,795205,3.008,9.064,1241519,274011,967508,2.087,9.456,-51410,-0.392,18.129,36,36,54438
1999,g) 1000+,3542,6442,13606906,13753943,193,3.0010000000000003,172,2.674,1179834,376949,802885,2.741,8.578,1467301,323732,1143569,2.354,10.668,-287467,-2.09,17.156,39,39,74906
2000,g) 1000+,3597,6617,14100522,14208073,199,3.01,188,2.844,1339721,382505,957216,2.692,9.429,1559935,376876,1183059,2.653,10.979,-220214,-1.55,18.859,28,28,52410
2001,g) 1000+,3657,6806,14355760,14641723,201,2.947,230,3.372,1291862,410262,881600,2.802,8.823,1864701,481275,1383426,3.287,12.736,-572839,-3.912,17.646,45,46,98151
2002,g) 1000+,3760,6952,14107380,14768037,235,3.37,277,3.972,1223378,430903,792475,2.918,8.283999999999999,2549139,587715,1961424,3.98,17.261,-1325761,-8.977,16.567999999999998,90,109,242856
2003,g) 1000+,3594,6610,13750019,14196502,159,2.403,172,2.6,1099998,351322,748676,2.475,7.747999999999998,1973983,400258,1573725,2.819,13.905,-873985,-6.1560000000000015,15.497,52,52,106965
2004,g) 1000+,3622,6583,13796362,14125821,166,2.516,193,2.926,1074672,311176,763496,2.2030000000000003,7.608,1744193,479181,1265012,3.392,12.348,-669521,-4.74,15.216,39,45,93622
2005,g) 1000+,3758,6785,14114521,14370702,179,2.645,142,2.099,1071354,368050,703304,2.5610000000000004,7.455,1581166,307042,1274124,2.137,11.003,-509812,-3.548,14.91,46,46,114033
2006,g) 1000+,3765,6807,14618614,14680303,141,2.074,123,1.809,1180037,262484,917553,1.788,8.038,1314388,255247,1059141,1.739,8.953,-134351,-0.915,16.076,34,35,88281
2007,g) 1000+,3920,6953,14999893,15175141,151,2.168,178,2.555,1292856,293464,999392,1.934,8.52,1648891,397914,1250977,2.622,10.866,-356035,-2.346,17.039,42,43,118169
2008,g) 1000+,3889,6972,15171250,15399602,131,1.872,180,2.573,1088929,248715,840214,1.615,7.0710000000000015,1560192,336610,1223582,2.186,10.131,-471263,-3.06,14.142,44,48,109324
2009,g) 1000+,3955,6993,14835146,15308329,130,1.857,142,2.029,907019,247922,659097,1.62,5.925,1856235,276916,1579319,1.809,12.126,-949216,-6.2010000000000005,11.85,56,56,120705
2010,g) 1000+,3707,6581,14301573,14598231,111,1.6840000000000002,131,1.988,827672,190165,637507,1.3030000000000002,5.67,1420921,274786,1146135,1.882,9.734,-593249,-4.064,11.339,38,38,80418
2011,g) 1000+,3669,6510,14535417,14599352,89,1.366,99,1.52,997756,166129,831627,1.138,6.834,1124629,196626,928003,1.347,7.7029999999999985,-126873,-0.8690000000000001,13.668,26,28,48016
2012,g) 1000+,3730,6664,15003549,15095873,103,1.5419999999999998,136,2.036,1070961,168461,902500,1.116,7.0939999999999985,1255793,282999,972794,1.875,8.318999999999999,-184832,-1.224,14.189,36,43,100355
2013,g) 1000+,3797,6819,15441793,15568205,112,1.639,145,2.121,1077728,252072,825656,1.619,6.922999999999999,1337211,328554,1008657,2.11,8.589,-259483,-1.6669999999999998,13.845,34,34,73989
2014,g) 1000+,3858,7050,15903838,16008875,134,1.903,118,1.676,1212026,300674,911352,1.878,7.5710000000000015,1417001,259728,1157273,1.622,8.851,-204975,-1.28,15.142,21,23,53113
2015,g) 1000+,3969,7237,16503026,16575806,130,1.798,116,1.604,1252012,244450,1007562,1.475,7.553,1402592,258730,1143862,1.561,8.462,-150580,-0.908,15.106,34,34,69643
2016,g) 1000+,4029,7398,16906315,17060295,112,1.514,113,1.527,1180046,225065,954981,1.319,6.917000000000002,1489189,345082,1144107,2.023,8.729,-309143,-1.812,13.834,31,34,94339
2017,g) 1000+,4023,7597,17423328,17483628,174,2.297,133,1.755,1375583,299116,1076467,1.711,7.8679999999999986,1494812,288923,1205889,1.653,8.55,-119229,-0.682,15.736,33,33,88073
2018,g) 1000+,4238,7949,18444156,18352995,201,2.545,96,1.216,1378255,416634,961621,2.27,7.51,1190801,198309,992492,1.081,6.488,187454,1.021,12.977,22,23,43337
