year,fsize,firms,estabs,emp,denom,estabs_entry,estabs_entry_rate,estabs_exit,estabs_exit_rate,job_creation,job_creation_births,job_creation_continuers,job_creation_rate_births,job_creation_rate,job_destruction,job_destruction_deaths,job_destruction_continuers,job_destruction_rate_deaths,job_destruction_rate,net_job_creation,net_job_creation_rate,reallocation_rate,firmdeath_firms,firmdeath_estabs,firmdeath_emp
1978,a) 1 to 4,2160280,2168849,5298699,4959263,488169,23.172,363866,17.272000000000002,2049052,1260777,788275,25.423,41.31800000000001,1361420,906474,454946,18.278,27.452,687632,13.866,54.904,293714,294609,748643
1979,a) 1 to 4,2171739,2179300,5265517,5037480,476636,22.609,334344,15.86,1926037,1234923,691114,24.515,38.234,1472523,886326,586197,17.595,29.231,453514,9.003,58.463,264008,265105,709085
1980,a) 1 to 4,2165964,2174260,5109794,5170812,442824,20.628,387775,18.063,1715902,1143698,572204,22.118,33.184,1842186,999355,842831,19.327,35.62699999999999,-126284,-2.442,66.369,306195,307465,795307
1981,a) 1 to 4,2205777,2213585,5230976,5115215,435147,20.018,355530,16.355,1769740,1154822,614918,22.576,34.598,1540467,883410,657057,17.27,30.115,229273,4.482,60.231,264864,266574,669367
1982,a) 1 to 4,2189951,2198684,5272522,5187516,446940,20.487,412771,18.921,1843288,1193291,649997,23.003,35.533,1672675,1028896,643779,19.834,32.244,170613,3.289,64.488,325282,326786,836206
1983,a) 1 to 4,2282870,2291447,5436450,5244502,486007,21.985,324369,14.673,1855652,1242932,612720,23.7,35.383,1473842,848866,624976,16.186,28.103,381810,7.28,56.205,256134,257619,696093
1984,a) 1 to 4,2387902,2396291,5817849,5462626,551754,24.038,349908,15.244000000000002,2171326,1448100,723226,26.509,39.749,1459327,896891,562436,16.419,26.715,711999,13.034,53.43,281960,283656,745572
1985,a) 1 to 4,2398569,2406544,5866517,5620902,540856,23.118,406763,17.387,2154475,1438631,715844,25.594,38.33,1661674,1064190,597484,18.933,29.562,492801,8.767000000000001,59.125,327732,329839,882848
1986,a) 1 to 4,2402181,2410865,5868541,5665703,518936,22.065,400834,17.044,2090855,1387076,703779,24.482,36.904,1683690,1062663,621027,18.756,29.717,407165,7.186,59.434,319871,321752,873544
1987,a) 1 to 4,2433924,2441657,5971826,5759844,539879,22.709,411274,17.3,2158989,1438290,720699,24.971,37.483,1735067,1096224,638843,19.032,30.124,423922,7.36,60.247,331336,333115,908803
1988,a) 1 to 4,2494416,2501686,6079598,5887759,539596,22.137,411324,16.874000000000002,2151090,1425980,725110,24.219,36.535,1769185,1075856,693329,18.273,30.049,381905,6.4860000000000015,60.097,331223,333143,891770
1989,a) 1 to 4,2520792,2529053,6130127,5936845,530240,21.475,410358,16.62,2136728,1407676,729052,23.711,35.991,1750958,1077680,673278,18.152,29.493,385770,6.497999999999998,58.986,335162,337234,906914
1990,a) 1 to 4,2543433,2551717,6187013,6011852,524621,20.995,418886,16.762999999999998,2132235,1395160,737075,23.207,35.467,1783417,1096666,686751,18.242,29.665,348818,5.8020000000000005,59.33,343924,346535,929935
1991,a) 1 to 4,2529885,2538952,6026939,6036497,481647,19.119,442047,17.547,1918669,1255018,663651,20.791,31.784,1941958,1161294,780664,19.238,32.17,-23289,-0.386,63.569,356867,359495,970520
1992,a) 1 to 4,2551170,2556891,6093873,6019896,477334,18.897,415452,16.447,1939225,1232815,706410,20.479,32.214,1794379,1060779,733600,17.621,29.807,144846,2.406,59.615,328297,330934,869873
1993,a) 1 to 4,2603872,2609545,6242057,6086163,503739,19.651,411458,16.051,2034535,1295273,739262,21.282,33.429,1721970,1037046,684924,17.039,28.293000000000006,312565,5.136,56.58600000000001,330959,332557,863204
1994,a) 1 to 4,2656864,2662963,6318974,6202454,510818,19.508,421783,16.108,2045530,1304695,740835,21.035,32.979,1813798,1066851,746947,17.2,29.243,231732,3.736,58.486,341292,343228,893574
1995,a) 1 to 4,2718894,2725103,6457863,6271357,529563,19.834,419308,15.705,2114096,1350658,763438,21.537,33.71,1739559,1051179,688380,16.762,27.738000000000003,374537,5.972,55.476000000000006,340946,342894,885246
1996,a) 1 to 4,2747552,2753444,6487067,6347550,523214,19.306,436532,16.108,2079225,1334219,745006,21.019,32.756,1800013,1094548,705465,17.244,28.358,279212,4.399,56.715,355178,357169,922553
1997,a) 1 to 4,2775167,2779458,6555227,6427445,525922,19.175,452567,16.5,2100231,1334823,765408,20.768,32.676,1843429,1147120,696309,17.847,28.681,256802,3.995,57.361,367939,370549,963721
1998,a) 1 to 4,2804162,2807391,6600248,6487794,508238,18.35,432738,15.624,2043018,1283960,759058,19.79,31.49,1814691,1083456,731235,16.7,27.971,228327,3.519,55.942,341655,343039,877010
1999,a) 1 to 4,2810978,2814790,6566339,6483634,495522,17.782,439107,15.758,1997124,1237716,759408,19.09,30.803,1830710,1099130,731580,16.952,28.236,166414,2.567,56.472,345593,346995,884776
2000,a) 1 to 4,2802780,2807115,6582312,6479704,482863,17.328,441903,15.858,2003211,1233352,769859,19.034,30.915,1796082,1098247,697835,16.949,27.719,207129,3.197,55.437,343535,345241,872832
2001,a) 1 to 4,2806252,2811960,6527120,6487457,487118,17.449,446562,15.996,1937430,1233400,704030,19.012,29.864,1857166,1116111,741055,17.204,28.627,80264,1.237,57.254,345648,347510,883464
2002,a) 1 to 4,2828542,2832483,6648537,6590980,508138,18.042,476162,16.906,2058655,1301564,757091,19.748,31.234,1944012,1180024,763988,17.904,29.495,114643,1.739,58.99,360327,362449,931384
2003,a) 1 to 4,2870789,2874500,6725743,6612571,532128,18.755,457683,16.131,2078582,1325320,753262,20.042,31.434,1848096,1109005,739091,16.771,27.948,230486,3.486,55.896,351927,353363,886268
2004,a) 1 to 4,2921274,2925628,6847468,6700862,550541,19.123,457273,15.883,2120272,1356176,764096,20.239,31.642,1829766,1112329,717437,16.6,27.306,290506,4.335,54.613,351889,353016,888161
2005,a) 1 to 4,2990811,2995798,6906731,6875917,574448,19.481,480398,16.291,2138650,1410624,728026,20.515,31.103,2080936,1168197,912739,16.99,30.264,57714,0.8390000000000001,60.528,369233,370860,931210
2006,a) 1 to 4,3059751,3065142,7090420,6947063,626016,20.754,528442,17.519000000000002,2278015,1537607,740408,22.133000000000006,32.791,1989593,1273985,715608,18.338,28.639,288422,4.152,57.279,424713,426399,1064443
2007,a) 1 to 4,3073770,3078257,6965706,6930613,565618,18.567,501784,16.472,2058058,1339125,718933,19.322,29.695,1993891,1180135,813756,17.028,28.769,64167,0.926,57.539,394573,396303,959534
2008,a) 1 to 4,3033399,3037557,6805789,6899543,503670,16.468,545338,17.831,1896157,1197323,698834,17.354,27.482,2083679,1245474,838205,18.052,30.2,-187522,-2.718,54.965,427786,429105,1011601
2009,a) 1 to 4,2953830,2958871,6547896,6814670,448669,14.818,586746,19.378,1684087,1050829,633258,15.42,24.713,2220198,1338312,881886,19.639,32.58,-536111,-7.867000000000001,49.425,442789,444247,1051532
2010,a) 1 to 4,2938444,2944279,6527064,6647871,456244,15.337,517184,17.386,1677738,1055587,622151,15.879,25.237,1919381,1165424,753957,17.531,28.872,-241643,-3.635,50.474,380327,382161,897760
2011,a) 1 to 4,2943359,2949298,6600005,6596468,480853,16.283,488343,16.537,1780241,1114011,666230,16.887999999999998,26.988000000000003,1774466,1088907,685559,16.507,26.9,5775,0.08800000000000001,53.8,363398,365488,848082
2012,a) 1 to 4,2986011,2989852,6708121,6598009,496008,16.769000000000002,432059,14.607,1843198,1147418,695780,17.39,27.936,1622851,981692,641159,14.879,24.596,220347,3.34,49.192,323494,325476,775115
2013,a) 1 to 4,2990884,2994680,6676068,6620091,478250,16.08,437341,14.704,1773032,1099675,673357,16.611,26.783,1660343,1003049,657294,15.152,25.08,112689,1.702,50.161,330811,331838,794616
2014,a) 1 to 4,3005817,3010202,6715644,6630942,482295,16.153,433643,14.523,1794680,1112031,682649,16.77,27.065,1622136,986060,636076,14.871,24.463,172544,2.602,48.926,333561,334583,792103
2015,a) 1 to 4,3025270,3029917,6748205,6655113,487945,16.26,429928,14.327,1811148,1124520,686628,16.897000000000002,27.214,1626718,988198,638520,14.849,24.443,184430,2.7710000000000004,48.886,334960,336085,798957
2016,a) 1 to 4,3062372,3067326,6817546,6699317,507518,16.76,429325,14.177,1866034,1173215,692819,17.512,27.854,1628960,983429,645531,14.68,24.315,237074,3.539,48.631,342929,344082,814252
2017,a) 1 to 4,3079297,3083570,6759739,6713598,495511,16.212,441212,14.436,1776845,1125425,651420,16.762999999999998,26.466,1685631,1008891,676740,15.028,25.108,91214,1.359,50.215,360251,361596,847181
2018,a) 1 to 4,3089110,3092697,6787496,6711510,492399,16.051,442284,14.418,1795769,1118845,676924,16.671,26.757,1640715,1004480,636235,14.967,24.446,155054,2.31,48.893,384190,385558,889314
1978,b) 5 to 9,664035,683391,4940978,4644905,45027,6.676,27114,4.02,1360472,512050,848422,11.024,29.29,771053,320412,450641,6.898,16.6,589419,12.69,33.2,20139,21115,266284
1979,b) 5 to 9,699862,719626,5107805,4941822,40035,5.597,31257,4.37,1292429,483601,808828,9.786,26.153,963175,369258,593917,7.472,19.49,329254,6.6629999999999985,38.981,21960,22993,290056
1980,b) 5 to 9,703230,722885,4935715,4993586,36999,5.124,35298,4.8889999999999985,1075462,440311,635151,8.818,21.537,1190994,420711,770283,8.425,23.85,-115532,-2.314,43.074,24669,25766,326449
1981,b) 5 to 9,711345,731917,5051206,4982665,38254,5.2639999999999985,27748,3.819,1159132,473530,685602,9.504,23.263,1022529,330502,692027,6.632999999999999,20.522,136603,2.742,41.043,19089,20491,252630
1982,b) 5 to 9,718724,739520,5074801,5053007,43134,5.871,33461,4.5539999999999985,1166668,494964,671704,9.795,23.089,1122065,384239,737826,7.604,22.206,44603,0.883,44.412,24090,25214,320164
1983,b) 5 to 9,732835,754181,5177015,5126182,38684,5.1629999999999985,28846,3.85,1112380,452688,659692,8.831,21.7,1011232,344109,667123,6.712999999999999,19.727,101148,1.973,39.454,22103,23398,293141
1984,b) 5 to 9,760309,782491,5540839,5325762,40625,5.23,29191,3.758,1349377,505423,843954,9.49,25.337,920924,346634,574290,6.509,17.292,428453,8.045,34.584,22360,23691,296927
1985,b) 5 to 9,787595,809131,5686268,5555963,43470,5.394,36901,4.579,1354576,541903,812673,9.754,24.381,1094075,451369,642706,8.124,19.692,260501,4.689,39.384,28847,30459,383762
1986,b) 5 to 9,810055,832283,5812476,5689652,45558,5.509,34991,4.231,1355911,538436,817475,9.463,23.831,1110173,432108,678065,7.595,19.512,245738,4.319,39.024,27763,29083,368986
1987,b) 5 to 9,823933,845024,5933643,5810547,49065,5.832999999999998,41277,4.907,1414834,567406,847428,9.765,24.349,1169510,469288,700222,8.076,20.127,245324,4.222,40.255,29713,31090,393666
1988,b) 5 to 9,849542,870370,6095925,5981003,46425,5.367000000000001,35556,4.1110000000000015,1392846,545310,847536,9.117,23.288,1163170,433317,729853,7.245,19.448,229676,3.84,38.895,28182,29769,373375
1989,b) 5 to 9,865872,888036,6215181,6090746,45249,5.12,36788,4.162,1416665,549058,867607,9.015,23.259,1168620,451180,717440,7.407999999999999,19.187,248045,4.072,38.374,29915,31884,397248
1990,b) 5 to 9,880995,903796,6290255,6198788,43600,4.841,37402,4.1530000000000005,1397296,528312,868984,8.523,22.541,1215105,458444,756661,7.396,19.602,182191,2.939,39.205,30601,32735,405857
1991,b) 5 to 9,884025,909075,6166760,6223810,44900,4.953,39689,4.378,1259586,506913,752673,8.145,20.238,1372617,492698,879919,7.916,22.054,-113031,-1.816,40.476,32474,34154,432272
1992,b) 5 to 9,879030,899391,6191343,6161013,43087,4.796,41137,4.579,1295747,474796,820951,7.706,21.031,1235002,446498,788504,7.247000000000001,20.045,60745,0.986,40.091,28000,29801,371181
1993,b) 5 to 9,887273,906007,6284238,6209369,38410,4.251,33708,3.73,1307551,463440,844111,7.463999999999999,21.058000000000003,1157448,408201,749247,6.574,18.64,150103,2.417,37.281,26786,28363,354857
1994,b) 5 to 9,900125,919605,6379993,6315759,39851,4.342,36069,3.93,1326879,477761,849118,7.565,21.009,1198150,425832,772318,6.742000000000001,18.971,128729,2.0380000000000003,37.942,28006,30070,372383
1995,b) 5 to 9,907403,926917,6474212,6353747,39757,4.302,34377,3.72,1356641,486269,870372,7.653,21.352,1116194,414103,702091,6.517,17.567,240447,3.784,35.135,27609,29591,366508
1996,b) 5 to 9,915881,934939,6500974,6424276,39529,4.2360000000000015,35997,3.857,1322625,486978,835647,7.58,20.588,1168506,436967,731539,6.8020000000000005,18.189,154119,2.399,36.378,28947,30894,386393
1997,b) 5 to 9,925329,941652,6583422,6506362,42244,4.4860000000000015,42462,4.509,1362591,496725,865866,7.633999999999999,20.942,1209719,483371,726348,7.4289999999999985,18.593,152872,2.35,37.186,30915,33008,412449
1998,b) 5 to 9,938108,951950,6682271,6613949,36113,3.795,35212,3.701,1331203,460371,870832,6.961,20.127,1194032,428299,765733,6.476,18.053,137171,2.074,36.106,26777,28477,357547
1999,b) 5 to 9,942197,956171,6673681,6624872,33241,3.471,36172,3.777,1294028,423882,870146,6.398,19.533,1197135,449024,748111,6.778,18.07,96893,1.463,36.141,28165,30026,375353
2000,b) 5 to 9,946846,961075,6749608,6657573,35368,3.68,35649,3.709,1348931,450392,898539,6.765,20.262,1165114,439927,725187,6.608,17.500999999999998,183817,2.761,35.001,27254,29124,363658
2001,b) 5 to 9,945341,960415,6659991,6657967,35302,3.673,36545,3.803,1245370,439834,805536,6.606,18.705,1241401,454478,786923,6.8260000000000005,18.645,3969,0.06,37.291,27963,29931,373065
2002,b) 5 to 9,951728,965341,6711120,6715317,46215,4.794,43487,4.511,1358476,534125,824351,7.954,20.23,1366540,511312,855228,7.614,20.35,-8064,-0.12,40.459,32049,33654,429890
2003,b) 5 to 9,955166,967427,6748862,6685941,38007,3.937,34127,3.535,1331646,471530,860116,7.053,19.917,1205957,418625,787332,6.261,18.037,125689,1.88,36.074,26890,28293,357201
2004,b) 5 to 9,969693,983096,6881761,6793158,36986,3.769,33329,3.397,1359254,474105,885149,6.979,20.009,1182455,422643,759812,6.222,17.407,176799,2.603,34.813,26972,28208,359561
2005,b) 5 to 9,981972,996024,6900902,6899352,40723,4.1,35223,3.5460000000000003,1346966,520106,826860,7.5379999999999985,19.523,1343285,442752,900533,6.417000000000002,19.47,3681,0.053,38.939,28246,29796,376324
2006,b) 5 to 9,994099,1009164,7104618,6973631,47351,4.715,37715,3.755,1494192,593725,900467,8.514,21.426,1233282,477269,756013,6.8439999999999985,17.685,260910,3.741,35.37,32000,33282,424367
2007,b) 5 to 9,1005039,1018364,7045331,7034779,41377,4.067,39287,3.862,1365387,504520,860867,7.1720000000000015,19.409,1344109,462632,881477,6.5760000000000005,19.107,21278,0.302,38.213,29122,30416,385354
2008,b) 5 to 9,994161,1007537,6916298,6964873,37197,3.692,37093,3.682,1255569,455901,799668,6.546,18.027,1352503,457821,894682,6.573,19.419,-96934,-1.392,36.054,29737,31073,394685
2009,b) 5 to 9,967989,982730,6614812,6796543,31980,3.248,35871,3.643,1090688,398192,692496,5.859,16.048,1450751,451820,998931,6.648,21.345,-360063,-5.297999999999999,32.095,29382,30719,388929
2010,b) 5 to 9,946302,961811,6566344,6603001,37322,3.891,31916,3.3280000000000003,1171662,456112,715550,6.908,17.744,1243227,393977,849250,5.9670000000000005,18.828,-71565,-1.084,35.48900000000001,25473,27016,336720
2011,b) 5 to 9,934145,949699,6490836,6528358,33243,3.5010000000000003,32860,3.4610000000000003,1143084,410240,732844,6.284,17.51,1217106,404097,813009,6.19,18.643,-74022,-1.134,35.019,25772,27242,339219
2012,b) 5 to 9,934213,946820,6565016,6508049,32105,3.39,32534,3.435,1156809,397094,759715,6.102,17.775,1043184,370977,672207,5.7,16.029,113625,1.746,32.058,23410,24782,310590
2013,b) 5 to 9,937721,949508,6585321,6527076,32476,3.426,29091,3.069,1126043,399094,726949,6.114,17.252,1009331,357078,652253,5.471,15.464,116712,1.788,30.928,23251,24371,308774
2014,b) 5 to 9,939958,953053,6621208,6549596,31205,3.28,28126,2.9560000000000004,1128500,388873,739627,5.937,17.23,985994,350484,635510,5.351,15.054,142506,2.176,30.109,23169,24259,306663
2015,b) 5 to 9,944323,957823,6660360,6583051,31278,3.27,28507,2.9810000000000003,1138275,388340,749935,5.899,17.291,984141,357812,626329,5.435,14.95,154134,2.341,29.899,23341,24566,311235
2016,b) 5 to 9,952525,966657,6737574,6648852,33000,3.4210000000000003,28953,3.0010000000000003,1179002,411112,767890,6.183,17.732,1002603,364724,637879,5.4860000000000015,15.079,176399,2.653,30.159,24288,25420,323888
2017,b) 5 to 9,954361,966695,6722706,6670978,33272,3.445,31713,3.283,1153675,410982,742693,6.1610000000000005,17.294,1050730,383908,666822,5.755,15.751,102945,1.543,31.502,25283,26501,337642
2018,b) 5 to 9,957933,969814,6785240,6709199,33273,3.435,31092,3.21,1209451,429638,779813,6.404,18.027,1056958,391291,665667,5.832000000000002,15.754,152493,2.273,31.508000000000006,26913,28225,359559
1978,c) 10 to 19,387865,427410,5718442,5404896,23427,5.5360000000000005,14889,3.519,1384255,430305,953950,7.961,25.611,757704,278111,479593,5.146,14.019,626551,11.592,28.038,8179,9270,219256
1979,c) 10 to 19,415788,454968,6029904,5834431,18756,4.137,15589,3.438,1311220,387272,923948,6.638,22.474,920056,305417,614639,5.235,15.769,391164,6.704,31.539,8695,9600,231846
1980,c) 10 to 19,420085,458545,5873880,5914885,17456,3.806,17697,3.858,1086542,357908,728634,6.051,18.37,1167913,356955,810958,6.035,19.745,-81371,-1.376,36.739,9916,10966,266408
1981,c) 10 to 19,421903,460910,5953013,5894501,18089,3.946,13093,2.8560000000000003,1159312,402300,757012,6.825,19.668,1041316,278133,763183,4.7189999999999985,17.666,117996,2.002,35.332,7778,8842,209031
1982,c) 10 to 19,423246,461987,5927734,5914045,22318,4.853,18102,3.936,1185959,444046,741913,7.507999999999999,20.053,1157691,332445,825246,5.621,19.575,28268,0.478,39.151,9900,10978,266002
1983,c) 10 to 19,425400,467011,5951315,5940106,19571,4.209,15598,3.354,1104782,389049,715733,6.55,18.599,1082617,308252,774365,5.189,18.226,22165,0.373,36.451,9581,10858,257093
1984,c) 10 to 19,439021,481089,6385579,6149034,18201,3.796,14913,3.11,1383255,411847,971408,6.698,22.495,911815,305396,606419,4.967,14.829,471440,7.667000000000002,29.657,9647,10991,259578
1985,c) 10 to 19,455992,495952,6557298,6420357,20168,4.073,18605,3.757,1375728,449674,926054,7.004,21.428,1101858,420524,681334,6.55,17.162,273870,4.266,34.324,13093,14572,354138
1986,c) 10 to 19,473219,514589,6753679,6605236,25058,4.909,16854,3.302,1413367,485517,927850,7.35,21.398000000000003,1116297,375191,741106,5.68,16.9,297070,4.497,33.8,11897,13333,319597
1987,c) 10 to 19,483037,524465,6903926,6783496,26853,5.138,23172,4.434,1488350,516189,972161,7.609,21.941,1248368,438327,810041,6.4620000000000015,18.403,239982,3.5380000000000003,36.806,13348,14547,358284
1988,c) 10 to 19,500383,544344,7156007,7021939,24269,4.4830000000000005,18363,3.392,1459123,486986,972137,6.935,20.779,1191653,393618,798035,5.606,16.97,267470,3.809,33.941,12681,14341,341174
1989,c) 10 to 19,512525,558002,7333810,7185008,22475,4.041,18718,3.366,1473050,476316,996734,6.629,20.502,1175251,405857,769394,5.649,16.357,297799,4.145,32.714,13229,15591,357078
1990,c) 10 to 19,523796,569278,7453439,7346234,21941,3.866,18388,3.24,1452940,464974,987966,6.329,19.778,1239303,413580,825723,5.63,16.87,213637,2.908,33.74,13782,15793,370642
1991,c) 10 to 19,524864,576897,7249643,7335612,30655,5.359,21001,3.671,1315221,495478,819743,6.754,17.929000000000006,1487124,478238,1008886,6.519,20.273,-171903,-2.343,35.859,15548,17630,424175
1992,c) 10 to 19,516744,566996,7239339,7228640,25564,4.515,23878,4.218,1379843,440409,939434,6.093,19.089,1358893,422890,936003,5.85,18.799,20950,0.29,37.597,12472,13993,337026
1993,c) 10 to 19,519910,570984,7339719,7254092,19793,3.471,18320,3.213,1365943,413879,952064,5.705,18.83,1195587,377354,818233,5.202000000000001,16.482,170356,2.3480000000000003,32.963,11948,13685,322114
1994,c) 10 to 19,527730,576490,7475770,7388690,21406,3.718,19981,3.47,1389927,428104,961823,5.794,18.812,1215869,398860,817009,5.398,16.456,174058,2.356,32.912,12727,14890,343921
1995,c) 10 to 19,536740,584260,7657478,7497266,20700,3.549,18773,3.218,1435174,434825,1000349,5.8,19.143,1114450,387217,727233,5.165,14.865,320724,4.2780000000000005,29.73,12538,14836,339560
1996,c) 10 to 19,542611,588210,7663036,7575639,21135,3.599,19323,3.29,1374419,441619,932800,5.829,18.143,1199558,406773,792785,5.369,15.834,174861,2.3080000000000003,31.669,13172,15240,356239
1997,c) 10 to 19,550134,593118,7805957,7707657,24266,4.086,25689,4.3260000000000005,1463114,453100,1010014,5.879,18.983,1267493,468556,798937,6.079,16.445,195621,2.5380000000000003,32.889,14339,16621,387405
1998,c) 10 to 19,559611,599937,7969723,7875992,17734,2.951,19754,3.287,1425952,417761,1008191,5.3039999999999985,18.105,1237046,410011,827035,5.206,15.707,188906,2.399,31.413,12502,14508,339085
1999,c) 10 to 19,566078,604167,8021804,7949020,16368,2.701,19926,3.2880000000000003,1376219,373480,1002739,4.698,17.313,1230377,435232,795145,5.475,15.478,145842,1.835,30.957,13481,15975,364342
2000,c) 10 to 19,575696,612337,8209866,8126760,17648,2.878,19240,3.138,1454252,403169,1051083,4.961,17.895,1287291,419110,868181,5.157,15.84,166961,2.0540000000000003,31.68,12841,15309,348237
2001,c) 10 to 19,578053,613966,8145164,8122055,18258,2.972,19138,3.115,1335927,401164,934763,4.939,16.448,1290332,426514,863818,5.251,15.887,45595,0.561,31.774,13083,15289,353991
2002,c) 10 to 19,582620,619134,8177772,8189016,32196,5.223,26780,4.3439999999999985,1511264,571676,939588,6.981,18.455,1532192,533241,998951,6.5120000000000005,18.71,-20928,-0.256,36.91,16323,18044,443609
2003,c) 10 to 19,585053,621097,8249186,8169055,20666,3.3310000000000004,19206,3.096,1446409,438811,1007598,5.372000000000001,17.706,1285425,394720,890705,4.832,15.735,160984,1.971,31.471,12214,13890,329448
2004,c) 10 to 19,593197,629321,8404872,8303664,18066,2.873,17202,2.735,1451478,424410,1027068,5.1110000000000015,17.48,1248575,393879,854696,4.743,15.036,202903,2.444,30.073,12398,14148,334656
2005,c) 10 to 19,597338,633053,8347747,8357567,20114,3.1830000000000003,17703,2.802,1399637,468656,930981,5.608,16.747,1418257,405504,1012753,4.852,16.97,-18620,-0.223,33.494,12785,14570,344804
2006,c) 10 to 19,602811,640909,8582206,8416445,26642,4.184,18418,2.892,1571312,552123,1019189,6.56,18.67,1238276,426386,811890,5.066,14.713,333036,3.957,29.425,13852,15432,372383
2007,c) 10 to 19,609400,644480,8521801,8499907,23823,3.701,22153,3.442,1436389,484335,952054,5.698,16.899,1392874,439226,953648,5.167000000000002,16.387,43515,0.512,32.774,13050,14583,350050
2008,c) 10 to 19,601351,637155,8366259,8397139,21315,3.349,19908,3.128,1301268,432080,869188,5.146,15.497,1363331,421549,941782,5.02,16.236,-62063,-0.7390000000000001,30.993,13320,15163,358523
2009,c) 10 to 19,585578,623162,7981344,8198085,16891,2.709,17735,2.844,1089833,361032,728801,4.404,13.294,1522162,403748,1118414,4.925,18.567,-432329,-5.274,26.588,12963,14788,349740
2010,c) 10 to 19,575162,614627,7907370,8007234,15492,2.52,15700,2.5540000000000003,1086395,326242,760153,4.074,13.568,1284519,348171,936348,4.348,16.042,-198124,-2.474,27.135,11101,12775,298490
2011,c) 10 to 19,567375,607461,7889998,7871143,16417,2.707,14495,2.39,1160113,351340,808773,4.464,14.739,1121344,314417,806927,3.995,14.246,38769,0.493,28.493,10037,11695,269428
2012,c) 10 to 19,561595,598095,7927331,7810811,18941,3.168,18374,3.074,1255901,397420,858481,5.088,16.079,1022032,338455,683577,4.333,13.085,233869,2.994,26.17,10126,11694,273593
2013,c) 10 to 19,567036,602495,7981923,7887028,19317,3.215,15916,2.649,1210425,391707,818718,4.966,15.347,1019200,329173,690027,4.174,12.922,191225,2.425,25.845,10336,11729,278489
2014,c) 10 to 19,574038,609744,8099344,7999188,17233,2.832,14793,2.431,1204393,373677,830716,4.671,15.056,1003776,326900,676876,4.087,12.548,200617,2.508,25.097,10514,11919,281391
2015,c) 10 to 19,582078,618051,8232387,8112482,17952,2.912,14972,2.428,1234023,385909,848114,4.757,15.211,995008,340240,654768,4.194,12.265,239015,2.946,24.53,10985,12335,295037
2016,c) 10 to 19,590712,626949,8360387,8242808,18184,2.907,15393,2.461,1264134,398075,866059,4.829,15.336,1030048,351807,678241,4.268,12.496,234086,2.84,24.993,11464,12917,309812
2017,c) 10 to 19,597007,630962,8427974,8347875,19398,3.073,19751,3.129,1283953,409207,874746,4.902,15.380999999999998,1124355,403785,720570,4.837,13.469,159598,1.912,26.938,12746,14578,345542
2018,c) 10 to 19,601744,634968,8510799,8435827,15663,2.463,17574,2.764,1267614,389183,878431,4.613,15.027,1118200,384215,733985,4.555,13.255,149414,1.771,26.511,13084,15196,353424
1978,d) 20 to 99,304214,428998,12680286,12017034,29495,6.937,21816,5.131,2847729,774937,2072792,6.449,23.697,1522806,554413,968393,4.614,12.672,1324923,11.025,25.344,4663,6245,339754
1979,d) 20 to 99,331570,458941,13653618,13208761,22004,4.819,17299,3.789,2624690,620160,2004530,4.695,19.871,1732984,515097,1217887,3.9,13.12,891706,6.751,26.24,4507,5622,320959
1980,d) 20 to 99,338909,465236,13507865,13538341,19241,4.142,17891,3.851,2183373,575757,1607616,4.253,16.127,2244459,589190,1655269,4.352,16.579,-61086,-0.451,32.255,5149,6800,372912
1981,d) 20 to 99,339817,468858,13592861,13465526,23262,5.007,14640,3.151,2321090,723351,1597739,5.372000000000001,17.237000000000002,2064789,466399,1598390,3.464,15.334,256301,1.903,30.668000000000006,4058,5573,287988
1982,d) 20 to 99,338941,470519,13552278,13471806,22646,4.841,17245,3.686,2434276,803042,1631234,5.961,18.069000000000006,2275105,510731,1764374,3.791,16.887999999999998,159171,1.182,33.776,5157,6687,364523
1983,d) 20 to 99,337729,472265,13372751,13389903,22692,4.824,18946,4.0280000000000005,2235657,670595,1565062,5.008,16.697,2266725,542561,1724164,4.052,16.929000000000002,-31068,-0.232,33.393,5223,7261,370491
1984,d) 20 to 99,349374,483836,14466642,13864073,19982,4.151,15162,3.149,2878435,660523,2217912,4.7639999999999985,20.762,1674803,476479,1198324,3.437,12.08,1203632,8.682,24.16,4898,6291,343158
1985,d) 20 to 99,365247,496686,14989605,14666389,19191,3.872,17020,3.434,2805561,729593,2075968,4.975,19.129,2158891,742784,1416107,5.065,14.72,646670,4.409,29.44,7929,9892,577181
1986,d) 20 to 99,382444,520786,15599894,15239298,34090,6.643,18831,3.67,3051658,958719,2092939,6.291,20.025,2331025,654166,1676859,4.293,15.296,720633,4.729,30.592,6688,8648,481855
1987,d) 20 to 99,388430,535625,15924901,15641770,33191,6.252999999999999,23598,4.4460000000000015,3169601,983304,2186297,6.2860000000000005,20.264,2603587,764249,1839338,4.886,16.645,566014,3.619,33.29,7784,9897,562054
1988,d) 20 to 99,403175,558253,16495869,16193227,32860,5.949,21044,3.81,3082135,912423,2169712,5.635,19.033,2475821,709925,1765896,4.384,15.289,606314,3.744,30.578000000000007,7354,10040,536720
1989,d) 20 to 99,415918,573254,17022132,16636456,30828,5.4220000000000015,21478,3.777,3139507,907557,2231950,5.455,18.871,2369196,762561,1606635,4.584,14.241,770311,4.63,28.482,8069,11407,582430
1990,d) 20 to 99,428611,586699,17361211,17107137,28974,4.98,19228,3.305,2985860,872570,2113290,5.101,17.454,2478727,699023,1779704,4.086,14.489,507133,2.964,28.979,7790,10507,557614
1991,d) 20 to 99,420320,596580,16557995,16850991,46144,7.854,27969,4.761,2759872,1001822,1758050,5.945,16.378,3345649,1011989,2333660,6.006,19.854,-585777,-3.4760000000000004,32.756,10807,14450,801650
1992,d) 20 to 99,411890,600512,16514562,16379729,32174,5.398,23156,3.885,2889597,817722,2071875,4.992,17.641,2620965,690252,1930713,4.214,16.000999999999998,268632,1.64,32.003,7105,9867,512746
1993,d) 20 to 99,416346,605106,16761848,16577688,23986,3.964,23955,3.959,2790370,733408,2056962,4.424,16.832,2425882,664241,1761641,4.007,14.633,364488,2.199,29.267,6691,10035,490287
1994,d) 20 to 99,425356,613176,17324225,17045015,26253,4.297,21736,3.5580000000000003,2884544,801812,2082732,4.704,16.923,2326437,711623,1614814,4.175,13.649,558107,3.274,27.298,7682,11607,572864
1995,d) 20 to 99,439846,627527,17982367,17566154,26077,4.173,20740,3.319,2999328,800349,2198979,4.556,17.074,2165565,688966,1476599,3.922,12.328,833763,4.746,24.656,7536,12110,565708
1996,d) 20 to 99,445508,632209,17973687,17805613,26079,4.14,21575,3.425,2788812,812485,1976327,4.563,15.663,2453307,740623,1712684,4.159,13.778,335505,1.884,27.557,8083,12867,602523
1997,d) 20 to 99,454137,642156,18555221,18220760,32762,5.115,29574,4.617,3255956,869708,2386248,4.773,17.869,2585273,872289,1712984,4.787,14.189,670683,3.681,28.377,8766,13404,650362
1998,d) 20 to 99,467712,648760,19197411,18896128,22634,3.482,25001,3.847,3139005,814253,2324752,4.309,16.612000000000002,2536735,736493,1800242,3.898,13.425,602270,3.187,26.849,7388,11608,546203
1999,d) 20 to 99,476367,650795,19381257,19158728,22460,3.449,23106,3.549,2917420,710396,2207024,3.708,15.228,2471146,818164,1652982,4.27,12.898,446274,2.329,25.797,8847,14959,664493
2000,d) 20 to 99,487556,655405,19987658,19603284,22398,3.422,20662,3.157,3110321,750278,2360043,3.827,15.866,2340331,741652,1598679,3.783,11.938,769990,3.928,23.877,8025,13378,591471
2001,d) 20 to 99,494106,658689,20010756,19891231,25205,3.839,20878,3.18,2877218,760195,2117023,3.822,14.465,2639040,778707,1860333,3.915,13.267,238178,1.197,26.535,8432,13131,630232
2002,d) 20 to 99,490039,664261,19651612,19832780,45830,6.973,31876,4.85,3323833,1304185,2019648,6.5760000000000005,16.759,3683521,1149296,2534225,5.795,18.573,-359688,-1.814,33.519,11566,15735,893866
2003,d) 20 to 99,491895,666104,19889712,19627028,25692,3.861,24358,3.66,3183747,803388,2380359,4.093,16.221,2657940,718992,1938948,3.663,13.542,525807,2.679,27.084,7188,10830,533418
2004,d) 20 to 99,499660,672490,20221938,19987884,19808,2.951,17266,2.572,2939341,772291,2167050,3.864,14.706,2470105,676689,1793416,3.385,12.358,469236,2.3480000000000003,24.716,7350,11004,546656
2005,d) 20 to 99,503047,675405,20215898,20128566,22913,3.406,17707,2.632,2888767,832703,2056064,4.137,14.352,2710875,685667,2025208,3.406,13.468,177892,0.884,26.936,7464,11340,551066
2006,d) 20 to 99,508418,690990,20840519,20402567,37224,5.464,17656,2.592,3346653,1086195,2260458,5.324,16.403,2469649,719568,1750081,3.527,12.105,877004,4.298,24.209,7892,11000,583219
2007,d) 20 to 99,513143,698382,20646344,20596291,31042,4.468,23857,3.434,3083647,899042,2184605,4.365,14.972,2979405,832900,2146505,4.044,14.466,104242,0.506,28.931,7802,10616,578693
2008,d) 20 to 99,508055,692820,20485696,20433079,26774,3.875,22861,3.309,2866117,788879,2077238,3.861,14.027,2761628,744382,2017246,3.643,13.515,104489,0.511,27.031,7724,10797,570115
2009,d) 20 to 99,490159,675638,19117998,19745452,19951,2.957,17892,2.652,2103662,632449,1471213,3.2030000000000003,10.654000000000002,3356824,748247,2608577,3.789,17.0,-1253162,-6.347,21.308000000000003,8067,11745,620273
2010,d) 20 to 99,468944,659401,18466987,18684842,23697,3.615,15803,2.411,2123447,722977,1400470,3.869,11.365,2558952,551954,2006998,2.954,13.695,-435505,-2.331,22.729,6135,9705,443469
2011,d) 20 to 99,462087,654092,18604201,18408555,22598,3.475,15017,2.309,2373520,649937,1723583,3.531,12.894,1981032,526119,1454913,2.858,10.761,392488,2.132,21.523000000000003,5709,8872,420034
2012,d) 20 to 99,471259,659528,19127257,18789437,24064,3.649,23773,3.605,2757654,750599,2007055,3.995,14.677,2080997,623076,1457921,3.3160000000000003,11.075,676657,3.6010000000000004,22.151,5860,9114,426453
2013,d) 20 to 99,480115,666679,19381646,19155364,23491,3.534,19443,2.925,2519510,682676,1836834,3.564,13.153,2064078,592456,1471622,3.093,10.775,455432,2.378,21.551,6145,8543,449434
2014,d) 20 to 99,489532,677849,19832726,19532185,23723,3.5210000000000004,15661,2.324,2489110,722308,1766802,3.698,12.744000000000002,1886715,552723,1333992,2.83,9.66,602395,3.084,19.319000000000006,5969,9174,437716
2015,d) 20 to 99,502371,693273,20377936,20045536,25823,3.749,16725,2.428,2597494,774383,1823111,3.863,12.958,1935424,600173,1335251,2.994,9.655,662070,3.303,19.31,6699,10010,485499
2016,d) 20 to 99,513887,705991,20780409,20503327,25757,3.673,16328,2.3280000000000003,2619435,769143,1850292,3.751,12.776,2064521,613757,1450764,2.9930000000000003,10.069,554914,2.7060000000000004,20.138,6852,9946,499130
2017,d) 20 to 99,520663,709557,21056737,20799958,24825,3.5,24250,3.419,2928345,801827,2126518,3.855,14.079,2415836,780341,1635495,3.752,11.615,512509,2.464,23.229,8092,11972,594378
2018,d) 20 to 99,526358,708508,21256120,21095557,14714,2.07,19164,2.696,2619090,667151,1951939,3.1630000000000003,12.415,2298702,661957,1636745,3.138,10.897,320388,1.519,21.793000000000006,7732,13112,569186
1978,e) 100 to 499,45410,163094,8951775,8612626,17944,11.037,16923,10.409,1922923,534533,1388390,6.206,22.327,1246214,493757,752457,5.733,14.47,676709,7.857,28.939,391,1021,136417
1979,e) 100 to 499,49436,175359,9697182,9422538,15296,8.825,11211,6.4689999999999985,1739278,459698,1279580,4.879,18.459,1189056,377508,811548,4.006,12.619000000000002,550222,5.839,25.239,310,686,100025
1980,e) 100 to 499,51069,183358,9833626,9782670,14430,7.957999999999998,10363,5.715,1502048,419022,1083026,4.283,15.354,1402876,387984,1014892,3.966,14.34,99172,1.014,28.681,375,1141,129890
1981,e) 100 to 499,51471,188741,9827274,9754874,16252,8.761000000000001,9774,5.269,1525355,507661,1017694,5.204,15.637,1378252,313758,1064494,3.216,14.129,147103,1.508,28.258000000000006,275,881,93361
1982,e) 100 to 499,52209,197080,10121383,9956071,15472,7.989,8658,4.47,1770730,647514,1123216,6.504,17.785,1441806,285103,1156703,2.864,14.482,328924,3.304,28.963,318,1024,106529
1983,e) 100 to 499,52007,196625,9822063,9847266,15097,7.737,12080,6.191,1585666,494739,1090927,5.024,16.102999999999998,1634026,335565,1298461,3.408,16.594,-48360,-0.491,32.205,337,981,108813
1984,e) 100 to 499,53927,202442,10639251,10212806,15933,7.997000000000001,9546,4.791,1974398,482256,1492142,4.722,19.333,1120481,264398,856083,2.589,10.970999999999998,853917,8.361,21.943,264,586,85992
1985,e) 100 to 499,57033,209895,11246375,10884647,15830,7.659,9400,4.548,2062371,537112,1525259,4.935,18.948,1338722,381517,957205,3.505,12.299,723649,6.648,24.598000000000006,570,1451,188402
1986,e) 100 to 499,59028,208993,11331762,11149834,17586,8.529,12002,5.8210000000000015,2078456,618699,1459757,5.549,18.641,1714308,393367,1320941,3.528,15.375,364148,3.266,30.75,485,965,158754
1987,e) 100 to 499,61477,223369,12090836,11857466,22082,10.092,12972,5.928,2449193,862365,1586828,7.273,20.655,1989290,468263,1521027,3.949,16.777,459903,3.879,33.553000000000004,629,1502,212653
1988,e) 100 to 499,64306,238503,12472281,12245316,25400,10.917,13702,5.8889999999999985,2346027,795329,1550698,6.495,19.159,1891022,515551,1375471,4.21,15.443,455005,3.716,30.886,686,1895,242528
1989,e) 100 to 499,66809,246423,13004210,12674966,23038,9.518,14309,5.9110000000000005,2318591,698373,1620218,5.51,18.293,1657345,486254,1171091,3.836,13.076,661246,5.2170000000000005,26.151,612,2240,200495
1990,e) 100 to 499,69045,255192,13300905,13109074,21182,8.427999999999999,13443,5.349,2116576,660180,1456396,5.0360000000000005,16.146,1733746,447286,1286460,3.412,13.226,382830,2.92,26.451,663,1887,219906
1991,e) 100 to 499,67068,262063,12725704,12908164,24235,9.399,15777,6.119,1889008,680388,1208620,5.271,14.634,2256784,631882,1624902,4.895,17.483,-367776,-2.849,29.268,1047,3133,356537
1992,e) 100 to 499,66223,272531,12837324,12686609,19965,7.411,13689,5.081,2081992,608991,1473001,4.8,16.410999999999998,1779978,423340,1356638,3.337,14.03,302014,2.381,28.061,605,1990,200468
1993,e) 100 to 499,67980,273672,13240893,13029103,17287,6.28,20443,7.427,2170243,561359,1608884,4.309,16.657,1747618,521431,1226187,4.002,13.413,422625,3.244,26.826,636,3012,226578
1994,e) 100 to 499,69593,277576,13612356,13385024,18796,6.831,13951,5.07,2150664,588188,1562476,4.394,16.067999999999998,1697503,564236,1133267,4.215,12.682,453161,3.386,25.364,890,2496,323862
1995,e) 100 to 499,72662,281669,14108344,13824904,19582,7.0310000000000015,13301,4.775,2216210,620175,1596035,4.4860000000000015,16.031,1653580,490133,1163447,3.545,11.961,562630,4.07,23.922,742,2448,260979
1996,e) 100 to 499,72346,285652,13912169,13789820,19688,6.971,13257,4.694,2020468,599278,1421190,4.346,14.652,1776476,474160,1302316,3.438,12.883,243992,1.769,25.765,744,2497,255245
1997,e) 100 to 499,73846,293523,14458486,14163254,24449,8.451,16029,5.54,2495333,702135,1793198,4.957,17.618,1903222,584007,1319215,4.123,13.438,592111,4.181,26.875,898,3145,320268
1998,e) 100 to 499,77219,299047,15168648,14861951,22798,7.683,18154,6.1179999999999986,2517612,694138,1823474,4.671,16.94,1908805,532820,1375985,3.585,12.844,608807,4.096,25.687,731,4027,263569
1999,e) 100 to 499,79210,304041,15428826,15185576,25288,8.442,16295,5.44,2376531,702989,1673542,4.629,15.65,1891051,557666,1333385,3.672,12.453,485480,3.197,24.906,824,3682,288808
2000,e) 100 to 499,81636,307463,16013628,15618136,23291,7.662000000000001,16336,5.374,2563041,687683,1875358,4.4030000000000005,16.410999999999998,1770731,505071,1265660,3.234,11.338,792310,5.073,22.675,703,3850,255851
2001,e) 100 to 499,82798,312205,15981412,15889358,22650,7.317,17317,5.5939999999999985,2248951,606225,1642726,3.815,14.154000000000002,2064998,563475,1501523,3.5460000000000003,12.996,183953,1.158,25.992,803,3077,286453
2002,e) 100 to 499,81167,318651,15444009,15679065,24067,7.6179999999999986,18648,5.902,2352934,849574,1503360,5.419,15.007,2823861,763755,2060106,4.871,18.01,-470927,-3.004,30.014,1293,4338,461822
2003,e) 100 to 499,82971,326959,16060849,15810567,20684,6.347,18573,5.699,2559489,614513,1944976,3.887,16.188,2057757,568196,1489561,3.594,13.015,501732,3.173,26.03,745,2559,258978
2004,e) 100 to 499,84497,329993,16389895,16239346,17923,5.457999999999998,14716,4.481,2159664,555688,1603976,3.422,13.299,1860022,497719,1362303,3.065,11.454,299642,1.845,22.908,747,3254,270989
2005,e) 100 to 499,85677,334746,16695733,16444236,22190,6.728,12285,3.725,2305060,640166,1664894,3.893,14.017,1804503,439007,1365496,2.67,10.973,500557,3.044,21.947,648,1805,226499
2006,e) 100 to 499,87589,346571,17129038,16821995,27938,8.237,13147,3.876,2513000,795332,1717668,4.728,14.939,1896971,458692,1438279,2.727,11.277,616029,3.662,22.553,659,2394,236660
2007,e) 100 to 499,87844,351674,16901414,16879205,22926,6.587999999999999,15574,4.475,2249808,570289,1679519,3.379,13.329,2203872,513650,1690222,3.043,13.057,45936,0.272,26.113000000000003,702,2618,246497
2008,e) 100 to 499,87809,353339,17053279,16886782,21662,6.175,16582,4.727,2288343,550343,1738000,3.259,13.550999999999998,1956741,491945,1464796,2.9130000000000003,11.587,331602,1.964,23.175,726,2387,247181
2009,e) 100 to 499,84752,353606,15930672,16390815,19644,5.598,14285,4.0710000000000015,1616310,489321,1126989,2.985,9.861,2533379,529434,2003945,3.23,15.456,-917069,-5.595,19.722,862,2823,307962
2010,e) 100 to 499,81386,355013,15598662,15633051,22350,6.372999999999998,13698,3.906,1783676,567188,1216488,3.628,11.41,1854620,362541,1492079,2.319,11.863,-70944,-0.454,22.819000000000006,490,2561,177934
2011,e) 100 to 499,80915,355372,15766214,15588246,17562,4.979,12240,3.47,1845160,423926,1421234,2.72,11.837,1489453,320810,1168643,2.0580000000000003,9.555,355707,2.282,19.11,456,1908,154835
2012,e) 100 to 499,81421,351769,15977507,15742817,15784,4.4830000000000005,16436,4.668,2075744,438999,1636745,2.789,13.185,1609102,406594,1202508,2.583,10.221,466642,2.964,20.442,506,2295,182971
2013,e) 100 to 499,83600,354558,16414624,16159679,16597,4.7,13780,3.902,2024358,427487,1596871,2.645,12.527,1512981,399883,1113098,2.475,9.363,511377,3.165,18.725,575,1323,198112
2014,e) 100 to 499,85740,360976,16848207,16569702,19150,5.364,11166,3.128,1944935,506722,1438213,3.0580000000000003,11.738,1388619,331948,1056671,2.003,8.38,556316,3.357,16.761,521,1907,179823
2015,e) 100 to 499,87836,366960,17282916,17001857,21349,5.8870000000000005,12737,3.512,2040282,537632,1502650,3.162,12.0,1477344,345784,1131560,2.0340000000000003,8.689,562938,3.3110000000000004,17.379,528,2144,184639
2016,e) 100 to 499,89480,374335,17599001,17355545,20987,5.67,12608,3.406,2028386,525529,1502857,3.028,11.687,1539012,351192,1187820,2.024,8.868,489374,2.82,17.735,569,2469,196992
2017,e) 100 to 499,90515,372753,17884973,17621251,17760,4.775,16188,4.352,2453612,503939,1949673,2.86,13.924,1925198,477813,1447385,2.712,10.925,528414,2.999,21.851,676,2353,234452
2018,e) 100 to 499,91758,373906,18217673,17993505,13514,3.621,12155,3.257,2137668,443022,1694646,2.462,11.88,1689478,386291,1303187,2.147,9.389,448190,2.491,18.779,679,4370,234173
1978,f) 500 to 999,5514,51643,3374710,3288261,6282,12.225,5769,11.227,667492,204721,462771,6.226,20.299,495120,218043,277077,6.631,15.057,172372,5.242000000000001,30.114,30,87,42010
1979,f) 500 to 999,5681,53825,3541939,3461326,5597,10.469,4873,9.115,571254,181740,389514,5.251,16.504,407598,148320,259278,4.285,11.776,163656,4.728,23.552,14,124,14766
1980,f) 500 to 999,5737,56434,3529682,3490777,5888,10.607,4041,7.28,498814,184379,314435,5.282,14.289,421091,116624,304467,3.341,12.063,77723,2.227,24.126,21,89,23173
1981,f) 500 to 999,5867,58160,3527419,3490045,6292,11.119000000000002,3147,5.561,508049,193233,314816,5.537000000000001,14.557,431068,102544,328524,2.938,12.351,76981,2.206,24.703000000000007,13,272,18465
1982,f) 500 to 999,5821,62162,3622745,3543783,5932,9.742,3396,5.577000000000001,587498,250105,337393,7.058,16.578,428921,107819,321102,3.042,12.103,158577,4.475,24.207,8,39,11368
1983,f) 500 to 999,6023,61800,3530283,3537420,5250,8.588,3912,6.399,516221,180616,335605,5.106,14.593,531885,102570,429315,2.9,15.036,-15664,-0.443,29.186,6,42,7826
1984,f) 500 to 999,6077,64987,3826291,3673007,6184,9.764,2885,4.555,651430,205332,446098,5.59,17.736,345781,68421,277360,1.863,9.414,305649,8.321,18.828,(D),(D),(D)
1985,f) 500 to 999,6374,65248,4011052,3859191,6483,10.187,3270,5.138,745530,257424,488106,6.67,19.318,438272,108367,329905,2.8080000000000003,11.357,307258,7.9620000000000015,22.713,18,145,20567
1986,f) 500 to 999,6720,68495,4091356,4027859,7843,11.864,3065,4.636,686909,252036,434873,6.2570000000000014,17.054000000000002,559795,118749,441046,2.948,13.898,127114,3.156,27.796,16,183,20513
1987,f) 500 to 999,7119,69905,4314653,4260157,7110,10.355,4623,6.733,813080,348055,465025,8.17,19.086,702486,156677,545809,3.678,16.49,110594,2.596,32.979,18,225,24697
1988,f) 500 to 999,7533,75671,4552122,4470405,8796,11.941,4780,6.489,809549,302857,506692,6.775,18.109,649648,195501,454147,4.373,14.532,159901,3.577,29.064,37,211,50865
1989,f) 500 to 999,7766,79700,4694748,4584007,8879,11.45,4570,5.893,748787,256590,492197,5.598,16.335,523746,148681,375065,3.2430000000000003,11.425999999999998,225041,4.909,22.851,19,251,26945
1990,f) 500 to 999,7971,83591,4806196,4721478,9727,12.003,4622,5.7029999999999985,706032,229194,476838,4.854,14.954,536209,124245,411964,2.631,11.357,169823,3.597,22.714,15,50,19582
1991,f) 500 to 999,7858,81364,4634084,4671802,8153,10.177,5656,7.06,611605,217028,394577,4.645,13.091,687560,189696,497864,4.06,14.717,-75955,-1.626,26.183000000000003,46,160,60399
1992,f) 500 to 999,7896,82968,4706317,4655422,8692,10.73,4774,5.893,688034,246374,441660,5.292000000000002,14.779000000000002,586684,139750,446934,3.002,12.602,101350,2.177,25.204,21,366,29902
1993,f) 500 to 999,7909,80481,4747881,4685498,6198,7.7,6221,7.729,702507,200728,501779,4.284,14.993,578422,183396,395026,3.914,12.345,124085,2.648,24.69,24,281,33098
1994,f) 500 to 999,8089,82996,4897577,4804972,8013,9.802,5517,6.749,700428,223225,477203,4.646,14.577,515150,147865,367285,3.077,10.720999999999998,185278,3.856,21.442,34,288,44669
1995,f) 500 to 999,8251,88896,5035372,4926318,8533,9.786,5125,5.877999999999999,747974,245074,502900,4.975,15.183,529310,141325,387985,2.869,10.745,218664,4.439,21.489,30,474,41537
1996,f) 500 to 999,8377,88225,5072122,5015514,7344,8.379,6198,7.0710000000000015,725873,226942,498931,4.525,14.473,610307,177704,432603,3.543,12.168,115566,2.3040000000000003,24.337,40,380,54576
1997,f) 500 to 999,8439,92687,5238270,5154815,9964,10.953,6524,7.1720000000000015,845742,285450,560292,5.5379999999999985,16.407,678271,213477,464794,4.141,13.158,167471,3.249,26.316,58,846,86321
1998,f) 500 to 999,8868,95770,5437891,5325932,10356,11.007,6994,7.433,901853,279071,622782,5.24,16.933,676234,206094,470140,3.87,12.697,225619,4.2360000000000015,25.394,42,343,55658
1999,f) 500 to 999,8973,96885,5523975,5453047,10752,11.306,7186,7.556,870046,296944,573102,5.445,15.955,727199,215232,511967,3.947,13.336,142847,2.62,26.671,47,761,61155
2000,f) 500 to 999,9256,99099,5737928,5612311,10634,10.924,7123,7.317,925031,294720,630311,5.251,16.482,670150,219578,450572,3.912,11.941,254881,4.541,23.881,45,726,58238
2001,f) 500 to 999,9424,101410,5841080,5796490,9160,9.114,7342,7.305,848093,255800,592293,4.413,14.630999999999998,760821,212367,548454,3.664,13.126,87272,1.506,26.251,44,1136,61810
2002,f) 500 to 999,9462,103819,5646654,5753592,10083,9.788,8463,8.216000000000001,808100,277742,530358,4.827,14.045,1021792,299411,722381,5.204,17.759,-213692,-3.714,28.09,81,1325,110381
2003,f) 500 to 999,9365,104546,5601689,5582906,7421,7.102,7315,7.0,787808,211236,576572,3.784,14.111,749114,204278,544836,3.659,13.418,38694,0.693,26.836,39,353,54060
2004,f) 500 to 999,9257,104260,5664630,5612347,6914,6.613,7495,7.169,736821,194697,542124,3.469,13.129,635691,185098,450593,3.298,11.327,101130,1.802,22.653,33,1264,42851
2005,f) 500 to 999,9507,110235,5896486,5786633,10275,9.477,6641,6.125,865702,287931,577771,4.976,14.96,645417,171688,473729,2.967,11.154000000000002,220285,3.807,22.307,41,1092,56943
2006,f) 500 to 999,9817,110113,6061892,5957480,9550,8.818,5937,5.482,837536,229995,607541,3.861,14.059,630033,148179,481854,2.487,10.575,207503,3.483,21.151,32,878,46532
2007,f) 500 to 999,10066,114034,6135453,6076111,9944,8.887,5671,5.0680000000000005,828040,219343,608697,3.61,13.628,709634,164696,544938,2.7110000000000003,11.679,118406,1.949,23.358,32,306,43985
2008,f) 500 to 999,10148,116105,6169627,6129621,8255,7.157,6730,5.835,808506,215327,593179,3.513,13.19,729772,188683,541089,3.0780000000000003,11.906,78734,1.284,23.811,36,421,47308
2009,f) 500 to 999,9718,118593,5863166,6013403,8208,6.952000000000001,7147,6.0539999999999985,636307,214537,421770,3.568,10.581,934633,188447,746186,3.134,15.542,-298326,-4.961,21.163,47,599,63722
2010,f) 500 to 999,9458,121317,5780847,5804553,7858,6.5139999999999985,6477,5.369,649921,194219,455702,3.346,11.197,700387,148791,551596,2.563,12.066,-50466,-0.8690000000000001,22.393,35,319,47723
2011,f) 500 to 999,9413,122085,5927752,5843904,6245,5.134,5368,4.413,685987,148156,537831,2.535,11.739,517822,103059,414763,1.764,8.861,168165,2.878,17.722,16,192,20032
2012,f) 500 to 999,9876,124723,6213488,6114361,6234,5.002,6066,4.867,764941,143786,621155,2.352,12.511,567193,129055,438138,2.111,9.276,197748,3.234,18.553,25,232,34244
2013,f) 500 to 999,10088,124359,6333231,6257796,6790,5.482,5798,4.681,770223,154862,615361,2.475,12.308,617724,154043,463681,2.462,9.871,152499,2.437,19.743,35,398,49605
2014,f) 500 to 999,10322,124709,6494006,6395432,7536,6.101,5156,4.174,812008,197294,614714,3.085,12.697,613886,129864,484022,2.031,9.599,198122,3.0980000000000003,19.198,19,215,27998
2015,f) 500 to 999,10514,128880,6608672,6506054,8648,6.803,5120,4.0280000000000005,815110,224599,590511,3.452,12.528,611442,132414,479028,2.035,9.398,203668,3.13,18.796,32,243,42341
2016,f) 500 to 999,10627,131097,6699372,6619456,8830,6.825,5406,4.178,812985,197165,615820,2.979,12.282,653708,129467,524241,1.956,9.876,159277,2.406,19.751,30,509,40376
2017,f) 500 to 999,10845,133332,6854292,6732678,7997,6.045,5926,4.479,913798,201384,712414,2.991,13.573,671815,145059,526756,2.155,9.978,241983,3.594,19.957,28,514,40118
2018,f) 500 to 999,10857,135997,7049675,6939906,7516,5.564,5711,4.227,909512,232396,677116,3.349,13.106,689051,127536,561515,1.838,9.929,220461,3.177,19.858,29,953,38403
1978,g) 1000 to 2499,3357,65646,4280971,4186936,8196,12.505999999999998,7977,12.172,770500,262495,508005,6.269,18.402,583088,277801,305287,6.635,13.925999999999998,187412,4.476,27.853,13,77,37559
1979,g) 1000 to 2499,3412,69250,4491919,4356867,8604,12.703,5567,8.219,719308,262970,456338,6.0360000000000005,16.51,453308,185665,267643,4.261,10.404000000000002,266000,6.105,20.809,5,17,8135
1980,g) 1000 to 2499,3533,70745,4628021,4541736,9189,13.424,4602,6.723,653376,267808,385568,5.897,14.386,478312,154030,324282,3.391,10.531,175064,3.855,21.063,3,3,4126
1981,g) 1000 to 2499,3711,71604,4650544,4611014,7060,10.021,4751,6.744,593258,223427,369831,4.846,12.866,513591,137632,375959,2.985,11.138,79667,1.7280000000000002,22.277,(D),(D),(D)
1982,g) 1000 to 2499,3804,76123,4961544,4841422,7786,10.421,4966,6.647,748421,354415,394006,7.32,15.459,509177,135102,374075,2.7910000000000004,10.517,239244,4.942,21.034,(D),(D),(D)
1983,g) 1000 to 2499,3852,75459,4774106,4773235,6569,8.816,4674,6.273,604287,232436,371851,4.87,12.66,601048,131705,469343,2.759,12.592,3239,0.068,25.184,(D),(D),(D)
1984,g) 1000 to 2499,3932,79682,5132153,4966351,7618,9.783,3988,5.122000000000001,781033,283743,497290,5.712999999999999,15.726,454370,97879,356491,1.971,9.149,326663,6.5779999999999985,18.298,(D),(D),(D)
1985,g) 1000 to 2499,4115,83731,5461084,5284782,8575,10.486,4666,5.706,900220,336063,564157,6.359,17.034000000000002,545845,139976,405869,2.649,10.329,354375,6.706,20.657,4,83,10047
1986,g) 1000 to 2499,4306,85673,5585867,5471834,9435,11.349,4354,5.237,878973,357492,521481,6.533,16.064,646282,134572,511710,2.459,11.811,232691,4.253,23.622,3,3,6668
1987,g) 1000 to 2499,4458,86606,5792329,5771041,10468,12.487,4921,5.87,951965,432240,519725,7.49,16.496,910540,205638,704902,3.563,15.778,41425,0.718,31.555,8,73,17817
1988,g) 1000 to 2499,4734,92605,6145785,5985849,12338,13.858,5191,5.831,1035643,426423,609220,7.124,17.302,713734,222818,490916,3.722,11.924,321909,5.377999999999999,23.847,11,75,33035
1989,g) 1000 to 2499,5000,98128,6472893,6310730,11350,11.942,5172,5.442,984519,349182,635337,5.533,15.601,662104,185945,476159,2.946,10.492,322415,5.109,20.983,12,142,28552
1990,g) 1000 to 2499,5107,104160,6677782,6598253,9925,9.706,6110,5.975,883572,322301,561271,4.885,13.390999999999998,724976,175319,549657,2.657,10.987,158596,2.404,21.975,7,401,18939
1991,g) 1000 to 2499,5119,107549,6602533,6601473,11306,10.761,6339,6.033,818769,315468,503301,4.779,12.403,817979,212694,605285,3.222,12.390999999999998,790,0.012,24.782,17,42,48369
1992,g) 1000 to 2499,5110,110349,6675154,6620029,9621,8.808,7393,6.768,893676,289611,604065,4.375,13.5,782663,215820,566843,3.26,11.823,111013,1.6769999999999998,23.645,7,7,23036
1993,g) 1000 to 2499,5101,109963,6728745,6656338,8948,8.184,7705,7.0470000000000015,886036,267002,619034,4.011,13.311,736353,217959,518394,3.274,11.062,149683,2.249,22.125,11,20,30018
1994,g) 1000 to 2499,5371,111850,6903635,6795881,11049,10.021,7863,7.1320000000000014,935819,307878,627941,4.53,13.77,719067,216383,502684,3.184,10.581,216752,3.189,21.162,16,328,44090
1995,g) 1000 to 2499,5409,115275,7017412,6878900,12196,10.786,7782,6.882999999999999,956682,338721,617961,4.924,13.907,678446,192261,486185,2.795,9.863,278236,4.045,19.725,9,415,26627
1996,g) 1000 to 2499,5366,112184,6943929,6884512,10847,9.803,7778,7.029,908841,310682,598159,4.513,13.201,791915,219546,572369,3.189,11.503,116926,1.6980000000000002,23.006,7,40,17122
1997,g) 1000 to 2499,5390,118609,7197456,7047347,13812,11.854,9632,8.266,1200789,452195,748594,6.417000000000002,17.039,899682,265399,634283,3.766,12.765999999999998,301107,4.273,25.533,15,422,38880
1998,g) 1000 to 2499,5606,123256,7402040,7245184,14526,12.109000000000002,7928,6.609,1130039,391990,738049,5.41,15.597,812708,243037,569671,3.354,11.217,317331,4.38,22.434,8,155,22480
1999,g) 1000 to 2499,5640,122343,7560593,7444430,13598,11.32,9161,7.626,1121329,407059,714270,5.468,15.063,882178,272423,609755,3.659,11.85,239151,3.212,23.7,22,384,60895
2000,g) 1000 to 2499,5845,128537,7731023,7578513,15002,11.932,9390,7.468,1183949,419512,764437,5.5360000000000005,15.622,878645,277749,600896,3.665,11.594,305304,4.029,23.188,13,710,44641
2001,g) 1000 to 2499,5823,130868,7787142,7736707,15421,11.973,11278,8.756,1107442,369352,738090,4.774,14.314,1004958,289338,715620,3.74,12.989,102484,1.325,25.979,24,1769,67743
2002,g) 1000 to 2499,5938,127094,7494951,7649542,11038,8.647,12141,9.511,1057008,367862,689146,4.809,13.818,1363536,448054,915482,5.857,17.825,-306528,-4.007,27.636,41,1763,122262
2003,g) 1000 to 2499,5871,129278,7517899,7494772,11813,9.214,9670,7.542999999999998,1027008,326038,700970,4.35,13.703,972302,279893,692409,3.735,12.973,54706,0.73,25.946,23,1039,69449
2004,g) 1000 to 2499,5789,131236,7627606,7569058,12257,9.527,7093,5.513,966107,300898,665209,3.975,12.764,850724,242073,608651,3.198,11.239,115383,1.524,22.479,15,19,46544
2005,g) 1000 to 2499,5862,125706,7757713,7678457,10744,8.633,8241,6.622000000000001,999646,328590,671056,4.279,13.019,841101,235998,605103,3.074,10.954,158545,2.065,21.908,14,219,42074
2006,g) 1000 to 2499,5993,136079,8039125,7875247,13942,10.496,7453,5.6110000000000015,1088018,337975,750043,4.292,13.816,760536,199924,560612,2.539,9.657,327482,4.158,19.315,10,172,31991
2007,g) 1000 to 2499,6379,141748,8296293,8192991,13272,9.513,8797,6.306,1099777,315935,783842,3.856,13.423,893436,242876,650560,2.964,10.905,206341,2.519,21.81,19,154,51898
2008,g) 1000 to 2499,6265,141462,8285071,8264038,10792,7.647,10125,7.174,1015936,264758,751178,3.204,12.293,975103,257595,717508,3.117,11.799,40833,0.494,23.599,20,596,62675
2009,g) 1000 to 2499,6099,145777,7969442,8136491,12281,8.427999999999999,12175,8.355,838262,297762,540500,3.66,10.303,1171153,281937,889216,3.465,14.394,-332891,-4.091,20.605,27,1332,69734
2010,g) 1000 to 2499,5936,145203,7852167,7929311,10260,7.09,9280,6.4129999999999985,804656,239794,564862,3.024,10.148,963663,224403,739260,2.83,12.153,-159007,-2.005,20.296,12,636,37880
2011,g) 1000 to 2499,5937,150405,8079963,7986084,9947,6.691,6466,4.349,882850,209207,673643,2.62,11.055,696507,164591,531916,2.061,8.722000000000001,186343,2.333,17.442999999999998,12,148,31053
2012,g) 1000 to 2499,6130,148825,8254950,8140044,9558,6.461,7789,5.265,970789,214962,755827,2.641,11.925999999999998,737730,209289,528441,2.571,9.063,233059,2.863,18.126,14,34,46017
2013,g) 1000 to 2499,6334,148418,8258824,8162389,9958,6.742000000000001,8544,5.784,965280,233849,731431,2.865,11.826,772420,192569,579851,2.359,9.463,192860,2.363,18.926,14,615,41112
2014,g) 1000 to 2499,6270,153802,8511486,8361589,11975,7.914,6983,4.615,1020835,265493,755342,3.175,12.209,720242,154775,565467,1.851,8.613999999999999,300593,3.595,17.227,5,133,16452
2015,g) 1000 to 2499,6459,156858,8771303,8627267,12477,8.077,7708,4.99,1050231,286031,764200,3.315,12.173,763294,163046,600248,1.89,8.847000000000003,286937,3.326,17.695,6,451,17216
2016,g) 1000 to 2499,6482,158764,8848394,8763766,11793,7.51,8334,5.307,1027379,286354,741025,3.267,11.723,855717,170440,685277,1.945,9.764,171662,1.959,19.529,12,874,33601
2017,g) 1000 to 2499,6678,161082,8989170,8922459,10786,6.747999999999998,8310,5.199,1023324,228678,794646,2.563,11.469,885701,230695,655006,2.5860000000000003,9.927,137623,1.5419999999999998,19.853,18,693,58050
2018,g) 1000 to 2499,6528,164044,9314149,9170075,11594,7.144,8101,4.9910000000000005,1122398,317052,805346,3.457,12.24,839237,176704,662533,1.927,9.152,283161,3.088,18.304,12,868,38615
1978,h) 2500 to 4999,1357,54369,3276325,3217499,6244,11.494000000000002,6156,11.332,564179,209834,354345,6.522,17.535,446680,202924,243756,6.307,13.883,117499,3.652,27.766,(D),(D),(D)
1979,h) 2500 to 4999,1370,52804,3349240,3226363,8248,16.168,4670,9.154,590720,247396,343324,7.667999999999998,18.309,347511,143331,204180,4.442,10.771,243209,7.5379999999999985,21.542,(D),(D),(D)
1980,h) 2500 to 4999,1388,55939,3463403,3400223,7205,13.347,3295,6.104,504389,224904,279485,6.614,14.834,373331,115157,258174,3.387,10.98,131058,3.854,21.959,0,0,0
1981,h) 2500 to 4999,1453,61218,3597380,3583382,6482,10.894,3042,5.113,427547,175419,252128,4.895,11.931,395684,96837,298847,2.702,11.042,31863,0.889,22.084,0,0,0
1982,h) 2500 to 4999,1434,59592,3626087,3608581,5253,8.839,4926,8.289,493049,211154,281895,5.851,13.663,453796,147774,306022,4.095,12.575,39253,1.088,25.151,(D),(D),(D)
1983,h) 2500 to 4999,1541,61130,3658057,3645982,5263,8.765,3098,5.159,543001,272483,270518,7.474,14.893,519148,104829,414319,2.875,14.239,23853,0.654,28.478,0,0,0
1984,h) 2500 to 4999,1578,60861,3849109,3715146,5732,9.688,2341,3.957,644004,258609,385395,6.961,17.335,376026,92991,283035,2.503,10.121,267978,7.212999999999999,20.243,(D),(D),(D)
1985,h) 2500 to 4999,1575,61621,3857699,3790804,6938,11.656,2742,4.607,627631,258830,368801,6.8279999999999985,16.557000000000002,491951,122050,369901,3.22,12.977,135680,3.579,25.955,(D),(D),(D)
1986,h) 2500 to 4999,1709,63450,4020157,3956366,6598,10.634,3791,6.11,621329,249859,371470,6.315,15.705,494771,110628,384143,2.7960000000000003,12.505999999999998,126558,3.199,25.011,0,0,0
1987,h) 2500 to 4999,1760,71041,4200071,4187202,7605,10.95,4426,6.372999999999998,666540,270728,395812,6.466,15.919,641940,183765,458175,4.3889999999999985,15.331,24600,0.588,30.662,(D),(D),(D)
1988,h) 2500 to 4999,1811,77444,4347108,4265051,8446,11.094,5814,7.637,701238,300315,400923,7.041,16.441,533528,180731,352797,4.237,12.509,167710,3.932,25.019,(D),(D),(D)
1989,h) 2500 to 4999,1904,82178,4646896,4529148,8700,10.869000000000002,4433,5.5379999999999985,719670,283760,435910,6.265,15.89,484419,139402,345017,3.0780000000000003,10.696,235251,5.194,21.391,0,0,0
1990,h) 2500 to 4999,1906,83648,4771230,4697008,8775,10.74,4880,5.973,628189,225320,402869,4.797,13.374,478867,115399,363468,2.457,10.195,149322,3.179,20.39,0,0,0
1991,h) 2500 to 4999,1930,82881,4644018,4648318,9130,11.314,4762,5.901,563280,228069,335211,4.9060000000000015,12.118,574386,148607,425779,3.197,12.357,-11106,-0.239,24.236,(D),(D),(D)
1992,h) 2500 to 4999,1987,81930,4805410,4768792,7536,9.276,6156,7.5779999999999985,635398,211651,423747,4.438,13.324000000000002,563125,158674,404451,3.327,11.809,72273,1.516,23.617,3,3,21480
1993,h) 2500 to 4999,1977,87235,5026319,4976818,6663,7.584,7894,8.986,626678,201242,425436,4.044,12.592,530272,164414,365858,3.304,10.655,96406,1.937,21.31,(D),(D),(D)
1994,h) 2500 to 4999,2098,90692,5184830,5125844,9074,10.205,5517,6.205,621872,206318,415554,4.025,12.132,505549,167633,337916,3.27,9.863,116323,2.269,19.725,3,3,17991
1995,h) 2500 to 4999,2249,95624,5634782,5519101,10493,11.272,5426,5.829,755999,261805,494194,4.744,13.698,523188,137008,386180,2.482,9.48,232811,4.218,18.959,(D),(D),(D)
1996,h) 2500 to 4999,2171,98168,5465442,5418318,10126,10.462,7376,7.62,702662,249817,452845,4.6110000000000015,12.968,609361,176451,432910,3.257,11.246,93301,1.722,22.493,(D),(D),(D)
1997,h) 2500 to 4999,2148,93683,5519931,5498216,11115,11.978,9333,10.058,826019,300232,525787,5.461,15.023,782578,239866,542712,4.363,14.233,43441,0.79,28.467,3,3,21865
1998,h) 2500 to 4999,2288,94341,5803045,5674930,11086,11.992,7298,7.894,871254,307699,563555,5.4220000000000015,15.353,611469,203743,407726,3.59,10.775,259785,4.578,21.55,0,0,0
1999,h) 2500 to 4999,2315,104969,5901756,5795057,14166,14.009,6465,6.393,911446,376641,534805,6.499,15.728,698159,201267,496892,3.4730000000000003,12.047,213287,3.68,24.095,(D),(D),(D)
2000,h) 2500 to 4999,2404,101601,6082064,5967171,12024,12.092,7696,7.74,947284,371107,576177,6.2189999999999985,15.875,717575,225065,492510,3.772,12.025,229709,3.85,24.051,(D),(D),(D)
2001,h) 2500 to 4999,2368,103834,6091551,6044328,13456,13.129,10762,10.501,915741,313688,602053,5.19,15.15,822366,276585,545781,4.5760000000000005,13.606,93375,1.545,27.211,5,133,36952
2002,h) 2500 to 4999,2437,102448,5864728,5971759,10508,10.252,10607,10.349,836623,287242,549381,4.81,14.01,1052535,344065,708470,5.7620000000000005,17.625,-215912,-3.616,28.019,10,1036,71655
2003,h) 2500 to 4999,2402,104031,5858958,5878279,9066,8.717,9017,8.67,760401,226719,533682,3.857,12.936,795464,227723,567741,3.874,13.532,-35063,-0.596,25.872,(D),(D),(D)
2004,h) 2500 to 4999,2324,107888,6050720,6049679,10706,10.043,8126,7.622999999999998,753585,234939,518646,3.883,12.457,753514,240688,512826,3.979,12.455,71,0.001,24.911,6,722,38330
2005,h) 2500 to 4999,2327,108878,6147708,6073368,10064,9.372,7073,6.5870000000000015,779390,242672,536718,3.996,12.833,627656,185222,442434,3.05,10.335,151734,2.498,20.669,(D),(D),(D)
2006,h) 2500 to 4999,2394,109226,6339951,6267091,10173,9.48,6348,5.915,786558,262657,523901,4.191,12.550999999999998,637576,158569,479007,2.53,10.173,148982,2.377,20.347,(D),(D),(D)
2007,h) 2500 to 4999,2549,113283,6524567,6438095,11794,10.617,7390,6.653,871373,249251,622122,3.872,13.535,699499,176429,523070,2.74,10.865,171874,2.67,21.73,(D),(D),(D)
2008,h) 2500 to 4999,2509,118056,6557016,6519050,10815,9.271,8011,6.867000000000001,801671,250675,550996,3.845,12.297,727528,210132,517396,3.2230000000000003,11.16,74143,1.137,22.32,5,383,31493
2009,h) 2500 to 4999,2417,117350,6251371,6381861,10386,8.931000000000003,8273,7.114,625889,218337,407552,3.4210000000000003,9.807,884629,193367,691262,3.03,13.862,-258740,-4.0539999999999985,19.615,3,60,19912
2010,h) 2500 to 4999,2305,118514,6087021,6166150,8342,7.028,8691,7.322999999999999,569061,162407,406654,2.634,9.229,728498,197399,531099,3.201,11.814,-159437,-2.5860000000000003,18.458,4,339,27075
2011,h) 2500 to 4999,2273,120265,6234299,6186823,7583,6.3210000000000015,6990,5.827000000000001,631548,150105,481443,2.426,10.208,534915,133063,401852,2.151,8.646,96633,1.5619999999999998,17.292,(D),(D),(D)
2012,h) 2500 to 4999,2343,122052,6296008,6217703,6641,5.444,6500,5.329,706250,151901,554349,2.443,11.359000000000002,546938,129038,417900,2.075,8.796,159312,2.562,17.593,(D),(D),(D)
2013,h) 2500 to 4999,2454,131855,6737317,6651108,9101,6.9510000000000005,7254,5.54,796045,192879,603166,2.9,11.969,624286,144174,480112,2.168,9.386,171759,2.582,18.772,3,52,16319
2014,h) 2500 to 4999,2534,133459,6878025,6805495,8698,6.5120000000000005,8899,6.6629999999999985,778883,205821,573062,3.024,11.445,630523,141474,489049,2.079,9.265,148360,2.18,18.53,(D),(D),(D)
2015,h) 2500 to 4999,2517,133438,6967406,6865868,8978,6.77,7349,5.541,814885,190862,624023,2.78,11.869000000000002,612946,160278,452668,2.334,8.927,201939,2.9410000000000003,17.855,5,501,32715
2016,h) 2500 to 4999,2558,137598,7129458,7064312,9103,6.6770000000000005,6556,4.809,774506,198558,575948,2.8110000000000004,10.964,647144,125219,521925,1.773,9.161,127362,1.803,18.322,(D),(D),(D)
2017,h) 2500 to 4999,2665,139730,7133859,7086928,8971,6.43,8534,6.117000000000001,803130,187853,615277,2.651,11.333,707833,179120,528713,2.527,9.988,95297,1.345,19.976,5,283,26167
2018,h) 2500 to 4999,2439,137441,7228964,7140137,8317,6.002999999999999,10545,7.6110000000000015,843041,222107,620934,3.111,11.807,662770,183480,479290,2.57,9.282,180271,2.525,18.565,4,225,26385
1978,i) 5000 to 9999,815,48504,3510139,3418488,6295,13.147,5052,10.550999999999998,628632,226169,402463,6.6160000000000005,18.389,445724,177610,268114,5.1960000000000015,13.039,182908,5.351,26.077,(D),(D),(D)
1979,i) 5000 to 9999,803,55401,3847795,3740675,5708,10.493,3704,6.809,604475,204754,399721,5.474,16.16,391650,125046,266604,3.343,10.47,212825,5.689,20.94,(D),(D),(D)
1980,i) 5000 to 9999,840,60119,3910133,3843337,6975,11.999,2995,5.152,539895,243529,296366,6.336,14.048,410195,120166,290029,3.127,10.673,129700,3.375,21.346,0,0,0
1981,i) 5000 to 9999,868,63921,3751296,3754045,6330,10.141,3324,5.325,425171,158060,267111,4.21,11.326,430292,123068,307224,3.278,11.462,-5121,-0.136,22.651,(D),(D),(D)
1982,i) 5000 to 9999,874,67744,3930609,3937081,6119,9.147,4426,6.6160000000000005,486856,179042,307814,4.548,12.366,499388,142781,356607,3.627,12.684,-12532,-0.318,24.732,0,0,0
1983,i) 5000 to 9999,929,67564,4040961,4013748,4978,7.388,4617,6.852,640266,312067,328199,7.775,15.952,580217,138523,441694,3.451,14.456,60049,1.496,28.911,0,0,0
1984,i) 5000 to 9999,909,69266,4064308,4020266,5809,8.533,3424,5.03,557482,190806,366676,4.746,13.867,467157,108715,358442,2.704,11.62,90325,2.247,23.24,0,0,0
1985,i) 5000 to 9999,937,76991,4183520,4131364,7218,9.577,3966,5.2620000000000005,637667,275871,361796,6.6770000000000005,15.435,536214,135056,401158,3.269,12.979,101453,2.456,25.958,0,0,0
1986,i) 5000 to 9999,989,79318,4362856,4288146,7097,9.089,4627,5.926,623138,235861,387277,5.5,14.532,475336,141857,333479,3.3080000000000003,11.085,147802,3.447,22.17,0,0,0
1987,i) 5000 to 9999,1071,83551,4409131,4431126,11230,13.949000000000002,5147,6.393,641745,249897,391848,5.64,14.483,683818,173109,510709,3.907,15.432,-42073,-0.949,28.965,0,0,0
1988,i) 5000 to 9999,1041,78486,4576756,4546177,8645,11.217,5809,7.537000000000001,705452,266567,438885,5.864,15.517,645052,208924,436128,4.596,14.189,60400,1.329,28.378,(D),(D),(D)
1989,i) 5000 to 9999,1072,84872,4762739,4701261,6925,8.213,5817,6.899,696055,239324,456731,5.091,14.806,568508,179815,388693,3.825,12.093,127547,2.713,24.185,0,0,0
1990,i) 5000 to 9999,1096,87150,4922025,4825255,6425,7.4860000000000015,3780,4.404,680681,211923,468758,4.392,14.107,488724,102233,386491,2.119,10.128,191957,3.978,20.257,0,0,0
1991,i) 5000 to 9999,1127,90968,4884056,4900425,6344,7.025,5014,5.5520000000000005,560449,184027,376422,3.755,11.437,590238,142404,447834,2.906,12.045,-29789,-0.608,22.873,0,0,0
1992,i) 5000 to 9999,1103,94353,5052101,5026073,6353,6.789,4794,5.122999999999998,658864,235793,423071,4.691,13.109000000000002,606341,145642,460699,2.898,12.064,52523,1.045,24.128,(D),(D),(D)
1993,i) 5000 to 9999,1117,91250,5046891,4998337,7005,7.723,5911,6.517,641569,215511,426058,4.312,12.836,540366,147077,393289,2.943,10.811,101203,2.025,21.622,0,0,0
1994,i) 5000 to 9999,1204,94046,5251031,5175058,10422,11.38,5497,6.002000000000002,700417,277514,422903,5.363,13.534,545223,137963,407260,2.6660000000000004,10.536,155194,2.999,21.071,0,0,0
1995,i) 5000 to 9999,1297,93559,5211585,5132647,10696,11.724,6047,6.627999999999999,732151,290570,441581,5.6610000000000005,14.265,572692,149089,423603,2.905,11.158,159459,3.107,22.316,0,0,0
1996,i) 5000 to 9999,1303,106637,5554707,5490984,10298,9.79,7397,7.032,746758,261351,485407,4.76,13.6,621453,166977,454476,3.0410000000000004,11.318,125305,2.282,22.635,0,0,0
1997,i) 5000 to 9999,1203,104146,5624391,5568442,12225,11.854,10186,9.877,862346,341416,520930,6.131,15.486,749933,216467,533466,3.887,13.468,112413,2.019,26.935,0,0,0
1998,i) 5000 to 9999,1345,115688,6101657,5938328,15552,13.821,9222,8.196,1018030,363898,654132,6.127999999999999,17.143,692930,221395,471535,3.728,11.669,325100,5.475,23.338,0,0,0
1999,i) 5000 to 9999,1339,118609,6279071,6167208,16236,14.047,10187,8.812999999999997,1048043,450052,597991,7.2970000000000015,16.994,820941,242511,578430,3.932,13.311,227102,3.682,26.623,0,0,0
2000,i) 5000 to 9999,1442,122615,6282490,6221303,14956,12.35,11928,9.85,994974,341969,653005,5.497000000000001,15.993,872776,293565,579211,4.7189999999999985,14.029000000000002,122198,1.964,28.058000000000003,(D),(D),(D)
2001,i) 5000 to 9999,1338,119216,6444650,6446037,14644,12.438,11688,9.927,974045,393389,580656,6.103,15.111,971753,301266,670487,4.674,15.075,2292,0.036000000000000004,30.15,0,0,0
2002,i) 5000 to 9999,1393,119446,6167401,6318167,12064,10.117,11668,9.785,887473,324343,563130,5.132999999999999,14.046,1177457,377508,799949,5.975,18.636,-289984,-4.59,28.093000000000004,3,313,42009
2003,i) 5000 to 9999,1390,117374,6282367,6327426,11928,10.23,10382,8.904,819279,229326,589953,3.624,12.948,909250,282840,626410,4.47,14.37,-89971,-1.422,25.896,0,0,0
2004,i) 5000 to 9999,1340,118208,6365538,6351206,12102,10.398,8470,7.277,867323,260137,607186,4.096,13.656,840916,302103,538813,4.757,13.24,26407,0.416,26.481,0,0,0
2005,i) 5000 to 9999,1326,122049,6305611,6284892,9870,8.158999999999999,7724,6.385,763842,247847,515995,3.944,12.154000000000002,724058,213690,510368,3.4,11.521,39784,0.633,23.041,(D),(D),(D)
2006,i) 5000 to 9999,1356,123604,6639115,6529875,13800,11.452,7607,6.312,931373,286904,644469,4.394,14.263,716756,216371,500385,3.314,10.977,214617,3.287,21.953000000000007,(D),(D),(D)
2007,i) 5000 to 9999,1452,121614,6712707,6680556,13835,11.494000000000002,11350,9.429,882880,302775,580105,4.532,13.216,818195,236197,581998,3.536,12.247,64685,0.968,24.495,(D),(D),(D)
2008,i) 5000 to 9999,1436,122680,6884182,6835148,15056,12.532,9976,8.304,897807,309070,588737,4.522,13.135,802162,230358,571804,3.37,11.736,95645,1.399,23.472,(D),(D),(D)
2009,i) 5000 to 9999,1359,120347,6535244,6666100,11555,9.668,9892,8.277000000000001,701543,267040,434503,4.006,10.524,968324,227323,741001,3.41,14.526,-266781,-4.002,21.048,(D),(D),(D)
2010,i) 5000 to 9999,1361,119557,6351427,6397902,11387,9.656,8128,6.892,684325,241861,442464,3.78,10.696,771370,187844,583526,2.9360000000000004,12.057,-87045,-1.361,21.392,0,0,0
2011,i) 5000 to 9999,1286,121653,6499371,6414648,12331,10.319,8021,6.7120000000000015,753414,221068,532346,3.446,11.745,579222,154301,424921,2.405,9.03,174192,2.716,18.059,(D),(D),(D)
2012,i) 5000 to 9999,1327,121155,6730255,6673835,8605,7.05,10420,8.537,788015,188111,599904,2.819,11.808,678805,219681,459124,3.292,10.171,109210,1.636,20.342,4,2088,56316
2013,i) 5000 to 9999,1299,121646,6564194,6494441,10090,8.328,9123,7.53,770445,222030,548415,3.419,11.863,629519,172503,457016,2.656,9.693,140926,2.17,19.386,0,0,0
2014,i) 5000 to 9999,1355,126501,6815860,6749003,9213,7.346,7045,5.617000000000001,767803,221451,546352,3.281,11.377,635481,162986,472495,2.415,9.416,132322,1.961,18.832,(D),(D),(D)
2015,i) 5000 to 9999,1352,129527,7016224,6917592,9249,7.215,6595,5.144,790294,222322,567972,3.214,11.424,592943,138519,454424,2.002,8.572000000000001,197351,2.853,17.143,0,0,0
2016,i) 5000 to 9999,1406,136452,7202416,7154489,12469,9.355,6147,4.612,792989,223487,569502,3.124,11.084,691309,162866,528443,2.276,9.663,101680,1.421,19.325,(D),(D),(D)
2017,i) 5000 to 9999,1483,137355,7228307,7124868,12004,8.872,7894,5.834,905222,272067,633155,3.819,12.705,698266,182540,515726,2.562,9.8,206956,2.905,19.601,0,0,0
2018,i) 5000 to 9999,1308,134908,7341891,7268270,8853,6.608,6977,5.207999999999998,861871,208278,653593,2.866,11.858,705825,158806,547019,2.185,9.711,156046,2.147,19.422,0,0,0
1978,j) 10000+,689,217183,17311043,17001746,22169,10.319,17489,8.14,2479338,770508,1708830,4.532,14.583,1857702,634819,1222883,3.734,10.927,621636,3.656,21.853,(D),(D),(D)
1979,j) 10000+,686,229359,18349106,17990807,24287,10.733,18143,8.017999999999999,2509565,764071,1745494,4.247,13.949000000000002,1777927,572954,1204973,3.185,9.882,731638,4.067,19.765,0,0,0
1980,j) 10000+,728,243195,18961184,18882944,21224,8.854,14264,5.95,2338315,779279,1559036,4.127,12.383,2173048,485922,1687126,2.573,11.508,165267,0.875,23.016,0,0,0
1981,j) 10000+,792,254162,19199197,19332000,19134,7.567,16535,6.539,2077435,651936,1425499,3.372,10.746,2339917,564652,1775265,2.9210000000000003,12.104,-262482,-1.358,21.492,0,0,0
1982,j) 10000+,866,262931,18602627,18950151,23266,8.898,20326,7.774,1964034,649489,1314545,3.427,10.364,2654271,654715,1999556,3.455,14.007,-690237,-3.642,20.728,0,0,0
1983,j) 10000+,911,264308,18035205,18290995,19153,7.255,18530,7.019,2319073,627683,1691390,3.432,12.679,2828299,663303,2164996,3.626,15.463,-509226,-2.784,25.358,0,0,0
1984,j) 10000+,878,279730,18962081,18612357,26159,9.556,14190,5.184,2653877,963937,1689940,5.1789999999999985,14.259,1935791,511033,1424758,2.7460000000000004,10.401,718086,3.858,20.801,0,0,0
1985,j) 10000+,925,280225,19769623,19524335,22229,7.922999999999999,22876,8.154,2730005,922630,1807375,4.726,13.983,2251236,778816,1472420,3.989,11.53,478769,2.452,23.061,0,0,0
1986,j) 10000+,954,284850,19997955,19968431,21720,7.666,18678,6.5920000000000005,2374642,770939,1603703,3.861,11.892,2314662,678871,1635791,3.4,11.592,59980,0.3,23.183000000000003,0,0,0
1987,j) 10000+,957,291756,19801978,19974808,27597,9.519,23920,8.251,2596652,975662,1620990,4.884,13.0,2928366,944059,1984307,4.726,14.66,-331714,-1.661,25.999,0,0,0
1988,j) 10000+,894,324490,20440484,20313875,39012,12.365,21047,6.671,2830499,984028,1846471,4.8439999999999985,13.934,2585530,831406,1754124,4.093,12.728,244969,1.206,25.456,0,0,0
1989,j) 10000+,962,337866,21142361,20986324,41344,12.594,22198,6.7620000000000005,2835742,989037,1846705,4.713,13.512,2549302,689556,1859746,3.286,12.147,286440,1.365,24.295,0,0,0
1990,j) 10000+,972,349792,22005630,21832432,29142,8.463,18228,5.294,2662706,802912,1859794,3.678,12.196,2307587,584931,1722656,2.679,10.57,355119,1.6269999999999998,21.139,0,0,0
1991,j) 10000+,950,362800,22055222,22217876,31039,8.689,19909,5.573,2451394,880266,1571128,3.962,11.033,2783795,627760,2156035,2.825,12.53,-332401,-1.496,22.067,(D),(D),(D)
1992,j) 10000+,875,358186,21719832,21892085,24773,6.903,26123,7.279,2502851,799651,1703200,3.653,11.433,2836441,838715,1997726,3.831,12.956,-333590,-1.524,22.865,(D),(D),(D)
1993,j) 10000+,1004,353423,21927422,22100074,24988,6.924,39970,11.075,2623358,755875,1867483,3.42,11.87,2984732,982543,2002189,4.4460000000000015,13.505999999999998,-361374,-1.635,23.741,0,0,0
1994,j) 10000+,1135,371573,22514660,22500470,32990,8.878,33031,8.889,2761118,979378,1781740,4.353,12.271,2724328,898196,1826132,3.992,12.108,36790,0.16399999999999998,24.216,0,0,0
1995,j) 10000+,1120,391548,23664491,23507145,32985,8.419,33496,8.549,2934070,1072124,1861946,4.561,12.482,2608507,786756,1821751,3.347,11.097,325563,1.385,22.193,0,0,0
1996,j) 10000+,1118,403828,24437396,24454609,34892,8.649,34035,8.437000000000001,3100636,1073455,2027181,4.39,12.679,3139655,979726,2159929,4.006,12.839,-39019,-0.16,25.358,0,0,0
1997,j) 10000+,978,421208,25651967,25452955,43917,10.405,45654,10.817,3936018,1405765,2530253,5.523,15.464,3520621,1255038,2265583,4.931,13.832,415397,1.632,27.664,0,0,0
1998,j) 10000+,1188,447378,27178282,27009463,47692,10.720999999999998,42606,9.578,3782611,1331038,2451573,4.928,14.005,3420958,1206427,2214531,4.467,12.666,361653,1.339,25.332,0,0,0
1999,j) 10000+,1169,474154,28478107,28456222,47094,9.961,44352,9.381,3940311,1294303,2646008,4.548,13.847,3901049,1321586,2579463,4.644,13.709,39262,0.138,27.418000000000006,0,0,0
2000,j) 10000+,1209,498906,29867468,29746084,51493,10.324000000000002,51211,10.268,4355485,1478575,2876910,4.971,14.642,4121697,1601909,2519788,5.385,13.856,233788,0.7859999999999999,27.713,0,0,0
2001,j) 10000+,1125,526542,30516315,30490291,58092,11.1,51739,9.886,4438175,1714578,2723597,5.622999999999998,14.556,4406369,1401984,3004385,4.598,14.452,31806,0.104,28.903,0,0,0
2002,j) 10000+,1247,540062,29831488,30457820,58175,10.765999999999998,58798,10.880999999999998,4276575,1589555,2687020,5.2189999999999985,14.041,5554654,1780226,3774428,5.845,18.237,-1278079,-4.1960000000000015,28.082,3,194,81108
2003,j) 10000+,1516,547277,29388924,29749985,50714,9.229,55195,10.044,3616756,1298155,2318601,4.364,12.157,4361817,1438690,2923127,4.836,14.662,-745061,-2.504,24.314,(D),(D),(D)
2004,j) 10000+,1175,556263,29513030,29567564,53108,9.523,55891,10.023,3794880,1166864,2628016,3.946,12.835,3927328,1330076,2597252,4.498,13.283,-132448,-0.448,25.669,0,0,0
2005,j) 10000+,1197,575020,30151408,30194909,54103,9.424,52307,9.111,3502977,1170890,2332087,3.878,11.601,3584550,1082916,2501634,3.5860000000000003,11.871,-81573,-0.27,23.202,0,0,0
2006,j) 10000+,1175,607401,31277991,31052457,59789,9.933,48802,8.107999999999999,3982191,1357931,2624260,4.373,12.824000000000002,3554152,1042671,2511481,3.358,11.446,428039,1.378,22.891,0,0,0
2007,j) 10000+,1383,636750,31946465,32071663,67503,10.630999999999998,63887,10.062,4328468,1378434,2950034,4.298,13.496,4579611,1425233,3154378,4.444,14.279000000000002,-251143,-0.7829999999999999,26.992,(D),(D),(D)
2008,j) 10000+,2043,648497,31912182,32154490,49416,7.586,55287,8.487,3745945,1060745,2685200,3.299,11.65,4257611,1207580,3050031,3.756,13.241,-511666,-1.591,23.3,0,0,0
2009,j) 10000+,1198,641878,30746371,31482236,48653,7.487999999999999,64462,9.921,2950115,980350,1969765,3.114,9.371,4443653,1119394,3324259,3.556,14.115,-1493538,-4.744,18.741,(D),(D),(D)
2010,j) 10000+,1181,630847,30051199,30480628,38961,6.0920000000000005,56329,8.808,2789236,716521,2072715,2.351,9.151,3625003,978408,2646595,3.21,11.893,-835767,-2.742,18.302,(D),(D),(D)
2011,j) 10000+,1060,637163,30689847,30537052,48435,7.577000000000001,52607,8.23,3444626,840790,2603836,2.753,11.28,3133881,898802,2235079,2.943,10.263,310745,1.018,20.525,(D),(D),(D)
2012,j) 10000+,1118,647300,31380687,31353829,46704,7.199,49646,7.652,3344234,793660,2550574,2.531,10.666,3284338,888886,2395452,2.835,10.475,59896,0.191,20.95,0,0,0
2013,j) 10000+,1137,653592,32432216,32344126,51138,7.802,54783,8.359,3506122,1008878,2497244,3.119,10.84,3339910,1032655,2307255,3.193,10.326,166212,0.514,20.652,0,0,0
2014,j) 10000+,1145,675256,33184443,33041501,57313,8.562999999999999,45494,6.7970000000000015,3595508,1003953,2591555,3.0380000000000003,10.882,3312642,880565,2432077,2.665,10.026,282866,0.856,20.051,0,0,0
2015,j) 10000+,1238,694786,34472015,34226687,58189,8.399,54252,7.831,3935830,1182123,2753707,3.454,11.499,3425735,883525,2542210,2.5810000000000004,10.009,510095,1.49,20.018,0,0,0
2016,j) 10000+,1297,732075,35482131,35313190,56559,7.84,35265,4.888,3623754,1011735,2612019,2.865,10.262,3297573,920692,2376881,2.607,9.338,326181,0.924,18.676,(D),(D),(D)
2017,j) 10000+,1343,737072,36250901,36282174,42610,5.715,59610,7.995,3676857,969699,2707158,2.673,10.134,3742065,1132976,2609089,3.123,10.314,-65208,-0.18,20.268,0,0,0
2018,j) 10000+,1129,744847,37348632,37103862,41016,5.49,45396,6.077000000000001,3579427,990442,2588985,2.669,9.647,3089014,834509,2254505,2.249,8.325,490413,1.3219999999999998,16.651,0,0,0
